rank_number,actor,contributions,percent,cumulative_sum,cumulative_percent,all_contributions
1,phlax,1207,0.27862,1207,0.27862,433208
2,RamLavi,919,0.21214,2126,0.49076,433208
3,M00nF1sh,725,0.16736,2851,0.65811,433208
4,J0zi,663,0.15304,3514,0.81116,433208
5,mvalahtv,651,0.15027,4165,0.96143,433208
6,PhanLe1010,478,0.11034,4643,1.07177,433208
7,ormergi,470,0.10849,5113,1.18026,433208
8,zasweq,470,0.10849,5583,1.28876,433208
9,cynthia-sg,448,0.10341,6031,1.39217,433208
10,lhy1024,443,0.10226,6474,1.49443,433208
11,im-konge,442,0.10203,6916,1.59646,433208
12,rleungx,431,0.09949,7347,1.69595,433208
13,Yisaer,394,0.09095,7741,1.78690,433208
14,natalieparellano,374,0.08633,8115,1.87323,433208
15,nate-double-u,344,0.07941,8459,1.95264,433208
16,eduser25,338,0.07802,8797,2.03066,433208
17,mateuszrzeszutek,326,0.07525,9123,2.10592,433208
18,Thor-wl,325,0.07502,9448,2.18094,433208
19,jannfis,322,0.07433,9770,2.25527,433208
20,whynowy,317,0.07318,10087,2.32844,433208
21,xpivarc,288,0.06648,10375,2.39492,433208
22,eric846,287,0.06625,10662,2.46117,433208
23,mattcary,283,0.06533,10945,2.52650,433208
24,mraleph,283,0.06533,11228,2.59183,433208
25,mfelsche,280,0.06463,11508,2.65646,433208
26,Fox32,273,0.06302,11781,2.71948,433208
27,mvalarh,256,0.05909,12037,2.77857,433208
28,HunDunDM,250,0.05771,12287,2.83628,433208
29,aabmass,239,0.05517,12526,2.89145,433208
30,howieyuen,239,0.05517,12765,2.94662,433208
31,dubious90,229,0.05286,12994,2.99948,433208
32,NathanielRN,227,0.05240,13221,3.05188,433208
33,5kbpers,207,0.04778,13428,3.09967,433208
34,Little-Wallace,200,0.04617,13628,3.14583,433208
35,CLAassistant,192,0.04432,13820,3.19015,433208
36,hallaroo,191,0.04409,14011,3.23424,433208
37,fewdan,179,0.04132,14190,3.27556,433208
38,JornShen,178,0.04109,14368,3.31665,433208
39,tkashem,174,0.04017,14542,3.35682,433208
40,dengliming,172,0.03970,14714,3.39652,433208
41,hossain-rayhan,172,0.03970,14886,3.43622,433208
42,marcuseide,171,0.03947,15057,3.47570,433208
43,sanderson042,158,0.03647,15215,3.51217,433208
44,KBaichoo,152,0.03509,15367,3.54726,433208
45,wjuan-AFK,150,0.03463,15517,3.58188,433208
46,donnadionne,146,0.03370,15663,3.61558,433208
47,abhishekjakhar,140,0.03232,15803,3.64790,433208
48,anupdhml,134,0.03093,15937,3.67883,433208
49,brybacki,133,0.03070,16070,3.70953,433208
50,ZenoTan,133,0.03070,16203,3.74024,433208
51,andylokandy,131,0.03024,16334,3.77048,433208
52,farah,128,0.02955,16462,3.80002,433208
53,GsssC,125,0.02885,16587,3.82888,433208
54,chriswldenyer,121,0.02793,16708,3.85681,433208
55,markruler,120,0.02770,16828,3.88451,433208
56,nicolehanjing,120,0.02770,16948,3.91221,433208
57,lalitb,117,0.02701,17065,3.93922,433208
58,mx-psi,114,0.02632,17179,3.96553,433208
59,ryanvazquez,112,0.02585,17291,3.99139,433208
60,tetchel,112,0.02585,17403,4.01724,433208
61,silenceper,109,0.02516,17512,4.04240,433208
62,JQrdan,107,0.02470,17619,4.06710,433208
63,pmm-sumo,105,0.02424,17724,4.09134,433208
64,prezha,105,0.02424,17829,4.11557,433208
65,michalxo,104,0.02401,17933,4.13958,433208
66,hackabletype,103,0.02378,18036,4.16336,433208
67,nictownsend,103,0.02378,18139,4.18713,433208
68,ffe4,102,0.02355,18241,4.21068,433208
69,marseel,101,0.02331,18342,4.23399,433208
70,wbpcode,101,0.02331,18443,4.25731,433208
71,zhiguo-lu,98,0.02262,18541,4.27993,433208
72,dcherman,94,0.02170,18635,4.30163,433208
73,howardlau1999,94,0.02170,18729,4.32333,433208
74,imavroukakis,93,0.02147,18822,4.34480,433208
75,dwillist,89,0.02054,18911,4.36534,433208
76,Rustin-Liu,89,0.02054,19000,4.38588,433208
77,dhenneke,87,0.02008,19087,4.40597,433208
78,masap,85,0.01962,19172,4.42559,433208
79,mikechengwei,85,0.01962,19257,4.44521,433208
80,natasha41575,85,0.01962,19342,4.46483,433208
81,cloudcafetech,81,0.01870,19423,4.48353,433208
82,shysank,81,0.01870,19504,4.50223,433208
83,ashithasantosh,80,0.01847,19584,4.52069,433208
84,bsdnet,80,0.01847,19664,4.53916,433208
85,k-wiatrzyk,80,0.01847,19744,4.55763,433208
86,morlay,80,0.01847,19824,4.57609,433208
87,sbailey-arm,80,0.01847,19904,4.59456,433208
88,thejoycekung,80,0.01847,19984,4.61303,433208
89,robertlaurin,79,0.01824,20063,4.63126,433208
90,lipingxue,78,0.01801,20141,4.64927,433208
91,timbonicus,78,0.01801,20219,4.66727,433208
92,vteratipally,78,0.01801,20297,4.68528,433208
93,evantorrie,77,0.01777,20374,4.70305,433208
94,Marvin9,77,0.01777,20451,4.72083,433208
95,frigus02,76,0.01754,20527,4.73837,433208
96,hi-rustin,76,0.01754,20603,4.75591,433208
97,zorro786,76,0.01754,20679,4.77346,433208
98,cindyxue,73,0.01685,20752,4.79031,433208
99,gohilankit,73,0.01685,20825,4.80716,433208
100,khos2ow,73,0.01685,20898,4.82401,433208
101,demonCoder95,72,0.01662,20970,4.84063,433208
102,justin-mp,72,0.01662,21042,4.85725,433208
103,ityuhui,71,0.01639,21113,4.87364,433208
104,macrogreg,71,0.01639,21184,4.89003,433208
105,chlins,70,0.01616,21254,4.90619,433208
106,kennytm,70,0.01616,21324,4.92235,433208
107,ezrasilvera,69,0.01593,21393,4.93827,433208
108,keithchong,69,0.01593,21462,4.95420,433208
109,wanlin31,69,0.01593,21531,4.97013,433208
110,zhongzc,69,0.01593,21600,4.98606,433208
111,didier-durand,68,0.01570,21668,5.00175,433208
112,A4k9,67,0.01547,21735,5.01722,433208
113,Git-Jiro,67,0.01547,21802,5.03269,433208
114,spoplavskiy,67,0.01547,21869,5.04815,433208
115,djaglowski,66,0.01524,21935,5.06339,433208
116,eratnch,66,0.01524,22001,5.07862,433208
117,luogangyi,66,0.01524,22067,5.09386,433208
118,yashvardhan-kukreja,66,0.01524,22133,5.10909,433208
119,aman-bansal,65,0.01500,22198,5.12410,433208
120,Sakuralbj,65,0.01500,22263,5.13910,433208
121,warber,65,0.01500,22328,5.15411,433208
122,benhxy,64,0.01477,22392,5.16888,433208
123,qqustc,64,0.01477,22456,5.18365,433208
124,takaf04,64,0.01477,22520,5.19843,433208
125,Promaethius,63,0.01454,22583,5.21297,433208
126,prondubuisi,63,0.01454,22646,5.22751,433208
127,vamossagar12,63,0.01454,22709,5.24205,433208
128,xzfc,63,0.01454,22772,5.25660,433208
129,askdba,62,0.01431,22834,5.27091,433208
130,iain-b,62,0.01431,22896,5.28522,433208
131,sashrith,61,0.01408,22957,5.29930,433208
132,admiral0,60,0.01385,23017,5.31315,433208
133,MaXinjian,60,0.01385,23077,5.32700,433208
134,relu,59,0.01362,23136,5.34062,433208
135,yuyiying,59,0.01362,23195,5.35424,433208
136,bvwells,58,0.01339,23253,5.36763,433208
137,chgl,58,0.01339,23311,5.38102,433208
138,johncming,58,0.01339,23369,5.39441,433208
139,lianghao208,58,0.01339,23427,5.40779,433208
140,tjoshum,58,0.01339,23485,5.42118,433208
141,Rainton,57,0.01316,23542,5.43434,433208
142,toddmgreer,57,0.01316,23599,5.44750,433208
143,frezbo,56,0.01293,23655,5.46043,433208
144,jgwest,56,0.01293,23711,5.47335,433208
145,glorv,55,0.01270,23766,5.48605,433208
146,jim3ma,55,0.01270,23821,5.49874,433208
147,Tianlin-Zhao,55,0.01270,23876,5.51144,433208
148,duduainankai,54,0.01247,23930,5.52391,433208
149,erictnilsson,54,0.01247,23984,5.53637,433208
150,GuptaManan100,54,0.01247,24038,5.54884,433208
151,kubotat,54,0.01247,24092,5.56130,433208
152,supirman,54,0.01247,24146,5.57377,433208
153,Ashmita152,53,0.01223,24199,5.58600,433208
154,jonahjon,53,0.01223,24252,5.59823,433208
155,jimmyseto,52,0.01200,24304,5.61024,433208
156,namrata-ibm,52,0.01200,24356,5.62224,433208
157,rancherio-gh-m,52,0.01200,24408,5.63424,433208
158,sfowl,52,0.01200,24460,5.64625,433208
159,chux0519,51,0.01177,24511,5.65802,433208
160,gabrielecerami,51,0.01177,24562,5.66979,433208
161,ilya-zuyev,51,0.01177,24613,5.68157,433208
162,khhirani,51,0.01177,24664,5.69334,433208
163,shovnik,51,0.01177,24715,5.70511,433208
164,vinny-sabatini,51,0.01177,24766,5.71688,433208
165,Xaenalt,51,0.01177,24817,5.72866,433208
166,bhavyachoudhary,50,0.01154,24867,5.74020,433208
167,cfzjywxk,50,0.01154,24917,5.75174,433208
168,dlabaj,50,0.01154,24967,5.76328,433208
169,TannerGabriel,50,0.01154,25017,5.77482,433208
170,accelsao,49,0.01131,25066,5.78614,433208
171,foreseeable,49,0.01131,25115,5.79745,433208
172,johnnyshields,49,0.01131,25164,5.80876,433208
173,LuckySB,49,0.01131,25213,5.82007,433208
174,fpliu233,48,0.01108,25261,5.83115,433208
175,samiramkr,48,0.01108,25309,5.84223,433208
176,sumitjadhav1,48,0.01108,25357,5.85331,433208
177,WT-Liu,48,0.01108,25405,5.86439,433208
178,xukaren,48,0.01108,25453,5.87547,433208
179,dgiebert,47,0.01085,25500,5.88632,433208
180,erichsueh3,47,0.01085,25547,5.89717,433208
181,frbimo,47,0.01085,25594,5.90802,433208
182,reylejano-rxm,47,0.01085,25641,5.91887,433208
183,BellaXiang,46,0.01062,25687,5.92948,433208
184,daksh-sagar,46,0.01062,25733,5.94010,433208
185,samflattery,46,0.01062,25779,5.95072,433208
186,adamdmharvey,45,0.01039,25824,5.96111,433208
187,alertedsnake,45,0.01039,25869,5.97150,433208
188,amanbrar1999,45,0.01039,25914,5.98188,433208
189,ansjsun,45,0.01039,25959,5.99227,433208
190,ayberk,45,0.01039,26004,6.00266,433208
191,AzfaarQureshi,45,0.01039,26049,6.01305,433208
192,g-easy,45,0.01039,26094,6.02343,433208
193,MarcusNoble,45,0.01039,26139,6.03382,433208
194,raghvenders,45,0.01039,26184,6.04421,433208
195,thehajime,45,0.01039,26229,6.05460,433208
196,bharath-123,44,0.01016,26273,6.06475,433208
197,christopherfriedrich,44,0.01016,26317,6.07491,433208
198,Andres-GC,43,0.00993,26360,6.08484,433208
199,dlouks,43,0.00993,26403,6.09476,433208
200,evalsocket,43,0.00993,26446,6.10469,433208
201,gshively11,43,0.00993,26489,6.11461,433208
202,HaibaraAi96,43,0.00993,26532,6.12454,433208
203,JessicaGreben,43,0.00993,26575,6.13447,433208
204,mrnold,43,0.00993,26618,6.14439,433208
205,anukul,42,0.00970,26660,6.15409,433208
206,dthorsen,42,0.00970,26702,6.16378,433208
207,iciclespider,42,0.00970,26744,6.17348,433208
208,JasonXZLiu,42,0.00970,26786,6.18317,433208
209,marcingrzejszczak,42,0.00970,26828,6.19287,433208
210,themousepotato,42,0.00970,26870,6.20256,433208
211,yoonian,42,0.00970,26912,6.21226,433208
212,HaonanFeng,41,0.00946,26953,6.22172,433208
213,zen-xu,41,0.00946,26994,6.23119,433208
214,ankitjain28may,40,0.00923,27034,6.24042,433208
215,HaloFour,40,0.00923,27074,6.24965,433208
216,lala123912,40,0.00923,27114,6.25889,433208
217,PhilipSchmid,40,0.00923,27154,6.26812,433208
218,chetan-rns,39,0.00900,27193,6.27712,433208
219,kasey,39,0.00900,27232,6.28613,433208
220,dstdfx,38,0.00877,27270,6.29490,433208
221,yanchicago,38,0.00877,27308,6.30367,433208
222,Agent-Tao,37,0.00854,27345,6.31221,433208
223,LCaparelli,37,0.00854,27382,6.32075,433208
224,nprajilesh,37,0.00854,27419,6.32929,433208
225,soulseen,37,0.00854,27456,6.33783,433208
226,wenxinnnnn,37,0.00854,27493,6.34637,433208
227,yyyogev,37,0.00854,27530,6.35491,433208
228,acoutts,36,0.00831,27566,6.36323,433208
229,aribalam,36,0.00831,27602,6.37154,433208
230,aruniiird,36,0.00831,27638,6.37985,433208
231,christopher-taormina-zocdoc,36,0.00831,27674,6.38816,433208
232,eapolinario,36,0.00831,27710,6.39647,433208
233,evanap,36,0.00831,27746,6.40478,433208
234,jrivers96,36,0.00831,27782,6.41309,433208
235,lewtakm,36,0.00831,27818,6.42140,433208
236,mohanli-ml,36,0.00831,27854,6.42971,433208
237,sevagh,36,0.00831,27890,6.43802,433208
238,champtar,35,0.00808,27925,6.44610,433208
239,digambar15,35,0.00808,27960,6.45417,433208
240,Fullstop000,35,0.00808,27995,6.46225,433208
241,nebffa,35,0.00808,28030,6.47033,433208
242,nic-chen,35,0.00808,28065,6.47841,433208
243,pperiyasamy,35,0.00808,28100,6.48649,433208
244,ttlv,35,0.00808,28135,6.49457,433208
245,vitaliy-leschenko,35,0.00808,28170,6.50265,433208
246,amckinley,34,0.00785,28204,6.51050,433208
247,bai,34,0.00785,28238,6.51835,433208
248,brendasukh,34,0.00785,28272,6.52620,433208
249,czunker,34,0.00785,28306,6.53404,433208
250,eth0xFEED,34,0.00785,28340,6.54189,433208
251,jameshilliard,34,0.00785,28374,6.54974,433208
252,jkld11,34,0.00785,28408,6.55759,433208
253,luckoseabraham,34,0.00785,28442,6.56544,433208
254,Yellow-L,34,0.00785,28476,6.57329,433208
255,dnouri,33,0.00762,28509,6.58090,433208
256,Frodez,33,0.00762,28542,6.58852,433208
257,galemccommons,33,0.00762,28575,6.59614,433208
258,jabhishek87,33,0.00762,28608,6.60376,433208
259,jebter,33,0.00762,28641,6.61137,433208
260,kwangil-ha,33,0.00762,28674,6.61899,433208
261,mecampbellsoup,33,0.00762,28707,6.62661,433208
262,melkorm,33,0.00762,28740,6.63423,433208
263,neha-viswanathan,33,0.00762,28773,6.64184,433208
264,samrabelachew,33,0.00762,28806,6.64946,433208
265,saranyaeu2987,33,0.00762,28839,6.65708,433208
266,SteveMattar,33,0.00762,28872,6.66470,433208
267,svrnm,33,0.00762,28905,6.67231,433208
268,timebertt,33,0.00762,28938,6.67993,433208
269,Wenshiqi222,33,0.00762,28971,6.68755,433208
270,xiang17,33,0.00762,29004,6.69517,433208
271,baiyutang,32,0.00739,29036,6.70255,433208
272,h3poteto,32,0.00739,29068,6.70994,433208
273,hanamantagoudvk,32,0.00739,29100,6.71733,433208
274,HEllRZA,32,0.00739,29132,6.72471,433208
275,jorgenj,32,0.00739,29164,6.73210,433208
276,jsuereth,32,0.00739,29196,6.73949,433208
277,LalitMaganti,32,0.00739,29228,6.74687,433208
278,llhuii,32,0.00739,29260,6.75426,433208
279,obeyda,32,0.00739,29292,6.76165,433208
280,prakhargurunani,32,0.00739,29324,6.76903,433208
281,rdxmb,32,0.00739,29356,6.77642,433208
282,tkleczek,32,0.00739,29388,6.78381,433208
283,vijay5158,32,0.00739,29420,6.79119,433208
284,DirtyCajunRice,31,0.00716,29451,6.79835,433208
285,elgamal2020,31,0.00716,29482,6.80551,433208
286,jiajunye,31,0.00716,29513,6.81266,433208
287,jopit,31,0.00716,29544,6.81982,433208
288,jqmichael,31,0.00716,29575,6.82697,433208
289,kumars17,31,0.00716,29606,6.83413,433208
290,LeoLiuYan,31,0.00716,29637,6.84129,433208
291,mbakalov,31,0.00716,29668,6.84844,433208
292,sanvir10,31,0.00716,29699,6.85560,433208
293,ssscottt,31,0.00716,29730,6.86275,433208
294,Vemmy124,31,0.00716,29761,6.86991,433208
295,zhaocheng173,31,0.00716,29792,6.87707,433208
296,anthonyrtong,30,0.00693,29822,6.88399,433208
297,chhanz,30,0.00693,29852,6.89092,433208
298,darkn3rd,30,0.00693,29882,6.89784,433208
299,gmcrobert,30,0.00693,29912,6.90477,433208
300,maugustosilva,30,0.00693,29942,6.91169,433208
301,mmerkes,30,0.00693,29972,6.91862,433208
302,robwknox,30,0.00693,30002,6.92554,433208
303,shaochengwang,30,0.00693,30032,6.93247,433208
304,tustvold,30,0.00693,30062,6.93939,433208
305,willarmiros,30,0.00693,30092,6.94632,433208
306,andrascz,29,0.00669,30121,6.95301,433208
307,axelgobletbdr,29,0.00669,30150,6.95971,433208
308,clearday4,29,0.00669,30179,6.96640,433208
309,Emc1992,29,0.00669,30208,6.97309,433208
310,HannahShiSFB,29,0.00669,30237,6.97979,433208
311,jsalinas29,29,0.00669,30266,6.98648,433208
312,legendecas,29,0.00669,30295,6.99318,433208
313,PeterAdams-A,29,0.00669,30324,6.99987,433208
314,steled,29,0.00669,30353,7.00656,433208
315,yinlei-jinan,29,0.00669,30382,7.01326,433208
316,Akshay-Nagle,28,0.00646,30410,7.01972,433208
317,andrewbanchich,28,0.00646,30438,7.02619,433208
318,ansonauhk,28,0.00646,30466,7.03265,433208
319,bhiravabhatla,28,0.00646,30494,7.03911,433208
320,DanielQujun,28,0.00646,30522,7.04558,433208
321,ElisaMeng,28,0.00646,30550,7.05204,433208
322,linjiemiao,28,0.00646,30578,7.05850,433208
323,luizluca,28,0.00646,30606,7.06497,433208
324,merryzhou,28,0.00646,30634,7.07143,433208
325,Oghenebrume50,28,0.00646,30662,7.07789,433208
326,rptaylor,28,0.00646,30690,7.08436,433208
327,stefannica,28,0.00646,30718,7.09082,433208
328,todaygood,28,0.00646,30746,7.09728,433208
329,vpnachev,28,0.00646,30774,7.10375,433208
330,wilguo,28,0.00646,30802,7.11021,433208
331,aceeric,27,0.00623,30829,7.11644,433208
332,ahlaw,27,0.00623,30856,7.12268,433208
333,dearchap,27,0.00623,30883,7.12891,433208
334,harridu,27,0.00623,30910,7.13514,433208
335,holmesb,27,0.00623,30937,7.14137,433208
336,jibone,27,0.00623,30964,7.14761,433208
337,kkHAIKE,27,0.00623,30991,7.15384,433208
338,kscharm,27,0.00623,31018,7.16007,433208
339,liuming-dev,27,0.00623,31045,7.16630,433208
340,rampratapa,27,0.00623,31072,7.17254,433208
341,realshuting,27,0.00623,31099,7.17877,433208
342,TopSwagCode,27,0.00623,31126,7.18500,433208
343,advancedwebdeveloper,26,0.00600,31152,7.19100,433208
344,ananda1066,26,0.00600,31178,7.19700,433208
345,Benjile,26,0.00600,31204,7.20301,433208
346,bigkevmcd,26,0.00600,31230,7.20901,433208
347,dewan-ahmed,26,0.00600,31256,7.21501,433208
348,fabriziomello,26,0.00600,31282,7.22101,433208
349,fgiudici,26,0.00600,31308,7.22701,433208
350,fnpanic,26,0.00600,31334,7.23302,433208
351,GauravSarkar,26,0.00600,31360,7.23902,433208
352,hezise,26,0.00600,31386,7.24502,433208
353,miguelsorianod,26,0.00600,31412,7.25102,433208
354,pankajmt,26,0.00600,31438,7.25702,433208
355,polarathene,26,0.00600,31464,7.26302,433208
356,Poor12,26,0.00600,31490,7.26903,433208
357,ryaneorth,26,0.00600,31516,7.27503,433208
358,saswatamcode,26,0.00600,31542,7.28103,433208
359,stoyanr,26,0.00600,31568,7.28703,433208
360,xhebox,26,0.00600,31594,7.29303,433208
361,yxxhero,26,0.00600,31620,7.29903,433208
362,zhiweiyin318,26,0.00600,31646,7.30504,433208
363,3pointer,25,0.00577,31671,7.31081,433208
364,acharaj,25,0.00577,31696,7.31658,433208
365,bernokl,25,0.00577,31721,7.32235,433208
366,bnrjee,25,0.00577,31746,7.32812,433208
367,chinazj,25,0.00577,31771,7.33389,433208
368,fourpastmidnight,25,0.00577,31796,7.33966,433208
369,fzyzcjy,25,0.00577,31821,7.34543,433208
370,imeoer,25,0.00577,31846,7.35120,433208
371,jmpfar,25,0.00577,31871,7.35697,433208
372,lupengamzn,25,0.00577,31896,7.36274,433208
373,mbtamuli,25,0.00577,31921,7.36852,433208
374,mlavacca,25,0.00577,31946,7.37429,433208
375,mrmassis,25,0.00577,31971,7.38006,433208
376,NetPenguins,25,0.00577,31996,7.38583,433208
377,raiedkhan,25,0.00577,32021,7.39160,433208
378,sergeyshaykhullin,25,0.00577,32046,7.39737,433208
379,shahzzzam,25,0.00577,32071,7.40314,433208
380,shalier,25,0.00577,32096,7.40891,433208
381,sharkymcdongles,25,0.00577,32121,7.41468,433208
382,sudeeptoroy,25,0.00577,32146,7.42045,433208
383,vishaltak,25,0.00577,32171,7.42622,433208
384,yuhaohaoyu,25,0.00577,32196,7.43200,433208
385,zhangguanzhang,25,0.00577,32221,7.43777,433208
386,avats-dev,24,0.00554,32245,7.44331,433208
387,beshaya,24,0.00554,32269,7.44885,433208
388,bradwood,24,0.00554,32293,7.45439,433208
389,crflynn,24,0.00554,32317,7.45993,433208
390,DanteLee,24,0.00554,32341,7.46547,433208
391,felipecrs,24,0.00554,32365,7.47101,433208
392,geoffcline,24,0.00554,32389,7.47655,433208
393,iotty,24,0.00554,32413,7.48209,433208
394,jarebudev,24,0.00554,32437,7.48763,433208
395,kfirfer,24,0.00554,32461,7.49317,433208
396,Lucas-Irvine,24,0.00554,32485,7.49871,433208
397,Melissa-lu,24,0.00554,32509,7.50425,433208
398,mochizuki875,24,0.00554,32533,7.50979,433208
399,nirav-chotai,24,0.00554,32557,7.51533,433208
400,object88,24,0.00554,32581,7.52087,433208
401,scheler,24,0.00554,32605,7.52641,433208
402,simrandhaliw,24,0.00554,32629,7.53195,433208
403,smlx,24,0.00554,32653,7.53749,433208
404,snyksec,24,0.00554,32677,7.54303,433208
405,stschenk,24,0.00554,32701,7.54857,433208
406,Sudhar287,24,0.00554,32725,7.55411,433208
407,thomacos,24,0.00554,32749,7.55965,433208
408,tuxpeople,24,0.00554,32773,7.56519,433208
409,vkvamsiopsmx,24,0.00554,32797,7.57073,433208
410,yugantrana,24,0.00554,32821,7.57627,433208
411,AJEETRAI707,23,0.00531,32844,7.58158,433208
412,Akhilesh2412,23,0.00531,32867,7.58689,433208
413,hila3000,23,0.00531,32890,7.59220,433208
414,jrsapi,23,0.00531,32913,7.59751,433208
415,kashifsoofi,23,0.00531,32936,7.60281,433208
416,kinarashah,23,0.00531,32959,7.60812,433208
417,leeyspaul,23,0.00531,32982,7.61343,433208
418,mike1808,23,0.00531,33005,7.61874,433208
419,nitrag,23,0.00531,33028,7.62405,433208
420,Patrick0308,23,0.00531,33051,7.62936,433208
421,slaurencelle,23,0.00531,33074,7.63467,433208
422,snakwu,23,0.00531,33097,7.63998,433208
423,storyicon,23,0.00531,33120,7.64529,433208
424,varunpurohit76,23,0.00531,33143,7.65060,433208
425,vsychov,23,0.00531,33166,7.65591,433208
426,wangxy518,23,0.00531,33189,7.66122,433208
427,WilliamChang80,23,0.00531,33212,7.66653,433208
428,Andrewmatilde,22,0.00508,33234,7.67160,433208
429,carolinee21,22,0.00508,33256,7.67668,433208
430,dackroyd,22,0.00508,33278,7.68176,433208
431,eagleusb,22,0.00508,33300,7.68684,433208
432,fktkrt,22,0.00508,33322,7.69192,433208
433,GlennBullingham,22,0.00508,33344,7.69700,433208
434,Glyphack,22,0.00508,33366,7.70207,433208
435,goober,22,0.00508,33388,7.70715,433208
436,gwang550,22,0.00508,33410,7.71223,433208
437,Hongbo-Miao,22,0.00508,33432,7.71731,433208
438,iamEAP,22,0.00508,33454,7.72239,433208
439,jihoon-seo,22,0.00508,33476,7.72747,433208
440,kaifeng,22,0.00508,33498,7.73254,433208
441,MarkSeufert,22,0.00508,33520,7.73762,433208
442,nehaalhat,22,0.00508,33542,7.74270,433208
443,rajaskakodkar,22,0.00508,33564,7.74778,433208
444,rjs211,22,0.00508,33586,7.75286,433208
445,srjames90,22,0.00508,33608,7.75794,433208
446,stevenshuang,22,0.00508,33630,7.76301,433208
447,svallala,22,0.00508,33652,7.76809,433208
448,user-name-is-taken,22,0.00508,33674,7.77317,433208
449,VictoryWekwa,22,0.00508,33696,7.77825,433208
450,vperi1730,22,0.00508,33718,7.78333,433208
451,alokhom,21,0.00485,33739,7.78818,433208
452,gentcys,21,0.00485,33760,7.79302,433208
453,heidemn-faro,21,0.00485,33781,7.79787,433208
454,Howie66,21,0.00485,33802,7.80272,433208
455,itsecforu,21,0.00485,33823,7.80757,433208
456,jiashiwen,21,0.00485,33844,7.81241,433208
457,JPZ13,21,0.00485,33865,7.81726,433208
458,jtmalinowski,21,0.00485,33886,7.82211,433208
459,jwelch92,21,0.00485,33907,7.82696,433208
460,lmtyler,21,0.00485,33928,7.83180,433208
461,lyind,21,0.00485,33949,7.83665,433208
462,miff2000,21,0.00485,33970,7.84150,433208
463,mowangdk,21,0.00485,33991,7.84635,433208
464,Mr-Howard-Roark,21,0.00485,34012,7.85119,433208
465,mswilson,21,0.00485,34033,7.85604,433208
466,paulpach,21,0.00485,34054,7.86089,433208
467,pmalek-sumo,21,0.00485,34075,7.86574,433208
468,prithvi1307,21,0.00485,34096,7.87058,433208
469,ranton256,21,0.00485,34117,7.87543,433208
470,renkelvin,21,0.00485,34138,7.88028,433208
471,runewake2,21,0.00485,34159,7.88513,433208
472,srprash,21,0.00485,34180,7.88997,433208
473,tasekida,21,0.00485,34201,7.89482,433208
474,wuqihui0317,21,0.00485,34222,7.89967,433208
475,wyTrivail,21,0.00485,34243,7.90452,433208
476,zbbkeepgoing,21,0.00485,34264,7.90936,433208
477,ZhaoTianlin990121,21,0.00485,34285,7.91421,433208
478,akiselev1,20,0.00462,34305,7.91883,433208
479,basanthjenuhb,20,0.00462,34325,7.92345,433208
480,Bledai,20,0.00462,34345,7.92806,433208
481,blind-oracle,20,0.00462,34365,7.93268,433208
482,canut,20,0.00462,34385,7.93730,433208
483,christianjoun,20,0.00462,34405,7.94191,433208
484,cwildman,20,0.00462,34425,7.94653,433208
485,deads4k,20,0.00462,34445,7.95115,433208
486,djc,20,0.00462,34465,7.95576,433208
487,DP19,20,0.00462,34485,7.96038,433208
488,drexler,20,0.00462,34505,7.96500,433208
489,etefera,20,0.00462,34525,7.96961,433208
490,ghostsquad,20,0.00462,34545,7.97423,433208
491,hanjunlee,20,0.00462,34565,7.97885,433208
492,kangwoo,20,0.00462,34585,7.98346,433208
493,llapx,20,0.00462,34605,7.98808,433208
494,manueltellez,20,0.00462,34625,7.99270,433208
495,mik-laj,20,0.00462,34645,7.99731,433208
496,mingqishao,20,0.00462,34665,8.00193,433208
497,netikras,20,0.00462,34685,8.00655,433208
498,PatrickXYS,20,0.00462,34705,8.01116,433208
499,pyrl247,20,0.00462,34725,8.01578,433208
500,sestegra,20,0.00462,34745,8.02040,433208
501,shreyagupta30,20,0.00462,34765,8.02501,433208
502,sonofachamp,20,0.00462,34785,8.02963,433208
503,stevefan1999-personal,20,0.00462,34805,8.03425,433208
504,sxd,20,0.00462,34825,8.03886,433208
505,tbickford,20,0.00462,34845,8.04348,433208
506,Thoro,20,0.00462,34865,8.04810,433208
507,tkms0106,20,0.00462,34885,8.05271,433208
508,Zhanxueyou,20,0.00462,34905,8.05733,433208
509,ZihanJiang96,20,0.00462,34925,8.06195,433208
510,zoercai,20,0.00462,34945,8.06656,433208
511,AngleNet,19,0.00439,34964,8.07095,433208
512,brandong954,19,0.00439,34983,8.07534,433208
513,ClSlaid,19,0.00439,35002,8.07972,433208
514,cmastr,19,0.00439,35021,8.08411,433208
515,cpackingham,19,0.00439,35040,8.08849,433208
516,cyberblack28,19,0.00439,35059,8.09288,433208
517,dntosas,19,0.00439,35078,8.09727,433208
518,DrewZhang13,19,0.00439,35097,8.10165,433208
519,dsbrng25b,19,0.00439,35116,8.10604,433208
520,edrevo,19,0.00439,35135,8.11042,433208
521,gkao123,19,0.00439,35154,8.11481,433208
522,gstaware,19,0.00439,35173,8.11919,433208
523,isgoutham,19,0.00439,35192,8.12358,433208
524,jackywu,19,0.00439,35211,8.12797,433208
525,jaideepr97,19,0.00439,35230,8.13235,433208
526,laxmikantbpandhare,19,0.00439,35249,8.13674,433208
527,llyons,19,0.00439,35268,8.14112,433208
528,lvchenggang,19,0.00439,35287,8.14551,433208
529,MarcPow,19,0.00439,35306,8.14990,433208
530,mdeggies,19,0.00439,35325,8.15428,433208
531,MOZGIII,19,0.00439,35344,8.15867,433208
532,osaffer,19,0.00439,35363,8.16305,433208
533,qiutongs,19,0.00439,35382,8.16744,433208
534,SolidifiedRay,19,0.00439,35401,8.17183,433208
535,SpectralHiss,19,0.00439,35420,8.17621,433208
536,sribalakumar,19,0.00439,35439,8.18060,433208
537,SuperFunks,19,0.00439,35458,8.18498,433208
538,timhughes,19,0.00439,35477,8.18937,433208
539,tomqwpl,19,0.00439,35496,8.19375,433208
540,vadeg,19,0.00439,35515,8.19814,433208
541,vivekpatani,19,0.00439,35534,8.20253,433208
542,xiongjiwei,19,0.00439,35553,8.20691,433208
543,yodarshafrir1,19,0.00439,35572,8.21130,433208
544,zbigniew-mandziejewicz-3r,19,0.00439,35591,8.21568,433208
545,alexvaluyskiy,18,0.00416,35609,8.21984,433208
546,AlleyWei,18,0.00416,35627,8.22399,433208
547,BlackRider97,18,0.00416,35645,8.22815,433208
548,bttger,18,0.00416,35663,8.23230,433208
549,davydog187,18,0.00416,35681,8.23646,433208
550,elakito,18,0.00416,35699,8.24061,433208
551,ephesused,18,0.00416,35717,8.24477,433208
552,gavindoudou,18,0.00416,35735,8.24892,433208
553,goreleaserbot,18,0.00416,35753,8.25308,433208
554,heartTorres,18,0.00416,35771,8.25723,433208
555,ilyakaznacheev,18,0.00416,35789,8.26139,433208
556,irizzant,18,0.00416,35807,8.26554,433208
557,johnson-jesse,18,0.00416,35825,8.26970,433208
558,jyz0309,18,0.00416,35843,8.27385,433208
559,kavyashree-r,18,0.00416,35861,8.27801,433208
560,kisieland,18,0.00416,35879,8.28216,433208
561,koxu1996,18,0.00416,35897,8.28632,433208
562,lonewolf3739,18,0.00416,35915,8.29047,433208
563,loozhengyuan,18,0.00416,35933,8.29463,433208
564,matthchr,18,0.00416,35951,8.29878,433208
565,monicagangwar,18,0.00416,35969,8.30294,433208
566,phiremande,18,0.00416,35987,8.30709,433208
567,prahaladdarkin,18,0.00416,36005,8.31125,433208
568,Renkai,18,0.00416,36023,8.31541,433208
569,ryphon,18,0.00416,36041,8.31956,433208
570,Sonichigo,18,0.00416,36059,8.32372,433208
571,stavalfi,18,0.00416,36077,8.32787,433208
572,stylianosrigas,18,0.00416,36095,8.33203,433208
573,sullis,18,0.00416,36113,8.33618,433208
574,tomerleib,18,0.00416,36131,8.34034,433208
575,vanshBhatia-A4k9,18,0.00416,36149,8.34449,433208
576,yiweng-amz,18,0.00416,36167,8.34865,433208
577,yuanhuaiwang,18,0.00416,36185,8.35280,433208
578,yylt,18,0.00416,36203,8.35696,433208
579,actions-user,17,0.00392,36220,8.36088,433208
580,akitok,17,0.00392,36237,8.36480,433208
581,AstroProfundis,17,0.00392,36254,8.36873,433208
582,balchua,17,0.00392,36271,8.37265,433208
583,BernardTolosajr,17,0.00392,36288,8.37658,433208
584,bingbing8,17,0.00392,36305,8.38050,433208
585,cescoffier,17,0.00392,36322,8.38443,433208
586,chandu9333,17,0.00392,36339,8.38835,433208
587,congim,17,0.00392,36356,8.39227,433208
588,conrallendale,17,0.00392,36373,8.39620,433208
589,cpilton,17,0.00392,36390,8.40012,433208
590,daniel-hutao,17,0.00392,36407,8.40405,433208
591,dev-drprasad,17,0.00392,36424,8.40797,433208
592,dprabhua,17,0.00392,36441,8.41189,433208
593,d-reidenbach,17,0.00392,36458,8.41582,433208
594,hoffie,17,0.00392,36475,8.41974,433208
595,ivancili,17,0.00392,36492,8.42367,433208
596,JosephKang,17,0.00392,36509,8.42759,433208
597,liuximu,17,0.00392,36526,8.43152,433208
598,medined,17,0.00392,36543,8.43544,433208
599,mugugnu,17,0.00392,36560,8.43936,433208
600,Nuru,17,0.00392,36577,8.44329,433208
601,omerfsen,17,0.00392,36594,8.44721,433208
602,rayw000,17,0.00392,36611,8.45114,433208
603,santadasu,17,0.00392,36628,8.45506,433208
604,spencer-p,17,0.00392,36645,8.45899,433208
605,Sreevani871,17,0.00392,36662,8.46291,433208
606,steelrooter,17,0.00392,36679,8.46683,433208
607,tkornai,17,0.00392,36696,8.47076,433208
608,tobiaskohlbau,17,0.00392,36713,8.47468,433208
609,totee19,17,0.00392,36730,8.47861,433208
610,utpilla,17,0.00392,36747,8.48253,433208
611,vishsangale,17,0.00392,36764,8.48645,433208
612,wshi5985,17,0.00392,36781,8.49038,433208
613,akshat-kmr,16,0.00369,36797,8.49407,433208
614,ankit-kumar5,16,0.00369,36813,8.49777,433208
615,annapendleton,16,0.00369,36829,8.50146,433208
616,arnoldcui,16,0.00369,36845,8.50515,433208
617,Asafb26,16,0.00369,36861,8.50885,433208
618,Asarew,16,0.00369,36877,8.51254,433208
619,auxten,16,0.00369,36893,8.51623,433208
620,ceastman-ibm,16,0.00369,36909,8.51993,433208
621,chenyw1990,16,0.00369,36925,8.52362,433208
622,Chwetion,16,0.00369,36941,8.52731,433208
623,clarkmcc,16,0.00369,36957,8.53101,433208
624,Corey-Wang,16,0.00369,36973,8.53470,433208
625,courageJ,16,0.00369,36989,8.53839,433208
626,crunchtime-ali,16,0.00369,37005,8.54209,433208
627,cryptk,16,0.00369,37021,8.54578,433208
628,DangerOnTheRanger,16,0.00369,37037,8.54947,433208
629,dcplaya,16,0.00369,37053,8.55317,433208
630,dty1er,16,0.00369,37069,8.55686,433208
631,Duologic,16,0.00369,37085,8.56055,433208
632,dza89,16,0.00369,37101,8.56425,433208
633,dzr201732120115,16,0.00369,37117,8.56794,433208
634,enderson-pan,16,0.00369,37133,8.57163,433208
635,fragtom,16,0.00369,37149,8.57533,433208
636,gaganhegde,16,0.00369,37165,8.57902,433208
637,goku321,16,0.00369,37181,8.58271,433208
638,haslersn,16,0.00369,37197,8.58641,433208
639,jidalong,16,0.00369,37213,8.59010,433208
640,juanvasquezreyes,16,0.00369,37229,8.59379,433208
641,koresar,16,0.00369,37245,8.59749,433208
642,ls889,16,0.00369,37261,8.60118,433208
643,mamiu,16,0.00369,37277,8.60487,433208
644,MariusVolkhart,16,0.00369,37293,8.60857,433208
645,matthewmichihara,16,0.00369,37309,8.61226,433208
646,michalzxc,16,0.00369,37325,8.61595,433208
647,mikelorant,16,0.00369,37341,8.61965,433208
648,mvaal,16,0.00369,37357,8.62334,433208
649,n-oden,16,0.00369,37373,8.62703,433208
650,pallabi-sutradhar,16,0.00369,37389,8.63073,433208
651,paulosjca,16,0.00369,37405,8.63442,433208
652,perithompson,16,0.00369,37421,8.63811,433208
653,r0bj,16,0.00369,37437,8.64181,433208
654,rachelwang20,16,0.00369,37453,8.64550,433208
655,rmiller14,16,0.00369,37469,8.64919,433208
656,roelfdutoit,16,0.00369,37485,8.65289,433208
657,schrej,16,0.00369,37501,8.65658,433208
658,shimron,16,0.00369,37517,8.66027,433208
659,tetrohed,16,0.00369,37533,8.66397,433208
660,tom-haines,16,0.00369,37549,8.66766,433208
661,treasurechristain,16,0.00369,37565,8.67135,433208
662,vividh,16,0.00369,37581,8.67505,433208
663,wabernatScality,16,0.00369,37597,8.67874,433208
664,wangchen615,16,0.00369,37613,8.68243,433208
665,wutkemtt,16,0.00369,37629,8.68613,433208
666,yishuT,16,0.00369,37645,8.68982,433208
667,zsistla,16,0.00369,37661,8.69351,433208
668,ahmednasir91,15,0.00346,37676,8.69698,433208
669,alanisaac,15,0.00346,37691,8.70044,433208
670,alex-vmw,15,0.00346,37706,8.70390,433208
671,anthonyeleven,15,0.00346,37721,8.70736,433208
672,AshishMhrzn10,15,0.00346,37736,8.71083,433208
673,BioZrod,15,0.00346,37751,8.71429,433208
674,bodleytunes,15,0.00346,37766,8.71775,433208
675,chukka,15,0.00346,37781,8.72121,433208
676,distortedsignal,15,0.00346,37796,8.72468,433208
677,DRuggeri,15,0.00346,37811,8.72814,433208
678,dvermd,15,0.00346,37826,8.73160,433208
679,ecokova,15,0.00346,37841,8.73506,433208
680,faceair,15,0.00346,37856,8.73853,433208
681,flavray,15,0.00346,37871,8.74199,433208
682,foreversunyao,15,0.00346,37886,8.74545,433208
683,Frassle,15,0.00346,37901,8.74892,433208
684,glodomorski,15,0.00346,37916,8.75238,433208
685,gowrisankar22,15,0.00346,37931,8.75584,433208
686,grial1,15,0.00346,37946,8.75930,433208
687,HirazawaUi,15,0.00346,37961,8.76277,433208
688,irbekrm,15,0.00346,37976,8.76623,433208
689,jhdalek55,15,0.00346,37991,8.76969,433208
690,jk1z,15,0.00346,38006,8.77315,433208
691,juliusvonkohout,15,0.00346,38021,8.77662,433208
692,junghyeonsu,15,0.00346,38036,8.78008,433208
693,kendallroden,15,0.00346,38051,8.78354,433208
694,kenotsolutions,15,0.00346,38066,8.78700,433208
695,krya-kryak,15,0.00346,38081,8.79047,433208
696,liorokman,15,0.00346,38096,8.79393,433208
697,luodw,15,0.00346,38111,8.79739,433208
698,mailhari,15,0.00346,38126,8.80085,433208
699,marceloamaral,15,0.00346,38141,8.80432,433208
700,NarzeusNabartey,15,0.00346,38156,8.80778,433208
701,nshankar13,15,0.00346,38171,8.81124,433208
702,oldthreefeng,15,0.00346,38186,8.81470,433208
703,qhh0205,15,0.00346,38201,8.81817,433208
704,rajivml,15,0.00346,38216,8.82163,433208
705,ruicraveiro,15,0.00346,38231,8.82509,433208
706,sergioregueira,15,0.00346,38246,8.82855,433208
707,tcordeu,15,0.00346,38261,8.83202,433208
708,tiwalter,15,0.00346,38276,8.83548,433208
709,tjstansell,15,0.00346,38291,8.83894,433208
710,virtumonde,15,0.00346,38306,8.84240,433208
711,vmihailenco,15,0.00346,38321,8.84587,433208
712,wataruian,15,0.00346,38336,8.84933,433208
713,webmutation,15,0.00346,38351,8.85279,433208
714,xmonish,15,0.00346,38366,8.85625,433208
715,yoom2016,15,0.00346,38381,8.85972,433208
716,YourPsychiatrist,15,0.00346,38396,8.86318,433208
717,ZaradarDFDS,15,0.00346,38411,8.86664,433208
718,zjd87,15,0.00346,38426,8.87010,433208
719,abatilo,14,0.00323,38440,8.87334,433208
720,AdarShaked,14,0.00323,38454,8.87657,433208
721,AlexanderMann,14,0.00323,38468,8.87980,433208
722,amitkatyal,14,0.00323,38482,8.88303,433208
723,anmol372,14,0.00323,38496,8.88626,433208
724,antcs,14,0.00323,38510,8.88949,433208
725,astrived,14,0.00323,38524,8.89273,433208
726,aure-olli,14,0.00323,38538,8.89596,433208
727,baremaximum,14,0.00323,38552,8.89919,433208
728,daltonclaybrook,14,0.00323,38566,8.90242,433208
729,danielcooperxyz,14,0.00323,38580,8.90565,433208
730,djjayeeta,14,0.00323,38594,8.90888,433208
731,dr4Ke,14,0.00323,38608,8.91212,433208
732,dsayan154,14,0.00323,38622,8.91535,433208
733,dudadornelles,14,0.00323,38636,8.91858,433208
734,glazychev-art,14,0.00323,38650,8.92181,433208
735,huang-jy,14,0.00323,38664,8.92504,433208
736,humphrieslk,14,0.00323,38678,8.92827,433208
737,isantospardo,14,0.00323,38692,8.93151,433208
738,iusergii,14,0.00323,38706,8.93474,433208
739,khushbuparakh,14,0.00323,38720,8.93797,433208
740,kk-src,14,0.00323,38734,8.94120,433208
741,kosehy,14,0.00323,38748,8.94443,433208
742,lanzhiwang,14,0.00323,38762,8.94766,433208
743,lizhuqi,14,0.00323,38776,8.95090,433208
744,mahmoodhosseini,14,0.00323,38790,8.95413,433208
745,MaximGurschi,14,0.00323,38804,8.95736,433208
746,moikot,14,0.00323,38818,8.96059,433208
747,Naveenkhasyap,14,0.00323,38832,8.96382,433208
748,nishipy,14,0.00323,38846,8.96706,433208
749,Noremac201,14,0.00323,38860,8.97029,433208
750,Pick1a1username,14,0.00323,38874,8.97352,433208
751,postmaxin,14,0.00323,38888,8.97675,433208
752,rajatdiptabiswas,14,0.00323,38902,8.97998,433208
753,renan-campos,14,0.00323,38916,8.98321,433208
754,reselbob,14,0.00323,38930,8.98645,433208
755,ron-debajyoti,14,0.00323,38944,8.98968,433208
756,ryanmvazquez,14,0.00323,38958,8.99291,433208
757,saivishalvangala,14,0.00323,38972,8.99614,433208
758,SarthakJain26,14,0.00323,38986,8.99937,433208
759,Sayrus,14,0.00323,39000,9.00260,433208
760,secret104278,14,0.00323,39014,9.00584,433208
761,selina-cui,14,0.00323,39028,9.00907,433208
762,sguyennet,14,0.00323,39042,9.01230,433208
763,sky132333,14,0.00323,39056,9.01553,433208
764,someshkoli,14,0.00323,39070,9.01876,433208
765,sseneca,14,0.00323,39084,9.02199,433208
766,Svendegroote91,14,0.00323,39098,9.02523,433208
767,tengpengli,14,0.00323,39112,9.02846,433208
768,theangrydev,14,0.00323,39126,9.03169,433208
769,vicsufer,14,0.00323,39140,9.03492,433208
770,virus2016,14,0.00323,39154,9.03815,433208
771,wenzong,14,0.00323,39168,9.04138,433208
772,woodcockjosh,14,0.00323,39182,9.04462,433208
773,wuchaojing,14,0.00323,39196,9.04785,433208
774,xiangpingzhang,14,0.00323,39210,9.05108,433208
775,yixin21,14,0.00323,39224,9.05431,433208
776,Zhang-Jianming,14,0.00323,39238,9.05754,433208
777,zzxgzgz,14,0.00323,39252,9.06077,433208
778,123BLiN,13,0.00300,39265,9.06378,433208
779,abhay-krishna,13,0.00300,39278,9.06678,433208
780,aemperador,13,0.00300,39291,9.06978,433208
781,Anisha-28,13,0.00300,39304,9.07278,433208
782,anovis,13,0.00300,39317,9.07578,433208
783,arivatibm,13,0.00300,39330,9.07878,433208
784,binman-docker,13,0.00300,39343,9.08178,433208
785,bugok,13,0.00300,39356,9.08478,433208
786,celesteking,13,0.00300,39369,9.08778,433208
787,chuckpiercey,13,0.00300,39382,9.09078,433208
788,Coqueiro,13,0.00300,39395,9.09378,433208
789,csuzhangxc,13,0.00300,39408,9.09678,433208
790,darkl0rd,13,0.00300,39421,9.09979,433208
791,denissabramovs,13,0.00300,39434,9.10279,433208
792,dkulchinsky,13,0.00300,39447,9.10579,433208
793,dominikbraun,13,0.00300,39460,9.10879,433208
794,dorny,13,0.00300,39473,9.11179,433208
795,duluong,13,0.00300,39486,9.11479,433208
796,enderv,13,0.00300,39499,9.11779,433208
797,eunice98k,13,0.00300,39512,9.12079,433208
798,flaker,13,0.00300,39525,9.12379,433208
799,ganeshr2,13,0.00300,39538,9.12679,433208
800,hershkoy,13,0.00300,39551,9.12979,433208
801,husky-parul,13,0.00300,39564,9.13280,433208
802,idsvandermolen,13,0.00300,39577,9.13580,433208
803,istepura,13,0.00300,39590,9.13880,433208
804,ITonyLi,13,0.00300,39603,9.14180,433208
805,jasgeo75,13,0.00300,39616,9.14480,433208
806,JasonPad19,13,0.00300,39629,9.14780,433208
807,Jeyakumardevarajulu,13,0.00300,39642,9.15080,433208
808,jiangliu,13,0.00300,39655,9.15380,433208
809,JiaoDean,13,0.00300,39668,9.15680,433208
810,jkassis,13,0.00300,39681,9.15980,433208
811,jkowall,13,0.00300,39694,9.16280,433208
812,johanavril,13,0.00300,39707,9.16580,433208
813,JonghunBok,13,0.00300,39720,9.16881,433208
814,jpmsilva,13,0.00300,39733,9.17181,433208
815,jsrz,13,0.00300,39746,9.17481,433208
816,jurgenweber,13,0.00300,39759,9.17781,433208
817,KSerrania,13,0.00300,39772,9.18081,433208
818,kshitijcode,13,0.00300,39785,9.18381,433208
819,liguozhong,13,0.00300,39798,9.18681,433208
820,lmq1999,13,0.00300,39811,9.18981,433208
821,lostsquirrel,13,0.00300,39824,9.19281,433208
822,m8rge,13,0.00300,39837,9.19581,433208
823,MarianZoll,13,0.00300,39850,9.19881,433208
824,maybe-sybr,13,0.00300,39863,9.20182,433208
825,mbroz2,13,0.00300,39876,9.20482,433208
826,mixmind,13,0.00300,39889,9.20782,433208
827,msamad,13,0.00300,39902,9.21082,433208
828,msk-,13,0.00300,39915,9.21382,433208
829,Murphylu1993,13,0.00300,39928,9.21682,433208
830,nanikjava,13,0.00300,39941,9.21982,433208
831,nitrocode,13,0.00300,39954,9.22282,433208
832,ntaylor1781,13,0.00300,39967,9.22582,433208
833,panos,13,0.00300,39980,9.22882,433208
834,PhotonQuantum,13,0.00300,39993,9.23182,433208
835,phsmith,13,0.00300,40006,9.23482,433208
836,prymitive,13,0.00300,40019,9.23783,433208
837,quintans,13,0.00300,40032,9.24083,433208
838,rahulrai-in,13,0.00300,40045,9.24383,433208
839,RashmiRam,13,0.00300,40058,9.24683,433208
840,renuka-fernando,13,0.00300,40071,9.24983,433208
841,sandhyarme,13,0.00300,40084,9.25283,433208
842,satac2,13,0.00300,40097,9.25583,433208
843,seongpyoHong,13,0.00300,40110,9.25883,433208
844,sepich,13,0.00300,40123,9.26183,433208
845,sharur7,13,0.00300,40136,9.26483,433208
846,ShawnBian,13,0.00300,40149,9.26783,433208
847,Shpectator,13,0.00300,40162,9.27084,433208
848,simonfrey,13,0.00300,40175,9.27384,433208
849,simonvane,13,0.00300,40188,9.27684,433208
850,slavovojacek,13,0.00300,40201,9.27984,433208
851,sushil97,13,0.00300,40214,9.28284,433208
852,talcoh2x,13,0.00300,40227,9.28584,433208
853,tapaskapadia,13,0.00300,40240,9.28884,433208
854,tareqhs,13,0.00300,40253,9.29184,433208
855,therealadum,13,0.00300,40266,9.29484,433208
856,TuckTuckFloof,13,0.00300,40279,9.29784,433208
857,tumido,13,0.00300,40292,9.30084,433208
858,varac,13,0.00300,40305,9.30384,433208
859,VishalGupta04,13,0.00300,40318,9.30685,433208
860,vlsi,13,0.00300,40331,9.30985,433208
861,wangzh21,13,0.00300,40344,9.31285,433208
862,wobu,13,0.00300,40357,9.31585,433208
863,wsj0000,13,0.00300,40370,9.31885,433208
864,ydayagi,13,0.00300,40383,9.32185,433208
865,zerogvt,13,0.00300,40396,9.32485,433208
866,zhangyang1997,13,0.00300,40409,9.32785,433208
867,zlymeda,13,0.00300,40422,9.33085,433208
868,AdityaMisra,12,0.00277,40434,9.33362,433208
870,aimbot31,12,0.00277,40458,9.33916,433208
871,akshaysharama,12,0.00277,40470,9.34193,433208
872,alanbchristie,12,0.00277,40482,9.34470,433208
873,Alon-Katz,12,0.00277,40494,9.34747,433208
874,anishj0shi,12,0.00277,40506,9.35024,433208
875,avdhoot,12,0.00277,40518,9.35301,433208
876,avishayil,12,0.00277,40530,9.35578,433208
877,avorima,12,0.00277,40542,9.35855,433208
878,azush26,12,0.00277,40554,9.36132,433208
879,bkonyi,12,0.00277,40566,9.36409,433208
880,BojanPantovic1989,12,0.00277,40578,9.36686,433208
881,Brunomachadob,12,0.00277,40590,9.36963,433208
882,chenk008,12,0.00277,40602,9.37240,433208
883,clambin,12,0.00277,40614,9.37517,433208
884,clarakosi,12,0.00277,40626,9.37794,433208
885,cusri-admin,12,0.00277,40638,9.38071,433208
886,deveshkandpal24121990,12,0.00277,40650,9.38348,433208
887,devries,12,0.00277,40662,9.38625,433208
888,elweb9858,12,0.00277,40674,9.38902,433208
889,fishautumn,12,0.00277,40686,9.39179,433208
890,garanews,12,0.00277,40698,9.39456,433208
891,GayathriVenkatesh,12,0.00277,40710,9.39733,433208
892,gcacace,12,0.00277,40722,9.40010,433208
893,gee4vee,12,0.00277,40734,9.40287,433208
894,genofire,12,0.00277,40746,9.40564,433208
895,georgeteo,12,0.00277,40758,9.40841,433208
896,gnadaban,12,0.00277,40770,9.41118,433208
897,godomainz,12,0.00277,40782,9.41395,433208
898,hedeesaa,12,0.00277,40794,9.41672,433208
899,helli0n,12,0.00277,40806,9.41949,433208
900,Heraclitus,12,0.00277,40818,9.42226,433208
901,hillbun,12,0.00277,40830,9.42503,433208
902,hsyl4125,12,0.00277,40842,9.42780,433208
903,jamal,12,0.00277,40854,9.43057,433208
904,jorgecarleitao,12,0.00277,40866,9.43334,433208
905,jorgemarey,12,0.00277,40878,9.43611,433208
906,joshua-bone,12,0.00277,40890,9.43888,433208
907,kallisti5,12,0.00277,40902,9.44165,433208
908,Kelvin-M,12,0.00277,40914,9.44442,433208
909,kichloo,12,0.00277,40926,9.44719,433208
910,KKelvinLo,12,0.00277,40938,9.44996,433208
911,kmmanto,12,0.00277,40950,9.45273,433208
912,KR411-prog,12,0.00277,40962,9.45550,433208
913,leilajal,12,0.00277,40974,9.45827,433208
914,lemusthelroy,12,0.00277,40986,9.46104,433208
915,LogicalShark,12,0.00277,40998,9.46381,433208
916,lueenavarro,12,0.00277,41010,9.46658,433208
917,m1o1,12,0.00277,41022,9.46935,433208
918,madhu131313,12,0.00277,41034,9.47212,433208
919,massamany,12,0.00277,41046,9.47489,433208
920,maunavarro,12,0.00277,41058,9.47766,433208
921,miamipanther,12,0.00277,41070,9.48043,433208
922,mihirsoni,12,0.00277,41082,9.48320,433208
923,minxiaogang,12,0.00277,41094,9.48597,433208
924,mishal23,12,0.00277,41106,9.48874,433208
925,namco1992,12,0.00277,41118,9.49151,433208
926,nitgoy,12,0.00277,41130,9.49428,433208
927,noquarteer,12,0.00277,41142,9.49705,433208
928,omegas27,12,0.00277,41154,9.49982,433208
929,omnibs,12,0.00277,41166,9.50259,433208
930,osela,12,0.00277,41178,9.50536,433208
931,pablitoergosum,12,0.00277,41190,9.50813,433208
932,pantaoran,12,0.00277,41202,9.51090,433208
933,PierreZ,12,0.00277,41214,9.51367,433208
934,PocketMobsters,12,0.00277,41226,9.51644,433208
935,punjabdhaputar,12,0.00277,41238,9.51921,433208
936,rajibmitra,12,0.00277,41250,9.52198,433208
937,ramapalani,12,0.00277,41262,9.52475,433208
938,rgowrishankar,12,0.00277,41274,9.52752,433208
939,roysha1,12,0.00277,41286,9.53029,433208
940,rtfee,12,0.00277,41298,9.53306,433208
941,shantpschauhan,12,0.00277,41310,9.53583,433208
942,slott56,12,0.00277,41322,9.53861,433208
943,St0rmingBr4in,12,0.00277,41334,9.54138,433208
944,steve-gray,12,0.00277,41346,9.54415,433208
945,SyamSundarKirubakaran,12,0.00277,41358,9.54692,433208
946,Tej-Singh-Rana,12,0.00277,41370,9.54969,433208
947,tmaxjmc,12,0.00277,41382,9.55246,433208
948,Verlet64,12,0.00277,41394,9.55523,433208
949,vitalif,12,0.00277,41406,9.55800,433208
950,vMansiShah,12,0.00277,41418,9.56077,433208
951,vrodomista,12,0.00277,41430,9.56354,433208
952,vvanouytsel,12,0.00277,41442,9.56631,433208
953,wangao1236,12,0.00277,41454,9.56908,433208
954,WaterKnight1998,12,0.00277,41466,9.57185,433208
955,WillWcchan,12,0.00277,41478,9.57462,433208
956,xesjkeee,12,0.00277,41490,9.57739,433208
957,yangmarcyang,12,0.00277,41502,9.58016,433208
958,yang-padawan,12,0.00277,41514,9.58293,433208
959,yawboateng,12,0.00277,41526,9.58570,433208
960,ying2025,12,0.00277,41538,9.58847,433208
961,yoichiro0217,12,0.00277,41550,9.59124,433208
962,Yoshiki0705,12,0.00277,41562,9.59401,433208
963,yydzhou,12,0.00277,41574,9.59678,433208
964,zhiweiv,12,0.00277,41586,9.59955,433208
965,zihengCat,12,0.00277,41598,9.60232,433208
966,zyshi,12,0.00277,41610,9.60509,433208
967,AbhishekMallick,11,0.00254,41621,9.60762,433208
968,adamnovak,11,0.00254,41632,9.61016,433208
969,ak89224,11,0.00254,41643,9.61270,433208
970,alandovskis,11,0.00254,41654,9.61524,433208
971,allymparker,11,0.00254,41665,9.61778,433208
972,alpha2320,11,0.00254,41676,9.62032,433208
973,amitkrout,11,0.00254,41687,9.62286,433208
974,AmitVishwash,11,0.00254,41698,9.62540,433208
975,andyyumiao,11,0.00254,41709,9.62794,433208
976,ari-hacks,11,0.00254,41720,9.63048,433208
977,bartle-stripe,11,0.00254,41731,9.63302,433208
978,BedivereZero,11,0.00254,41742,9.63556,433208
979,benridley,11,0.00254,41753,9.63810,433208
980,Betula-L,11,0.00254,41764,9.64063,433208
981,boundless-thread,11,0.00254,41775,9.64317,433208
982,cafeliker,11,0.00254,41786,9.64571,433208
983,changweige,11,0.00254,41797,9.64825,433208
984,Chivolta,11,0.00254,41808,9.65079,433208
985,ckuduvalli,11,0.00254,41819,9.65333,433208
986,clementnuss,11,0.00254,41830,9.65587,433208
987,c-n-c,11,0.00254,41841,9.65841,433208
988,cnmcavoy,11,0.00254,41852,9.66095,433208
989,codegagan,11,0.00254,41863,9.66349,433208
990,crazycs520,11,0.00254,41874,9.66603,433208
991,CYarros10,11,0.00254,41885,9.66857,433208
992,dangen-effy,11,0.00254,41896,9.67110,433208
993,danielkucera,11,0.00254,41907,9.67364,433208
994,danrusei,11,0.00254,41918,9.67618,433208
995,davidraskin,11,0.00254,41929,9.67872,433208
996,dekimsey,11,0.00254,41940,9.68126,433208
997,dfeldman,11,0.00254,41951,9.68380,433208
998,dkorzuno,11,0.00254,41962,9.68634,433208
999,domanq,11,0.00254,41973,9.68888,433208
1000,dthadi3,11,0.00254,41984,9.69142,433208
1001,ebullient,11,0.00254,41995,9.69396,433208
1002,efe-selcuk,11,0.00254,42006,9.69650,433208
1003,erismaster,11,0.00254,42017,9.69904,433208
1004,excieve,11,0.00254,42028,9.70158,433208
1005,fabrizior,11,0.00254,42039,9.70411,433208
1006,faust64,11,0.00254,42050,9.70665,433208
1007,forvaidya,11,0.00254,42061,9.70919,433208
1008,gadinaor,11,0.00254,42072,9.71173,433208
1009,gaurav517,11,0.00254,42083,9.71427,433208
1010,glumand,11,0.00254,42094,9.71681,433208
1011,Gsealy,11,0.00254,42105,9.71935,433208
1012,harnitsignalfx,11,0.00254,42116,9.72189,433208
1013,hmlkao,11,0.00254,42127,9.72443,433208
1014,ianbuss,11,0.00254,42138,9.72697,433208
1015,Illyrix,11,0.00254,42149,9.72951,433208
1016,ilmanzo,11,0.00254,42160,9.73205,433208
1017,ilyamor,11,0.00254,42171,9.73458,433208
1018,inigohu,11,0.00254,42182,9.73712,433208
1019,ITD27M01,11,0.00254,42193,9.73966,433208
1020,jayantjain93,11,0.00254,42204,9.74220,433208
1021,jc-roman,11,0.00254,42215,9.74474,433208
1022,jiangxinlingdu,11,0.00254,42226,9.74728,433208
1023,JohnWu20,11,0.00254,42237,9.74982,433208
1024,JonathanLachapelle,11,0.00254,42248,9.75236,433208
1025,jonesbr17,11,0.00254,42259,9.75490,433208
1026,JubayerJoy,11,0.00254,42270,9.75744,433208
1027,kohrapha,11,0.00254,42281,9.75998,433208
1028,kohtala,11,0.00254,42292,9.76252,433208
1029,korjek,11,0.00254,42303,9.76506,433208
1030,lichenglin,11,0.00254,42314,9.76759,433208
1031,lmm,11,0.00254,42325,9.77013,433208
1032,LochanRn,11,0.00254,42336,9.77267,433208
1033,lubingfeng,11,0.00254,42347,9.77521,433208
1034,marsishandsome,11,0.00254,42358,9.77775,433208
1035,mboutet,11,0.00254,42369,9.78029,433208
1036,mc36,11,0.00254,42380,9.78283,433208
1037,MG40,11,0.00254,42391,9.78537,433208
1038,mshivanna,11,0.00254,42402,9.78791,433208
1039,mtsmfm,11,0.00254,42413,9.79045,433208
1040,mugdha-adhav,11,0.00254,42424,9.79299,433208
1041,navinjoy,11,0.00254,42435,9.79553,433208
1042,neilfordyce,11,0.00254,42446,9.79806,433208
1043,NerdSec,11,0.00254,42457,9.80060,433208
1044,odidev,11,0.00254,42468,9.80314,433208
1045,ofirshtrull,11,0.00254,42479,9.80568,433208
1046,ozooxo,11,0.00254,42490,9.80822,433208
1047,paoloteti,11,0.00254,42501,9.81076,433208
1048,pashafirdous,11,0.00254,42512,9.81330,433208
1049,paul42,11,0.00254,42523,9.81584,433208
1050,piyush0609,11,0.00254,42534,9.81838,433208
1051,pnnferreira,11,0.00254,42545,9.82092,433208
1052,potiuk,11,0.00254,42556,9.82346,433208
1053,prash911,11,0.00254,42567,9.82600,433208
1054,qixiaobo,11,0.00254,42578,9.82854,433208
1055,quaff,11,0.00254,42589,9.83107,433208
1056,ricardbejarano,11,0.00254,42600,9.83361,433208
1057,roflc0pter,11,0.00254,42611,9.83615,433208
1058,ronaldyuwandika,11,0.00254,42622,9.83869,433208
1059,RoSk0,11,0.00254,42633,9.84123,433208
1060,SameeraGrandhi,11,0.00254,42644,9.84377,433208
1061,shaowenchen,11,0.00254,42655,9.84631,433208
1062,shibataka000,11,0.00254,42666,9.84885,433208
1063,shmargum,11,0.00254,42677,9.85139,433208
1064,shubham-pampattiwar,11,0.00254,42688,9.85393,433208
1065,SimonMen65,11,0.00254,42699,9.85647,433208
1066,Skarlso,11,0.00254,42710,9.85901,433208
1067,slewiskelly,11,0.00254,42721,9.86154,433208
1068,snehilchopra,11,0.00254,42732,9.86408,433208
1069,soyoo,11,0.00254,42743,9.86662,433208
1070,spaced,11,0.00254,42754,9.86916,433208
1071,srikant-code,11,0.00254,42765,9.87170,433208
1072,SwanSpouse,11,0.00254,42776,9.87424,433208
1073,syacko,11,0.00254,42787,9.87678,433208
1074,tangmingming1,11,0.00254,42798,9.87932,433208
1075,th3wyatt,11,0.00254,42809,9.88186,433208
1076,tillhoff,11,0.00254,42820,9.88440,433208
1077,time-and-fate,11,0.00254,42831,9.88694,433208
1078,timmy59100,11,0.00254,42842,9.88948,433208
1079,timvaillancourt,11,0.00254,42853,9.89201,433208
1080,trishitapingolia,11,0.00254,42864,9.89455,433208
1081,tse77,11,0.00254,42875,9.89709,433208
1082,U24543426,11,0.00254,42886,9.89963,433208
1083,vassilvk,11,0.00254,42897,9.90217,433208
1084,vbfox,11,0.00254,42908,9.90471,433208
1085,vears91,11,0.00254,42919,9.90725,433208
1086,vijayto,11,0.00254,42930,9.90979,433208
1087,walkley,11,0.00254,42941,9.91233,433208
1088,wenyingd,11,0.00254,42952,9.91487,433208
1089,wespanther,11,0.00254,42963,9.91741,433208
1090,wingsofovnia,11,0.00254,42974,9.91995,433208
1091,wpeng102,11,0.00254,42985,9.92249,433208
1092,XanderStrike,11,0.00254,42996,9.92502,433208
1093,xudesheng,11,0.00254,43007,9.92756,433208
1094,yue-wen,11,0.00254,43018,9.93010,433208
1095,zhanghjster,11,0.00254,43029,9.93264,433208
1096,zheng1,11,0.00254,43040,9.93518,433208
1097,ZhuGongpu,11,0.00254,43051,9.93772,433208
1098,zianke,11,0.00254,43062,9.94026,433208
1099,zonnie,11,0.00254,43073,9.94280,433208
1100,abelal83,10,0.00231,43083,9.94511,433208
1101,AdaephonBen,10,0.00231,43093,9.94742,433208
1102,Adolph-An,10,0.00231,43103,9.94972,433208
1103,aebirim,10,0.00231,43113,9.95203,433208
1104,agbanagba,10,0.00231,43123,9.95434,433208
1105,Ailsa-Wu,10,0.00231,43133,9.95665,433208
1106,Aishwarya-Nair-work,10,0.00231,43143,9.95896,433208
1107,akria18,10,0.00231,43153,9.96127,433208
1108,AlexandreInsua,10,0.00231,43163,9.96357,433208
1109,allanmoso,10,0.00231,43173,9.96588,433208
1110,AllenzhLi,10,0.00231,43183,9.96819,433208
1111,amoore877,10,0.00231,43193,9.97050,433208
1112,ankitm123,10,0.00231,43203,9.97281,433208
1113,AntonSmolkov,10,0.00231,43213,9.97512,433208
1114,arisgi,10,0.00231,43223,9.97742,433208
1115,AudienceX,10,0.00231,43233,9.97973,433208
1116,Bak3y,10,0.00231,43243,9.98204,433208
1117,bcarlsson,10,0.00231,43253,9.98435,433208
1118,bemanuel,10,0.00231,43263,9.98666,433208
1119,birdiesanders,10,0.00231,43273,9.98897,433208
1120,briannd81,10,0.00231,43283,9.99127,433208
1121,caleb15,10,0.00231,43293,9.99358,433208
1122,candlerb,10,0.00231,43303,9.99589,433208
1123,catweisun,10,0.00231,43313,9.99820,433208
1124,chemikadze,10,0.00231,43323,10.00051,433208
1125,christomas1,10,0.00231,43333,10.00282,433208
1126,Chuongv,10,0.00231,43343,10.00512,433208
1127,civilizeddev,10,0.00231,43353,10.00743,433208
1128,cjmckenna,10,0.00231,43363,10.00974,433208
1129,ckyiricky,10,0.00231,43373,10.01205,433208
1130,coders-kitchen,10,0.00231,43383,10.01436,433208
1131,consoleKEC,10,0.00231,43393,10.01667,433208
1132,csandiri11,10,0.00231,43403,10.01897,433208
1133,cxt90730,10,0.00231,43413,10.02128,433208
1134,cyrus-mc,10,0.00231,43423,10.02359,433208
1135,d1vious,10,0.00231,43433,10.02590,433208
1136,danielmittelman,10,0.00231,43443,10.02821,433208
1137,danielzhanghl,10,0.00231,43453,10.03052,433208
1138,DarianAnjuhal,10,0.00231,43463,10.03282,433208
1139,dbluxo,10,0.00231,43473,10.03513,433208
1140,devsharma1979,10,0.00231,43483,10.03744,433208
1141,DiptoChakrabarty,10,0.00231,43493,10.03975,433208
1142,dove-young,10,0.00231,43503,10.04206,433208
1143,drraghavendra,10,0.00231,43513,10.04437,433208
1144,ediezh,10,0.00231,43523,10.04668,433208
1145,endocrimes,10,0.00231,43533,10.04898,433208
1146,faicker,10,0.00231,43543,10.05129,433208
1147,ferwasy,10,0.00231,43553,10.05360,433208
1148,Filius-Patris,10,0.00231,43563,10.05591,433208
1149,firecast,10,0.00231,43573,10.05822,433208
1150,fnurk,10,0.00231,43583,10.06053,433208
1151,gordonbondon,10,0.00231,43593,10.06283,433208
1152,gutek9,10,0.00231,43603,10.06514,433208
1153,hawksight,10,0.00231,43613,10.06745,433208
1154,hcbdfinity,10,0.00231,43623,10.06976,433208
1155,Hello-Linux,10,0.00231,43633,10.07207,433208
1156,HerrNaN,10,0.00231,43643,10.07438,433208
1157,IJOL,10,0.00231,43653,10.07668,433208
1158,IlyaNakhaichuk,10,0.00231,43663,10.07899,433208
1159,ingbyr,10,0.00231,43673,10.08130,433208
1160,ItalyPaleAle,10,0.00231,43683,10.08361,433208
1161,jeffreybrowning,10,0.00231,43693,10.08592,433208
1162,jgarces21,10,0.00231,43703,10.08823,433208
1163,jingwei99,10,0.00231,43713,10.09053,433208
1164,jMarkP,10,0.00231,43723,10.09284,433208
1165,jonathanheaden,10,0.00231,43733,10.09515,433208
1166,joohee,10,0.00231,43743,10.09746,433208
1167,JorenZ,10,0.00231,43753,10.09977,433208
1168,jsonmp-k8,10,0.00231,43763,10.10208,433208
1169,kavitha-jm,10,0.00231,43773,10.10438,433208
1170,KilimAnnejaro,10,0.00231,43783,10.10669,433208
1171,laymain,10,0.00231,43793,10.10900,433208
1172,LeeHampton,10,0.00231,43803,10.11131,433208
1173,lemonli,10,0.00231,43813,10.11362,433208
1174,leosunmo,10,0.00231,43823,10.11593,433208
1175,lmarszal,10,0.00231,43833,10.11823,433208
1176,loftkun,10,0.00231,43843,10.12054,433208
1177,loopingz,10,0.00231,43853,10.12285,433208
1178,Lord-Y,10,0.00231,43863,10.12516,433208
1179,loveRhythm1990,10,0.00231,43873,10.12747,433208
1180,lyyao09,10,0.00231,43883,10.12978,433208
1181,m3y,10,0.00231,43893,10.13208,433208
1182,MahikanthNag,10,0.00231,43903,10.13439,433208
1183,matte21,10,0.00231,43913,10.13670,433208
1184,meetme2meat,10,0.00231,43923,10.13901,433208
1185,meurig,10,0.00231,43933,10.14132,433208
1186,mikeyrcamp,10,0.00231,43943,10.14363,433208
1187,milenkovicm,10,0.00231,43953,10.14593,433208
1188,mkoziel2000,10,0.00231,43963,10.14824,433208
1189,mvarrieur,10,0.00231,43973,10.15055,433208
1190,mzingarelli,10,0.00231,43983,10.15286,433208
1191,nerzhul,10,0.00231,43993,10.15517,433208
1192,ocavue,10,0.00231,44003,10.15748,433208
1193,ordovicia,10,0.00231,44013,10.15978,433208
1194,pandaamanda,10,0.00231,44023,10.16209,433208
1195,PankhudiB,10,0.00231,44033,10.16440,433208
1196,pavankrish123,10,0.00231,44043,10.16671,433208
1197,PriyaKatkade,10,0.00231,44053,10.16902,433208
1198,Rachel-Shao,10,0.00231,44063,10.17133,433208
1199,rafaeelaudibert,10,0.00231,44073,10.17363,433208
1200,rafal-jan,10,0.00231,44083,10.17594,433208
1201,rhummelmose,10,0.00231,44093,10.17825,433208
1202,RonnyMaas,10,0.00231,44103,10.18056,433208
1203,RUKip,10,0.00231,44113,10.18287,433208
1204,rydzykje,10,0.00231,44123,10.18518,433208
1205,scevallos,10,0.00231,44133,10.18748,433208
1206,segevfiner,10,0.00231,44143,10.18979,433208
1207,sergeyzenchenko,10,0.00231,44153,10.19210,433208
1208,sfriberg,10,0.00231,44163,10.19441,433208
1209,shonge,10,0.00231,44173,10.19672,433208
1210,shreyas-srinivas,10,0.00231,44183,10.19903,433208
1211,shuangkun,10,0.00231,44193,10.20134,433208
1212,Skyego,10,0.00231,44203,10.20364,433208
1213,Smita8081,10,0.00231,44213,10.20595,433208
1214,smorimoto,10,0.00231,44223,10.20826,433208
1215,sridhav,10,0.00231,44233,10.21057,433208
1216,sschne,10,0.00231,44243,10.21288,433208
1217,ST-DDT,10,0.00231,44253,10.21519,433208
1218,stephen-harris,10,0.00231,44263,10.21749,433208
1219,suramrit,10,0.00231,44273,10.21980,433208
1220,suryast,10,0.00231,44283,10.22211,433208
1221,teddylear,10,0.00231,44293,10.22442,433208
1222,thatdevsherry,10,0.00231,44303,10.22673,433208
1223,TisVictress,10,0.00231,44313,10.22904,433208
1224,tmshn,10,0.00231,44323,10.23134,433208
1225,TonyBogdanov,10,0.00231,44333,10.23365,433208
1226,tyarimi,10,0.00231,44343,10.23596,433208
1227,unbyte,10,0.00231,44353,10.23827,433208
1228,vbusch,10,0.00231,44363,10.24058,433208
1229,vkumbhar94,10,0.00231,44373,10.24289,433208
1230,vladimirfx,10,0.00231,44383,10.24519,433208
1231,wayne-li2,10,0.00231,44393,10.24750,433208
1232,Weil0ng,10,0.00231,44403,10.24981,433208
1233,willgleich,10,0.00231,44413,10.25212,433208
1234,williamsfu99,10,0.00231,44423,10.25443,433208
1235,WLun001,10,0.00231,44433,10.25674,433208
1236,xkbarkar,10,0.00231,44443,10.25904,433208
1237,xmcqueen,10,0.00231,44453,10.26135,433208
1238,xujyan,10,0.00231,44463,10.26366,433208
1239,yabli,10,0.00231,44473,10.26597,433208
1240,ysicing,10,0.00231,44483,10.26828,433208
1241,zeromberto,10,0.00231,44493,10.27059,433208
1242,zichangg,10,0.00231,44503,10.27289,433208
1243,zswanson,10,0.00231,44513,10.27520,433208
1244,abudavis,9,0.00208,44522,10.27728,433208
1245,adamchalmers,9,0.00208,44531,10.27936,433208
1246,adaptivecorporation,9,0.00208,44540,10.28144,433208
1247,adityashirodkar,9,0.00208,44549,10.28351,433208
1248,ahjohannessen,9,0.00208,44558,10.28559,433208
1249,Alexander1000,9,0.00208,44567,10.28767,433208
1250,alipatton10,9,0.00208,44576,10.28975,433208
1251,AnavMahajan,9,0.00208,44585,10.29182,433208
1252,andrewsali,9,0.00208,44594,10.29390,433208
1253,AndreyUtka,9,0.00208,44603,10.29598,433208
1254,anmolbabu,9,0.00208,44612,10.29806,433208
1255,aravinsiva,9,0.00208,44621,10.30013,433208
1256,arberx,9,0.00208,44630,10.30221,433208
1257,Asuforce,9,0.00208,44639,10.30429,433208
1258,atulaggarwal,9,0.00208,44648,10.30637,433208
1259,azkore,9,0.00208,44657,10.30844,433208
1260,BhartiAgrawalNvidia,9,0.00208,44666,10.31052,433208
1261,bhvkrishna90,9,0.00208,44675,10.31260,433208
1262,BigDarkClown,9,0.00208,44684,10.31468,433208
1263,bluven,9,0.00208,44693,10.31675,433208
1264,brianpham,9,0.00208,44702,10.31883,433208
1265,bruth,9,0.00208,44711,10.32091,433208
1266,BUERCRAZY,9,0.00208,44720,10.32299,433208
1267,bugrayilmazz,9,0.00208,44729,10.32506,433208
1268,burningalchemist,9,0.00208,44738,10.32714,433208
1269,chaimch,9,0.00208,44747,10.32922,433208
1270,chaseSpace,9,0.00208,44756,10.33130,433208
1271,ChristianCiach,9,0.00208,44765,10.33337,433208
1272,chungktran,9,0.00208,44774,10.33545,433208
1273,clausa20,9,0.00208,44783,10.33753,433208
1274,crazybg321,9,0.00208,44792,10.33961,433208
1275,CurryX,9,0.00208,44801,10.34168,433208
1276,DatzAtWork,9,0.00208,44810,10.34376,433208
1277,daviddyball,9,0.00208,44819,10.34584,433208
1278,dbenduga,9,0.00208,44828,10.34792,433208
1279,dfioravanti,9,0.00208,44837,10.34999,433208
1280,diuming,9,0.00208,44846,10.35207,433208
1281,doeasier,9,0.00208,44855,10.35415,433208
1282,Donghui-Sudo,9,0.00208,44864,10.35623,433208
1283,drGrove,9,0.00208,44873,10.35830,433208
1284,dseapy,9,0.00208,44882,10.36038,433208
1285,ebrake,9,0.00208,44891,10.36246,433208
1286,entropitor,9,0.00208,44900,10.36454,433208
1287,evananyonga,9,0.00208,44909,10.36661,433208
1288,evanstucker-hates-2fa,9,0.00208,44918,10.36869,433208
1289,fabstu,9,0.00208,44927,10.37077,433208
1290,fangpenlin,9,0.00208,44936,10.37285,433208
1291,FillZpp,9,0.00208,44945,10.37492,433208
1292,fl-max,9,0.00208,44954,10.37700,433208
1293,floriankoch,9,0.00208,44963,10.37908,433208
1294,FWiesner,9,0.00208,44972,10.38116,433208
1295,ganga1980,9,0.00208,44981,10.38323,433208
1296,gizmosense,9,0.00208,44990,10.38531,433208
1297,Godtide,9,0.00208,44999,10.38739,433208
1298,gonzalobarbitta,9,0.00208,45008,10.38947,433208
1299,gowxw,9,0.00208,45017,10.39154,433208
1300,GRXself,9,0.00208,45026,10.39362,433208
1301,Gui13,9,0.00208,45035,10.39570,433208
1302,guoweis-outreach,9,0.00208,45044,10.39778,433208
1303,halachkin,9,0.00208,45053,10.39985,433208
1304,heygroot,9,0.00208,45062,10.40193,433208
1305,hyorigo,9,0.00208,45071,10.40401,433208
1306,IanColdwater,9,0.00208,45080,10.40609,433208
1307,ibraimgm,9,0.00208,45089,10.40816,433208
1308,ijackcy,9,0.00208,45098,10.41024,433208
1309,ilknarf,9,0.00208,45107,10.41232,433208
1310,imyashvinder,9,0.00208,45116,10.41440,433208
1311,ipatrykx,9,0.00208,45125,10.41647,433208
1312,IvanBodnya,9,0.00208,45134,10.41855,433208
1313,ivannpaz,9,0.00208,45143,10.42063,433208
1314,izzyleung,9,0.00208,45152,10.42271,433208
1315,jaalle,9,0.00208,45161,10.42478,433208
1316,japsu,9,0.00208,45170,10.42686,433208
1317,jasper-d,9,0.00208,45179,10.42894,433208
1318,jayendra13,9,0.00208,45188,10.43102,433208
1319,JeremyShih,9,0.00208,45197,10.43309,433208
1320,jmoldow,9,0.00208,45206,10.43517,433208
1321,jonaskello,9,0.00208,45215,10.43725,433208
1322,joostas,9,0.00208,45224,10.43933,433208
1323,joshmue,9,0.00208,45233,10.44140,433208
1324,jpaskhay,9,0.00208,45242,10.44348,433208
1325,jranson,9,0.00208,45251,10.44556,433208
1326,JScon01,9,0.00208,45260,10.44764,433208
1327,jvesely,9,0.00208,45269,10.44971,433208
1328,jwesolowski-rms,9,0.00208,45278,10.45179,433208
1329,kamilzzz,9,0.00208,45287,10.45387,433208
1330,KarthikNedunchezhiyan,9,0.00208,45296,10.45595,433208
1331,kaykhancheckpoint,9,0.00208,45305,10.45802,433208
1332,kcking,9,0.00208,45314,10.46010,433208
1333,kelvinsand,9,0.00208,45323,10.46218,433208
1334,khatrig,9,0.00208,45332,10.46426,433208
1335,kiwi1969,9,0.00208,45341,10.46633,433208
1336,kyle-burnette,9,0.00208,45350,10.46841,433208
1337,laurovenancio,9,0.00208,45359,10.47049,433208
1338,LENSHOOD,9,0.00208,45368,10.47257,433208
1339,lhb008,9,0.00208,45377,10.47464,433208
1340,lhluo,9,0.00208,45386,10.47672,433208
1341,lhw,9,0.00208,45395,10.47880,433208
1342,lirlia,9,0.00208,45404,10.48088,433208
1343,liuchintao,9,0.00208,45413,10.48296,433208
1344,luoMonkeyKing,9,0.00208,45422,10.48503,433208
1345,marinkobabic,9,0.00208,45431,10.48711,433208
1346,MartinLeedotOrg,9,0.00208,45440,10.48919,433208
1347,mashenjun,9,0.00208,45449,10.49127,433208
1348,mattlord,9,0.00208,45458,10.49334,433208
1349,matveym,9,0.00208,45467,10.49542,433208
1350,maxisam,9,0.00208,45476,10.49750,433208
1351,mdgrotheer,9,0.00208,45485,10.49958,433208
1352,Med-All,9,0.00208,45494,10.50165,433208
1353,mfykmn,9,0.00208,45503,10.50373,433208
1354,mn0o7,9,0.00208,45512,10.50581,433208
1355,mosesyou,9,0.00208,45521,10.50789,433208
1356,neox5,9,0.00208,45530,10.50996,433208
1357,nielsbasjes,9,0.00208,45539,10.51204,433208
1358,ninja-,9,0.00208,45548,10.51412,433208
1359,nitingadekar,9,0.00208,45557,10.51620,433208
1360,nitinkansal1984,9,0.00208,45566,10.51827,433208
1361,nlarzon,9,0.00208,45575,10.52035,433208
1362,onkarbhat,9,0.00208,45584,10.52243,433208
1363,pacospace,9,0.00208,45593,10.52451,433208
1364,paulcarlton-ww,9,0.00208,45602,10.52658,433208
1365,ping-localhost,9,0.00208,45611,10.52866,433208
1366,PPCM,9,0.00208,45620,10.53074,433208
1367,pradeepnnv,9,0.00208,45629,10.53282,433208
1368,prageethw,9,0.00208,45638,10.53489,433208
1369,pranavmarla,9,0.00208,45647,10.53697,433208
1370,priyamaplelabs,9,0.00208,45656,10.53905,433208
1371,PriyaModali,9,0.00208,45665,10.54113,433208
1372,rangp,9,0.00208,45674,10.54320,433208
1373,reggie-k,9,0.00208,45683,10.54528,433208
1374,ruiwen-zhao,9,0.00208,45692,10.54736,433208
1375,rumanzo,9,0.00208,45701,10.54944,433208
1376,Sam8301-arch,9,0.00208,45710,10.55151,433208
1377,sanskar-p,9,0.00208,45719,10.55359,433208
1378,sbookworm,9,0.00208,45728,10.55567,433208
1379,sean-quinn,9,0.00208,45737,10.55775,433208
1380,serkantkaraca,9,0.00208,45746,10.55982,433208
1381,servo1x,9,0.00208,45755,10.56190,433208
1382,sharajat,9,0.00208,45764,10.56398,433208
1383,shivanshs9,9,0.00208,45773,10.56606,433208
1384,slj211,9,0.00208,45782,10.56813,433208
1385,snowmanstark,9,0.00208,45791,10.57021,433208
1386,spyridonas,9,0.00208,45800,10.57229,433208
1387,sqkerner,9,0.00208,45809,10.57437,433208
1388,stevenarvar,9,0.00208,45818,10.57644,433208
1389,sumitmundhada,9,0.00208,45827,10.57852,433208
1390,sundar-cs,9,0.00208,45836,10.58060,433208
1391,taciomcosta,9,0.00208,45845,10.58268,433208
1392,tacoelho,9,0.00208,45854,10.58475,433208
1393,Talador12,9,0.00208,45863,10.58683,433208
1394,tannaga,9,0.00208,45872,10.58891,433208
1395,teoyaomiqui,9,0.00208,45881,10.59099,433208
1396,TheTFo,9,0.00208,45890,10.59306,433208
1397,TomaszKlosinski,9,0.00208,45899,10.59514,433208
1398,Trackhe,9,0.00208,45908,10.59722,433208
1399,trallnag,9,0.00208,45917,10.59930,433208
1400,tzzed,9,0.00208,45926,10.60137,433208
1401,vbottu,9,0.00208,45935,10.60345,433208
1402,Venkatvenstvm,9,0.00208,45944,10.60553,433208
1403,vgv,9,0.00208,45953,10.60761,433208
1404,victor-timofei,9,0.00208,45962,10.60968,433208
1405,Vishwanath-GitHub,9,0.00208,45971,10.61176,433208
1406,vixus0,9,0.00208,45980,10.61384,433208
1407,vovencij,9,0.00208,45989,10.61592,433208
1408,vuggg,9,0.00208,45998,10.61799,433208
1409,wangxiyuan,9,0.00208,46007,10.62007,433208
1410,wdalmut,9,0.00208,46016,10.62215,433208
1411,Wing924,9,0.00208,46025,10.62423,433208
1412,wwulfric,9,0.00208,46034,10.62630,433208
1413,wzg0120,9,0.00208,46043,10.62838,433208
1414,xinau,9,0.00208,46052,10.63046,433208
1415,xq2005,9,0.00208,46061,10.63254,433208
1416,yankeexe,9,0.00208,46070,10.63461,433208
1417,yaowenqiang,9,0.00208,46079,10.63669,433208
1418,yovizzle,9,0.00208,46088,10.63877,433208
1419,yushanjin,9,0.00208,46097,10.64085,433208
1420,yuswift,9,0.00208,46106,10.64292,433208
1421,Yvonnehrr,9,0.00208,46115,10.64500,433208
1422,2339478391,8,0.00185,46123,10.64685,433208
1423,2nick,8,0.00185,46131,10.64870,433208
1424,3scava1i3r,8,0.00185,46139,10.65054,433208
1425,abhimjoshi,8,0.00185,46147,10.65239,433208
1426,absnamohammed,8,0.00185,46155,10.65424,433208
1427,akartsky,8,0.00185,46163,10.65608,433208
1428,akosveres,8,0.00185,46171,10.65793,433208
1429,alarco-l,8,0.00185,46179,10.65978,433208
1430,alash3al,8,0.00185,46187,10.66162,433208
1431,alexanderccc,8,0.00185,46195,10.66347,433208
1432,alexmirkhaydarov,8,0.00185,46203,10.66532,433208
1433,altmas5,8,0.00185,46211,10.66716,433208
1434,AmitBenAmi,8,0.00185,46219,10.66901,433208
1435,aryanrawlani28,8,0.00185,46227,10.67086,433208
1436,atheriel,8,0.00185,46235,10.67270,433208
1437,axk7812,8,0.00185,46243,10.67455,433208
1438,belak,8,0.00185,46251,10.67640,433208
1439,binkkatal,8,0.00185,46259,10.67824,433208
1440,BitFis,8,0.00185,46267,10.68009,433208
1441,bit-herder,8,0.00185,46275,10.68194,433208
1442,BoBiene,8,0.00185,46283,10.68378,433208
1443,Born2Bake,8,0.00185,46291,10.68563,433208
1444,bradfordcp,8,0.00185,46299,10.68748,433208
1445,bytecook,8,0.00185,46307,10.68932,433208
1446,cbrake,8,0.00185,46315,10.69117,433208
1447,cemsusal,8,0.00185,46323,10.69302,433208
1448,champak,8,0.00185,46331,10.69486,433208
1449,chrisob,8,0.00185,46339,10.69671,433208
1450,chriswells0,8,0.00185,46347,10.69856,433208
1451,c-mcdonnell,8,0.00185,46355,10.70040,433208
1452,codearky,8,0.00185,46363,10.70225,433208
1453,commixon,8,0.00185,46371,10.70410,433208
1454,conanoc,8,0.00185,46379,10.70594,433208
1455,conradwt,8,0.00185,46387,10.70779,433208
1456,corymurphy,8,0.00185,46395,10.70964,433208
1457,Cryptonex7,8,0.00185,46403,10.71148,433208
1458,cwhfa,8,0.00185,46411,10.71333,433208
1459,CyberHippo,8,0.00185,46419,10.71518,433208
1460,daniel-shuy,8,0.00185,46427,10.71702,433208
1461,danniel1205,8,0.00185,46435,10.71887,433208
1462,devurandom,8,0.00185,46443,10.72072,433208
1463,dgdelahera,8,0.00185,46451,10.72256,433208
1464,dgrozenok,8,0.00185,46459,10.72441,433208
1465,Diddaa,8,0.00185,46467,10.72626,433208
1466,dili91,8,0.00185,46475,10.72810,433208
1467,djablonski-moia,8,0.00185,46483,10.72995,433208
1468,djshow832,8,0.00185,46491,10.73180,433208
1469,dostalradim,8,0.00185,46499,10.73364,433208
1470,dsam82,8,0.00185,46507,10.73549,433208
1471,dverbeir,8,0.00185,46515,10.73734,433208
1472,easimon,8,0.00185,46523,10.73918,433208
1473,elpiel,8,0.00185,46531,10.74103,433208
1474,erezo9,8,0.00185,46539,10.74288,433208
1475,etashsingh,8,0.00185,46547,10.74472,433208
1476,f35f0ef9d0e827dae86552d3899f78fc,8,0.00185,46555,10.74657,433208
1477,FabianKramm,8,0.00185,46563,10.74842,433208
1478,feranwq,8,0.00185,46571,10.75026,433208
1479,fischerman,8,0.00185,46579,10.75211,433208
1480,fujitatomoya,8,0.00185,46587,10.75396,433208
1481,fvdnabee,8,0.00185,46595,10.75580,433208
1482,gabhijit,8,0.00185,46603,10.75765,433208
1483,GannonTdW,8,0.00185,46611,10.75950,433208
1484,genehynson,8,0.00185,46619,10.76134,433208
1485,ggjjlldd,8,0.00185,46627,10.76319,433208
1486,Giancarlo1974,8,0.00185,46635,10.76504,433208
1487,girirajthara,8,0.00185,46643,10.76688,433208
1488,glitchcrab,8,0.00185,46651,10.76873,433208
1489,gmfmi,8,0.00185,46659,10.77058,433208
1490,grissius,8,0.00185,46667,10.77242,433208
1491,gulati-diksha,8,0.00185,46675,10.77427,433208
1492,gustav3d,8,0.00185,46683,10.77612,433208
1493,hadianr,8,0.00185,46691,10.77796,433208
1494,HaveFun83,8,0.00185,46699,10.77981,433208
1495,hendrikmaus,8,0.00185,46707,10.78166,433208
1496,heriet,8,0.00185,46715,10.78350,433208
1497,hrasadi,8,0.00185,46723,10.78535,433208
1498,hunsche,8,0.00185,46731,10.78720,433208
1499,iamleot,8,0.00185,46739,10.78904,433208
1500,ifermo,8,0.00185,46747,10.79089,433208
1501,iKarthik,8,0.00185,46755,10.79274,433208
1502,IlyaKobelevskiy,8,0.00185,46763,10.79458,433208
1503,imacks,8,0.00185,46771,10.79643,433208
1504,ishg,8,0.00185,46779,10.79828,433208
1505,ishitasequeira,8,0.00185,46787,10.80012,433208
1506,ivanov-aleksander,8,0.00185,46795,10.80197,433208
1507,jakob-o,8,0.00185,46803,10.80382,433208
1508,jayz28,8,0.00185,46811,10.80566,433208
1509,jdmarshall,8,0.00185,46819,10.80751,433208
1510,JeffResc,8,0.00185,46827,10.80936,433208
1511,jidckii,8,0.00185,46835,10.81120,433208
1512,joey95033,8,0.00185,46843,10.81305,433208
1513,joneal,8,0.00185,46851,10.81490,433208
1514,JPRbrs,8,0.00185,46859,10.81674,433208
1515,justenwalker,8,0.00185,46867,10.81859,433208
1516,kartikx,8,0.00185,46875,10.82044,433208
1517,kaushiksrinivas,8,0.00185,46883,10.82228,433208
1518,keer25,8,0.00185,46891,10.82413,433208
1519,kg-ops,8,0.00185,46899,10.82598,433208
1520,kinghrothgar,8,0.00185,46907,10.82782,433208
1521,kiranpatel11,8,0.00185,46915,10.82967,433208
1522,KonH,8,0.00185,46923,10.83152,433208
1523,ksummersill2,8,0.00185,46931,10.83336,433208
1524,kylejohnson514,8,0.00185,46939,10.83521,433208
1525,latteczy,8,0.00185,46947,10.83706,433208
1526,lentil1016,8,0.00185,46955,10.83890,433208
1527,Leo-ljr,8,0.00185,46963,10.84075,433208
1528,LetzNico,8,0.00185,46971,10.84260,433208
1529,limburgher,8,0.00185,46979,10.84444,433208
1530,longwa,8,0.00185,46987,10.84629,433208
1531,lukasz-bielinski,8,0.00185,46995,10.84814,433208
1532,Lukasz-SendGrid,8,0.00185,47003,10.84998,433208
1533,LukeCarrier,8,0.00185,47011,10.85183,433208
1534,magnologan,8,0.00185,47019,10.85368,433208
1535,magnusja,8,0.00185,47027,10.85552,433208
1536,mallick370,8,0.00185,47035,10.85737,433208
1537,mancini0,8,0.00185,47043,10.85922,433208
1538,mapshen,8,0.00185,47051,10.86106,433208
1539,markrexwinkel,8,0.00185,47059,10.86291,433208
1540,marunachalam,8,0.00185,47067,10.86476,433208
1541,matthieuprat,8,0.00185,47075,10.86660,433208
1542,maxmil7,8,0.00185,47083,10.86845,433208
1543,mdkent,8,0.00185,47091,10.87030,433208
1544,MeNsaaH,8,0.00185,47099,10.87214,433208
1545,mheers,8,0.00185,47107,10.87399,433208
1546,MichaelWasher,8,0.00185,47115,10.87584,433208
1547,michaelywg,8,0.00185,47123,10.87768,433208
1548,mildmojo,8,0.00185,47131,10.87953,433208
1549,mirkop-mattr,8,0.00185,47139,10.88138,433208
1550,mkilchhofer,8,0.00185,47147,10.88322,433208
1551,montmanu,8,0.00185,47155,10.88507,433208
1552,mplesec,8,0.00185,47163,10.88692,433208
1553,nayoungson,8,0.00185,47171,10.88876,433208
1554,ncri,8,0.00185,47179,10.89061,433208
1555,newtoworld999,8,0.00185,47187,10.89246,433208
1556,niccheww,8,0.00185,47195,10.89430,433208
1557,nicktming,8,0.00185,47203,10.89615,433208
1558,nigels-com,8,0.00185,47211,10.89800,433208
1559,nmousouros,8,0.00185,47219,10.89984,433208
1560,nocanstillbb,8,0.00185,47227,10.90169,433208
1561,northrup,8,0.00185,47235,10.90354,433208
1562,nprokopic,8,0.00185,47243,10.90538,433208
1563,nxf5025,8,0.00185,47251,10.90723,433208
1564,ofir-popowski,8,0.00185,47259,10.90908,433208
1565,pantelis-karamolegkos,8,0.00185,47267,10.91093,433208
1566,paulhodson,8,0.00185,47275,10.91277,433208
1567,perezjasonr,8,0.00185,47283,10.91462,433208
1568,plallin,8,0.00185,47291,10.91647,433208
1569,qingchen1203,8,0.00185,47299,10.91831,433208
1570,ramprasathasokan,8,0.00185,47307,10.92016,433208
1571,raunaqgupta,8,0.00185,47315,10.92201,433208
1572,raviteja628,8,0.00185,47323,10.92385,433208
1573,RinChanNOWWW,8,0.00185,47331,10.92570,433208
1574,rishinair11,8,0.00185,47339,10.92755,433208
1575,rittneje,8,0.00185,47347,10.92939,433208
1576,robertzhouxh,8,0.00185,47355,10.93124,433208
1577,rohasharma,8,0.00185,47363,10.93309,433208
1578,roshnaeem,8,0.00185,47371,10.93493,433208
1579,sabyadi,8,0.00185,47379,10.93678,433208
1580,Sadzeih,8,0.00185,47387,10.93863,433208
1581,sahil-sawhney,8,0.00185,47395,10.94047,433208
1582,saloni-2404,8,0.00185,47403,10.94232,433208
1583,sanarena,8,0.00185,47411,10.94417,433208
1584,sc-chad,8,0.00185,47419,10.94601,433208
1585,searsaw,8,0.00185,47427,10.94786,433208
1586,sebbrandt87,8,0.00185,47435,10.94971,433208
1587,secretlifeof,8,0.00185,47443,10.95155,433208
1588,selvaranjith92,8,0.00185,47451,10.95340,433208
1589,ShadowJonathan,8,0.00185,47459,10.95525,433208
1590,shahriak,8,0.00185,47467,10.95709,433208
1591,shenkonghui,8,0.00185,47475,10.95894,433208
1592,Shivam7-1,8,0.00185,47483,10.96079,433208
1593,shmsr,8,0.00185,47491,10.96263,433208
1594,ShubhamSood1406,8,0.00185,47499,10.96448,433208
1595,simingweng,8,0.00185,47507,10.96633,433208
1596,simonfr,8,0.00185,47515,10.96817,433208
1597,SimonVHB,8,0.00185,47523,10.97002,433208
1598,sinbadonline,8,0.00185,47531,10.97187,433208
1599,Someshbose,8,0.00185,47539,10.97371,433208
1600,sparkingdark,8,0.00185,47547,10.97556,433208
1601,sp-nikolay-tenev,8,0.00185,47555,10.97741,433208
1602,sptrakesh,8,0.00185,47563,10.97925,433208
1603,srinivasev,8,0.00185,47571,10.98110,433208
1604,sshiba,8,0.00185,47579,10.98295,433208
1605,ssvvnn,8,0.00185,47587,10.98479,433208
1606,stanleynguyen,8,0.00185,47595,10.98664,433208
1607,starofys,8,0.00185,47603,10.98849,433208
1608,stewartshea,8,0.00185,47611,10.99033,433208
1609,sunix,8,0.00185,47619,10.99218,433208
1610,surlyengineer,8,0.00185,47627,10.99403,433208
1611,tarunwadhwa13,8,0.00185,47635,10.99587,433208
1612,Tecktron,8,0.00185,47643,10.99772,433208
1613,thpham,8,0.00185,47651,10.99957,433208
1614,thynquest,8,0.00185,47659,11.00141,433208
1615,timmysilv,8,0.00185,47667,11.00326,433208
1616,TJM,8,0.00185,47675,11.00511,433208
1617,togis123,8,0.00185,47683,11.00695,433208
1618,tomhjp,8,0.00185,47691,11.00880,433208
1619,tscswcn,8,0.00185,47699,11.01065,433208
1620,venkataramu,8,0.00185,47707,11.01249,433208
1621,via-jordan-sokolic,8,0.00185,47715,11.01434,433208
1622,vijaymateti,8,0.00185,47723,11.01619,433208
1623,vishalbharg,8,0.00185,47731,11.01803,433208
1624,vmr1532,8,0.00185,47739,11.01988,433208
1625,vutkin,8,0.00185,47747,11.02173,433208
1626,w33dw0r7d,8,0.00185,47755,11.02357,433208
1627,weiranzhixin,8,0.00185,47763,11.02542,433208
1628,whitehack2512,8,0.00185,47771,11.02727,433208
1629,whoan,8,0.00185,47779,11.02911,433208
1630,WilliamHYZhang,8,0.00185,47787,11.03096,433208
1631,worr,8,0.00185,47795,11.03281,433208
1632,wr0ngway,8,0.00185,47803,11.03465,433208
1633,ws-way,8,0.00185,47811,11.03650,433208
1634,wwillsey,8,0.00185,47819,11.03835,433208
1635,xinbinhuang,8,0.00185,47827,11.04019,433208
1636,xoxbet,8,0.00185,47835,11.04204,433208
1637,y00j,8,0.00185,47843,11.04389,433208
1638,yangvipguang,8,0.00185,47851,11.04573,433208
1639,YourTechBud,8,0.00185,47859,11.04758,433208
1640,yttan,8,0.00185,47867,11.04943,433208
1641,yzdann,8,0.00185,47875,11.05127,433208
1642,zecke,8,0.00185,47883,11.05312,433208
1643,zengyongjie,8,0.00185,47891,11.05497,433208
1644,zerothZone,8,0.00185,47899,11.05681,433208
1645,zjkmxy,8,0.00185,47907,11.05866,433208
1646,zuquan-song,8,0.00185,47915,11.06051,433208
1647,0xflotus,7,0.00162,47922,11.06212,433208
1648,180254,7,0.00162,47929,11.06374,433208
1649,1995parham,7,0.00162,47936,11.06535,433208
1650,85matthew,7,0.00162,47943,11.06697,433208
1651,abhiranjeet,7,0.00162,47950,11.06859,433208
1652,Abirdcfly,7,0.00162,47957,11.07020,433208
1653,adamjstewart,7,0.00162,47964,11.07182,433208
1654,Adhira-Deogade,7,0.00162,47971,11.07343,433208
1655,adinhodovic,7,0.00162,47978,11.07505,433208
1656,a-dyakov-mercuryo,7,0.00162,47985,11.07667,433208
1657,aermakov-zalando,7,0.00162,47992,11.07828,433208
1658,ahaeber,7,0.00162,47999,11.07990,433208
1659,akshah123,7,0.00162,48006,11.08151,433208
1660,alebedev87,7,0.00162,48013,11.08313,433208
1661,alebsys,7,0.00162,48020,11.08474,433208
1662,aliusmiles,7,0.00162,48027,11.08636,433208
1663,almorgv,7,0.00162,48034,11.08798,433208
1664,ambguo,7,0.00162,48041,11.08959,433208
1665,amorenoz,7,0.00162,48048,11.09121,433208
1666,amukherj1,7,0.00162,48055,11.09282,433208
1667,andelhie,7,0.00162,48062,11.09444,433208
1668,andrescaroc,7,0.00162,48069,11.09606,433208
1669,andyleap,7,0.00162,48076,11.09767,433208
1670,ankitsrao,7,0.00162,48083,11.09929,433208
1671,apurv15,7,0.00162,48090,11.10090,433208
1672,archit041198,7,0.00162,48097,11.10252,433208
1673,arn95,7,0.00162,48104,11.10413,433208
1674,aryan9600,7,0.00162,48111,11.10575,433208
1675,asellappen,7,0.00162,48118,11.10737,433208
1676,ashlineldridge,7,0.00162,48125,11.10898,433208
1677,AshutoshNirkhe,7,0.00162,48132,11.11060,433208
1678,asos-craigmorten,7,0.00162,48139,11.11221,433208
1679,asychev,7,0.00162,48146,11.11383,433208
1680,aude,7,0.00162,48153,11.11545,433208
1681,AudriusButkevicius,7,0.00162,48160,11.11706,433208
1682,avr1254,7,0.00162,48167,11.11868,433208
1683,avsej,7,0.00162,48174,11.12029,433208
1684,azhang,7,0.00162,48181,11.12191,433208
1685,baurine,7,0.00162,48188,11.12352,433208
1686,betweenclouds,7,0.00162,48195,11.12514,433208
1687,BEvgeniyS,7,0.00162,48202,11.12676,433208
1688,Bhargavamacha,7,0.00162,48209,11.12837,433208
1689,bmf-san,7,0.00162,48216,11.12999,433208
1690,bobwanglyft,7,0.00162,48223,11.13160,433208
1691,brianmajor,7,0.00162,48230,11.13322,433208
1692,Bryce-huang,7,0.00162,48237,11.13484,433208
1693,bukbuk1231,7,0.00162,48244,11.13645,433208
1694,bznein,7,0.00162,48251,11.13807,433208
1695,caboteria,7,0.00162,48258,11.13968,433208
1696,carlosrbcunha,7,0.00162,48265,11.14130,433208
1697,catblade,7,0.00162,48272,11.14292,433208
1698,cdyue,7,0.00162,48279,11.14453,433208
1699,Chans321,7,0.00162,48286,11.14615,433208
1700,chirangaalwis,7,0.00162,48293,11.14776,433208
1701,codifierr,7,0.00162,48300,11.14938,433208
1702,coolamiy,7,0.00162,48307,11.15099,433208
1703,cowwoc,7,0.00162,48314,11.15261,433208
1704,crazy-max,7,0.00162,48321,11.15423,433208
1705,dandragut,7,0.00162,48328,11.15584,433208
1706,danielfoehrKn,7,0.00162,48335,11.15746,433208
1707,danielo515,7,0.00162,48342,11.15907,433208
1708,danil-smirnov,7,0.00162,48349,11.16069,433208
1709,danpopSD,7,0.00162,48356,11.16231,433208
1710,DarthBenro008,7,0.00162,48363,11.16392,433208
1711,daved,7,0.00162,48370,11.16554,433208
1712,davefranklin02,7,0.00162,48377,11.16715,433208
1713,Davidrjx,7,0.00162,48384,11.16877,433208
1714,dddddai,7,0.00162,48391,11.17038,433208
1715,ddesna,7,0.00162,48398,11.17200,433208
1716,DestiGames,7,0.00162,48405,11.17362,433208
1717,devkappa,7,0.00162,48412,11.17523,433208
1718,dewe,7,0.00162,48419,11.17685,433208
1719,dimstars,7,0.00162,48426,11.17846,433208
1720,dirien,7,0.00162,48433,11.18008,433208
1721,divz11,7,0.00162,48440,11.18170,433208
1722,dmilind,7,0.00162,48447,11.18331,433208
1723,dogukanturan,7,0.00162,48454,11.18493,433208
1724,dsonck92,7,0.00162,48461,11.18654,433208
1725,duanhongyi,7,0.00162,48468,11.18816,433208
1726,dynamicmindset,7,0.00162,48475,11.18977,433208
1727,ejweber,7,0.00162,48482,11.19139,433208
1728,ElectricRabbit,7,0.00162,48489,11.19301,433208
1729,EmoinLanyu,7,0.00162,48496,11.19462,433208
1730,eoinnoble,7,0.00162,48503,11.19624,433208
1731,erikbos,7,0.00162,48510,11.19785,433208
1732,ErolPeel,7,0.00162,48517,11.19947,433208
1733,ewrenn8,7,0.00162,48524,11.20109,433208
1734,ffazzini,7,0.00162,48531,11.20270,433208
1735,Fgruntjes,7,0.00162,48538,11.20432,433208
1736,fkpwolf,7,0.00162,48545,11.20593,433208
1737,fuguohong1024,7,0.00162,48552,11.20755,433208
1738,gajus,7,0.00162,48559,11.20917,433208
1739,gcapizzi,7,0.00162,48566,11.21078,433208
1740,gecgooden,7,0.00162,48573,11.21240,433208
1741,GiottoLee,7,0.00162,48580,11.21401,433208
1742,GlenGeng,7,0.00162,48587,11.21563,433208
1743,gloomytrousers,7,0.00162,48594,11.21724,433208
1744,Gouthamkreddy1234,7,0.00162,48601,11.21886,433208
1745,gpt-4,7,0.00162,48608,11.22048,433208
1746,gthb,7,0.00162,48615,11.22209,433208
1747,guni1192,7,0.00162,48622,11.22371,433208
1748,hamza-tumturk,7,0.00162,48629,11.22532,433208
1749,han-so1omon,7,0.00162,48636,11.22694,433208
1750,hazelnutsgz,7,0.00162,48643,11.22856,433208
1751,hikhvar,7,0.00162,48650,11.23017,433208
1752,Himanshuxone,7,0.00162,48657,11.23179,433208
1753,HiveTraum,7,0.00162,48664,11.23340,433208
1754,hooklee2000,7,0.00162,48671,11.23502,433208
1755,howarddierking,7,0.00162,48678,11.23663,433208
1756,Hugome,7,0.00162,48685,11.23825,433208
1757,hustclf,7,0.00162,48692,11.23987,433208
1758,hyc3z,7,0.00162,48699,11.24148,433208
1759,iamcnx,7,0.00162,48706,11.24310,433208
1760,ibmhack2020,7,0.00162,48713,11.24471,433208
1761,ielshal,7,0.00162,48720,11.24633,433208
1762,iibb,7,0.00162,48727,11.24795,433208
1763,immanuelfodor,7,0.00162,48734,11.24956,433208
1764,ionutbalutoiu,7,0.00162,48741,11.25118,433208
1765,IshaDave,7,0.00162,48748,11.25279,433208
1766,ivanjaros,7,0.00162,48755,11.25441,433208
1767,iyashu,7,0.00162,48762,11.25602,433208
1768,j2gg0s,7,0.00162,48769,11.25764,433208
1769,JakeCooper,7,0.00162,48776,11.25926,433208
1770,jameOne,7,0.00162,48783,11.26087,433208
1771,jangel97,7,0.00162,48790,11.26249,433208
1772,javiercri,7,0.00162,48797,11.26410,433208
1773,jbd,7,0.00162,48804,11.26572,433208
1774,JBerny,7,0.00162,48811,11.26734,433208
1775,jbilliau-rcd,7,0.00162,48818,11.26895,433208
1776,jeenx,7,0.00162,48825,11.27057,433208
1777,JennySimen,7,0.00162,48832,11.27218,433208
1778,JESWINKNINAN,7,0.00162,48839,11.27380,433208
1779,jodeev,7,0.00162,48846,11.27542,433208
1780,JohnStarich,7,0.00162,48853,11.27703,433208
1781,joshti,7,0.00162,48860,11.27865,433208
1782,jphx,7,0.00162,48867,11.28026,433208
1783,jrstrengen,7,0.00162,48874,11.28188,433208
1784,j-vanderstoep,7,0.00162,48881,11.28349,433208
1785,jvmlet,7,0.00162,48888,11.28511,433208
1786,KalagaSahitya,7,0.00162,48895,11.28673,433208
1787,kamaci,7,0.00162,48902,11.28834,433208
1788,kangni,7,0.00162,48909,11.28996,433208
1789,karras,7,0.00162,48916,11.29157,433208
1790,kireledan,7,0.00162,48923,11.29319,433208
1791,koceg,7,0.00162,48930,11.29481,433208
1792,kofan,7,0.00162,48937,11.29642,433208
1793,kristinnardal2,7,0.00162,48944,11.29804,433208
1794,Krit2521,7,0.00162,48951,11.29965,433208
1795,krol3,7,0.00162,48958,11.30127,433208
1796,kunal-kushwaha,7,0.00162,48965,11.30288,433208
1797,lallinger-arbeit,7,0.00162,48972,11.30450,433208
1798,larosek,7,0.00162,48979,11.30612,433208
1799,laszbalo,7,0.00162,48986,11.30773,433208
1800,lazybetrayer,7,0.00162,48993,11.30935,433208
1801,Lazzaretti,7,0.00162,49000,11.31096,433208
1802,Lemmons,7,0.00162,49007,11.31258,433208
1803,lexfrei,7,0.00162,49014,11.31420,433208
1804,linjmeyer,7,0.00162,49021,11.31581,433208
1805,lithiumoxide,7,0.00162,49028,11.31743,433208
1806,long1eu,7,0.00162,49035,11.31904,433208
1807,lonnix,7,0.00162,49042,11.32066,433208
1808,loongify,7,0.00162,49049,11.32227,433208
1809,louhde,7,0.00162,49056,11.32389,433208
1810,lucernae,7,0.00162,49063,11.32551,433208
1811,lukedirtwalker,7,0.00162,49070,11.32712,433208
1812,lz006,7,0.00162,49077,11.32874,433208
1813,maaoBit,7,0.00162,49084,11.33035,433208
1814,macskay,7,0.00162,49091,11.33197,433208
1815,madhukar93,7,0.00162,49098,11.33359,433208
1816,madhukirans,7,0.00162,49105,11.33520,433208
1817,majoyz,7,0.00162,49112,11.33682,433208
1818,mariusioana,7,0.00162,49119,11.33843,433208
1819,mark9white,7,0.00162,49126,11.34005,433208
1820,mark-church,7,0.00162,49133,11.34166,433208
1821,MarkLodato,7,0.00162,49140,11.34328,433208
1822,marviniter,7,0.00162,49147,11.34490,433208
1823,MaxRenaud,7,0.00162,49154,11.34651,433208
1824,mberwanger,7,0.00162,49161,11.34813,433208
1825,mcavoyk,7,0.00162,49168,11.34974,433208
1826,MerveeYilmaz,7,0.00162,49175,11.35136,433208
1827,mhewedy,7,0.00162,49182,11.35298,433208
1828,MicahDShackelford,7,0.00162,49189,11.35459,433208
1829,michalss,7,0.00162,49196,11.35621,433208
1830,michelzanini,7,0.00162,49203,11.35782,433208
1831,mmckane,7,0.00162,49210,11.35944,433208
1832,mobouchardcoveo,7,0.00162,49217,11.36106,433208
1833,mohideen,7,0.00162,49224,11.36267,433208
1834,mohjam2004,7,0.00162,49231,11.36429,433208
1835,moshen,7,0.00162,49238,11.36590,433208
1836,mothershipper,7,0.00162,49245,11.36752,433208
1837,MRamos62786,7,0.00162,49252,11.36913,433208
1838,MrYourM,7,0.00162,49259,11.37075,433208
1839,musaprg,7,0.00162,49266,11.37237,433208
1840,muwon,7,0.00162,49273,11.37398,433208
1841,n2ygk,7,0.00162,49280,11.37560,433208
1842,n4nn31355,7,0.00162,49287,11.37721,433208
1843,NamikoToriyama,7,0.00162,49294,11.37883,433208
1844,nanonyme,7,0.00162,49301,11.38045,433208
1845,neel8989,7,0.00162,49308,11.38206,433208
1846,nhcarrigan,7,0.00162,49315,11.38368,433208
1847,nishuihan,7,0.00162,49322,11.38529,433208
1848,NissesSenap,7,0.00162,49329,11.38691,433208
1849,NiteshKoushik,7,0.00162,49336,11.38852,433208
1850,nkiraly,7,0.00162,49343,11.39014,433208
1851,NonStatic2014,7,0.00162,49350,11.39176,433208
1852,nsilve,7,0.00162,49357,11.39337,433208
1853,odg0318,7,0.00162,49364,11.39499,433208
1854,onmyflow,7,0.00162,49371,11.39660,433208
1855,oyb001,7,0.00162,49378,11.39822,433208
1856,p37ruh4,7,0.00162,49385,11.39984,433208
1857,p3t3rp3pp3r,7,0.00162,49392,11.40145,433208
1858,pankajgavit,7,0.00162,49399,11.40307,433208
1859,parshnt,7,0.00162,49406,11.40468,433208
1860,PDVJAM,7,0.00162,49413,11.40630,433208
1861,peng-isi,7,0.00162,49420,11.40791,433208
1862,penland365,7,0.00162,49427,11.40953,433208
1863,perriea,7,0.00162,49434,11.41115,433208
1864,peterjc85,7,0.00162,49441,11.41276,433208
1865,piyushpyoaknorth,7,0.00162,49448,11.41438,433208
1866,plsnotracking,7,0.00162,49455,11.41599,433208
1867,pmeng99,7,0.00162,49462,11.41761,433208
1868,polygonhell,7,0.00162,49469,11.41923,433208
1869,pranavbaitule,7,0.00162,49476,11.42084,433208
1870,rachgupt,7,0.00162,49483,11.42246,433208
1871,raul1991,7,0.00162,49490,11.42407,433208
1872,raz3k,7,0.00162,49497,11.42569,433208
1873,recet,7,0.00162,49504,11.42731,433208
1874,richard-fairthorne,7,0.00162,49511,11.42892,433208
1875,rickardp,7,0.00162,49518,11.43054,433208
1876,rishabh625,7,0.00162,49525,11.43215,433208
1877,riticksingh,7,0.00162,49532,11.43377,433208
1878,RnkeZ,7,0.00162,49539,11.43538,433208
1879,roligupt,7,0.00162,49546,11.43700,433208
1880,rons4,7,0.00162,49553,11.43862,433208
1881,rstreics,7,0.00162,49560,11.44023,433208
1882,rx5801,7,0.00162,49567,11.44185,433208
1883,ryanjbaxter,7,0.00162,49574,11.44346,433208
1884,sagarvilas,7,0.00162,49581,11.44508,433208
1885,samene,7,0.00162,49588,11.44670,433208
1886,sanamsarath,7,0.00162,49595,11.44831,433208
1887,santoshborse,7,0.00162,49602,11.44993,433208
1888,saranhada,7,0.00162,49609,11.45154,433208
1889,saranyavignesh2123,7,0.00162,49616,11.45316,433208
1890,sbvitok,7,0.00162,49623,11.45477,433208
1891,scottslowe,7,0.00162,49630,11.45639,433208
1892,seemonicago,7,0.00162,49637,11.45801,433208
1893,shadiramadan,7,0.00162,49644,11.45962,433208
1894,shibaPuppy,7,0.00162,49651,11.46124,433208
1895,Shivansh2407,7,0.00162,49658,11.46285,433208
1896,shokada,7,0.00162,49665,11.46447,433208
1897,sh-sekigawa,7,0.00162,49672,11.46609,433208
1898,shubhamc183,7,0.00162,49679,11.46770,433208
1899,Shumatsu,7,0.00162,49686,11.46932,433208
1900,silborynirmata,7,0.00162,49693,11.47093,433208
1901,sirwio,7,0.00162,49700,11.47255,433208
1902,sjdweb,7,0.00162,49707,11.47416,433208
1903,skyrain,7,0.00162,49714,11.47578,433208
1904,smartaquarius10,7,0.00162,49721,11.47740,433208
1905,smira,7,0.00162,49728,11.47901,433208
1906,softcane,7,0.00162,49735,11.48063,433208
1907,solovyevt,7,0.00162,49742,11.48224,433208
1908,spyvip,7,0.00162,49749,11.48386,433208
1909,srinathganesh1,7,0.00162,49756,11.48548,433208
1910,srteam2020,7,0.00162,49763,11.48709,433208
1911,ssebayam,7,0.00162,49770,11.48871,433208
1912,sshukun,7,0.00162,49777,11.49032,433208
1913,stadaki,7,0.00162,49784,11.49194,433208
1914,steveteuber,7,0.00162,49791,11.49356,433208
1915,sudhirjangir,7,0.00162,49798,11.49517,433208
1916,sumitKash,7,0.00162,49805,11.49679,433208
1917,tbsoares,7,0.00162,49812,11.49840,433208
1918,Tchoupinax,7,0.00162,49819,11.50002,433208
1919,tgdfool2,7,0.00162,49826,11.50163,433208
1920,thibautcharry,7,0.00162,49833,11.50325,433208
1921,thomasfrederikhoeck,7,0.00162,49840,11.50487,433208
1922,timchenxiaoyu,7,0.00162,49847,11.50648,433208
1923,tiwariashish86,7,0.00162,49854,11.50810,433208
1924,tkzkno,7,0.00162,49861,11.50971,433208
1925,tmwheel,7,0.00162,49868,11.51133,433208
1926,tomasz-zylka-fluke,7,0.00162,49875,11.51295,433208
1927,tomgoren,7,0.00162,49882,11.51456,433208
1928,toninis,7,0.00162,49889,11.51618,433208
1929,torresdal,7,0.00162,49896,11.51779,433208
1930,trondhindenes,7,0.00162,49903,11.51941,433208
1931,tvanderka,7,0.00162,49910,11.52102,433208
1932,Ultra4life,7,0.00162,49917,11.52264,433208
1933,unknowingknow,7,0.00162,49924,11.52426,433208
1934,uwemaurer,7,0.00162,49931,11.52587,433208
1935,vadv,7,0.00162,49938,11.52749,433208
1936,vanugrah,7,0.00162,49945,11.52910,433208
1937,varadaprasanth,7,0.00162,49952,11.53072,433208
1938,vfiset,7,0.00162,49959,11.53234,433208
1939,Vickey-Wu,7,0.00162,49966,11.53395,433208
1940,victorfrancax1,7,0.00162,49973,11.53557,433208
1941,vishnubraj,7,0.00162,49980,11.53718,433208
1942,viveksahu26,7,0.00162,49987,11.53880,433208
1943,vlinevych,7,0.00162,49994,11.54041,433208
1944,v-pap,7,0.00162,50001,11.54203,433208
1945,Wang-Kai,7,0.00162,50008,11.54365,433208
1946,whitetiger1399,7,0.00162,50015,11.54526,433208
1947,Wihrt,7,0.00162,50022,11.54688,433208
1948,wrayzheng,7,0.00162,50029,11.54849,433208
1949,wrdls,7,0.00162,50036,11.55011,433208
1950,wuxiaohui94,7,0.00162,50043,11.55173,433208
1951,WywTed,7,0.00162,50050,11.55334,433208
1952,XGameCloud,7,0.00162,50057,11.55496,433208
1953,XiaoJiangWang,7,0.00162,50064,11.55657,433208
1954,xishengcai,7,0.00162,50071,11.55819,433208
1955,xtreme-sameer-vohra,7,0.00162,50078,11.55980,433208
1956,xuchuan-666,7,0.00162,50085,11.56142,433208
1957,yamlCase,7,0.00162,50092,11.56304,433208
1958,yangjy20169717,7,0.00162,50099,11.56465,433208
1959,yaroze,7,0.00162,50106,11.56627,433208
1960,yehiyam,7,0.00162,50113,11.56788,433208
1961,yuwtennis,7,0.00162,50120,11.56950,433208
1962,zacharycmontoya,7,0.00162,50127,11.57112,433208
1963,zhamdoctor,7,0.00162,50134,11.57273,433208
1964,zhangjaycee,7,0.00162,50141,11.57435,433208
1965,zhangxingdeppon,7,0.00162,50148,11.57596,433208
1966,ZhenLiu94,7,0.00162,50155,11.57758,433208
1967,zk19930911,7,0.00162,50162,11.57920,433208
1968,zxpan,7,0.00162,50169,11.58081,433208
1969,7hacker,6,0.00139,50175,11.58220,433208
1970,a1k24,6,0.00139,50181,11.58358,433208
1971,aakifshaikh,6,0.00139,50187,11.58497,433208
1972,Aaron-23,6,0.00139,50193,11.58635,433208
1973,abarke,6,0.00139,50199,11.58774,433208
1974,abhinavkhanna-sf,6,0.00139,50205,11.58912,433208
1975,Abhishek-Srivastava,6,0.00139,50211,11.59051,433208
1976,abyth,6,0.00139,50217,11.59189,433208
1977,adamkane13,6,0.00139,50223,11.59328,433208
1978,adirburke,6,0.00139,50229,11.59466,433208
1979,AdolfoJulcamoro,6,0.00139,50235,11.59605,433208
1980,adrianke77,6,0.00139,50241,11.59743,433208
1981,adrianparks,6,0.00139,50247,11.59882,433208
1982,ajchiarello,6,0.00139,50253,11.60020,433208
1983,akonale,6,0.00139,50259,11.60159,433208
1984,akwanmaroso,6,0.00139,50265,11.60297,433208
1985,albertomiglionni,6,0.00139,50271,11.60436,433208
1986,aletepe,6,0.00139,50277,11.60574,433208
1987,AlexandrePicosson,6,0.00139,50283,11.60713,433208
1988,AlexOQ,6,0.00139,50289,11.60851,433208
1989,alileza,6,0.00139,50295,11.60990,433208
1990,ali-raza-tariq,6,0.00139,50301,11.61128,433208
1991,alittlec,6,0.00139,50307,11.61267,433208
1992,Alxspb,6,0.00139,50313,11.61405,433208
1993,alyzidi222,6,0.00139,50319,11.61544,433208
1994,Amauche,6,0.00139,50325,11.61682,433208
1995,amitkhurana92,6,0.00139,50331,11.61821,433208
1996,andrewipmtl,6,0.00139,50337,11.61959,433208
1997,andrewpmartinez,6,0.00139,50343,11.62098,433208
1998,andrew-whiriskey,6,0.00139,50349,11.62236,433208
1999,andreyprezotto,6,0.00139,50355,11.62375,433208
2000,andschneider,6,0.00139,50361,11.62513,433208
2001,Anil-YadavK8s,6,0.00139,50367,11.62652,433208
2002,anusood,6,0.00139,50373,11.62790,433208
2003,AnyISalIn,6,0.00139,50379,11.62929,433208
2004,apyrgio,6,0.00139,50385,11.63067,433208
2005,aravindputrevu,6,0.00139,50391,11.63206,433208
2006,arcreigh,6,0.00139,50397,11.63344,433208
2007,arnoldfranz,6,0.00139,50403,11.63483,433208
2008,Arsen-Uulu,6,0.00139,50409,11.63621,433208
2009,artemmikhalitsin,6,0.00139,50415,11.63760,433208
2010,arthurlogilab,6,0.00139,50421,11.63898,433208
2011,ashokc27,6,0.00139,50427,11.64037,433208
2012,astrikos,6,0.00139,50433,11.64175,433208
2013,atomerz,6,0.00139,50439,11.64314,433208
2014,avacaru,6,0.00139,50445,11.64452,433208
2015,avairavan,6,0.00139,50451,11.64591,433208
2016,avenda,6,0.00139,50457,11.64729,433208
2017,awesomenix,6,0.00139,50463,11.64868,433208
2018,AyushCloud,6,0.00139,50469,11.65006,433208
2019,azarudeena,6,0.00139,50475,11.65145,433208
2020,Azim-Palmer,6,0.00139,50481,11.65283,433208
2021,b1tamara,6,0.00139,50487,11.65422,433208
2022,balonik,6,0.00139,50493,11.65560,433208
2023,bassambst,6,0.00139,50499,11.65699,433208
2024,bbyrne5,6,0.00139,50505,11.65837,433208
2025,bdudelsack,6,0.00139,50511,11.65976,433208
2026,Beardface123,6,0.00139,50517,11.66114,433208
2027,ben-turner,6,0.00139,50523,11.66253,433208
2028,bessyosper,6,0.00139,50529,11.66391,433208
2029,bfoxstudio,6,0.00139,50535,11.66530,433208
2030,BigeYoung,6,0.00139,50541,11.66668,433208
2031,binnythomas-1989,6,0.00139,50547,11.66807,433208
2032,blackjackyau,6,0.00139,50553,11.66945,433208
2033,blmhemu,6,0.00139,50559,11.67084,433208
2034,bozzo,6,0.00139,50565,11.67222,433208
2035,bresmith-wayfair,6,0.00139,50571,11.67361,433208
2036,bri365,6,0.00139,50577,11.67499,433208
2037,briankmatheson,6,0.00139,50583,11.67638,433208
2038,bs444,6,0.00139,50589,11.67776,433208
2039,bukowa,6,0.00139,50595,11.67915,433208
2040,caddac,6,0.00139,50601,11.68053,433208
2041,CertainLach,6,0.00139,50607,11.68192,433208
2042,challapradyumna,6,0.00139,50613,11.68330,433208
2043,charith-elastic,6,0.00139,50619,11.68469,433208
2044,chenchunxiu,6,0.00139,50625,11.68607,433208
2045,chicknsoup,6,0.00139,50631,11.68746,433208
2046,chiducaf,6,0.00139,50637,11.68884,433208
2047,ChrisJBurns,6,0.00139,50643,11.69023,433208
2048,christarazi,6,0.00139,50649,11.69161,433208
2049,citananda,6,0.00139,50655,11.69300,433208
2050,clemenko,6,0.00139,50661,11.69438,433208
2051,cobb-tx,6,0.00139,50667,11.69577,433208
2052,coderigo,6,0.00139,50673,11.69715,433208
2053,cprayer,6,0.00139,50679,11.69854,433208
2054,cranzy,6,0.00139,50685,11.69992,433208
2055,Crazy-Kitty,6,0.00139,50691,11.70131,433208
2056,crisesw,6,0.00139,50697,11.70269,433208
2057,cristianburca,6,0.00139,50703,11.70408,433208
2058,csor-dev,6,0.00139,50709,11.70546,433208
2059,cxz0804,6,0.00139,50715,11.70685,433208
2060,Cynocracy,6,0.00139,50721,11.70823,433208
2061,dagenius007,6,0.00139,50727,11.70962,433208
2062,DaInco,6,0.00139,50733,11.71100,433208
2063,Daniel451,6,0.00139,50739,11.71239,433208
2064,darfux,6,0.00139,50745,11.71377,433208
2065,Dariusch,6,0.00139,50751,11.71516,433208
2066,DarkBlaez,6,0.00139,50757,11.71654,433208
2067,darxkies,6,0.00139,50763,11.71793,433208
2068,davidpoblador,6,0.00139,50769,11.71931,433208
2069,dawid-nowak,6,0.00139,50775,11.72070,433208
2070,dbseel,6,0.00139,50781,11.72208,433208
2071,dcodix,6,0.00139,50787,11.72347,433208
2072,debu99,6,0.00139,50793,11.72485,433208
2073,decanus,6,0.00139,50799,11.72624,433208
2074,DemonsLu,6,0.00139,50805,11.72762,433208
2075,dertodestod,6,0.00139,50811,11.72901,433208
2076,designedforplaygames,6,0.00139,50817,11.73039,433208
2077,dhananjaya-senanayake,6,0.00139,50823,11.73178,433208
2078,digibank-rons,6,0.00139,50829,11.73316,433208
2079,dimitraPat,6,0.00139,50835,11.73455,433208
2080,dinever,6,0.00139,50841,11.73593,433208
2081,dinvlad,6,0.00139,50847,11.73732,433208
2082,dlavrenuek,6,0.00139,50853,11.73870,433208
2083,dmilde,6,0.00139,50859,11.74009,433208
2084,d-mo,6,0.00139,50865,11.74147,433208
2085,doubletao318,6,0.00139,50871,11.74286,433208
2086,dragoneena12,6,0.00139,50877,11.74424,433208
2087,dshomoye,6,0.00139,50883,11.74563,433208
2088,dswij,6,0.00139,50889,11.74701,433208
2089,duncanhall,6,0.00139,50895,11.74840,433208
2090,dwaiba,6,0.00139,50901,11.74978,433208
2091,eddycharly,6,0.00139,50907,11.75117,433208
2092,eitanpo,6,0.00139,50913,11.75255,433208
2093,ekrecker,6,0.00139,50919,11.75394,433208
2094,elmariofredo,6,0.00139,50925,11.75532,433208
2095,EngRajabi,6,0.00139,50931,11.75671,433208
2096,erikcostlow,6,0.00139,50937,11.75809,433208
2097,ErrReporter,6,0.00139,50943,11.75948,433208
2098,etifontaine,6,0.00139,50949,11.76086,433208
2099,etwillbefine,6,0.00139,50955,11.76225,433208
2100,excavador,6,0.00139,50961,11.76363,433208
2101,FakeNameSE,6,0.00139,50967,11.76502,433208
2102,fals,6,0.00139,50973,11.76640,433208
2103,fantastic2085,6,0.00139,50979,11.76779,433208
2104,fcantournet,6,0.00139,50985,11.76917,433208
2105,fengypants,6,0.00139,50991,11.77056,433208
2106,Fixmetal,6,0.00139,50997,11.77194,433208
2107,flouthoc,6,0.00139,51003,11.77333,433208
2108,forumsheth,6,0.00139,51009,11.77471,433208
2109,FranciscoMSM,6,0.00139,51015,11.77610,433208
2110,FrankYang0529,6,0.00139,51021,11.77748,433208
2111,fredericve,6,0.00139,51027,11.77887,433208
2112,froggyling,6,0.00139,51033,11.78025,433208
2113,FroMage,6,0.00139,51039,11.78164,433208
2114,gabhangra,6,0.00139,51045,11.78302,433208
2115,gabidrg,6,0.00139,51051,11.78441,433208
2116,gabrielcalderon,6,0.00139,51057,11.78579,433208
2117,gabriellemadden,6,0.00139,51063,11.78718,433208
2118,Gauravjaitly,6,0.00139,51069,11.78856,433208
2119,gburek-fastly,6,0.00139,51075,11.78995,433208
2120,gkesavan,6,0.00139,51081,11.79133,433208
2121,gokula-krishna-dev,6,0.00139,51087,11.79272,433208
2122,govargo,6,0.00139,51093,11.79410,433208
2123,grantliu3,6,0.00139,51099,11.79549,433208
2124,GTB3NW,6,0.00139,51105,11.79687,433208
2125,gugahoa,6,0.00139,51111,11.79826,433208
2126,guoruijing,6,0.00139,51117,11.79964,433208
2127,gussj,6,0.00139,51123,11.80103,433208
2128,gybfefe,6,0.00139,51129,11.80241,433208
2129,h1de27,6,0.00139,51135,11.80380,433208
2130,hack3r-0m,6,0.00139,51141,11.80518,433208
2131,HackRanger,6,0.00139,51147,11.80657,433208
2132,hakuno,6,0.00139,51153,11.80795,433208
2133,HansK-p,6,0.00139,51159,11.80934,433208
2134,HappyCerberus,6,0.00139,51165,11.81072,433208
2135,happywzy,6,0.00139,51171,11.81211,433208
2136,Hard-Coder05,6,0.00139,51177,11.81349,433208
2137,harlesbayu,6,0.00139,51183,11.81488,433208
2138,hatamiarash7,6,0.00139,51189,11.81626,433208
2139,hatharom,6,0.00139,51195,11.81765,433208
2140,headshot289,6,0.00139,51201,11.81903,433208
2141,hectorhuertas,6,0.00139,51207,11.82042,433208
2142,herozabbix,6,0.00139,51213,11.82180,433208
2143,hikimochi,6,0.00139,51219,11.82319,433208
2144,hintofbasil,6,0.00139,51225,11.82457,433208
2145,hjkatz,6,0.00139,51231,11.82596,433208
2146,hnifmaghfur,6,0.00139,51237,11.82734,433208
2147,hobbytp,6,0.00139,51243,11.82873,433208
2148,hq6,6,0.00139,51249,11.83011,433208
2149,huangkaiyan10,6,0.00139,51255,11.83150,433208
2150,HubertStefanski,6,0.00139,51261,11.83288,433208
2151,hummerd,6,0.00139,51267,11.83427,433208
2152,husoule,6,0.00139,51273,11.83565,433208
2153,ianvari,6,0.00139,51279,11.83704,433208
2154,IceeMC,6,0.00139,51285,11.83842,433208
2155,imilchev,6,0.00139,51291,11.83981,433208
2156,impsik,6,0.00139,51297,11.84119,433208
2157,infa-vmannam,6,0.00139,51303,11.84258,433208
2158,infiniteoverflow,6,0.00139,51309,11.84396,433208
2159,ingshtrom,6,0.00139,51315,11.84535,433208
2160,inosvaruag,6,0.00139,51321,11.84673,433208
2161,ioquatix,6,0.00139,51327,11.84812,433208
2162,IrisChanTW,6,0.00139,51333,11.84950,433208
2163,irivera007,6,0.00139,51339,11.85089,433208
2164,itsMeDacarvalho,6,0.00139,51345,11.85227,433208
2165,jackivanov,6,0.00139,51351,11.85366,433208
2166,jaksky,6,0.00139,51357,11.85504,433208
2167,jamesfer,6,0.00139,51363,11.85643,433208
2168,jamesylgan,6,0.00139,51369,11.85781,433208
2169,jan-xyz,6,0.00139,51375,11.85920,433208
2170,jcaesar,6,0.00139,51381,11.86058,433208
2171,JebasinghLuccas,6,0.00139,51387,11.86197,433208
2172,jeisen,6,0.00139,51393,11.86335,433208
2173,jemygraw,6,0.00139,51399,11.86474,433208
2174,jeromeroserio,6,0.00139,51405,11.86612,433208
2175,jgato,6,0.00139,51411,11.86751,433208
2176,Jigar3,6,0.00139,51417,11.86889,433208
2177,jitendar-singh,6,0.00139,51423,11.87028,433208
2178,jl0x61,6,0.00139,51429,11.87166,433208
2179,jlcox1970,6,0.00139,51435,11.87305,433208
2180,jmeis,6,0.00139,51441,11.87443,433208
2181,joe-getcouragenow,6,0.00139,51447,11.87582,433208
2182,josefcub,6,0.00139,51453,11.87720,433208
2183,jp-gouin,6,0.00139,51459,11.87859,433208
2184,jschwinger23,6,0.00139,51465,11.87997,433208
2185,juliohm1978,6,0.00139,51471,11.88136,433208
2186,j-windsor,6,0.00139,51477,11.88274,433208
2187,jwm,6,0.00139,51483,11.88413,433208
2188,Kamerads,6,0.00139,51489,11.88551,433208
2189,karancode,6,0.00139,51495,11.88690,433208
2190,katiewasnothere,6,0.00139,51501,11.88828,433208
2191,kaxil,6,0.00139,51507,11.88967,433208
2192,kbokarius,6,0.00139,51513,11.89105,433208
2193,kenji-cloudnatix,6,0.00139,51519,11.89244,433208
2194,khs1994,6,0.00139,51525,11.89382,433208
2195,king311247,6,0.00139,51531,11.89521,433208
2196,KIRY4,6,0.00139,51537,11.89659,433208
2197,kkessels,6,0.00139,51543,11.89798,433208
2198,kmindi,6,0.00139,51549,11.89936,433208
2199,kraney,6,0.00139,51555,11.90075,433208
2200,LasTshaMAN,6,0.00139,51561,11.90213,433208
2201,LeandroMoura3,6,0.00139,51567,11.90352,433208
2202,LittleFox94,6,0.00139,51573,11.90490,433208
2203,liujiang0529,6,0.00139,51579,11.90629,433208
2204,lmolas,6,0.00139,51585,11.90767,433208
2205,lomori,6,0.00139,51591,11.90906,433208
2206,lonfme,6,0.00139,51597,11.91044,433208
2207,loomsen,6,0.00139,51603,11.91183,433208
2208,lorenz,6,0.00139,51609,11.91321,433208
2209,lorenzo-biava,6,0.00139,51615,11.91460,433208
2210,love-miao,6,0.00139,51621,11.91598,433208
2211,luwang-vmware,6,0.00139,51627,11.91737,433208
2212,luyisa,6,0.00139,51633,11.91875,433208
2213,lxm,6,0.00139,51639,11.92014,433208
2214,lywyue,6,0.00139,51645,11.92152,433208
2215,maelfosso,6,0.00139,51651,11.92291,433208
2216,mallow111,6,0.00139,51657,11.92430,433208
2217,marcinc,6,0.00139,51663,11.92568,433208
2218,MartinKirchner,6,0.00139,51669,11.92707,433208
2219,matt-demers,6,0.00139,51675,11.92845,433208
2220,matt-sm,6,0.00139,51681,11.92984,433208
2221,mehran-prs,6,0.00139,51687,11.93122,433208
2222,MeirP-3,6,0.00139,51693,11.93261,433208
2223,mel1nn,6,0.00139,51699,11.93399,433208
2224,melissajenner22,6,0.00139,51705,11.93538,433208
2225,mfickett,6,0.00139,51711,11.93676,433208
2226,MichaelMedvedskiy,6,0.00139,51717,11.93815,433208
2227,michielvangendt,6,0.00139,51723,11.93953,433208
2228,mikeBashStuff,6,0.00139,51729,11.94092,433208
2229,minamijoyo,6,0.00139,51735,11.94230,433208
2230,mingjie-li,6,0.00139,51741,11.94369,433208
2231,mllu,6,0.00139,51747,11.94507,433208
2232,mmat11,6,0.00139,51753,11.94646,433208
2233,mndrix,6,0.00139,51759,11.94784,433208
2234,mopsfelder,6,0.00139,51765,11.94923,433208
2235,mparamas-zz,6,0.00139,51771,11.95061,433208
2236,mpkonmbk,6,0.00139,51777,11.95200,433208
2237,mrSingh007,6,0.00139,51783,11.95338,433208
2238,mssanjay,6,0.00139,51789,11.95477,433208
2239,msshroff,6,0.00139,51795,11.95615,433208
2240,munagekar,6,0.00139,51801,11.95754,433208
2241,munjalpatel,6,0.00139,51807,11.95892,433208
2242,mvrhov,6,0.00139,51813,11.96031,433208
2243,m-yosefpor,6,0.00139,51819,11.96169,433208
2244,Mystigan,6,0.00139,51825,11.96308,433208
2245,nairb774,6,0.00139,51831,11.96446,433208
2246,nao-ri,6,0.00139,51837,11.96585,433208
2247,nataraj24,6,0.00139,51843,11.96723,433208
2248,nbhargava,6,0.00139,51849,11.96862,433208
2249,nchetan,6,0.00139,51855,11.97000,433208
2250,nelsonspbr,6,0.00139,51861,11.97139,433208
2251,nestorsokil,6,0.00139,51867,11.97277,433208
2252,nfyxhan,6,0.00139,51873,11.97416,433208
2253,nicolasduminil,6,0.00139,51879,11.97554,433208
2254,Nicwalle,6,0.00139,51885,11.97693,433208
2255,niebomin,6,0.00139,51891,11.97831,433208
2256,niksanla2,6,0.00139,51897,11.97970,433208
2257,nikutelusuiphone,6,0.00139,51903,11.98108,433208
2258,niladrih,6,0.00139,51909,11.98247,433208
2259,nirmal-mehta,6,0.00139,51915,11.98385,433208
2260,nmathew,6,0.00139,51921,11.98524,433208
2261,nucleusv,6,0.00139,51927,11.98662,433208
2262,oliversalzburg,6,0.00139,51933,11.98801,433208
2263,olivierboudet,6,0.00139,51939,11.98939,433208
2264,Ooyixiao,6,0.00139,51945,11.99078,433208
2265,orange-llajeanne,6,0.00139,51951,11.99216,433208
2266,OrenLederman,6,0.00139,51957,11.99355,433208
2267,oulin-coder,6,0.00139,51963,11.99493,433208
2268,paranblues,6,0.00139,51969,11.99632,433208
2269,pascal71,6,0.00139,51975,11.99770,433208
2270,paulcaskey,6,0.00139,51981,11.99909,433208
2271,paulpuvi06,6,0.00139,51987,12.00047,433208
2272,PavelSosin-320,6,0.00139,51993,12.00186,433208
2273,pbxqdown,6,0.00139,51999,12.00324,433208
2274,pedroandrade,6,0.00139,52005,12.00463,433208
2275,pierreneter,6,0.00139,52011,12.00601,433208
2276,pieterv-icloud-com,6,0.00139,52017,12.00740,433208
2277,pikhovkin,6,0.00139,52023,12.00878,433208
2278,pingdink,6,0.00139,52029,12.01017,433208
2279,poojan-dalal,6,0.00139,52035,12.01155,433208
2280,porytskyi,6,0.00139,52041,12.01294,433208
2281,pranjaljain0,6,0.00139,52047,12.01432,433208
2282,prgaly,6,0.00139,52053,12.01571,433208
2283,primeroz,6,0.00139,52059,12.01709,433208
2284,programistka,6,0.00139,52065,12.01848,433208
2285,psavva,6,0.00139,52071,12.01986,433208
2286,pschmitt,6,0.00139,52077,12.02125,433208
2287,p-yang,6,0.00139,52083,12.02263,433208
2288,qbarrand,6,0.00139,52089,12.02402,433208
2289,qfliu,6,0.00139,52095,12.02540,433208
2290,r10r,6,0.00139,52101,12.02679,433208
2291,RagingPuppies,6,0.00139,52107,12.02817,433208
2292,rajat404,6,0.00139,52113,12.02956,433208
2293,ramran-r,6,0.00139,52119,12.03094,433208
2294,Rashmi-K-A,6,0.00139,52125,12.03233,433208
2295,realnikhilkumar,6,0.00139,52131,12.03371,433208
2296,renvrant,6,0.00139,52137,12.03510,433208
2297,RiyaJohn,6,0.00139,52143,12.03648,433208
2298,rjn01,6,0.00139,52149,12.03787,433208
2299,robertsmieja,6,0.00139,52155,12.03925,433208
2300,robherley,6,0.00139,52161,12.04064,433208
2301,robojones,6,0.00139,52167,12.04202,433208
2302,rohannevrikar,6,0.00139,52173,12.04341,433208
2303,roobert,6,0.00139,52179,12.04479,433208
2304,rubelw,6,0.00139,52185,12.04618,433208
2305,ruben-herold,6,0.00139,52191,12.04756,433208
2306,ryan-dyer-sp,6,0.00139,52197,12.04895,433208
2307,safl,6,0.00139,52203,12.05033,433208
2308,saintmalik,6,0.00139,52209,12.05172,433208
2309,sajjad-shirazy,6,0.00139,52215,12.05310,433208
2310,salahalsaleh,6,0.00139,52221,12.05449,433208
2311,sanjeevnewar2007,6,0.00139,52227,12.05587,433208
2312,Sathishkunisai,6,0.00139,52233,12.05726,433208
2313,savitha-ping,6,0.00139,52239,12.05864,433208
2314,sdodsley,6,0.00139,52245,12.06003,433208
2315,S-dwinter,6,0.00139,52251,12.06141,433208
2316,sedovalx,6,0.00139,52257,12.06280,433208
2317,Seitanas,6,0.00139,52263,12.06418,433208
2318,shirolimit,6,0.00139,52269,12.06557,433208
2319,shooshx,6,0.00139,52275,12.06695,433208
2320,showingtime-devops,6,0.00139,52281,12.06834,433208
2321,shrpne,6,0.00139,52287,12.06972,433208
2322,Shuanglu,6,0.00139,52293,12.07111,433208
2323,sibidass,6,0.00139,52299,12.07249,433208
2324,sirpeanut,6,0.00139,52305,12.07388,433208
2325,sobi3ch,6,0.00139,52311,12.07526,433208
2326,sserantes,6,0.00139,52317,12.07665,433208
2327,staschuk-bungalow,6,0.00139,52323,12.07803,433208
2328,steigr,6,0.00139,52329,12.07942,433208
2329,strangeminds,6,0.00139,52335,12.08080,433208
2330,SueKocher,6,0.00139,52341,12.08219,433208
2331,Surbowl,6,0.00139,52347,12.08357,433208
2332,susu3621,6,0.00139,52353,12.08496,433208
2333,sw919678915,6,0.00139,52359,12.08634,433208
2334,sykp241095,6,0.00139,52365,12.08773,433208
2335,system51,6,0.00139,52371,12.08911,433208
2336,tae9yu,6,0.00139,52377,12.09050,433208
2337,talhalatifkhan,6,0.00139,52383,12.09188,433208
2338,tbox1911,6,0.00139,52389,12.09327,433208
2339,tdihp,6,0.00139,52395,12.09465,433208
2340,teamsmiley,6,0.00139,52401,12.09604,433208
2341,texanraj,6,0.00139,52407,12.09742,433208
2342,theherk,6,0.00139,52413,12.09881,433208
2343,thernstig,6,0.00139,52419,12.10019,433208
2344,TigerHe7,6,0.00139,52425,12.10158,433208
2345,tim-brand,6,0.00139,52431,12.10296,433208
2346,Timoses,6,0.00139,52437,12.10435,433208
2347,toan-hf,6,0.00139,52443,12.10573,433208
2348,tokyowizard,6,0.00139,52449,12.10712,433208
2349,tomaslm,6,0.00139,52455,12.10850,433208
2350,TommyUnger,6,0.00139,52461,12.10989,433208
2351,tplavcic,6,0.00139,52467,12.11127,433208
2352,trilitheus,6,0.00139,52473,12.11266,433208
2353,ts-mini,6,0.00139,52479,12.11404,433208
2354,tuananhnguyen-ct,6,0.00139,52485,12.11543,433208
2355,turettn,6,0.00139,52491,12.11681,433208
2356,TWL007,6,0.00139,52497,12.11820,433208
2357,twobombs,6,0.00139,52503,12.11958,433208
2358,ufou,6,0.00139,52509,12.12097,433208
2359,ulucinar,6,0.00139,52515,12.12235,433208
2360,UnwashedMeme,6,0.00139,52521,12.12374,433208
2361,Velyks,6,0.00139,52527,12.12512,433208
2362,venkatbvc,6,0.00139,52533,12.12651,433208
2363,venkatvghub,6,0.00139,52539,12.12789,433208
2364,vignesh-codes,6,0.00139,52545,12.12928,433208
2365,vivainio,6,0.00139,52551,12.13066,433208
2366,VladoPortos,6,0.00139,52557,12.13205,433208
2367,V-Soni,6,0.00139,52563,12.13343,433208
2368,vyom-soft,6,0.00139,52569,12.13482,433208
2369,wakeupcolumn,6,0.00139,52575,12.13620,433208
2370,walidshaari,6,0.00139,52581,12.13759,433208
2371,wangyx1992,6,0.00139,52587,12.13897,433208
2372,wangzhipeng,6,0.00139,52593,12.14036,433208
2373,wanyoulc,6,0.00139,52599,12.14174,433208
2374,WarpRat,6,0.00139,52605,12.14313,433208
2375,waynesun09,6,0.00139,52611,12.14451,433208
2376,wazery,6,0.00139,52617,12.14590,433208
2377,WestEnlarged,6,0.00139,52623,12.14728,433208
2378,whfuyn,6,0.00139,52629,12.14867,433208
2379,WhitePhoera,6,0.00139,52635,12.15005,433208
2380,windniw,6,0.00139,52641,12.15144,433208
2381,woa7,6,0.00139,52647,12.15282,433208
2382,wpwoodjr,6,0.00139,52653,12.15421,433208
2383,Wykiki,6,0.00139,52659,12.15559,433208
2384,Wyntuition,6,0.00139,52665,12.15698,433208
2385,XiXiaPdx,6,0.00139,52671,12.15836,433208
2386,xtreme-nitin-ravindran,6,0.00139,52677,12.15975,433208
2387,XuejiaoZhang,6,0.00139,52683,12.16113,433208
2388,yanji09,6,0.00139,52689,12.16252,433208
2389,yarcyarc,6,0.00139,52695,12.16390,433208
2390,yelhouti,6,0.00139,52701,12.16529,433208
2391,yinjianjin,6,0.00139,52707,12.16667,433208
2392,yiyu0x,6,0.00139,52713,12.16806,433208
2393,youjiahe,6,0.00139,52719,12.16944,433208
2394,youssefazrak,6,0.00139,52725,12.17083,433208
2395,yuanbaodong,6,0.00139,52731,12.17221,433208
2396,yuanyiran,6,0.00139,52737,12.17360,433208
2397,yuchen-sun,6,0.00139,52743,12.17498,433208
2398,YunWang,6,0.00139,52749,12.17637,433208
2399,Yuuraa,6,0.00139,52755,12.17775,433208
2400,yuzisun,6,0.00139,52761,12.17914,433208
2401,zachomedia,6,0.00139,52767,12.18052,433208
2402,zhaxzhax,6,0.00139,52773,12.18191,433208
2403,zkyle95,6,0.00139,52779,12.18329,433208
2404,ZongqiangZhang,6,0.00139,52785,12.18468,433208
2405,zukko78,6,0.00139,52791,12.18606,433208
2406,zvolchak,6,0.00139,52797,12.18745,433208
2407,0pendev,5,0.00115,52802,12.18860,433208
2408,2shsh,5,0.00115,52807,12.18976,433208
2409,4n4nd,5,0.00115,52812,12.19091,433208
2410,532910,5,0.00115,52817,12.19206,433208
2411,5-sigma,5,0.00115,52822,12.19322,433208
2412,A9u,5,0.00115,52827,12.19437,433208
2413,abardavi,5,0.00115,52832,12.19553,433208
2414,abb3r,5,0.00115,52837,12.19668,433208
2415,abhisheknsit,5,0.00115,52842,12.19784,433208
2416,a-b-v,5,0.00115,52847,12.19899,433208
2417,adamcstephens,5,0.00115,52852,12.20014,433208
2418,adamkgray,5,0.00115,52857,12.20130,433208
2419,adamstirk-ct,5,0.00115,52862,12.20245,433208
2420,agarwal-mudit,5,0.00115,52867,12.20361,433208
2421,agneum,5,0.00115,52872,12.20476,433208
2422,agranado2k,5,0.00115,52877,12.20591,433208
2423,ahjmorton,5,0.00115,52882,12.20707,433208
2424,ahmmub,5,0.00115,52887,12.20822,433208
2425,ahtik,5,0.00115,52892,12.20938,433208
2426,ailurarctos,5,0.00115,52897,12.21053,433208
2427,aitorpazos,5,0.00115,52902,12.21169,433208
2428,ajaykmis,5,0.00115,52907,12.21284,433208
2429,akalenyu,5,0.00115,52912,12.21399,433208
2430,akloss-cibo,5,0.00115,52917,12.21515,433208
2431,alegmal,5,0.00115,52922,12.21630,433208
2432,alesanmed,5,0.00115,52927,12.21746,433208
2433,Alex4684,5,0.00115,52932,12.21861,433208
2434,alexmojo,5,0.00115,52937,12.21977,433208
2435,alkapov,5,0.00115,52942,12.22092,433208
2436,allir,5,0.00115,52947,12.22207,433208
2437,AlperEnver,5,0.00115,52952,12.22323,433208
2438,alterEgo123,5,0.00115,52957,12.22438,433208
2439,amomsi,5,0.00115,52962,12.22554,433208
2440,analytically,5,0.00115,52967,12.22669,433208
2441,anandagirish2,5,0.00115,52972,12.22784,433208
2442,andres-lowrie,5,0.00115,52977,12.22900,433208
2443,andreyryabov,5,0.00115,52982,12.23015,433208
2444,andyliumstar,5,0.00115,52987,12.23131,433208
2445,aneagoe,5,0.00115,52992,12.23246,433208
2446,ankit1mg,5,0.00115,52997,12.23362,433208
2447,ankitsingh999,5,0.00115,53002,12.23477,433208
2448,Annegies,5,0.00115,53007,12.23592,433208
2449,anpanigr,5,0.00115,53012,12.23708,433208
2450,antitree,5,0.00115,53017,12.23823,433208
2451,AntonNep,5,0.00115,53022,12.23939,433208
2452,AntonOfTheWoods,5,0.00115,53027,12.24054,433208
2453,AntonQubecinema,5,0.00115,53032,12.24169,433208
2454,appleciderjack,5,0.00115,53037,12.24285,433208
2455,ArgTang,5,0.00115,53042,12.24400,433208
2456,arielhernandezmusa,5,0.00115,53047,12.24516,433208
2457,arielmoraes,5,0.00115,53052,12.24631,433208
2458,arjantop-cai,5,0.00115,53057,12.24747,433208
2459,arnikasky,5,0.00115,53062,12.24862,433208
2460,arnogeurts,5,0.00115,53067,12.24977,433208
2461,arturmon,5,0.00115,53072,12.25093,433208
2462,Asaf-m,5,0.00115,53077,12.25208,433208
2463,aspettl,5,0.00115,53082,12.25324,433208
2464,astencel-sumo,5,0.00115,53087,12.25439,433208
2465,audunsol,5,0.00115,53092,12.25554,433208
2466,AvihuHenya,5,0.00115,53097,12.25670,433208
2467,AvvariSaiBharadwaj,5,0.00115,53102,12.25785,433208
2468,axiangcoding,5,0.00115,53107,12.25901,433208
2469,axiqia,5,0.00115,53112,12.26016,433208
2470,azarzar15,5,0.00115,53117,12.26132,433208
2471,balpert89,5,0.00115,53122,12.26247,433208
2472,balpreet-telnyx,5,0.00115,53127,12.26362,433208
2473,bamarni,5,0.00115,53132,12.26478,433208
2474,BBialeckiACR,5,0.00115,53137,12.26593,433208
2475,bebyx,5,0.00115,53142,12.26709,433208
2476,behos,5,0.00115,53147,12.26824,433208
2477,bendavis78,5,0.00115,53152,12.26939,433208
2478,bfmiv,5,0.00115,53157,12.27055,433208
2479,bh-tt,5,0.00115,53162,12.27170,433208
2480,bigdnf,5,0.00115,53167,12.27286,433208
2481,Binyang2014,5,0.00115,53172,12.27401,433208
2482,bitjson,5,0.00115,53177,12.27517,433208
2483,bklaubos,5,0.00115,53182,12.27632,433208
2484,blackprowler,5,0.00115,53187,12.27747,433208
2485,blind3dd,5,0.00115,53192,12.27863,433208
2486,bluechips23,5,0.00115,53197,12.27978,433208
2487,bmaehr,5,0.00115,53202,12.28094,433208
2488,bmalynovytch,5,0.00115,53207,12.28209,433208
2489,branden,5,0.00115,53212,12.28325,433208
2490,BretFisher,5,0.00115,53217,12.28440,433208
2491,C123R,5,0.00115,53222,12.28555,433208
2492,camdencheek,5,0.00115,53227,12.28671,433208
2493,campbel,5,0.00115,53232,12.28786,433208
2494,caslurjf,5,0.00115,53237,12.28902,433208
2495,cedi,5,0.00115,53242,12.29017,433208
2496,cevian,5,0.00115,53247,12.29132,433208
2497,chainhead,5,0.00115,53252,12.29248,433208
2498,chandanb91,5,0.00115,53257,12.29363,433208
2499,changshuchao,5,0.00115,53262,12.29479,433208
2500,chaochn47,5,0.00115,53267,12.29594,433208
2501,charithe,5,0.00115,53272,12.29710,433208
2502,charles-bluett,5,0.00115,53277,12.29825,433208
2503,charles-woshicai,5,0.00115,53282,12.29940,433208
2504,CheneyDing,5,0.00115,53287,12.30056,433208
2505,chensheng0,5,0.00115,53292,12.30171,433208
2506,ChenYida,5,0.00115,53297,12.30287,433208
2507,chenzx,5,0.00115,53302,12.30402,433208
2508,chinglinwen,5,0.00115,53307,12.30517,433208
2509,chrisdoherty4,5,0.00115,53312,12.30633,433208
2510,chris-mccoy,5,0.00115,53317,12.30748,433208
2511,ChristianWeyer,5,0.00115,53322,12.30864,433208
2512,chuonglh,5,0.00115,53327,12.30979,433208
2513,ciaranRoche,5,0.00115,53332,12.31095,433208
2514,cjpluss2k18,5,0.00115,53337,12.31210,433208
2515,cloudengineers,5,0.00115,53342,12.31325,433208
2516,Cloud-Mak,5,0.00115,53347,12.31441,433208
2517,codayblue,5,0.00115,53352,12.31556,433208
2518,colltoaction,5,0.00115,53357,12.31672,433208
2519,Congrool,5,0.00115,53362,12.31787,433208
2520,creydr,5,0.00115,53367,12.31902,433208
2521,cristiangreco,5,0.00115,53372,12.32018,433208
2522,CrossRoast,5,0.00115,53377,12.32133,433208
2523,cupen,5,0.00115,53382,12.32249,433208
2524,cwsolee,5,0.00115,53387,12.32364,433208
2525,cxhansen,5,0.00115,53392,12.32480,433208
2526,Cyldei,5,0.00115,53397,12.32595,433208
2527,cyrilcros,5,0.00115,53402,12.32710,433208
2528,damnever,5,0.00115,53407,12.32826,433208
2529,danielbang907,5,0.00115,53412,12.32941,433208
2530,danielsand,5,0.00115,53417,12.33057,433208
2531,dan-slinky-ckpd,5,0.00115,53422,12.33172,433208
2532,darkweaver87,5,0.00115,53427,12.33287,433208
2533,davidhoelzel,5,0.00115,53432,12.33403,433208
2534,davidjumani,5,0.00115,53437,12.33518,433208
2535,davidnortonjr-sps,5,0.00115,53442,12.33634,433208
2536,DavidSimner,5,0.00115,53447,12.33749,433208
2537,DavidSpek,5,0.00115,53452,12.33865,433208
2538,dbaker-rh,5,0.00115,53457,12.33980,433208
2539,dbalzan,5,0.00115,53462,12.34095,433208
2540,dennybritz,5,0.00115,53467,12.34211,433208
2541,DesistDaydream,5,0.00115,53472,12.34326,433208
2542,devjgm,5,0.00115,53477,12.34442,433208
2543,devsentient,5,0.00115,53482,12.34557,433208
2544,devthejo,5,0.00115,53487,12.34672,433208
2545,dgrnd4,5,0.00115,53492,12.34788,433208
2546,dguendisch,5,0.00115,53497,12.34903,433208
2547,dhc3800,5,0.00115,53502,12.35019,433208
2548,dhoppe,5,0.00115,53507,12.35134,433208
2549,diemus,5,0.00115,53512,12.35250,433208
2550,divbhasin,5,0.00115,53517,12.35365,433208
2551,diwap,5,0.00115,53522,12.35480,433208
2552,djha736,5,0.00115,53527,12.35596,433208
2553,dmanchikalapudi,5,0.00115,53532,12.35711,433208
2554,dmitrydiavita,5,0.00115,53537,12.35827,433208
2555,dobegor,5,0.00115,53542,12.35942,433208
2556,domasx2,5,0.00115,53547,12.36058,433208
2557,Dong-wook94,5,0.00115,53552,12.36173,433208
2558,donkeyx,5,0.00115,53557,12.36288,433208
2559,Drake8710,5,0.00115,53562,12.36404,433208
2560,drcoolsanjeev,5,0.00115,53567,12.36519,433208
2561,dschuldt,5,0.00115,53572,12.36635,433208
2562,dtw45,5,0.00115,53577,12.36750,433208
2563,duboc,5,0.00115,53582,12.36865,433208
2564,dufcrule,5,0.00115,53587,12.36981,433208
2565,dvulpe,5,0.00115,53592,12.37096,433208
2566,dxGuan,5,0.00115,53597,12.37212,433208
2567,dzilbermanvmw,5,0.00115,53602,12.37327,433208
2568,dzou,5,0.00115,53607,12.37443,433208
2569,EgorLu,5,0.00115,53612,12.37558,433208
2570,ellieseastream,5,0.00115,53617,12.37673,433208
2571,elloe,5,0.00115,53622,12.37789,433208
2572,EmilMichalczewski,5,0.00115,53627,12.37904,433208
2573,emiran-orange,5,0.00115,53632,12.38020,433208
2574,eoli3n,5,0.00115,53637,12.38135,433208
2575,ercpereda,5,0.00115,53642,12.38250,433208
2576,erdii,5,0.00115,53647,12.38366,433208
2577,EricLemieux,5,0.00115,53652,12.38481,433208
2578,fallion,5,0.00115,53657,12.38597,433208
2579,femrtnz,5,0.00115,53662,12.38712,433208
2580,firezjs,5,0.00115,53667,12.38828,433208
2581,flaviopicci,5,0.00115,53672,12.38943,433208
2582,flixpae,5,0.00115,53677,12.39058,433208
2583,ForestCold,5,0.00115,53682,12.39174,433208
2584,foriequal0,5,0.00115,53687,12.39289,433208
2585,foxracle,5,0.00115,53692,12.39405,433208
2586,fredstanley,5,0.00115,53697,12.39520,433208
2587,fridex,5,0.00115,53702,12.39635,433208
2588,fuleow,5,0.00115,53707,12.39751,433208
2589,fyangd,5,0.00115,53712,12.39866,433208
2590,gaurimadhok,5,0.00115,53717,12.39982,433208
2591,gautaz,5,0.00115,53722,12.40097,433208
2592,gautierdelorme,5,0.00115,53727,12.40213,433208
2593,gcohler,5,0.00115,53732,12.40328,433208
2594,gdhuper,5,0.00115,53737,12.40443,433208
2595,geofflancaster,5,0.00115,53742,12.40559,433208
2596,George-Chia,5,0.00115,53747,12.40674,433208
2597,girishgouda,5,0.00115,53752,12.40790,433208
2598,giulianovarriale,5,0.00115,53757,12.40905,433208
2599,gknepper,5,0.00115,53762,12.41020,433208
2600,gldraphael,5,0.00115,53767,12.41136,433208
2601,glittershark,5,0.00115,53772,12.41251,433208
2602,GMarkfjard,5,0.00115,53777,12.41367,433208
2603,Gmtstephane,5,0.00115,53782,12.41482,433208
2604,grem11n,5,0.00115,53787,12.41598,433208
2605,guettli,5,0.00115,53792,12.41713,433208
2606,guleng,5,0.00115,53797,12.41828,433208
2607,gustavovalverde,5,0.00115,53802,12.41944,433208
2608,gynter,5,0.00115,53807,12.42059,433208
2609,h4ghhh,5,0.00115,53812,12.42175,433208
2610,hafkaM,5,0.00115,53817,12.42290,433208
2611,Halmoni100,5,0.00115,53822,12.42405,433208
2612,HamzaZo,5,0.00115,53827,12.42521,433208
2613,hantmac,5,0.00115,53832,12.42636,433208
2614,haraldatbmw,5,0.00115,53837,12.42752,433208
2615,Harkole,5,0.00115,53842,12.42867,433208
2616,harshik9,5,0.00115,53847,12.42983,433208
2617,hdoro,5,0.00115,53852,12.43098,433208
2618,hexsel,5,0.00115,53857,12.43213,433208
2619,hezhizhen,5,0.00115,53862,12.43329,433208
2620,hhhhsdxxxx,5,0.00115,53867,12.43444,433208
2621,hhollenstain,5,0.00115,53872,12.43560,433208
2622,hidiego,5,0.00115,53877,12.43675,433208
2623,hojerst,5,0.00115,53882,12.43791,433208
2624,holynakamoto,5,0.00115,53887,12.43906,433208
2625,hongli-my,5,0.00115,53892,12.44021,433208
2626,hoyho,5,0.00115,53897,12.44137,433208
2627,hubt,5,0.00115,53902,12.44252,433208
2628,huhaipeng,5,0.00115,53907,12.44368,433208
2629,hussein-awala,5,0.00115,53912,12.44483,433208
2630,hypePG,5,0.00115,53917,12.44598,433208
2631,iamsoorya,5,0.00115,53922,12.44714,433208
2632,IanvsPoplicola,5,0.00115,53927,12.44829,433208
2633,infa-ssaurabh,5,0.00115,53932,12.44945,433208
2634,IngussNeilands,5,0.00115,53937,12.45060,433208
2635,inspiremirnal,5,0.00115,53942,12.45176,433208
2636,israellot,5,0.00115,53947,12.45291,433208
2637,ivang,5,0.00115,53952,12.45406,433208
2638,jacky68147527,5,0.00115,53957,12.45522,433208
2639,jadonwolffs,5,0.00115,53962,12.45637,433208
2640,jaegchoi,5,0.00115,53967,12.45753,433208
2641,jaggerwang,5,0.00115,53972,12.45868,433208
2642,jalseth,5,0.00115,53977,12.45983,433208
2643,jamesharr,5,0.00115,53982,12.46099,433208
2644,janboll,5,0.00115,53987,12.46214,433208
2645,JasonChen86899,5,0.00115,53992,12.46330,433208
2646,jasondemps1,5,0.00115,53997,12.46445,433208
2647,jdkelley,5,0.00115,54002,12.46561,433208
2648,jdockter,5,0.00115,54007,12.46676,433208
2649,jefer94,5,0.00115,54012,12.46791,433208
2650,jeffhubLR,5,0.00115,54017,12.46907,433208
2651,jellevanhees,5,0.00115,54022,12.47022,433208
2652,jfbai,5,0.00115,54027,12.47138,433208
2653,jfroche,5,0.00115,54032,12.47253,433208
2654,jgardiner68,5,0.00115,54037,12.47368,433208
2655,jgournet,5,0.00115,54042,12.47484,433208
2656,jhead-slg,5,0.00115,54047,12.47599,433208
2657,jiangkaihua,5,0.00115,54052,12.47715,433208
2658,jimil749,5,0.00115,54057,12.47830,433208
2659,jjfmarket,5,0.00115,54062,12.47946,433208
2660,JoeHFB,5,0.00115,54067,12.48061,433208
2661,joewilliams,5,0.00115,54072,12.48176,433208
2662,jonathanendy,5,0.00115,54077,12.48292,433208
2663,jonathanjuursema,5,0.00115,54082,12.48407,433208
2664,josemaia,5,0.00115,54087,12.48523,433208
2665,JosephWoodward,5,0.00115,54092,12.48638,433208
2666,joshrwolf,5,0.00115,54097,12.48753,433208
2667,jsing157,5,0.00115,54102,12.48869,433208
2668,jtackaberry,5,0.00115,54107,12.48984,433208
2669,juchaosong,5,0.00115,54112,12.49100,433208
2670,justinrush,5,0.00115,54117,12.49215,433208
2671,kaitoii11,5,0.00115,54122,12.49331,433208
2672,KaranSinghBisht,5,0.00115,54127,12.49446,433208
2673,karasjoh000,5,0.00115,54132,12.49561,433208
2674,karlism,5,0.00115,54137,12.49677,433208
2675,kasramp,5,0.00115,54142,12.49792,433208
2676,kenchan0130,5,0.00115,54147,12.49908,433208
2677,kengan,5,0.00115,54152,12.50023,433208
2678,Kerstin08,5,0.00115,54157,12.50139,433208
2679,kevinhwang,5,0.00115,54162,12.50254,433208
2680,kevinsulatra,5,0.00115,54167,12.50369,433208
2681,KevinThompsonYCRX,5,0.00115,54172,12.50485,433208
2682,kishorv06,5,0.00115,54177,12.50600,433208
2683,kmai,5,0.00115,54182,12.50716,433208
2684,kmat9933,5,0.00115,54187,12.50831,433208
2685,Knappek,5,0.00115,54192,12.50946,433208
2686,kobynet,5,0.00115,54197,12.51062,433208
2687,kopal2212,5,0.00115,54202,12.51177,433208
2688,koraktor,5,0.00115,54207,12.51293,433208
2689,kornelbicskei,5,0.00115,54212,12.51408,433208
2690,kpr6,5,0.00115,54217,12.51524,433208
2691,krzysdabro,5,0.00115,54222,12.51639,433208
2692,ktoso,5,0.00115,54227,12.51754,433208
2693,kunalmohan,5,0.00115,54232,12.51870,433208
2694,kuznetsovkk,5,0.00115,54237,12.51985,433208
2695,KYannick,5,0.00115,54242,12.52101,433208
2696,lcapaldo,5,0.00115,54247,12.52216,433208
2697,lee3164,5,0.00115,54252,12.52331,433208
2698,leinad87,5,0.00115,54257,12.52447,433208
2699,leroy-chen,5,0.00115,54262,12.52562,433208
2700,Leulz,5,0.00115,54267,12.52678,433208
2701,lianzhang132,5,0.00115,54272,12.52793,433208
2702,lilinghai,5,0.00115,54277,12.52909,433208
2703,linbingdouzhe,5,0.00115,54282,12.53024,433208
2704,Lin-Liang,5,0.00115,54287,12.53139,433208
2705,Linutux,5,0.00115,54292,12.53255,433208
2706,LinXiaoJian,5,0.00115,54297,12.53370,433208
2707,liuyuan10,5,0.00115,54302,12.53486,433208
2708,lixy529,5,0.00115,54307,12.53601,433208
2709,lkatalin,5,0.00115,54312,12.53716,433208
2710,loganfuller,5,0.00115,54317,12.53832,433208
2711,logicflakes,5,0.00115,54322,12.53947,433208
2712,loopever,5,0.00115,54327,12.54063,433208
2713,lopsided98,5,0.00115,54332,12.54178,433208
2714,lordcf,5,0.00115,54337,12.54294,433208
2715,LouisStAmour,5,0.00115,54342,12.54409,433208
2716,lpakula,5,0.00115,54347,12.54524,433208
2717,lucasqueiroz,5,0.00115,54352,12.54640,433208
2718,luigibk,5,0.00115,54357,12.54755,433208
2719,LukeCz,5,0.00115,54362,12.54871,433208
2720,luotian-github,5,0.00115,54367,12.54986,433208
2721,madetara,5,0.00115,54372,12.55101,433208
2722,MadsJakobsen,5,0.00115,54377,12.55217,433208
2723,majorinche,5,0.00115,54382,12.55332,433208
2724,MalachiCunliffe,5,0.00115,54387,12.55448,433208
2725,Mametee,5,0.00115,54392,12.55563,433208
2726,mandelsoft,5,0.00115,54397,12.55679,433208
2727,manuNCL,5,0.00115,54402,12.55794,433208
2728,maoueh,5,0.00115,54407,12.55909,433208
2729,marcel-apf,5,0.00115,54412,12.56025,433208
2730,MarlonGamez,5,0.00115,54417,12.56140,433208
2731,mars64,5,0.00115,54422,12.56256,433208
2732,martinlevesque,5,0.00115,54427,12.56371,433208
2733,MartinLogan,5,0.00115,54432,12.56486,433208
2734,Marymota,5,0.00115,54437,12.56602,433208
2735,mavenraven,5,0.00115,54442,12.56717,433208
2736,mbaglole,5,0.00115,54447,12.56833,433208
2737,mbwhite,5,0.00115,54452,12.56948,433208
2738,mc256,5,0.00115,54457,12.57064,433208
2739,mengzhen94,5,0.00115,54462,12.57179,433208
2740,mfbrj,5,0.00115,54467,12.57294,433208
2741,mfonner,5,0.00115,54472,12.57410,433208
2742,mghildiy,5,0.00115,54477,12.57525,433208
2743,mhabicht,5,0.00115,54482,12.57641,433208
2744,MichaelJDrK,5,0.00115,54487,12.57756,433208
2745,mikebou,5,0.00115,54492,12.57872,433208
2746,mikebz,5,0.00115,54497,12.57987,433208
2747,mike-stewart,5,0.00115,54502,12.58102,433208
2748,milgradesec,5,0.00115,54507,12.58218,433208
2749,millermatt,5,0.00115,54512,12.58333,433208
2750,ming-ddtechcg,5,0.00115,54517,12.58449,433208
2751,mintenghung,5,0.00115,54522,12.58564,433208
2752,misteruly,5,0.00115,54527,12.58679,433208
2753,mitsos1os,5,0.00115,54532,12.58795,433208
2754,mkbhanda,5,0.00115,54537,12.58910,433208
2755,mleklund,5,0.00115,54542,12.59026,433208
2756,mneil,5,0.00115,54547,12.59141,433208
2757,mnff,5,0.00115,54552,12.59257,433208
2758,MohamedTalhaoui,5,0.00115,54557,12.59372,433208
2759,mohit-a21,5,0.00115,54562,12.59487,433208
2760,momon,5,0.00115,54567,12.59603,433208
2761,monchier,5,0.00115,54572,12.59718,433208
2762,morengab,5,0.00115,54577,12.59834,433208
2763,moustafab,5,0.00115,54582,12.59949,433208
2764,moustaphasene,5,0.00115,54587,12.60064,433208
2765,mpitt,5,0.00115,54592,12.60180,433208
2766,mrajashree,5,0.00115,54597,12.60295,433208
2767,mr-bjerre,5,0.00115,54602,12.60411,433208
2768,mruoss,5,0.00115,54607,12.60526,433208
2769,mtorromeo,5,0.00115,54612,12.60642,433208
2770,mykidong,5,0.00115,54617,12.60757,433208
2771,NadavkOptimalQ,5,0.00115,54622,12.60872,433208
2772,naioja,5,0.00115,54627,12.60988,433208
2773,narahari92,5,0.00115,54632,12.61103,433208
2774,nathan-beneke,5,0.00115,54637,12.61219,433208
2775,NavidZ,5,0.00115,54642,12.61334,433208
2776,nbendafi-yseop,5,0.00115,54647,12.61449,433208
2777,nbonavia,5,0.00115,54652,12.61565,433208
2778,neilstevenson,5,0.00115,54657,12.61680,433208
2779,nemanjan00,5,0.00115,54662,12.61796,433208
2780,newrelic-eheinlein,5,0.00115,54667,12.61911,433208
2781,nhemchandra,5,0.00115,54672,12.62027,433208
2782,Nikita128,5,0.00115,54677,12.62142,433208
2783,ningyougang,5,0.00115,54682,12.62257,433208
2784,niroowns,5,0.00115,54687,12.62373,433208
2785,Nit123,5,0.00115,54692,12.62488,433208
2786,noahdav,5,0.00115,54697,12.62604,433208
2787,Nokel81,5,0.00115,54702,12.62719,433208
2788,NomadXD,5,0.00115,54707,12.62834,433208
2789,nomstradamus,5,0.00115,54712,12.62950,433208
2790,nuthanbn,5,0.00115,54717,12.63065,433208
2791,nvenkatapavan,5,0.00115,54722,12.63181,433208
2792,Nwhouse,5,0.00115,54727,12.63296,433208
2793,nyxi,5,0.00115,54732,12.63412,433208
2794,obrientimothya,5,0.00115,54737,12.63527,433208
2795,Oliveirakun,5,0.00115,54742,12.63642,433208
2796,opa-updater-automation,5,0.00115,54747,12.63758,433208
2797,osery,5,0.00115,54752,12.63873,433208
2798,p53,5,0.00115,54757,12.63989,433208
2799,pasqualet,5,0.00115,54762,12.64104,433208
2800,patsevanton,5,0.00115,54767,12.64219,433208
2801,pavan2004it,5,0.00115,54772,12.64335,433208
2802,pavanfhw,5,0.00115,54777,12.64450,433208
2803,pavelpatrin,5,0.00115,54782,12.64566,433208
2804,pendyalal,5,0.00115,54787,12.64681,433208
2805,peter-pulik,5,0.00115,54792,12.64797,433208
2806,pgonin,5,0.00115,54797,12.64912,433208
2807,phenixdotnet,5,0.00115,54802,12.65027,433208
2808,philippwostry,5,0.00115,54807,12.65143,433208
2809,phunziker,5,0.00115,54812,12.65258,433208
2810,phxnsharp,5,0.00115,54817,12.65374,433208
2811,pierre-emmanuelJ,5,0.00115,54822,12.65489,433208
2812,plajjan,5,0.00115,54827,12.65605,433208
2813,pmengelbert,5,0.00115,54832,12.65720,433208
2814,potatopankakes,5,0.00115,54837,12.65835,433208
2815,prashilgupta,5,0.00115,54842,12.65951,433208
2816,prateekkhera,5,0.00115,54847,12.66066,433208
2817,praveenthuwat,5,0.00115,54852,12.66182,433208
2818,previsenathan,5,0.00115,54857,12.66297,433208
2819,Prototik,5,0.00115,54862,12.66412,433208
2820,purplezimmermann,5,0.00115,54867,12.66528,433208
2821,pururaj1908,5,0.00115,54872,12.66643,433208
2822,pvsone,5,0.00115,54877,12.66759,433208
2823,qw4990,5,0.00115,54882,12.66874,433208
2824,rabi-abdel,5,0.00115,54887,12.66990,433208
2825,radTuti,5,0.00115,54892,12.67105,433208
2826,rafagsiqueira,5,0.00115,54897,12.67220,433208
2827,rahulkjoshi,5,0.00115,54902,12.67336,433208
2828,rajeshwrn,5,0.00115,54907,12.67451,433208
2829,rchernobelskiy,5,0.00115,54912,12.67567,433208
2830,redondoxx,5,0.00115,54917,12.67682,433208
2831,renich,5,0.00115,54922,12.67797,433208
2832,rennokki,5,0.00115,54927,12.67913,433208
2833,reta,5,0.00115,54932,12.68028,433208
2834,richardpringle,5,0.00115,54937,12.68144,433208
2835,rmazzine,5,0.00115,54942,12.68259,433208
2836,rpiteira,5,0.00115,54947,12.68375,433208
2837,rtatnet3,5,0.00115,54952,12.68490,433208
2838,rudeigerc,5,0.00115,54957,12.68605,433208
2839,rueyaa332266,5,0.00115,54962,12.68721,433208
2840,rumstead,5,0.00115,54967,12.68836,433208
2841,rushi47,5,0.00115,54972,12.68952,433208
2842,ryancastle,5,0.00115,54977,12.69067,433208
2843,ryanmt,5,0.00115,54982,12.69182,433208
2844,sadoMasupilami,5,0.00115,54987,12.69298,433208
2845,Saewo0,5,0.00115,54992,12.69413,433208
2846,saiteja313,5,0.00115,54997,12.69529,433208
2847,sakshigupta-29,5,0.00115,55002,12.69644,433208
2848,SamarSidharth,5,0.00115,55007,12.69760,433208
2849,samitpal,5,0.00115,55012,12.69875,433208
2850,samuel-sujith,5,0.00115,55017,12.69990,433208
2851,samvarankashyap,5,0.00115,55022,12.70106,433208
2852,sandrotosi,5,0.00115,55027,12.70221,433208
2853,santosh-hegde,5,0.00115,55032,12.70337,433208
2854,sanzende,5,0.00115,55037,12.70452,433208
2855,Saurman,5,0.00115,55042,12.70567,433208
2856,savealive,5,0.00115,55047,12.70683,433208
2857,sburris0,5,0.00115,55052,12.70798,433208
2858,schizoid90,5,0.00115,55057,12.70914,433208
2859,schmirgo,5,0.00115,55062,12.71029,433208
2860,scottrobertson,5,0.00115,55067,12.71145,433208
2861,sebagomez,5,0.00115,55072,12.71260,433208
2862,Sebosek,5,0.00115,55077,12.71375,433208
2863,seperman,5,0.00115,55082,12.71491,433208
2864,sethev,5,0.00115,55087,12.71606,433208
2865,SezalAgrawal,5,0.00115,55092,12.71722,433208
2866,sgrimes-stackod,5,0.00115,55097,12.71837,433208
2867,s-h-a-d-o-w,5,0.00115,55102,12.71953,433208
2868,shanesveller,5,0.00115,55107,12.72068,433208
2869,sharmababu,5,0.00115,55112,12.72183,433208
2870,shibi1989,5,0.00115,55117,12.72299,433208
2871,shivam-51,5,0.00115,55122,12.72414,433208
2872,shouhei,5,0.00115,55127,12.72530,433208
2873,siddhant94,5,0.00115,55132,12.72645,433208
2874,SilpaSuresh1513,5,0.00115,55137,12.72760,433208
2875,simbou2000,5,0.00115,55142,12.72876,433208
2876,sjmiller609,5,0.00115,55147,12.72991,433208
2877,sklarsa,5,0.00115,55152,12.73107,433208
2878,sknat,5,0.00115,55157,12.73222,433208
2879,slashmo,5,0.00115,55162,12.73338,433208
2880,SmiffyJ,5,0.00115,55167,12.73453,433208
2881,SMillerDev,5,0.00115,55172,12.73568,433208
2882,smitaraut,5,0.00115,55177,12.73684,433208
2883,snuggie12,5,0.00115,55182,12.73799,433208
2884,solarkennedy,5,0.00115,55187,12.73915,433208
2885,sophieyfang,5,0.00115,55192,12.74030,433208
2886,sshishov,5,0.00115,55197,12.74145,433208
2887,steeling,5,0.00115,55202,12.74261,433208
2888,stefanbucur,5,0.00115,55207,12.74376,433208
2889,steve13814,5,0.00115,55212,12.74492,433208
2890,stevek-pro,5,0.00115,55217,12.74607,433208
2891,stevensu1977,5,0.00115,55222,12.74723,433208
2892,stevesworkgithub,5,0.00115,55227,12.74838,433208
2893,strigona-worksight,5,0.00115,55232,12.74953,433208
2894,Stroppel,5,0.00115,55237,12.75069,433208
2895,suab321321,5,0.00115,55242,12.75184,433208
2896,SubhakarKotta,5,0.00115,55247,12.75300,433208
2897,Subreptivus,5,0.00115,55252,12.75415,433208
2898,sudopk,5,0.00115,55257,12.75530,433208
2899,sunmou99,5,0.00115,55262,12.75646,433208
2900,sureshballa,5,0.00115,55267,12.75761,433208
2901,Sushant20,5,0.00115,55272,12.75877,433208
2902,sztanyoo,5,0.00115,55277,12.75992,433208
2903,tahmmee,5,0.00115,55282,12.76108,433208
2904,tanelso2,5,0.00115,55287,12.76223,433208
2905,Taranzz25,5,0.00115,55292,12.76338,433208
2906,tarquin-the-brave,5,0.00115,55297,12.76454,433208
2907,taru-svg,5,0.00115,55302,12.76569,433208
2908,tdiesler,5,0.00115,55307,12.76685,433208
2909,tdinucci,5,0.00115,55312,12.76800,433208
2910,TeddyAndrieux,5,0.00115,55317,12.76915,433208
2911,TejaBeta,5,0.00115,55322,12.77031,433208
2912,thaishankar,5,0.00115,55327,12.77146,433208
2913,thebsdbox,5,0.00115,55332,12.77262,433208
2914,theodor2311,5,0.00115,55337,12.77377,433208
2915,thewilli,5,0.00115,55342,12.77493,433208
2916,TheYkk,5,0.00115,55347,12.77608,433208
2917,thiagoyeds,5,0.00115,55352,12.77723,433208
2918,ThisIsQasim,5,0.00115,55357,12.77839,433208
2919,Thomasdezeeuw,5,0.00115,55362,12.77954,433208
2920,tiffanyjachja,5,0.00115,55367,12.78070,433208
2921,Tijmen34,5,0.00115,55372,12.78185,433208
2922,till,5,0.00115,55377,12.78300,433208
2923,timdeluxe,5,0.00115,55382,12.78416,433208
2924,tim-elliott,5,0.00115,55387,12.78531,433208
2925,tjamet,5,0.00115,55392,12.78647,433208
2926,tklebanoff,5,0.00115,55397,12.78762,433208
2927,tmckayus,5,0.00115,55402,12.78878,433208
2928,tniita,5,0.00115,55407,12.78993,433208
2929,tom-dudley,5,0.00115,55412,12.79108,433208
2930,tonychoe,5,0.00115,55417,12.79224,433208
2931,toshok,5,0.00115,55422,12.79339,433208
2932,tpetrov-lp,5,0.00115,55427,12.79455,433208
2933,ttsrg,5,0.00115,55432,12.79570,433208
2934,tudi2d,5,0.00115,55437,12.79686,433208
2935,tumd,5,0.00115,55442,12.79801,433208
2936,tyuhara,5,0.00115,55447,12.79916,433208
2937,u2bo,5,0.00115,55452,12.80032,433208
2938,ufoproger,5,0.00115,55457,12.80147,433208
2939,uluzox,5,0.00115,55462,12.80263,433208
2940,umairmkhan,5,0.00115,55467,12.80378,433208
2941,umanwizard,5,0.00115,55472,12.80493,433208
2942,unacceptable,5,0.00115,55477,12.80609,433208
2943,unai-ttxu,5,0.00115,55482,12.80724,433208
2944,unnown,5,0.00115,55487,12.80840,433208
2945,varunpalekar,5,0.00115,55492,12.80955,433208
2946,Velektron,5,0.00115,55497,12.81071,433208
2947,vgaurihar,5,0.00115,55502,12.81186,433208
2948,Victor1319,5,0.00115,55507,12.81301,433208
2949,viktorradnai,5,0.00115,55512,12.81417,433208
2950,virnet,5,0.00115,55517,12.81532,433208
2951,vishjain,5,0.00115,55522,12.81648,433208
2952,vishwa306,5,0.00115,55527,12.81763,433208
2953,vitarb,5,0.00115,55532,12.81878,433208
2954,vivekzhere,5,0.00115,55537,12.81994,433208
2955,vjtm,5,0.00115,55542,12.82109,433208
2956,vtdat,5,0.00115,55547,12.82225,433208
2957,waelmas,5,0.00115,55552,12.82340,433208
2958,wahern-splunk,5,0.00115,55557,12.82456,433208
2959,wand3r3r,5,0.00115,55562,12.82571,433208
2960,wcc526,5,0.00115,55567,12.82686,433208
2961,web-refinery,5,0.00115,55572,12.82802,433208
2962,WeetA34,5,0.00115,55577,12.82917,433208
2963,weriKK,5,0.00115,55582,12.83033,433208
2964,wesleywh,5,0.00115,55587,12.83148,433208
2965,whitleykeith,5,0.00115,55592,12.83263,433208
2966,willdeuschle,5,0.00115,55597,12.83379,433208
2967,wilstoff,5,0.00115,55602,12.83494,433208
2968,windegao,5,0.00115,55607,12.83610,433208
2969,windsource,5,0.00115,55612,12.83725,433208
2970,wiredin,5,0.00115,55617,12.83841,433208
2971,wonkarthik,5,0.00115,55622,12.83956,433208
2972,wooviet,5,0.00115,55627,12.84071,433208
2973,wssgyyg,5,0.00115,55632,12.84187,433208
2974,wtchangdm,5,0.00115,55637,12.84302,433208
2975,xakraz,5,0.00115,55642,12.84418,433208
2976,xh3b4sd,5,0.00115,55647,12.84533,433208
2977,xiedaijin1018,5,0.00115,55652,12.84648,433208
2978,xirzec,5,0.00115,55657,12.84764,433208
2979,xposix,5,0.00115,55662,12.84879,433208
2980,xsreality,5,0.00115,55667,12.84995,433208
2981,YangKian,5,0.00115,55672,12.85110,433208
2982,Yanhao,5,0.00115,55677,12.85226,433208
2983,yanivroz,5,0.00115,55682,12.85341,433208
2984,yanowitz,5,0.00115,55687,12.85456,433208
2985,yardenshoham,5,0.00115,55692,12.85572,433208
2986,ycao56,5,0.00115,55697,12.85687,433208
2987,YiniXu9506,5,0.00115,55702,12.85803,433208
2988,yoave23,5,0.00115,55707,12.85918,433208
2989,yottta,5,0.00115,55712,12.86033,433208
2990,ysjjovo,5,0.00115,55717,12.86149,433208
2991,yuha0,5,0.00115,55722,12.86264,433208
2992,yutachaos,5,0.00115,55727,12.86380,433208
2993,zainhasib,5,0.00115,55732,12.86495,433208
2994,zawachte-msft,5,0.00115,55737,12.86611,433208
2995,zcola,5,0.00115,55742,12.86726,433208
2996,Zeka13,5,0.00115,55747,12.86841,433208
2997,zenbones,5,0.00115,55752,12.86957,433208
2998,zettaittenani,5,0.00115,55757,12.87072,433208
2999,zhiyxu,5,0.00115,55762,12.87188,433208
3000,zhsgao,5,0.00115,55767,12.87303,433208
3001,zrks,5,0.00115,55772,12.87419,433208
3002,zuh0,5,0.00115,55777,12.87534,433208
3003,zzguang520,5,0.00115,55782,12.87649,433208
3004,zzhutianyu,5,0.00115,55787,12.87765,433208
3005,zzvara,5,0.00115,55792,12.87880,433208
3006,0x2b3bfa0,4,0.00092,55796,12.87973,433208
3007,1d2u3c,4,0.00092,55800,12.88065,433208
3008,2hamed,4,0.00092,55804,12.88157,433208
3009,a2batic,4,0.00092,55808,12.88250,433208
3010,abezard,4,0.00092,55812,12.88342,433208
3011,abjrcode,4,0.00092,55816,12.88434,433208
3012,acobaugh,4,0.00092,55820,12.88527,433208
3013,adacaccia,4,0.00092,55824,12.88619,433208
3014,adams0619,4,0.00092,55828,12.88711,433208
3015,adecarolis,4,0.00092,55832,12.88804,433208
3016,admirito,4,0.00092,55836,12.88896,433208
3017,adriangonz,4,0.00092,55840,12.88988,433208
3018,ahmad-hamade,4,0.00092,55844,12.89081,433208
3019,ahmedtalhakhan,4,0.00092,55848,12.89173,433208
3020,ahrtr,4,0.00092,55852,12.89265,433208
3021,aimichelle,4,0.00092,55856,12.89358,433208
3022,aivarssilins,4,0.00092,55860,12.89450,433208
3023,ajcann,4,0.00092,55864,12.89542,433208
3024,ajeetas,4,0.00092,55868,12.89635,433208
3025,AjiArya,4,0.00092,55872,12.89727,433208
3026,ajouve,4,0.00092,55876,12.89819,433208
3027,akanshujamwal,4,0.00092,55880,12.89912,433208
3028,akennealy,4,0.00092,55884,12.90004,433208
3029,alan0415,4,0.00092,55888,12.90096,433208
3030,albalitz,4,0.00092,55892,12.90189,433208
3031,ale8k,4,0.00092,55896,12.90281,433208
3032,AleksandarGradina,4,0.00092,55900,12.90373,433208
3033,aleksandrmelnikov,4,0.00092,55904,12.90466,433208
3034,aleofreddi,4,0.00092,55908,12.90558,433208
3035,aleveille,4,0.00092,55912,12.90650,433208
3036,alexanderConstantinescu,4,0.00092,55916,12.90743,433208
3037,alexvazquez,4,0.00092,55920,12.90835,433208
3038,Alienuser,4,0.00092,55924,12.90927,433208
3039,alin-t,4,0.00092,55928,12.91020,433208
3040,allenmqcymp,4,0.00092,55932,12.91112,433208
3041,amaaniqbal,4,0.00092,55936,12.91204,433208
3042,Amab,4,0.00092,55940,12.91297,433208
3043,Aman1440,4,0.00092,55944,12.91389,433208
3044,amandahla,4,0.00092,55948,12.91481,433208
3045,amazingandyyy,4,0.00092,55952,12.91574,433208
3046,amenzhinsky,4,0.00092,55956,12.91666,433208
3047,andloh,4,0.00092,55960,12.91758,433208
3048,andreas-ahman,4,0.00092,55964,12.91851,433208
3049,andreicroitoriu,4,0.00092,55968,12.91943,433208
3050,andrejleal,4,0.00092,55972,12.92035,433208
3051,andresilva97,4,0.00092,55976,12.92128,433208
3052,AndrewBoklashko,4,0.00092,55980,12.92220,433208
3053,andyyaldoo,4,0.00092,55984,12.92312,433208
3054,angeloplsight,4,0.00092,55988,12.92405,433208
3055,Angry-Potato,4,0.00092,55992,12.92497,433208
3056,ankane,4,0.00092,55996,12.92589,433208
3057,anniefu,4,0.00092,56000,12.92682,433208
3058,ansinlee,4,0.00092,56004,12.92774,433208
3059,anst270125,4,0.00092,56008,12.92866,433208
3060,anthonyt123,4,0.00092,56012,12.92959,433208
3061,Anticom,4,0.00092,56016,12.93051,433208
3062,AntoineNGUYEN31,4,0.00092,56020,12.93143,433208
3063,anttilinno,4,0.00092,56024,12.93236,433208
3064,anwesh-b,4,0.00092,56028,12.93328,433208
3065,anxolerd,4,0.00092,56032,12.93420,433208
3066,aps831,4,0.00092,56036,12.93513,433208
3067,aqw,4,0.00092,56040,12.93605,433208
3068,ArchangelX360,4,0.00092,56044,12.93697,433208
3069,Argha-2890,4,0.00092,56048,12.93790,433208
3070,ArunaLakmal,4,0.00092,56052,12.93882,433208
3071,arunsp1007,4,0.00092,56056,12.93974,433208
3072,Aryankpoor,4,0.00092,56060,12.94067,433208
3073,asldevi,4,0.00092,56064,12.94159,433208
3074,atam003,4,0.00092,56068,12.94251,433208
3075,Athosone,4,0.00092,56072,12.94344,433208
3076,atomic77,4,0.00092,56076,12.94436,433208
3077,aushafy,4,0.00092,56080,12.94528,433208
3078,austinpray,4,0.00092,56084,12.94621,433208
3079,Austin-Tan,4,0.00092,56088,12.94713,433208
3080,avmohan,4,0.00092,56092,12.94805,433208
3081,Avtandilko,4,0.00092,56096,12.94898,433208
3082,AVVS,4,0.00092,56100,12.94990,433208
3083,AWSNB,4,0.00092,56104,12.95082,433208
3084,ayoubeddafali,4,0.00092,56108,12.95175,433208
3085,azman0101,4,0.00092,56112,12.95267,433208
3086,b0rski,4,0.00092,56116,12.95359,433208
3087,badbart,4,0.00092,56120,12.95452,433208
3088,bansalsurya,4,0.00092,56124,12.95544,433208
3089,beanhacker,4,0.00092,56128,12.95636,433208
3090,benjaminp,4,0.00092,56132,12.95729,433208
3091,benpettman,4,0.00092,56136,12.95821,433208
3092,BharathB23,4,0.00092,56140,12.95913,433208
3093,bibinphilip,4,0.00092,56144,12.96006,433208
3094,bigmyx,4,0.00092,56148,12.96098,433208
3095,billoneil,4,0.00092,56152,12.96190,433208
3096,BinacsLee,4,0.00092,56156,12.96283,433208
3097,bisakhmondal,4,0.00092,56160,12.96375,433208
3098,bjoernrost,4,0.00092,56164,12.96467,433208
3099,blaisep-vgs,4,0.00092,56168,12.96560,433208
3100,blueabysm,4,0.00092,56172,12.96652,433208
3101,BnMcG,4,0.00092,56176,12.96744,433208
3102,bnoeson,4,0.00092,56180,12.96837,433208
3103,bnu0,4,0.00092,56184,12.96929,433208
3104,BoleynSu,4,0.00092,56188,12.97021,433208
3105,boniek83,4,0.00092,56192,12.97114,433208
3106,booleanbetrayal,4,0.00092,56196,12.97206,433208
3107,brandon-miles,4,0.00092,56200,12.97298,433208
3108,brichou,4,0.00092,56204,12.97391,433208
3109,brnl,4,0.00092,56208,12.97483,433208
3110,BruceHunter,4,0.00092,56212,12.97575,433208
3111,BrukT,4,0.00092,56216,12.97668,433208
3112,BryanEllington,4,0.00092,56220,12.97760,433208
3113,bryanisgreat,4,0.00092,56224,12.97852,433208
3114,bsnyder788,4,0.00092,56228,12.97945,433208
3115,buzzdan,4,0.00092,56232,12.98037,433208
3116,cachila,4,0.00092,56236,12.98129,433208
3117,caitmulholland,4,0.00092,56240,12.98222,433208
3118,capoferro,4,0.00092,56244,12.98314,433208
3119,carr123,4,0.00092,56248,12.98406,433208
3120,cedlerouge,4,0.00092,56252,12.98499,433208
3121,CeeBeeCee,4,0.00092,56256,12.98591,433208
3122,celliott,4,0.00092,56260,12.98683,433208
3123,cfz,4,0.00092,56264,12.98776,433208
3124,CH3CHO,4,0.00092,56268,12.98868,433208
3125,ChaituVR,4,0.00092,56272,12.98960,433208
3126,cheister,4,0.00092,56276,12.99053,433208
3127,chenfengjin,4,0.00092,56280,12.99145,433208
3128,chengdol,4,0.00092,56284,12.99237,433208
3129,chikinchoi,4,0.00092,56288,12.99330,433208
3130,chinayin,4,0.00092,56292,12.99422,433208
3131,Chitresh29,4,0.00092,56296,12.99514,433208
3132,chris13524,4,0.00092,56300,12.99607,433208
3133,chrisamert,4,0.00092,56304,12.99699,433208
3134,chrisbecke,4,0.00092,56308,12.99791,433208
3135,chrishoerl,4,0.00092,56312,12.99884,433208
3136,christle,4,0.00092,56316,12.99976,433208
3137,chriswolske,4,0.00092,56320,13.00068,433208
3138,chubirka,4,0.00092,56324,13.00161,433208
3139,chunmeng,4,0.00092,56328,13.00253,433208
3140,ChunyiLyu,4,0.00092,56332,13.00345,433208
3141,cjbehm,4,0.00092,56336,13.00438,433208
3142,cmdallas,4,0.00092,56340,13.00530,433208
3143,codeatri,4,0.00092,56344,13.00622,433208
3144,codeJack,4,0.00092,56348,13.00715,433208
3145,codykaup,4,0.00092,56352,13.00807,433208
3146,collivier,4,0.00092,56356,13.00899,433208
3147,colt415,4,0.00092,56360,13.00992,433208
3148,cosven,4,0.00092,56364,13.01084,433208
3149,courcelm,4,0.00092,56368,13.01176,433208
3150,cpollard0,4,0.00092,56372,13.01269,433208
3151,cprivite,4,0.00092,56376,13.01361,433208
3152,crazy-canux,4,0.00092,56380,13.01453,433208
3153,creativie,4,0.00092,56384,13.01546,433208
3154,crutonjohn,4,0.00092,56388,13.01638,433208
3155,csiemantel,4,0.00092,56392,13.01730,433208
3156,csquan,4,0.00092,56396,13.01823,433208
3157,cts-zeero,4,0.00092,56400,13.01915,433208
3158,cumirror,4,0.00092,56404,13.02007,433208
3159,damdo,4,0.00092,56408,13.02100,433208
3160,damerakd,4,0.00092,56412,13.02192,433208
3161,danielc103,4,0.00092,56416,13.02284,433208
3162,danielhass,4,0.00092,56420,13.02377,433208
3163,danielschnetler,4,0.00092,56424,13.02469,433208
3164,danishprakash,4,0.00092,56428,13.02561,433208
3165,danpoltawski,4,0.00092,56432,13.02654,433208
3166,danquah,4,0.00092,56436,13.02746,433208
3167,DanyHenriquez,4,0.00092,56440,13.02838,433208
3168,darkdragn,4,0.00092,56444,13.02931,433208
3169,darose,4,0.00092,56448,13.03023,433208
3170,davelosert,4,0.00092,56452,13.03115,433208
3171,dave-meier,4,0.00092,56456,13.03208,433208
3172,daveyostcom,4,0.00092,56460,13.03300,433208
3173,davidclin,4,0.00092,56464,13.03392,433208
3174,davidcsi,4,0.00092,56468,13.03485,433208
3175,david-l-riley,4,0.00092,56472,13.03577,433208
3176,DavidOGrady,4,0.00092,56476,13.03669,433208
3177,davidshare,4,0.00092,56480,13.03762,433208
3178,dbrennand,4,0.00092,56484,13.03854,433208
3179,ddmendes,4,0.00092,56488,13.03946,433208
3180,dedok1997,4,0.00092,56492,13.04039,433208
3181,deewhyweb,4,0.00092,56496,13.04131,433208
3182,defool,4,0.00092,56500,13.04223,433208
3183,DekelMalul,4,0.00092,56504,13.04316,433208
3184,Delorien84,4,0.00092,56508,13.04408,433208
3185,denniszielke,4,0.00092,56512,13.04500,433208
3186,derek-burdick,4,0.00092,56516,13.04593,433208
3187,descrepes,4,0.00092,56520,13.04685,433208
3188,dickeyf,4,0.00092,56524,13.04777,433208
3189,dilipnd,4,0.00092,56528,13.04870,433208
3190,dionysius,4,0.00092,56532,13.04962,433208
3191,divolgin,4,0.00092,56536,13.05054,433208
3192,divy4,4,0.00092,56540,13.05147,433208
3193,djkormo,4,0.00092,56544,13.05239,433208
3194,djs55,4,0.00092,56548,13.05331,433208
3195,dlobue,4,0.00092,56552,13.05424,433208
3196,dmakeroam,4,0.00092,56556,13.05516,433208
3197,dmanbu,4,0.00092,56560,13.05608,433208
3198,dohq,4,0.00092,56564,13.05701,433208
3199,Doout,4,0.00092,56568,13.05793,433208
3200,dotanrs,4,0.00092,56572,13.05885,433208
3201,douzt,4,0.00092,56576,13.05978,433208
3202,dsutphin,4,0.00092,56580,13.06070,433208
3203,dtpryce,4,0.00092,56584,13.06162,433208
3204,dwschulze,4,0.00092,56588,13.06255,433208
3205,DymentJen,4,0.00092,56592,13.06347,433208
3206,ebr,4,0.00092,56596,13.06439,433208
3207,ecda909,4,0.00092,56600,13.06532,433208
3208,echo80313,4,0.00092,56604,13.06624,433208
3209,edbighead,4,0.00092,56608,13.06716,433208
3210,edglynes,4,0.00092,56612,13.06809,433208
3211,eduardo3150,4,0.00092,56616,13.06901,433208
3212,eexe1,4,0.00092,56620,13.06993,433208
3213,ejemba,4,0.00092,56624,13.07086,433208
3214,ekarademir,4,0.00092,56628,13.07178,433208
3215,elinesterov,4,0.00092,56632,13.07270,433208
3216,elliott-davis,4,0.00092,56636,13.07363,433208
3217,elvinjgalarza,4,0.00092,56640,13.07455,433208
3218,Elynzis,4,0.00092,56644,13.07547,433208
3219,emil14,4,0.00092,56648,13.07640,433208
3220,encigem,4,0.00092,56652,13.07732,433208
3221,ENikS,4,0.00092,56656,13.07824,433208
3222,enokawa,4,0.00092,56660,13.07917,433208
3223,EnriqueL8,4,0.00092,56664,13.08009,433208
3224,enyo,4,0.00092,56668,13.08101,433208
3225,eoneal89,4,0.00092,56672,13.08194,433208
3226,EraYaN,4,0.00092,56676,13.08286,433208
3227,erikljung,4,0.00092,56680,13.08378,433208
3228,erinaboyd,4,0.00092,56684,13.08471,433208
3229,ernestas2k,4,0.00092,56688,13.08563,433208
3230,erosb,4,0.00092,56692,13.08655,433208
3231,escortnotice,4,0.00092,56696,13.08748,433208
3232,espindola,4,0.00092,56700,13.08840,433208
3233,essandess,4,0.00092,56704,13.08932,433208
3234,etedpet,4,0.00092,56708,13.09025,433208
3235,euh2,4,0.00092,56712,13.09117,433208
3236,evnsio,4,0.00092,56716,13.09209,433208
3237,ewassef,4,0.00092,56720,13.09302,433208
3238,eyinwag,4,0.00092,56724,13.09394,433208
3239,fabricev,4,0.00092,56728,13.09486,433208
3240,facchettos,4,0.00092,56732,13.09579,433208
3241,fatedier,4,0.00092,56736,13.09671,433208
3242,FCarvMobil,4,0.00092,56740,13.09763,433208
3243,fgsl,4,0.00092,56744,13.09856,433208
3244,fidato13,4,0.00092,56748,13.09948,433208
3245,filipecosta90,4,0.00092,56752,13.10040,433208
3246,firecat53,4,0.00092,56756,13.10133,433208
3247,FireDrunk,4,0.00092,56760,13.10225,433208
3248,firefixmaarten,4,0.00092,56764,13.10317,433208
3249,FischlerA,4,0.00092,56768,13.10410,433208
3250,FL3SH,4,0.00092,56772,13.10502,433208
3251,flaccid,4,0.00092,56776,13.10594,433208
3252,FLavalliere,4,0.00092,56780,13.10687,433208
3253,floatious,4,0.00092,56784,13.10779,433208
3254,florimondmanca,4,0.00092,56788,13.10871,433208
3255,fooevr,4,0.00092,56792,13.10964,433208
3256,FraBle,4,0.00092,56796,13.11056,433208
3257,Frederik-Baetens,4,0.00092,56800,13.11148,433208
3258,frittenlab,4,0.00092,56804,13.11241,433208
3259,Fruchtgummi,4,0.00092,56808,13.11333,433208
3260,fsommar,4,0.00092,56812,13.11425,433208
3261,fwfichtner,4,0.00092,56816,13.11518,433208
3262,g574,4,0.00092,56820,13.11610,433208
3263,gabrilabs75,4,0.00092,56824,13.11702,433208
3264,gagata,4,0.00092,56828,13.11795,433208
3265,galmasi,4,0.00092,56832,13.11887,433208
3266,gapro20022,4,0.00092,56836,13.11979,433208
3267,gastonqiu,4,0.00092,56840,13.12072,433208
3268,Gatsby-Lee,4,0.00092,56844,13.12164,433208
3269,GeoffMillerAZ,4,0.00092,56848,13.12256,433208
3270,georgr,4,0.00092,56852,13.12349,433208
3271,gep,4,0.00092,56856,13.12441,433208
3272,GerryWilko,4,0.00092,56860,13.12533,433208
3273,GianOrtiz,4,0.00092,56864,13.12626,433208
3274,gil-excelero,4,0.00092,56868,13.12718,433208
3275,gillg,4,0.00092,56872,13.12810,433208
3276,gitbeyond,4,0.00092,56876,13.12903,433208
3277,gkech,4,0.00092,56880,13.12995,433208
3278,gkramer,4,0.00092,56884,13.13087,433208
3279,gkrizek,4,0.00092,56888,13.13180,433208
3280,glenonn,4,0.00092,56892,13.13272,433208
3281,glightfoot,4,0.00092,56896,13.13364,433208
3282,gmaiztegi,4,0.00092,56900,13.13457,433208
3283,gmintoco,4,0.00092,56904,13.13549,433208
3284,gotoworld,4,0.00092,56908,13.13641,433208
3285,gouravbatra,4,0.00092,56912,13.13734,433208
3286,grep4error,4,0.00092,56916,13.13826,433208
3287,gricuk,4,0.00092,56920,13.13918,433208
3288,grzegorz-mirek,4,0.00092,56924,13.14011,433208
3289,gs-offcl,4,0.00092,56928,13.14103,433208
3290,guan840912,4,0.00092,56932,13.14195,433208
3291,guiadco,4,0.00092,56936,13.14288,433208
3292,gurrpi,4,0.00092,56940,13.14380,433208
3293,GusPrice,4,0.00092,56944,13.14472,433208
3294,gzlj,4,0.00092,56948,13.14565,433208
3295,hadrien-toma,4,0.00092,56952,13.14657,433208
3296,haifzhu,4,0.00092,56956,13.14749,433208
3297,Hanoko,4,0.00092,56960,13.14842,433208
3298,harmonyharmo,4,0.00092,56964,13.14934,433208
3299,hazcod,4,0.00092,56968,13.15026,433208
3300,hdacer,4,0.00092,56972,13.15119,433208
3301,Hefeweizen,4,0.00092,56976,13.15211,433208
3302,Helcaraxan,4,0.00092,56980,13.15304,433208
3303,helpfulBadger,4,0.00092,56984,13.15396,433208
3304,HeOpuHaMeH9I,4,0.00092,56988,13.15488,433208
3305,hepmkj,4,0.00092,56992,13.15581,433208
3306,hetii,4,0.00092,56996,13.15673,433208
3307,Hexta,4,0.00092,57000,13.15765,433208
3308,hideto0710,4,0.00092,57004,13.15858,433208
3309,himmakam,4,0.00092,57008,13.15950,433208
3310,HMaker,4,0.00092,57012,13.16042,433208
3311,hnasr,4,0.00092,57016,13.16135,433208
3312,Hokwang,4,0.00092,57020,13.16227,433208
3313,honzasara,4,0.00092,57024,13.16319,433208
3314,howdoicomputer,4,0.00092,57028,13.16412,433208
3315,hpamukcu,4,0.00092,57032,13.16504,433208
3316,hsuyuming,4,0.00092,57036,13.16596,433208
3317,htlabc,4,0.00092,57040,13.16689,433208
3318,hustshawn,4,0.00092,57044,13.16781,433208
3319,HW13,4,0.00092,57048,13.16873,433208
3320,hwk42,4,0.00092,57052,13.16966,433208
3321,hyscale,4,0.00092,57056,13.17058,433208
3322,hysyeah,4,0.00092,57060,13.17150,433208
3323,hyypan,4,0.00092,57064,13.17243,433208
3324,hzliangbin,4,0.00092,57068,13.17335,433208
3325,ianic,4,0.00092,57072,13.17427,433208
3326,ianwilkes,4,0.00092,57076,13.17520,433208
3327,ikibalnyi,4,0.00092,57080,13.17612,433208
3328,imrtfm,4,0.00092,57084,13.17704,433208
3329,infa-kparida,4,0.00092,57088,13.17797,433208
3330,infa-mlagad,4,0.00092,57092,13.17889,433208
3331,IrisG33,4,0.00092,57096,13.17981,433208
3332,isaactl,4,0.00092,57100,13.18074,433208
3333,istsh,4,0.00092,57104,13.18166,433208
3334,ivan-georgiev,4,0.00092,57108,13.18258,433208
3335,iyacontrol,4,0.00092,57112,13.18351,433208
3336,izone-airstream,4,0.00092,57116,13.18443,433208
3337,jabelone,4,0.00092,57120,13.18535,433208
3338,jacek-jablonski,4,0.00092,57124,13.18628,433208
3339,jacobvinzent,4,0.00092,57128,13.18720,433208
3340,jagodzinska,4,0.00092,57132,13.18812,433208
3341,jah23,4,0.00092,57136,13.18905,433208
3342,jaiawasthi,4,0.00092,57140,13.18997,433208
3343,jake15,4,0.00092,57144,13.19089,433208
3344,JakubJecminek,4,0.00092,57148,13.19182,433208
3345,jamesbeedy,4,0.00092,57152,13.19274,433208
3346,jamesla,4,0.00092,57156,13.19366,433208
3347,james-w,4,0.00092,57160,13.19459,433208
3348,jameszh,4,0.00092,57164,13.19551,433208
3349,Jane85,4,0.00092,57168,13.19643,433208
3350,JanScheurich,4,0.00092,57172,13.19736,433208
3351,jasiam,4,0.00092,57176,13.19828,433208
3352,jasonjjli,4,0.00092,57180,13.19920,433208
3353,jbuettnerbild,4,0.00092,57184,13.20013,433208
3354,jbuse,4,0.00092,57188,13.20105,433208
3355,jcassee,4,0.00092,57192,13.20197,433208
3356,jcferretti72,4,0.00092,57196,13.20290,433208
3357,jeffrson,4,0.00092,57200,13.20382,433208
3358,jeremybaumont,4,0.00092,57204,13.20474,433208
3359,jeremykuhnash,4,0.00092,57208,13.20567,433208
3360,jethrogb,4,0.00092,57212,13.20659,433208
3361,jewertow,4,0.00092,57216,13.20751,433208
3362,jfgosselin,4,0.00092,57220,13.20844,433208
3363,jianping0222,4,0.00092,57224,13.20936,433208
3364,jianzi123,4,0.00092,57228,13.21028,433208
3365,jiayiming001,4,0.00092,57232,13.21121,433208
3366,Jiboxiake,4,0.00092,57236,13.21213,433208
3367,JinLingChristopher,4,0.00092,57240,13.21305,433208
3368,jinxingwang,4,0.00092,57244,13.21398,433208
3369,JitendraDhakar,4,0.00092,57248,13.21490,433208
3370,jkh52,4,0.00092,57252,13.21582,433208
3371,jkschulz,4,0.00092,57256,13.21675,433208
3372,jlgeering,4,0.00092,57260,13.21767,433208
3373,jmw847,4,0.00092,57264,13.21859,433208
3374,jnewbigin,4,0.00092,57268,13.21952,433208
3375,jofia,4,0.00092,57272,13.22044,433208
3376,JohnGalt1717,4,0.00092,57276,13.22136,433208
3377,johnniee,4,0.00092,57280,13.22229,433208
3378,johnpemberton,4,0.00092,57284,13.22321,433208
3379,johnyannj,4,0.00092,57288,13.22413,433208
3380,JollyZeus,4,0.00092,57292,13.22506,433208
3381,jonathanpdx,4,0.00092,57296,13.22598,433208
3382,jond3k,4,0.00092,57300,13.22690,433208
3383,jonny-wg2,4,0.00092,57304,13.22783,433208
3384,joseadanof,4,0.00092,57308,13.22875,433208
3385,jot-hub,4,0.00092,57312,13.22967,433208
3386,jpds,4,0.00092,57316,13.23060,433208
3387,jrmyr,4,0.00092,57320,13.23152,433208
3388,jrudley,4,0.00092,57324,13.23244,433208
3389,jst-cyr,4,0.00092,57328,13.23337,433208
3390,jstewart612,4,0.00092,57332,13.23429,433208
3391,jswidler,4,0.00092,57336,13.23521,433208
3392,jun1-T,4,0.00092,57340,13.23614,433208
3393,jungwookim,4,0.00092,57344,13.23706,433208
3394,JustDoItSascha,4,0.00092,57348,13.23798,433208
3395,kagkarlsson,4,0.00092,57352,13.23891,433208
3396,kahou82,4,0.00092,57356,13.23983,433208
3397,kakaNo1,4,0.00092,57360,13.24075,433208
3398,kala2,4,0.00092,57364,13.24168,433208
3399,kapekost,4,0.00092,57368,13.24260,433208
3400,karimsa,4,0.00092,57372,13.24352,433208
3401,kasonglee,4,0.00092,57376,13.24445,433208
3402,kel-web,4,0.00092,57380,13.24537,433208
3403,kennygt51,4,0.00092,57384,13.24629,433208
3404,kep-w,4,0.00092,57388,13.24722,433208
3405,kerbyhughes,4,0.00092,57392,13.24814,433208
3406,kernel164,4,0.00092,57396,13.24906,433208
3407,kerrygunn,4,0.00092,57400,13.24999,433208
3408,kgumbs,4,0.00092,57404,13.25091,433208
3409,KhetanPawar,4,0.00092,57408,13.25183,433208
3410,kitos9112,4,0.00092,57412,13.25276,433208
3411,kkatrio,4,0.00092,57416,13.25368,433208
3412,kmcgovern-apixio,4,0.00092,57420,13.25460,433208
3413,kmr0877,4,0.00092,57424,13.25553,433208
3414,KodrAus,4,0.00092,57428,13.25645,433208
3415,konvergence,4,0.00092,57432,13.25737,433208
3416,kornelski,4,0.00092,57436,13.25830,433208
3417,kotyara85,4,0.00092,57440,13.25922,433208
3418,krangerich,4,0.00092,57444,13.26014,433208
3419,krausexb,4,0.00092,57448,13.26107,433208
3420,krecik,4,0.00092,57452,13.26199,433208
3421,krichardson-apexclearing,4,0.00092,57456,13.26291,433208
3422,krichter722,4,0.00092,57460,13.26384,433208
3423,krubot,4,0.00092,57464,13.26476,433208
3424,kumar-subashp,4,0.00092,57468,13.26568,433208
3425,kumarvikas2020,4,0.00092,57472,13.26661,433208
3426,kumarvin123,4,0.00092,57476,13.26753,433208
3427,KyleSanderson,4,0.00092,57480,13.26845,433208
3428,lancelot1989,4,0.00092,57484,13.26938,433208
3429,lang710,4,0.00092,57488,13.27030,433208
3430,laszlocph,4,0.00092,57492,13.27122,433208
3431,Leboudin,4,0.00092,57496,13.27215,433208
3432,lee5i3,4,0.00092,57500,13.27307,433208
3433,lelvisl,4,0.00092,57504,13.27399,433208
3434,lengrongfu,4,0.00092,57508,13.27492,433208
3435,leon-andria,4,0.00092,57512,13.27584,433208
3436,leozz37,4,0.00092,57516,13.27676,433208
3437,lgnashold,4,0.00092,57520,13.27769,433208
3438,liangminhua,4,0.00092,57524,13.27861,433208
3439,lijingchun0,4,0.00092,57528,13.27953,433208
3440,limberger,4,0.00092,57532,13.28046,433208
3441,Limoncho-san,4,0.00092,57536,13.28138,433208
3442,LionelJouin,4,0.00092,57540,13.28230,433208
3443,listaction,4,0.00092,57544,13.28323,433208
3444,little-guy-lxr,4,0.00092,57548,13.28415,433208
3445,liu4480,4,0.00092,57552,13.28507,433208
3446,liuzix,4,0.00092,57556,13.28600,433208
3447,liweitianux,4,0.00092,57560,13.28692,433208
3448,llavin,4,0.00092,57564,13.28784,433208
3449,lloydchang,4,0.00092,57568,13.28877,433208
3450,LO3N,4,0.00092,57572,13.28969,433208
3451,logicalphase,4,0.00092,57576,13.29061,433208
3452,longkai,4,0.00092,57580,13.29154,433208
3453,loudmouth,4,0.00092,57584,13.29246,433208
3454,LozanoMatheus,4,0.00092,57588,13.29338,433208
3455,lrhn,4,0.00092,57592,13.29431,433208
3456,Lucaber,4,0.00092,57596,13.29523,433208
3457,lucastheisen,4,0.00092,57600,13.29615,433208
3458,lucinvitae,4,0.00092,57604,13.29708,433208
3459,luka223,4,0.00092,57608,13.29800,433208
3460,luozhaoyu,4,0.00092,57612,13.29892,433208
3461,lvfei103650,4,0.00092,57616,13.29985,433208
3462,lwindolf,4,0.00092,57620,13.30077,433208
3463,lx-or-xxxl,4,0.00092,57624,13.30169,433208
3464,m0n0chr0m3,4,0.00092,57628,13.30262,433208
3465,madeelrh,4,0.00092,57632,13.30354,433208
3466,MaDongdong99,4,0.00092,57636,13.30446,433208
3467,magiccrafter,4,0.00092,57640,13.30539,433208
3468,mailtoraja18,4,0.00092,57644,13.30631,433208
3469,mainred,4,0.00092,57648,13.30723,433208
3470,majst01,4,0.00092,57652,13.30816,433208
3471,makhov,4,0.00092,57656,13.30908,433208
3472,malakar-soham,4,0.00092,57660,13.31000,433208
3473,manhhailua,4,0.00092,57664,13.31093,433208
3474,manishtiwari25,4,0.00092,57668,13.31185,433208
3475,manjeetsorout,4,0.00092,57672,13.31277,433208
3476,manute,4,0.00092,57676,13.31370,433208
3477,marcdel,4,0.00092,57680,13.31462,433208
3478,marcindulak,4,0.00092,57684,13.31554,433208
3479,marquetemb,4,0.00092,57688,13.31647,433208
3480,MarS919,4,0.00092,57692,13.31739,433208
3481,martinpovolny,4,0.00092,57696,13.31831,433208
3482,marvinlchen,4,0.00092,57700,13.31924,433208
3483,matedge,4,0.00092,57704,13.32016,433208
3484,matthewgrossman,4,0.00092,57708,13.32108,433208
3485,MatthewPattell,4,0.00092,57712,13.32201,433208
3486,mattKaczorowski,4,0.00092,57716,13.32293,433208
3487,mavrick,4,0.00092,57720,13.32385,433208
3488,maxweisspoker,4,0.00092,57724,13.32478,433208
3489,mberginbh,4,0.00092,57728,13.32570,433208
3490,mchtech,4,0.00092,57732,13.32662,433208
3491,mdh67899,4,0.00092,57736,13.32755,433208
3492,MegaEle,4,0.00092,57740,13.32847,433208
3493,mei2015,4,0.00092,57744,13.32939,433208
3494,mekstrem,4,0.00092,57748,13.33032,433208
3495,mgianatagh,4,0.00092,57752,13.33124,433208
3496,mhoshim,4,0.00092,57756,13.33216,433208
3497,MichaelDavisTSN,4,0.00092,57760,13.33309,433208
3498,michael-db,4,0.00092,57764,13.33401,433208
3499,michael-niemand,4,0.00092,57768,13.33493,433208
3500,micheam,4,0.00092,57772,13.33586,433208
3501,mickeypash,4,0.00092,57776,13.33678,433208
3502,mihailgmihaylov,4,0.00092,57780,13.33770,433208
3503,mikaelcabot,4,0.00092,57784,13.33863,433208
3504,mipnw,4,0.00092,57788,13.33955,433208
3505,mirusky,4,0.00092,57792,13.34047,433208
3506,miton18,4,0.00092,57796,13.34140,433208
3507,miyakz1192,4,0.00092,57800,13.34232,433208
3508,mjpieters,4,0.00092,57804,13.34324,433208
3509,mkaroshi,4,0.00092,57808,13.34417,433208
3510,mkralik3,4,0.00092,57812,13.34509,433208
3511,mlasevich,4,0.00092,57816,13.34601,433208
3512,MMeent,4,0.00092,57820,13.34694,433208
3513,mnottheone,4,0.00092,57824,13.34786,433208
3514,mogwai,4,0.00092,57828,13.34878,433208
3515,MoienTajik,4,0.00092,57832,13.34971,433208
3516,monofone,4,0.00092,57836,13.35063,433208
3517,morozov,4,0.00092,57840,13.35155,433208
3518,moshfeu,4,0.00092,57844,13.35248,433208
3519,mpatters72,4,0.00092,57848,13.35340,433208
3520,mpiexec,4,0.00092,57852,13.35432,433208
3521,mrbenosborne,4,0.00092,57856,13.35525,433208
3522,mrdulin,4,0.00092,57860,13.35617,433208
3523,mr-git,4,0.00092,57864,13.35709,433208
3524,mrhovunping,4,0.00092,57868,13.35802,433208
3525,mritunjaysharma394,4,0.00092,57872,13.35894,433208
3526,mrtns,4,0.00092,57876,13.35986,433208
3527,msdolbey,4,0.00092,57880,13.36079,433208
3528,mseiwald,4,0.00092,57884,13.36171,433208
3529,mtnbikenc,4,0.00092,57888,13.36263,433208
3530,mukulk2020,4,0.00092,57892,13.36356,433208
3531,mxtsuper,4,0.00092,57896,13.36448,433208
3532,myzhuh,4,0.00092,57900,13.36540,433208
3533,mzahor,4,0.00092,57904,13.36633,433208
3534,mzzgaopeng,4,0.00092,57908,13.36725,433208
3535,n0vad3v,4,0.00092,57912,13.36817,433208
3536,namgk,4,0.00092,57916,13.36910,433208
3537,nandeeshb09,4,0.00092,57920,13.37002,433208
3538,naotospace,4,0.00092,57924,13.37094,433208
3539,Narayami,4,0.00092,57928,13.37187,433208
3540,ncastrocosta,4,0.00092,57932,13.37279,433208
3541,nchandran3,4,0.00092,57936,13.37371,433208
3542,NelsonVides,4,0.00092,57940,13.37464,433208
3543,NeonOriginal,4,0.00092,57944,13.37556,433208
3544,nestajah,4,0.00092,57948,13.37648,433208
3545,neutiyoo,4,0.00092,57952,13.37741,433208
3546,Nevermore328,4,0.00092,57956,13.37833,433208
3547,ngocketit,4,0.00092,57960,13.37925,433208
3548,nhjiejan,4,0.00092,57964,13.38018,433208
3549,NickyBoy89,4,0.00092,57968,13.38110,433208
3550,NicolasFloquet,4,0.00092,57972,13.38202,433208
3551,nicolas-geniteau,4,0.00092,57976,13.38295,433208
3552,niketh,4,0.00092,57980,13.38387,433208
3553,NikolaeVarius,4,0.00092,57984,13.38479,433208
3554,Nimrodda,4,0.00092,57988,13.38572,433208
3555,nishchit,4,0.00092,57992,13.38664,433208
3556,njuptlzf,4,0.00092,57996,13.38756,433208
3557,nllptr,4,0.00092,58000,13.38849,433208
3558,nojvek,4,0.00092,58004,13.38941,433208
3559,NorseGaud,4,0.00092,58008,13.39033,433208
3560,nrchakradhar,4,0.00092,58012,13.39126,433208
3561,nrusinko,4,0.00092,58016,13.39218,433208
3562,nvrgngyup,4,0.00092,58020,13.39310,433208
3563,nwv-danvulpe,4,0.00092,58024,13.39403,433208
3564,nycdotnet,4,0.00092,58028,13.39495,433208
3565,oalbacha,4,0.00092,58032,13.39587,433208
3566,obaidomer,4,0.00092,58036,13.39680,433208
3567,obaudys,4,0.00092,58040,13.39772,433208
3568,Obooman,4,0.00092,58044,13.39864,433208
3569,ofey404,4,0.00092,58048,13.39957,433208
3570,oguzssahin,4,0.00092,58052,13.40049,433208
3571,oktocat,4,0.00092,58056,13.40141,433208
3572,olegsidokhmetov,4,0.00092,58060,13.40234,433208
3573,OmegaVVeapon,4,0.00092,58064,13.40326,433208
3574,omeryounus,4,0.00092,58068,13.40418,433208
3575,OmriHarary,4,0.00092,58072,13.40511,433208
3576,onepos-zaika,4,0.00092,58076,13.40603,433208
3577,opeco17,4,0.00092,58080,13.40695,433208
3578,orlakwahr,4,0.00092,58084,13.40788,433208
3579,otherview,4,0.00092,58088,13.40880,433208
3580,Palit-Mukul,4,0.00092,58092,13.40972,433208
3581,PallavRastogi165,4,0.00092,58096,13.41065,433208
3582,palsivertsen,4,0.00092,58100,13.41157,433208
3583,pambrose,4,0.00092,58104,13.41249,433208
3584,panzhongxian,4,0.00092,58108,13.41342,433208
3585,papirosko,4,0.00092,58112,13.41434,433208
3586,paprickar,4,0.00092,58116,13.41526,433208
3587,paranoidsp,4,0.00092,58120,13.41619,433208
3588,pardahlman,4,0.00092,58124,13.41711,433208
3589,parikmaan,4,0.00092,58128,13.41803,433208
3590,pbatg,4,0.00092,58132,13.41896,433208
3591,pcasaes,4,0.00092,58136,13.41988,433208
3592,pdebicki,4,0.00092,58140,13.42080,433208
3593,PedroCisnerosSantana,4,0.00092,58144,13.42173,433208
3594,pellywog,4,0.00092,58148,13.42265,433208
3595,peterfraedrich,4,0.00092,58152,13.42357,433208
3596,peteroneilljr,4,0.00092,58156,13.42450,433208
3597,peterstace,4,0.00092,58160,13.42542,433208
3598,phyrog,4,0.00092,58164,13.42634,433208
3599,Piccirello,4,0.00092,58168,13.42727,433208
3600,PierreC1024,4,0.00092,58172,13.42819,433208
3601,PierreF,4,0.00092,58176,13.42911,433208
3602,pinkfloydx33,4,0.00092,58180,13.43004,433208
3603,piotrkochan,4,0.00092,58184,13.43096,433208
3604,piroux,4,0.00092,58188,13.43188,433208
3605,piyush94,4,0.00092,58192,13.43281,433208
3606,pjastrzabek,4,0.00092,58196,13.43373,433208
3607,pmyjavec,4,0.00092,58200,13.43465,433208
3608,polivbr,4,0.00092,58204,13.43558,433208
3609,pp-dsouzajude,4,0.00092,58208,13.43650,433208
3610,prameetpatil,4,0.00092,58212,13.43742,433208
3611,prashantbhutani90,4,0.00092,58216,13.43835,433208
3612,prashantkumashi,4,0.00092,58220,13.43927,433208
3613,prasus,4,0.00092,58224,13.44020,433208
3614,prco5,4,0.00092,58228,13.44112,433208
3615,prithviramesh,4,0.00092,58232,13.44204,433208
3616,proggga,4,0.00092,58236,13.44297,433208
3617,prudhvigodithi,4,0.00092,58240,13.44389,433208
3618,psalaberria002,4,0.00092,58244,13.44481,433208
3619,pulkitsapra,4,0.00092,58248,13.44574,433208
3620,purplemysticx,4,0.00092,58252,13.44666,433208
3621,pushp1997,4,0.00092,58256,13.44758,433208
3622,qianfeiqianlan,4,0.00092,58260,13.44851,433208
3623,qiffang,4,0.00092,58264,13.44943,433208
3624,qi-min,4,0.00092,58268,13.45035,433208
3625,qu1queee,4,0.00092,58272,13.45128,433208
3626,queenns,4,0.00092,58276,13.45220,433208
3627,QuentinLeloire,4,0.00092,58280,13.45312,433208
3628,quickflash10,4,0.00092,58284,13.45405,433208
3629,quijote,4,0.00092,58288,13.45497,433208
3630,raine,4,0.00092,58292,13.45589,433208
3631,rajeshkodali,4,0.00092,58296,13.45682,433208
3632,rajurh,4,0.00092,58300,13.45774,433208
3633,ramonck,4,0.00092,58304,13.45866,433208
3634,ramzis,4,0.00092,58308,13.45959,433208
3635,ranshn,4,0.00092,58312,13.46051,433208
3636,rashidaga,4,0.00092,58316,13.46143,433208
3637,Rathgore,4,0.00092,58320,13.46236,433208
3638,ratulb,4,0.00092,58324,13.46328,433208
3639,ravidbro,4,0.00092,58328,13.46420,433208
3640,rawipfel,4,0.00092,58332,13.46513,433208
3641,razilevin,4,0.00092,58336,13.46605,433208
3642,rbankole,4,0.00092,58340,13.46697,433208
3643,rca-sgautier,4,0.00092,58344,13.46790,433208
3644,rcdmoreno,4,0.00092,58348,13.46882,433208
3645,Reamer,4,0.00092,58352,13.46974,433208
3646,red8888,4,0.00092,58356,13.47067,433208
3647,redriverhong,4,0.00092,58360,13.47159,433208
3648,reinaldo-pinto,4,0.00092,58364,13.47251,433208
3649,reith,4,0.00092,58368,13.47344,433208
3650,rene-m-hernandez,4,0.00092,58372,13.47436,433208
3651,renishb10,4,0.00092,58376,13.47528,433208
3652,renjikari,4,0.00092,58380,13.47621,433208
3653,renypaul,4,0.00092,58384,13.47713,433208
3654,retroflexer,4,0.00092,58388,13.47805,433208
3655,rgadeev,4,0.00092,58392,13.47898,433208
3656,rgbusato,4,0.00092,58396,13.47990,433208
3657,ridicule777,4,0.00092,58400,13.48082,433208
3658,riffling,4,0.00092,58404,13.48175,433208
3659,rileyL6122428,4,0.00092,58408,13.48267,433208
3660,RiRa12621,4,0.00092,58412,13.48359,433208
3661,risayew,4,0.00092,58416,13.48452,433208
3662,risinger,4,0.00092,58420,13.48544,433208
3663,RiskyAdventure,4,0.00092,58424,13.48636,433208
3664,rivencxl,4,0.00092,58428,13.48729,433208
3665,rkapoor028,4,0.00092,58432,13.48821,433208
3666,rmillzdev,4,0.00092,58436,13.48913,433208
3667,robarros,4,0.00092,58440,13.49006,433208
3668,robbertvdg,4,0.00092,58444,13.49098,433208
3669,RobbieJVMW,4,0.00092,58448,13.49190,433208
3670,RobEarl,4,0.00092,58452,13.49283,433208
3671,roblapp,4,0.00092,58456,13.49375,433208
3672,robshelly,4,0.00092,58460,13.49467,433208
3673,robstoll,4,0.00092,58464,13.49560,433208
3674,RollBack2010,4,0.00092,58468,13.49652,433208
3675,rootdeep,4,0.00092,58472,13.49744,433208
3676,roy-tonal,4,0.00092,58476,13.49837,433208
3677,rpahli,4,0.00092,58480,13.49929,433208
3678,rpeets,4,0.00092,58484,13.50021,433208
3679,rporres,4,0.00092,58488,13.50114,433208
3680,rroberts59110,4,0.00092,58492,13.50206,433208
3681,rtttech,4,0.00092,58496,13.50298,433208
3682,rubenrajkowski-nbcuni,4,0.00092,58500,13.50391,433208
3683,Rude-Monkey,4,0.00092,58504,13.50483,433208
3684,russoj88,4,0.00092,58508,13.50575,433208
3685,rvolosatovs,4,0.00092,58512,13.50668,433208
3686,ryanclark,4,0.00092,58516,13.50760,433208
3687,rymcol,4,0.00092,58520,13.50852,433208
3688,ryo-kagawa,4,0.00092,58524,13.50945,433208
3689,rzuku,4,0.00092,58528,13.51037,433208
3690,sacoefrancis,4,0.00092,58532,13.51129,433208
3691,saikrishnaa,4,0.00092,58536,13.51222,433208
3692,sajanjswl,4,0.00092,58540,13.51314,433208
3693,samwell61,4,0.00092,58544,13.51406,433208
3694,sandesha-rao-by,4,0.00092,58548,13.51499,433208
3695,sangcom15,4,0.00092,58552,13.51591,433208
3696,sanjaymsh,4,0.00092,58556,13.51683,433208
3697,sannour,4,0.00092,58560,13.51776,433208
3698,sanoojm,4,0.00092,58564,13.51868,433208
3699,santigl,4,0.00092,58568,13.51960,433208
3700,SantosRay,4,0.00092,58572,13.52053,433208
3701,sarthakvdev,4,0.00092,58576,13.52145,433208
3702,saswatac,4,0.00092,58580,13.52237,433208
3703,saurabhtmba2005,4,0.00092,58584,13.52330,433208
3704,sbaier1,4,0.00092,58588,13.52422,433208
3705,sbellan,4,0.00092,58592,13.52514,433208
3706,sbhnet,4,0.00092,58596,13.52607,433208
3707,scardena,4,0.00092,58600,13.52699,433208
3708,scotte,4,0.00092,58604,13.52791,433208
3709,sdatspun2,4,0.00092,58608,13.52884,433208
3710,sdeoras,4,0.00092,58612,13.52976,433208
3711,sdputurn,4,0.00092,58616,13.53068,433208
3712,seetaramrao,4,0.00092,58620,13.53161,433208
3713,sergiodj,4,0.00092,58624,13.53253,433208
3714,sgc109,4,0.00092,58628,13.53345,433208
3715,sgerace,4,0.00092,58632,13.53438,433208
3716,Sh1710,4,0.00092,58636,13.53530,433208
3717,shankar-forgerock,4,0.00092,58640,13.53622,433208
3718,shankarmohannamakkal,4,0.00092,58644,13.53715,433208
3719,Shiqin-Li,4,0.00092,58648,13.53807,433208
3720,shteou,4,0.00092,58652,13.53899,433208
3721,shubb30,4,0.00092,58656,13.53992,433208
3722,shyamg28,4,0.00092,58660,13.54084,433208
3723,siddhant3030,4,0.00092,58664,13.54176,433208
3724,siddharths2710,4,0.00092,58668,13.54269,433208
3725,sighingnow,4,0.00092,58672,13.54361,433208
3726,SilvaMatteus,4,0.00092,58676,13.54453,433208
3727,simonc-613,4,0.00092,58680,13.54546,433208
3728,sivatarunp,4,0.00092,58684,13.54638,433208
3729,skibum55,4,0.00092,58688,13.54730,433208
3730,Skymirrh,4,0.00092,58692,13.54823,433208
3731,SkySonR,4,0.00092,58696,13.54915,433208
3732,slaveofcode,4,0.00092,58700,13.55007,433208
3733,smcavallo,4,0.00092,58704,13.55100,433208
3734,SmithSgq,4,0.00092,58708,13.55192,433208
3735,smnz,4,0.00092,58712,13.55284,433208
3736,snehakpersistent,4,0.00092,58716,13.55377,433208
3737,snehal1797,4,0.00092,58720,13.55469,433208
3738,snirbenyosef,4,0.00092,58724,13.55561,433208
3739,snorlaX-sleeps,4,0.00092,58728,13.55654,433208
3740,solongtony,4,0.00092,58732,13.55746,433208
3741,somdoron,4,0.00092,58736,13.55838,433208
3742,soncaocc,4,0.00092,58740,13.55931,433208
3743,Sonlis,4,0.00092,58744,13.56023,433208
3744,soumyax1das,4,0.00092,58748,13.56115,433208
3745,sourcedelica,4,0.00092,58752,13.56208,433208
3746,specxybeardo,4,0.00092,58756,13.56300,433208
3747,Spritekin,4,0.00092,58760,13.56392,433208
3748,sriharshaj70,4,0.00092,58764,13.56485,433208
3749,srinivasannanduri,4,0.00092,58768,13.56577,433208
3750,ssharma2089,4,0.00092,58772,13.56669,433208
3751,Starttoaster,4,0.00092,58776,13.56762,433208
3752,STEPHINRACHEL,4,0.00092,58780,13.56854,433208
3753,storozhilov,4,0.00092,58784,13.56946,433208
3754,Strangerxxx,4,0.00092,58788,13.57039,433208
3755,strangiato,4,0.00092,58792,13.57131,433208
3756,striver619,4,0.00092,58796,13.57223,433208
3757,sturman,4,0.00092,58800,13.57316,433208
3758,stuzfuz,4,0.00092,58804,13.57408,433208
3759,subrnath,4,0.00092,58808,13.57500,433208
3760,sunchill06,4,0.00092,58812,13.57593,433208
3761,supasteev0,4,0.00092,58816,13.57685,433208
3762,suppix,4,0.00092,58820,13.57777,433208
3763,surensinghkhatana,4,0.00092,58824,13.57870,433208
3764,sverch,4,0.00092,58828,13.57962,433208
3765,SwatiKulkarni709,4,0.00092,58832,13.58054,433208
3766,swinges,4,0.00092,58836,13.58147,433208
3767,T0MASD,4,0.00092,58840,13.58239,433208
3768,t0rrant,4,0.00092,58844,13.58331,433208
3769,t1bb4r,4,0.00092,58848,13.58424,433208
3770,Tanmay17,4,0.00092,58852,13.58516,433208
3771,tantweiler,4,0.00092,58856,13.58608,433208
3772,tatsuya-ogawa,4,0.00092,58860,13.58701,433208
3773,te4336,4,0.00092,58864,13.58793,433208
3774,teemuteemu,4,0.00092,58868,13.58885,433208
3775,TennyZhuang,4,0.00092,58872,13.58978,433208
3776,tenzen-y,4,0.00092,58876,13.59070,433208
3777,tetsuya28,4,0.00092,58880,13.59162,433208
3778,tgrecojr,4,0.00092,58884,13.59255,433208
3779,thatguyjono94,4,0.00092,58888,13.59347,433208
3780,theAkito,4,0.00092,58892,13.59439,433208
3781,Thearas,4,0.00092,58896,13.59532,433208
3782,TheMisir,4,0.00092,58900,13.59624,433208
3783,TheSimpleZ,4,0.00092,58904,13.59716,433208
3784,throrin19,4,0.00092,58908,13.59809,433208
3785,tinyma123,4,0.00092,58912,13.59901,433208
3786,Titof974,4,0.00092,58916,13.59993,433208
3787,tlhunter,4,0.00092,58920,13.60086,433208
3788,toddkazakov,4,0.00092,58924,13.60178,433208
3789,tokomeno,4,0.00092,58928,13.60270,433208
3790,Tolsto,4,0.00092,58932,13.60363,433208
3791,tom20180101,4,0.00092,58936,13.60455,433208
3792,tomek-ifm,4,0.00092,58940,13.60547,433208
3793,TomHennen,4,0.00092,58944,13.60640,433208
3794,tomoyat1,4,0.00092,58948,13.60732,433208
3795,ToonvanStrijp,4,0.00092,58952,13.60824,433208
3796,torblerone,4,0.00092,58956,13.60917,433208
3797,ToucanBran,4,0.00092,58960,13.61009,433208
3798,tpoindessous,4,0.00092,58964,13.61101,433208
3799,tr2vil,4,0.00092,58968,13.61194,433208
3800,trashhalo,4,0.00092,58972,13.61286,433208
3801,trejjam,4,0.00092,58976,13.61378,433208
3802,trey2001,4,0.00092,58980,13.61471,433208
3803,trollydolly,4,0.00092,58984,13.61563,433208
3804,ts3ng,4,0.00092,58988,13.61655,433208
3805,tsandor,4,0.00092,58992,13.61748,433208
3806,ttarczynski,4,0.00092,58996,13.61840,433208
3807,tuskiomi,4,0.00092,59000,13.61932,433208
3808,tweing,4,0.00092,59004,13.62025,433208
3809,Tylertron1998,4,0.00092,59008,13.62117,433208
3810,tysng,4,0.00092,59012,13.62209,433208
3811,u2mejc,4,0.00092,59016,13.62302,433208
3812,uiuifree,4,0.00092,59020,13.62394,433208
3813,UlyssesCB,4,0.00092,59024,13.62486,433208
3814,Unb9rn,4,0.00092,59028,13.62579,433208
3815,uninvited,4,0.00092,59032,13.62671,433208
3816,unki,4,0.00092,59036,13.62763,433208
3817,userravs,4,0.00092,59040,13.62856,433208
3818,ushuz,4,0.00092,59044,13.62948,433208
3819,utdevops,4,0.00092,59048,13.63040,433208
3820,utkarsh-pandey-ext,4,0.00092,59052,13.63133,433208
3821,vaassi,4,0.00092,59056,13.63225,433208
3822,valery-zhurbenko,4,0.00092,59060,13.63317,433208
3823,vasuarv,4,0.00092,59064,13.63410,433208
3824,vazirim,4,0.00092,59068,13.63502,433208
3825,vcorr,4,0.00092,59072,13.63594,433208
3826,veith,4,0.00092,59076,13.63687,433208
3827,veronicagarciavazquez,4,0.00092,59080,13.63779,433208
3828,vguhesan,4,0.00092,59084,13.63871,433208
3829,VihanAgarwal97,4,0.00092,59088,13.63964,433208
3830,vijaygos,4,0.00092,59092,13.64056,433208
3831,vinsguru,4,0.00092,59096,13.64148,433208
3832,virendrasuryavanshi,4,0.00092,59100,13.64241,433208
3833,vishalk-rafay,4,0.00092,59104,13.64333,433208
3834,Vishnu-Lakkimsetty-E3640,4,0.00092,59108,13.64425,433208
3835,vit100,4,0.00092,59112,13.64518,433208
3836,vkhater,4,0.00092,59116,13.64610,433208
3837,vkmellon,4,0.00092,59120,13.64702,433208
3838,vpharabot,4,0.00092,59124,13.64795,433208
3839,vsai9594,4,0.00092,59128,13.64887,433208
3840,wanyaoqi,4,0.00092,59132,13.64979,433208
3841,wanyingd1996,4,0.00092,59136,13.65072,433208
3842,wd,4,0.00092,59140,13.65164,433208
3843,wflms20110333,4,0.00092,59144,13.65256,433208
3844,whatthefrog,4,0.00092,59148,13.65349,433208
3845,whillas,4,0.00092,59152,13.65441,433208
3846,wi1dcard,4,0.00092,59156,13.65533,433208
3847,wildermesser,4,0.00092,59160,13.65626,433208
3848,wingman-chakra,4,0.00092,59164,13.65718,433208
3849,wkchee,4,0.00092,59168,13.65810,433208
3850,Woile,4,0.00092,59172,13.65903,433208
3851,WoozyMasta,4,0.00092,59176,13.65995,433208
3852,wshwsh12,4,0.00092,59180,13.66087,433208
3853,wstrm,4,0.00092,59184,13.66180,433208
3854,wtreston,4,0.00092,59188,13.66272,433208
3855,wzq12345678,4,0.00092,59192,13.66364,433208
3856,x1wins,4,0.00092,59196,13.66457,433208
3857,xiangzhai,4,0.00092,59200,13.66549,433208
3858,xkortex,4,0.00092,59204,13.66641,433208
3859,xs233,4,0.00092,59208,13.66734,433208
3860,xstephen95x,4,0.00092,59212,13.66826,433208
3861,xuchenCN,4,0.00092,59216,13.66918,433208
3862,xuyinhao,4,0.00092,59220,13.67011,433208
3863,Xyaren,4,0.00092,59224,13.67103,433208
3864,yachtcaptain23,4,0.00092,59228,13.67195,433208
3865,yangcheng-icbc,4,0.00092,59232,13.67288,433208
3866,yangchenliang,4,0.00092,59236,13.67380,433208
3867,yang-rose,4,0.00092,59240,13.67472,433208
3868,yangyefei-bj,4,0.00092,59244,13.67565,433208
3869,yaoice,4,0.00092,59248,13.67657,433208
3870,yash0501,4,0.00092,59252,13.67749,433208
3871,yassan,4,0.00092,59256,13.67842,433208
3872,ycabrer,4,0.00092,59260,13.67934,433208
3873,ycjessyhuang,4,0.00092,59264,13.68026,433208
3874,yegle,4,0.00092,59268,13.68119,433208
3875,yeplaa,4,0.00092,59272,13.68211,433208
3876,yeqown,4,0.00092,59276,13.68303,433208
3877,YeSei,4,0.00092,59280,13.68396,433208
3878,yhaenggi,4,0.00092,59284,13.68488,433208
3879,yinzara,4,0.00092,59288,13.68580,433208
3880,ynqa,4,0.00092,59292,13.68673,433208
3881,yokaze,4,0.00092,59296,13.68765,433208
3882,YouEclipse,4,0.00092,59300,13.68857,433208
3883,yourmoonlight,4,0.00092,59304,13.68950,433208
3884,ypyly,4,0.00092,59308,13.69042,433208
3885,YSZhuoyang,4,0.00092,59312,13.69134,433208
3886,Yuaninga,4,0.00092,59316,13.69227,433208
3887,yunnysunny,4,0.00092,59320,13.69319,433208
3888,yurividal,4,0.00092,59324,13.69411,433208
3889,YuriyKrasilnikov,4,0.00092,59328,13.69504,433208
3890,yz8654773,4,0.00092,59332,13.69596,433208
3891,zacheryph,4,0.00092,59336,13.69688,433208
3892,zanjichao,4,0.00092,59340,13.69781,433208
3893,zengyuxing007,4,0.00092,59344,13.69873,433208
3894,zffocussss,4,0.00092,59348,13.69965,433208
3895,zhangwenlong8911,4,0.00092,59352,13.70058,433208
3896,zhenjiaogao,4,0.00092,59356,13.70150,433208
3897,zhoudayongdennis,4,0.00092,59360,13.70242,433208
3898,zhxnlai,4,0.00092,59364,13.70335,433208
3899,zishen,4,0.00092,59368,13.70427,433208
3900,ZiweiZhao,4,0.00092,59372,13.70519,433208
3901,zoemac11,4,0.00092,59376,13.70612,433208
3902,zonggen,4,0.00092,59380,13.70704,433208
3903,zoux86,4,0.00092,59384,13.70796,433208
3904,zpittmansf,4,0.00092,59388,13.70889,433208
3905,zxiaozhou,4,0.00092,59392,13.70981,433208
3906,zyf0330,4,0.00092,59396,13.71073,433208
3907,zzq900503,4,0.00092,59400,13.71166,433208
3908,0x63lv,3,0.00069,59403,13.71235,433208
3909,1150310621,3,0.00069,59406,13.71304,433208
3910,12Dong,3,0.00069,59409,13.71374,433208
3911,1964405262,3,0.00069,59412,13.71443,433208
3912,22dm,3,0.00069,59415,13.71512,433208
3913,3d0c,3,0.00069,59418,13.71581,433208
3914,4c74356b41,3,0.00069,59421,13.71651,433208
3915,4dahalibut,3,0.00069,59424,13.71720,433208
3916,7amou3,3,0.00069,59427,13.71789,433208
3917,a1russell,3,0.00069,59430,13.71858,433208
3918,aaad,3,0.00069,59433,13.71928,433208
3919,aasiutin,3,0.00069,59436,13.71997,433208
3920,abhassine,3,0.00069,59439,13.72066,433208
3921,abhijits1234,3,0.00069,59442,13.72135,433208
3922,abihf,3,0.00069,59445,13.72205,433208
3923,abu-2020-ghub,3,0.00069,59448,13.72274,433208
3924,abusalimov,3,0.00069,59451,13.72343,433208
3925,accnops,3,0.00069,59454,13.72412,433208
3926,achals,3,0.00069,59457,13.72482,433208
3927,achinook,3,0.00069,59460,13.72551,433208
3928,ac-obair,3,0.00069,59463,13.72620,433208
3929,AdamKorcz,3,0.00069,59466,13.72689,433208
3930,adam-power,3,0.00069,59469,13.72759,433208
3931,AdamSharif-MSFT,3,0.00069,59472,13.72828,433208
3932,AdamSLevy,3,0.00069,59475,13.72897,433208
3933,adamtulinius,3,0.00069,59478,13.72966,433208
3934,adamzr,3,0.00069,59481,13.73036,433208
3935,adarsh-k-tiwari,3,0.00069,59484,13.73105,433208
3936,addozhang,3,0.00069,59487,13.73174,433208
3937,adhocore,3,0.00069,59490,13.73243,433208
3938,adiezg,3,0.00069,59493,13.73313,433208
3939,adityamukho,3,0.00069,59496,13.73382,433208
3940,adombeck,3,0.00069,59499,13.73451,433208
3941,adr-arroyo,3,0.00069,59502,13.73520,433208
3942,adrian-skybaker,3,0.00069,59505,13.73590,433208
3943,adrian-thurston,3,0.00069,59508,13.73659,433208
3944,adzuci,3,0.00069,59511,13.73728,433208
3945,afilipchik,3,0.00069,59514,13.73797,433208
3946,agrajm,3,0.00069,59517,13.73867,433208
3947,AGSaidi,3,0.00069,59520,13.73936,433208
3948,ahrechushkin,3,0.00069,59523,13.74005,433208
3949,AilinKid,3,0.00069,59526,13.74074,433208
3950,AirbornePorcine,3,0.00069,59529,13.74144,433208
3951,Airex,3,0.00069,59532,13.74213,433208
3952,aiyengar2,3,0.00069,59535,13.74282,433208
3953,ajbouh,3,0.00069,59538,13.74351,433208
3954,ajkr,3,0.00069,59541,13.74421,433208
3955,akshatgit,3,0.00069,59544,13.74490,433208
3956,al3pht,3,0.00069,59547,13.74559,433208
3957,aldirrix,3,0.00069,59550,13.74628,433208
3958,AleksandrNull,3,0.00069,59553,13.74698,433208
3959,alexanderkyte,3,0.00069,59556,13.74767,433208
3960,AlexanderThaller,3,0.00069,59559,13.74836,433208
3961,AlexandreOuellet,3,0.00069,59562,13.74905,433208
3962,alexandrud,3,0.00069,59565,13.74975,433208
3963,alexgaganashvili,3,0.00069,59568,13.75044,433208
3964,AlexisMtr,3,0.00069,59571,13.75113,433208
3965,alextaran1996,3,0.00069,59574,13.75182,433208
3966,alextodicescu,3,0.00069,59577,13.75252,433208
3967,alexvanboxel,3,0.00069,59580,13.75321,433208
3968,Alfusainey,3,0.00069,59583,13.75390,433208
3969,alistarle,3,0.00069,59586,13.75459,433208
3970,AljoschaP,3,0.00069,59589,13.75529,433208
3971,allx,3,0.00069,59592,13.75598,433208
3972,almahmoud,3,0.00069,59595,13.75667,433208
3973,almato-mdm-support,3,0.00069,59598,13.75736,433208
3974,alombardo4,3,0.00069,59601,13.75806,433208
3975,altexdim,3,0.00069,59604,13.75875,433208
3976,alxmrtn,3,0.00069,59607,13.75944,433208
3977,AmaliMatharaarachchi,3,0.00069,59610,13.76013,433208
3978,amarjitmult,3,0.00069,59613,13.76083,433208
3979,amarruedo,3,0.00069,59616,13.76152,433208
3980,ambarve,3,0.00069,59619,13.76221,433208
3981,AmineMH7,3,0.00069,59622,13.76290,433208
3982,amitcmore,3,0.00069,59625,13.76360,433208
3983,AMoghrabi,3,0.00069,59628,13.76429,433208
3984,anakaiti,3,0.00069,59631,13.76498,433208
3985,ancatri,3,0.00069,59634,13.76567,433208
3986,andreea-asavoaei,3,0.00069,59637,13.76637,433208
3987,AndreiBamboi,3,0.00069,59640,13.76706,433208
3988,andrejguran,3,0.00069,59643,13.76775,433208
3989,andytsnowden,3,0.00069,59646,13.76844,433208
3990,aneelysis,3,0.00069,59649,13.76914,433208
3991,angristan,3,0.00069,59652,13.76983,433208
3992,anhem115,3,0.00069,59655,13.77052,433208
3993,ankita2910,3,0.00069,59658,13.77121,433208
3994,ankitabhopatkar13,3,0.00069,59661,13.77191,433208
3995,Ankitchandre,3,0.00069,59664,13.77260,433208
3996,ankur-anand,3,0.00069,59667,13.77329,433208
3997,anshlykov,3,0.00069,59670,13.77398,433208
3998,anshulsri12,3,0.00069,59673,13.77468,433208
3999,antaloala,3,0.00069,59676,13.77537,433208
4000,anthonymq,3,0.00069,59679,13.77606,433208
4001,anthr76,3,0.00069,59682,13.77675,433208
4002,antoinetran,3,0.00069,59685,13.77745,433208
4003,AntonBlomstrom,3,0.00069,59688,13.77814,433208
4004,Antonboom,3,0.00069,59691,13.77883,433208
4005,AnujAroshA,3,0.00069,59694,13.77952,433208
4006,anurags92,3,0.00069,59697,13.78022,433208
4007,Anynou,3,0.00069,59700,13.78091,433208
4008,apepojken,3,0.00069,59703,13.78160,433208
4009,aqua777,3,0.00069,59706,13.78229,433208
4010,AquoDev,3,0.00069,59709,13.78299,433208
4011,ArcticLight,3,0.00069,59712,13.78368,433208
4012,arctiqgreg,3,0.00069,59715,13.78437,433208
4013,ardymalihi,3,0.00069,59718,13.78506,433208
4014,Ares3266,3,0.00069,59721,13.78576,433208
4015,ariesyous,3,0.00069,59724,13.78645,433208
4016,Arnaud-Francois-Fausse,3,0.00069,59727,13.78714,433208
4017,aroramanish080282,3,0.00069,59730,13.78783,433208
4018,arpit1997,3,0.00069,59733,13.78853,433208
4019,Arrefelt,3,0.00069,59736,13.78922,433208
4020,artemsablin,3,0.00069,59739,13.78991,433208
4021,arun-blacklane,3,0.00069,59742,13.79060,433208
4022,aservera,3,0.00069,59745,13.79130,433208
4023,asheldon,3,0.00069,59748,13.79199,433208
4024,ashf,3,0.00069,59751,13.79268,433208
4025,Ashnam1100,3,0.00069,59754,13.79337,433208
4026,ashum81,3,0.00069,59757,13.79407,433208
4027,asitaru,3,0.00069,59760,13.79476,433208
4028,asyncee,3,0.00069,59763,13.79545,433208
4029,Atharva-gt,3,0.00069,59766,13.79614,433208
4030,atmosx,3,0.00069,59769,13.79684,433208
4031,atpons,3,0.00069,59772,13.79753,433208
4032,augustkang,3,0.00069,59775,13.79822,433208
4033,aurorazl,3,0.00069,59778,13.79891,433208
4034,austinwheelock,3,0.00069,59781,13.79961,433208
4035,autarchprinceps,3,0.00069,59784,13.80030,433208
4036,autodidaddict,3,0.00069,59787,13.80099,433208
4037,avasquez614,3,0.00069,59790,13.80168,433208
4038,avinashdhinwa,3,0.00069,59793,13.80238,433208
4039,AWSmith0216,3,0.00069,59796,13.80307,433208
4040,ayeganov,3,0.00069,59799,13.80376,433208
4041,azeemzaidi,3,0.00069,59802,13.80445,433208
4042,azizn03,3,0.00069,59805,13.80515,433208
4043,bananetomate,3,0.00069,59808,13.80584,433208
4044,Banchio,3,0.00069,59811,13.80653,433208
4045,banksyian,3,0.00069,59814,13.80722,433208
4046,banthaherder,3,0.00069,59817,13.80792,433208
4047,bartcode,3,0.00069,59820,13.80861,433208
4048,BartoszCki,3,0.00069,59823,13.80930,433208
4049,bastianeicher,3,0.00069,59826,13.80999,433208
4050,baurmatt,3,0.00069,59829,13.81069,433208
4051,bburky,3,0.00069,59832,13.81138,433208
4052,BeardyC,3,0.00069,59835,13.81207,433208
4053,beccabau,3,0.00069,59838,13.81276,433208
4054,beldred-umd,3,0.00069,59841,13.81346,433208
4055,benitogf,3,0.00069,59844,13.81415,433208
4056,benjojo,3,0.00069,59847,13.81484,433208
4057,bergkvist,3,0.00069,59850,13.81553,433208
4058,bfabec,3,0.00069,59853,13.81623,433208
4059,bgsilvait,3,0.00069,59856,13.81692,433208
4060,Bharat123rox,3,0.00069,59859,13.81761,433208
4061,biello,3,0.00069,59862,13.81830,433208
4062,BIGBALLON,3,0.00069,59865,13.81900,433208
4063,bigd510,3,0.00069,59868,13.81969,433208
4064,bigred94,3,0.00069,59871,13.82038,433208
4065,bikramnehra,3,0.00069,59874,13.82107,433208
4066,billiamx33,3,0.00069,59877,13.82177,433208
4067,bitspradp,3,0.00069,59880,13.82246,433208
4068,bk201,3,0.00069,59883,13.82315,433208
4069,BlackBsd,3,0.00069,59886,13.82384,433208
4070,blaubaer,3,0.00069,59889,13.82454,433208
4071,blepoutr,3,0.00069,59892,13.82523,433208
4072,blessengeorge,3,0.00069,59895,13.82592,433208
4073,blinkiz,3,0.00069,59898,13.82661,433208
4074,blorette,3,0.00069,59901,13.82731,433208
4075,blueseason,3,0.00069,59904,13.82800,433208
4076,bmhm,3,0.00069,59907,13.82869,433208
4077,bnaganathan,3,0.00069,59910,13.82938,433208
4078,bobrot,3,0.00069,59913,13.83008,433208
4079,Boca13,3,0.00069,59916,13.83077,433208
4080,bodilb,3,0.00069,59919,13.83146,433208
4081,Booster2ooo,3,0.00069,59922,13.83215,433208
4082,BorisRado,3,0.00069,59925,13.83285,433208
4083,bortek,3,0.00069,59928,13.83354,433208
4084,Bouncey,3,0.00069,59931,13.83423,433208
4085,bplasmeijer,3,0.00069,59934,13.83492,433208
4086,br0ziliy,3,0.00069,59937,13.83562,433208
4087,brasky,3,0.00069,59940,13.83631,433208
4088,brasseld,3,0.00069,59943,13.83700,433208
4089,braxtonchristensen,3,0.00069,59946,13.83769,433208
4090,brettplarson,3,0.00069,59949,13.83839,433208
4091,Brice187,3,0.00069,59952,13.83908,433208
4092,brumhard,3,0.00069,59955,13.83977,433208
4093,bryanasdev000,3,0.00069,59958,13.84046,433208
4094,bryanchang15,3,0.00069,59961,13.84116,433208
4095,bryanhorstmann,3,0.00069,59964,13.84185,433208
4096,bryankaraffa,3,0.00069,59967,13.84254,433208
4097,bryanlou,3,0.00069,59970,13.84323,433208
4098,bugaolengdeyuxiaoer,3,0.00069,59973,13.84393,433208
4099,BurtonQin,3,0.00069,59976,13.84462,433208
4100,byakku,3,0.00069,59979,13.84531,433208
4101,bycEEE,3,0.00069,59982,13.84600,433208
4102,bzuelke,3,0.00069,59985,13.84670,433208
4103,c4m4,3,0.00069,59988,13.84739,433208
4104,Cactusinhand,3,0.00069,59991,13.84808,433208
4105,calvinyv,3,0.00069,59994,13.84877,433208
4106,CaramelMario,3,0.00069,59997,13.84947,433208
4107,carlonoelle,3,0.00069,60000,13.85016,433208
4108,carneiroskeeled,3,0.00069,60003,13.85085,433208
4109,caseyclarkjamf,3,0.00069,60006,13.85154,433208
4110,casper-lc,3,0.00069,60009,13.85224,433208
4111,caugustus-ezcater,3,0.00069,60012,13.85293,433208
4112,cbenz,3,0.00069,60015,13.85362,433208
4113,cbrand,3,0.00069,60018,13.85431,433208
4114,cbrgm,3,0.00069,60021,13.85501,433208
4115,cbui,3,0.00069,60024,13.85570,433208
4116,Ccaomei,3,0.00069,60027,13.85639,433208
4117,ccgagnon,3,0.00069,60030,13.85708,433208
4118,cdecker,3,0.00069,60033,13.85778,433208
4119,CelineVc,3,0.00069,60036,13.85847,433208
4120,cesar-rodriguez,3,0.00069,60039,13.85916,433208
4121,cgarciae,3,0.00069,60042,13.85985,433208
4122,cgeers,3,0.00069,60045,13.86055,433208
4123,chadlwilson,3,0.00069,60048,13.86124,433208
4124,Champ-Goblem,3,0.00069,60051,13.86193,433208
4125,chandankashyap19,3,0.00069,60054,13.86262,433208
4126,Chandrakanth-R,3,0.00069,60057,13.86332,433208
4127,chandungc,3,0.00069,60060,13.86401,433208
4128,chankh,3,0.00069,60063,13.86470,433208
4129,charles2j,3,0.00069,60066,13.86539,433208
4130,chaunsin,3,0.00069,60069,13.86609,433208
4131,chbois,3,0.00069,60072,13.86678,433208
4132,chemasan,3,0.00069,60075,13.86747,433208
4133,cheng0214,3,0.00069,60078,13.86816,433208
4134,Chengxuan,3,0.00069,60081,13.86886,433208
4135,chenjiandongx,3,0.00069,60084,13.86955,433208
4136,chenkaigithub,3,0.00069,60087,13.87024,433208
4137,chennupushkar,3,0.00069,60090,13.87093,433208
4138,chiffacff,3,0.00069,60093,13.87163,433208
4139,chigichan24,3,0.00069,60096,13.87232,433208
4140,chintan-mishra,3,0.00069,60099,13.87301,433208
4141,chmreid,3,0.00069,60102,13.87371,433208
4142,choury,3,0.00069,60105,13.87440,433208
4143,chrisjohnson00,3,0.00069,60108,13.87509,433208
4144,chrisleavoy,3,0.00069,60111,13.87578,433208
4145,chris-morandi,3,0.00069,60114,13.87648,433208
4146,chris-ng-scmp,3,0.00069,60117,13.87717,433208
4147,christianknell,3,0.00069,60120,13.87786,433208
4148,christianri,3,0.00069,60123,13.87855,433208
4149,christine-gong,3,0.00069,60126,13.87925,433208
4150,ChristopherLenz,3,0.00069,60129,13.87994,433208
4151,chriswilliams1977,3,0.00069,60132,13.88063,433208
4152,chrisxrepo,3,0.00069,60135,13.88132,433208
4153,chrko,3,0.00069,60138,13.88202,433208
4154,chuan9,3,0.00069,60141,13.88271,433208
4155,ChuckHend,3,0.00069,60144,13.88340,433208
4156,cimes-isi,3,0.00069,60147,13.88409,433208
4157,cj-anthony,3,0.00069,60150,13.88479,433208
4158,cjk,3,0.00069,60153,13.88548,433208
4159,cjohnstoniv,3,0.00069,60156,13.88617,433208
4160,clarkds14,3,0.00069,60159,13.88686,433208
4161,clayvan,3,0.00069,60162,13.88756,433208
4162,clundquist-stripe,3,0.00069,60165,13.88825,433208
4163,cnukwas,3,0.00069,60168,13.88894,433208
4164,cobolbaby,3,0.00069,60171,13.88963,433208
4165,codinaut,3,0.00069,60174,13.89033,433208
4166,CodyGuo,3,0.00069,60177,13.89102,433208
4167,cognifloyd,3,0.00069,60180,13.89171,433208
4168,corburn,3,0.00069,60183,13.89240,433208
4169,CostelLupoaie,3,0.00069,60186,13.89310,433208
4170,cotterpl,3,0.00069,60189,13.89379,433208
4171,coulof,3,0.00069,60192,13.89448,433208
4172,Cr4fter,3,0.00069,60195,13.89517,433208
4173,crackcomm,3,0.00069,60198,13.89587,433208
4174,craigtmoore,3,0.00069,60201,13.89656,433208
4175,cro,3,0.00069,60204,13.89725,433208
4176,croman-skyhook,3,0.00069,60207,13.89794,433208
4177,croziere,3,0.00069,60210,13.89864,433208
4178,csonp,3,0.00069,60213,13.89933,433208
4179,ctison,3,0.00069,60216,13.90002,433208
4180,cujeff09,3,0.00069,60219,13.90071,433208
4181,cvalla,3,0.00069,60222,13.90141,433208
4182,cvvz,3,0.00069,60225,13.90210,433208
4183,cwells,3,0.00069,60228,13.90279,433208
4184,cwurm,3,0.00069,60231,13.90348,433208
4185,CYBERBUGJR,3,0.00069,60234,13.90418,433208
4186,cyran-ryan,3,0.00069,60237,13.90487,433208
4187,czardien,3,0.00069,60240,13.90556,433208
4188,CzarMich,3,0.00069,60243,13.90625,433208
4189,czs1993,3,0.00069,60246,13.90695,433208
4190,D3N14L,3,0.00069,60249,13.90764,433208
4191,Da5-Id,3,0.00069,60252,13.90833,433208
4192,daaain,3,0.00069,60255,13.90902,433208
4193,dabeck,3,0.00069,60258,13.90972,433208
4194,dabernie,3,0.00069,60261,13.91041,433208
4195,daftping,3,0.00069,60264,13.91110,433208
4196,dahoum,3,0.00069,60267,13.91179,433208
4197,dakele123,3,0.00069,60270,13.91249,433208
4198,dalejrodriguez,3,0.00069,60273,13.91318,433208
4199,dand0h,3,0.00069,60276,13.91387,433208
4200,DanHam,3,0.00069,60279,13.91456,433208
4201,danielcb,3,0.00069,60282,13.91526,433208
4202,danielkwinsor,3,0.00069,60285,13.91595,433208
4203,DanielZhangQD,3,0.00069,60288,13.91664,433208
4204,daniv-msft,3,0.00069,60291,13.91733,433208
4205,danmarcab,3,0.00069,60294,13.91803,433208
4206,danoh-recurly,3,0.00069,60297,13.91872,433208
4207,dansotirakis,3,0.00069,60300,13.91941,433208
4208,darkphoenix,3,0.00069,60303,13.92010,433208
4209,darthvader2,3,0.00069,60306,13.92080,433208
4210,dastbe,3,0.00069,60309,13.92149,433208
4211,davidamitchell,3,0.00069,60312,13.92218,433208
4212,davidbalazs,3,0.00069,60315,13.92287,433208
4213,davidchieregato,3,0.00069,60318,13.92357,433208
4214,DavidGrinberg,3,0.00069,60321,13.92426,433208
4215,david-kirby,3,0.00069,60324,13.92495,433208
4216,davidor,3,0.00069,60327,13.92564,433208
4217,Daxcor69,3,0.00069,60330,13.92634,433208
4218,Daych,3,0.00069,60333,13.92703,433208
4219,da-z,3,0.00069,60336,13.92772,433208
4220,dbevan-kabam,3,0.00069,60339,13.92841,433208
4221,dblackhall-tyro,3,0.00069,60342,13.92911,433208
4222,dbpolito,3,0.00069,60345,13.92980,433208
4223,dbsanfte,3,0.00069,60348,13.93049,433208
4224,DcardosoJS,3,0.00069,60351,13.93118,433208
4225,DeadZen,3,0.00069,60354,13.93188,433208
4226,deichhuhn,3,0.00069,60357,13.93257,433208
4227,dejoost,3,0.00069,60360,13.93326,433208
4228,dench201-cool,3,0.00069,60363,13.93395,433208
4229,dengalebr,3,0.00069,60366,13.93465,433208
4230,denistom,3,0.00069,60369,13.93534,433208
4231,depeele,3,0.00069,60372,13.93603,433208
4232,design365,3,0.00069,60375,13.93672,433208
4233,dev-e,3,0.00069,60378,13.93742,433208
4234,develar,3,0.00069,60381,13.93811,433208
4235,devil-cyber,3,0.00069,60384,13.93880,433208
4236,DevNMY,3,0.00069,60387,13.93949,433208
4237,dgajendran,3,0.00069,60390,13.94019,433208
4238,dhananshan,3,0.00069,60393,13.94088,433208
4239,dharmaanu,3,0.00069,60396,13.94157,433208
4240,dheerajinganti,3,0.00069,60399,13.94226,433208
4241,dhemeier,3,0.00069,60402,13.94296,433208
4242,dhouhamaa,3,0.00069,60405,13.94365,433208
4243,dhrn,3,0.00069,60408,13.94434,433208
4244,diamantisk,3,0.00069,60411,13.94503,433208
4245,digiserg,3,0.00069,60414,13.94573,433208
4246,dineshudayakumar,3,0.00069,60417,13.94642,433208
4247,DiogoMajela,3,0.00069,60420,13.94711,433208
4248,DirtySoc,3,0.00069,60423,13.94780,433208
4249,DisaPadla,3,0.00069,60426,13.94850,433208
4250,disposab1e,3,0.00069,60429,13.94919,433208
4251,Divechatofik,3,0.00069,60432,13.94988,433208
4252,divramod,3,0.00069,60435,13.95057,433208
4253,djj0809,3,0.00069,60438,13.95127,433208
4254,dkruyt,3,0.00069,60441,13.95196,433208
4255,dlbas,3,0.00069,60444,13.95265,433208
4256,dlumpp,3,0.00069,60447,13.95334,433208
4257,dm0610,3,0.00069,60450,13.95404,433208
4258,dmaixner,3,0.00069,60453,13.95473,433208
4259,dmitrievav,3,0.00069,60456,13.95542,433208
4260,dmoore62,3,0.00069,60459,13.95611,433208
4261,DMXGuru,3,0.00069,60462,13.95681,433208
4262,dmxlsj,3,0.00069,60465,13.95750,433208
4263,dohnuts,3,0.00069,60468,13.95819,433208
4264,dokterbob,3,0.00069,60471,13.95888,433208
4265,dolv,3,0.00069,60474,13.95958,433208
4266,domrod,3,0.00069,60477,13.96027,433208
4267,donataso,3,0.00069,60480,13.96096,433208
4268,dondreytaylor,3,0.00069,60483,13.96165,433208
4269,dongyu,3,0.00069,60486,13.96235,433208
4270,donovanmuller,3,0.00069,60489,13.96304,433208
4271,dooleyb1,3,0.00069,60492,13.96373,433208
4272,doruksonmez,3,0.00069,60495,13.96442,433208
4273,Dorye123,3,0.00069,60498,13.96512,433208
4274,doug-fish,3,0.00069,60501,13.96581,433208
4275,dreemkiller,3,0.00069,60504,13.96650,433208
4276,drewboswell,3,0.00069,60507,13.96719,433208
4277,dricoco,3,0.00069,60510,13.96789,433208
4278,DrMcTaco,3,0.00069,60513,13.96858,433208
4279,droopy4096,3,0.00069,60516,13.96927,433208
4280,Drugoy,3,0.00069,60519,13.96996,433208
4281,DrumSergio,3,0.00069,60522,13.97066,433208
4282,dudicoco,3,0.00069,60525,13.97135,433208
4283,Dulanic,3,0.00069,60528,13.97204,433208
4284,dustyhorizon,3,0.00069,60531,13.97273,433208
4285,duyquoc124,3,0.00069,60534,13.97343,433208
4286,dwdraju,3,0.00069,60537,13.97412,433208
4287,Dzhan85,3,0.00069,60540,13.97481,433208
4288,EaconTang,3,0.00069,60543,13.97550,433208
4289,eas5,3,0.00069,60546,13.97620,433208
4290,easel,3,0.00069,60549,13.97689,433208
4291,edmeister,3,0.00069,60552,13.97758,433208
4292,edrickwong,3,0.00069,60555,13.97827,433208
4293,eestewart,3,0.00069,60558,13.97897,433208
4294,efotopoulou,3,0.00069,60561,13.97966,433208
4295,egranata,3,0.00069,60564,13.98035,433208
4296,ehbello,3,0.00069,60567,13.98104,433208
4297,ejimz,3,0.00069,60570,13.98174,433208
4298,ekanai,3,0.00069,60573,13.98243,433208
4299,ekuusi,3,0.00069,60576,13.98312,433208
4300,Elegant996,3,0.00069,60579,13.98381,433208
4301,eleventigerssc,3,0.00069,60582,13.98451,433208
4302,elfring,3,0.00069,60585,13.98520,433208
4303,ellenemerson,3,0.00069,60588,13.98589,433208
4304,elliotfehr,3,0.00069,60591,13.98658,433208
4305,ellisvalentiner,3,0.00069,60594,13.98728,433208
4306,elonzh,3,0.00069,60597,13.98797,433208
4307,eloucks,3,0.00069,60600,13.98866,433208
4308,elrob,3,0.00069,60603,13.98935,433208
4309,eltalkarim,3,0.00069,60606,13.99005,433208
4310,emcay,3,0.00069,60609,13.99074,433208
4311,emilwangaa,3,0.00069,60612,13.99143,433208
4312,engyishere,3,0.00069,60615,13.99212,433208
4313,ericgomes56,3,0.00069,60618,13.99282,433208
4314,ericlin0101,3,0.00069,60621,13.99351,433208
4315,ErroKokkarda,3,0.00069,60624,13.99420,433208
4316,eseokoh,3,0.00069,60627,13.99489,433208
4317,eshepelyuk,3,0.00069,60630,13.99559,433208
4318,EStork09,3,0.00069,60633,13.99628,433208
4319,eugenekainara,3,0.00069,60636,13.99697,433208
4320,evgmoskalenko,3,0.00069,60639,13.99766,433208
4321,evildevel,3,0.00069,60642,13.99836,433208
4322,evilrussian,3,0.00069,60645,13.99905,433208
4323,fabb,3,0.00069,60648,13.99974,433208
4324,FabianHippmann,3,0.00069,60651,14.00043,433208
4325,falzm,3,0.00069,60654,14.00113,433208
4326,FarhadF,3,0.00069,60657,14.00182,433208
4327,farrajota,3,0.00069,60660,14.00251,433208
4328,fbdlampayan,3,0.00069,60663,14.00320,433208
4329,FeargusOG,3,0.00069,60666,14.00390,433208
4330,Fedomn,3,0.00069,60669,14.00459,433208
4331,Feeeenng,3,0.00069,60672,14.00528,433208
4332,feiguoL,3,0.00069,60675,14.00597,433208
4333,ffjia,3,0.00069,60678,14.00667,433208
4334,fifofonix,3,0.00069,60681,14.00736,433208
4335,Fil0sOFF,3,0.00069,60684,14.00805,433208
4336,filcoplax,3,0.00069,60687,14.00874,433208
4337,filipdadgar,3,0.00069,60690,14.00944,433208
4338,Firehed,3,0.00069,60693,14.01013,433208
4339,fishcakez,3,0.00069,60696,14.01082,433208
4340,fkaleo,3,0.00069,60699,14.01151,433208
4341,fknipp,3,0.00069,60702,14.01221,433208
4342,flanets,3,0.00069,60705,14.01290,433208
4343,flaviodsr,3,0.00069,60708,14.01359,433208
4344,flo-02-mu,3,0.00069,60711,14.01428,433208
4345,florent-tails,3,0.00069,60714,14.01498,433208
4346,flurreN,3,0.00069,60717,14.01567,433208
4347,flycash,3,0.00069,60720,14.01636,433208
4348,fnikolov,3,0.00069,60723,14.01705,433208
4349,foobaar,3,0.00069,60726,14.01775,433208
4350,ForcemCS,3,0.00069,60729,14.01844,433208
4351,forsberg,3,0.00069,60732,14.01913,433208
4352,foxdalas,3,0.00069,60735,14.01982,433208
4353,franck102,3,0.00069,60738,14.02052,433208
4354,FrankPetrilli,3,0.00069,60741,14.02121,433208
4355,FredM,3,0.00069,60744,14.02190,433208
4356,freegroup,3,0.00069,60747,14.02259,433208
4357,FreeManNumOne,3,0.00069,60750,14.02329,433208
4358,FrelDX,3,0.00069,60753,14.02398,433208
4359,friederbluemle,3,0.00069,60756,14.02467,433208
4360,funzie19,3,0.00069,60759,14.02536,433208
4361,fxgagnon,3,0.00069,60762,14.02606,433208
4362,fxnn,3,0.00069,60765,14.02675,433208
4363,g1stavo,3,0.00069,60768,14.02744,433208
4364,g30rg3-stoica,3,0.00069,60771,14.02813,433208
4365,Gabisonfire,3,0.00069,60774,14.02883,433208
4366,gabrielamartinezatwizeline,3,0.00069,60777,14.02952,433208
4367,gaius-qi,3,0.00069,60780,14.03021,433208
4368,gal-ofir-ms,3,0.00069,60783,14.03090,433208
4369,Ganesh0509,3,0.00069,60786,14.03160,433208
4370,gangadharmgithub,3,0.00069,60789,14.03229,433208
4371,garretwilson,3,0.00069,60792,14.03298,433208
4372,garysdevil,3,0.00069,60795,14.03367,433208
4373,gattytto,3,0.00069,60798,14.03437,433208
4374,g-crocker,3,0.00069,60801,14.03506,433208
4375,Geethree,3,0.00069,60804,14.03575,433208
4376,GeorgeGuo2018,3,0.00069,60807,14.03644,433208
4377,geototti21,3,0.00069,60810,14.03714,433208
4378,geraldnguyen,3,0.00069,60813,14.03783,433208
4379,gerardgorrion,3,0.00069,60816,14.03852,433208
4380,GerbenWelter,3,0.00069,60819,14.03921,433208
4381,gerrith3,3,0.00069,60822,14.03991,433208
4382,ghardin100,3,0.00069,60825,14.04060,433208
4383,gianmarcomurru,3,0.00069,60828,14.04129,433208
4384,Gikkman,3,0.00069,60831,14.04198,433208
4385,giordyb,3,0.00069,60834,14.04268,433208
4386,GiorgioG,3,0.00069,60837,14.04337,433208
4387,GitHanDong,3,0.00069,60840,14.04406,433208
4388,git-heera,3,0.00069,60843,14.04475,433208
4389,githubformichael,3,0.00069,60846,14.04545,433208
4390,github-zic,3,0.00069,60849,14.04614,433208
4391,gj-9lt,3,0.00069,60852,14.04683,433208
4392,gja,3,0.00069,60855,14.04752,433208
4393,glaucimar,3,0.00069,60858,14.04822,433208
4394,glentakahashi,3,0.00069,60861,14.04891,433208
4395,gmcelhoe,3,0.00069,60864,14.04960,433208
4396,Goend,3,0.00069,60867,14.05029,433208
4397,gogineni99,3,0.00069,60870,14.05099,433208
4398,gongx,3,0.00069,60873,14.05168,433208
4399,gontard,3,0.00069,60876,14.05237,433208
4400,GotGit20,3,0.00069,60879,14.05306,433208
4401,gouki777,3,0.00069,60882,14.05376,433208
4402,goyalmayankk,3,0.00069,60885,14.05445,433208
4403,gplessis,3,0.00069,60888,14.05514,433208
4404,gpodevijn,3,0.00069,60891,14.05583,433208
4405,gracedo,3,0.00069,60894,14.05653,433208
4406,GraysonCAdams,3,0.00069,60897,14.05722,433208
4407,gregoryguillou,3,0.00069,60900,14.05791,433208
4408,grey-droid,3,0.00069,60903,14.05860,433208
4409,grig-tar,3,0.00069,60906,14.05930,433208
4410,gs11,3,0.00069,60909,14.05999,433208
4411,GSalah,3,0.00069,60912,14.06068,433208
4412,gtarcoder,3,0.00069,60915,14.06137,433208
4413,GTP95,3,0.00069,60918,14.06207,433208
4414,guidodobboletta,3,0.00069,60921,14.06276,433208
4415,guiguan,3,0.00069,60924,14.06345,433208
4416,guihkx,3,0.00069,60927,14.06414,433208
4417,Gumi22,3,0.00069,60930,14.06484,433208
4418,gupf0719,3,0.00069,60933,14.06553,433208
4419,gutmensch,3,0.00069,60936,14.06622,433208
4420,guusvw,3,0.00069,60939,14.06691,433208
4421,guyellis,3,0.00069,60942,14.06761,433208
4422,guy-frontegg,3,0.00069,60945,14.06830,433208
4423,gw0,3,0.00069,60948,14.06899,433208
4424,gwatts,3,0.00069,60951,14.06968,433208
4425,gyang1129,3,0.00069,60954,14.07038,433208
4426,Haar,3,0.00069,60957,14.07107,433208
4427,habibali95,3,0.00069,60960,14.07176,433208
4428,hacst,3,0.00069,60963,14.07245,433208
4429,haemyung,3,0.00069,60966,14.07315,433208
4430,haimari,3,0.00069,60969,14.07384,433208
4431,haisum,3,0.00069,60972,14.07453,433208
4432,halfmatthalfcat,3,0.00069,60975,14.07522,433208
4433,halvards,3,0.00069,60978,14.07592,433208
4434,hansedong,3,0.00069,60981,14.07661,433208
4435,hargrave81,3,0.00069,60984,14.07730,433208
4436,hari2192,3,0.00069,60987,14.07799,433208
4437,HarryAtMove,3,0.00069,60990,14.07869,433208
4438,harryttd,3,0.00069,60993,14.07938,433208
4439,harshsharma22,3,0.00069,60996,14.08007,433208
4440,harshsingh1002,3,0.00069,60999,14.08076,433208
4441,hawkaa,3,0.00069,61002,14.08146,433208
4442,haymant,3,0.00069,61005,14.08215,433208
4443,hectoralicea,3,0.00069,61008,14.08284,433208
4444,Heiko-san,3,0.00069,61011,14.08353,433208
4445,hellobob,3,0.00069,61014,14.08423,433208
4446,helloworlde,3,0.00069,61017,14.08492,433208
4447,hemalsolgama,3,0.00069,61020,14.08561,433208
4448,hennersz,3,0.00069,61023,14.08630,433208
4449,herter4171,3,0.00069,61026,14.08700,433208
4450,hervelemeur,3,0.00069,61029,14.08769,433208
4451,heyf,3,0.00069,61032,14.08838,433208
4452,hhstu,3,0.00069,61035,14.08907,433208
4453,hickeng,3,0.00069,61038,14.08977,433208
4454,hieu29791,3,0.00069,61041,14.09046,433208
4455,hijerusalem,3,0.00069,61044,14.09115,433208
4456,hinawatts,3,0.00069,61047,14.09185,433208
4457,hktime,3,0.00069,61050,14.09254,433208
4458,Hlorry,3,0.00069,61053,14.09323,433208
4459,hodur,3,0.00069,61056,14.09392,433208
4460,hofmannma,3,0.00069,61059,14.09462,433208
4461,hongfei-cloud,3,0.00069,61062,14.09531,433208
4462,hostalp,3,0.00069,61065,14.09600,433208
4463,hotdawg789,3,0.00069,61068,14.09669,433208
4464,howshit,3,0.00069,61071,14.09739,433208
4465,hpasapp,3,0.00069,61074,14.09808,433208
4466,hpschry,3,0.00069,61077,14.09877,433208
4467,hpthai7,3,0.00069,61080,14.09946,433208
4468,hrobertson,3,0.00069,61083,14.10016,433208
4469,huangqiangxiong,3,0.00069,61086,14.10085,433208
4470,huataihuang,3,0.00069,61089,14.10154,433208
4471,HubbeKing,3,0.00069,61092,14.10223,433208
4472,hubeicaolei,3,0.00069,61095,14.10293,433208
4473,huone1,3,0.00069,61098,14.10362,433208
4474,huqiangjz,3,0.00069,61101,14.10431,433208
4475,hussainsaify,3,0.00069,61104,14.10500,433208
4476,hyperfocus1337,3,0.00069,61107,14.10570,433208
4477,hyt05,3,0.00069,61110,14.10639,433208
4478,hzhou97,3,0.00069,61113,14.10708,433208
4479,iaas365-dev,3,0.00069,61116,14.10777,433208
4480,iamaverrick,3,0.00069,61119,14.10847,433208
4481,icelynjennings,3,0.00069,61122,14.10916,433208
4482,icheikhrouhou,3,0.00069,61125,14.10985,433208
4483,icyxp,3,0.00069,61128,14.11054,433208
4484,igorwwwwwwwwwwwwwwwwwwww,3,0.00069,61131,14.11124,433208
4485,iHalt10,3,0.00069,61134,14.11193,433208
4486,ijelliti,3,0.00069,61137,14.11262,433208
4487,imdhruva,3,0.00069,61140,14.11331,433208
4488,ImgBotApp,3,0.00069,61143,14.11401,433208
4489,imjoseangel,3,0.00069,61146,14.11470,433208
4490,imsazzad,3,0.00069,61149,14.11539,433208
4491,indera-shsp,3,0.00069,61152,14.11608,433208
4492,inoam,3,0.00069,61155,14.11678,433208
4493,InvictusMB,3,0.00069,61158,14.11747,433208
4494,iofik,3,0.00069,61161,14.11816,433208
4495,ioolkos,3,0.00069,61164,14.11885,433208
4496,ipugh-xm,3,0.00069,61167,14.11955,433208
4497,ironhalo,3,0.00069,61170,14.12024,433208
4498,isaccavalcante,3,0.00069,61173,14.12093,433208
4499,isaidashev,3,0.00069,61176,14.12162,433208
4500,isaldana,3,0.00069,61179,14.12232,433208
4501,ishii1648,3,0.00069,61182,14.12301,433208
4502,iskto,3,0.00069,61185,14.12370,433208
4503,islamtaha,3,0.00069,61188,14.12439,433208
4504,itamarsher,3,0.00069,61191,14.12509,433208
4505,ItsJulian,3,0.00069,61194,14.12578,433208
4506,ivanmp91,3,0.00069,61197,14.12647,433208
4507,iwannay,3,0.00069,61200,14.12716,433208
4508,jabdoa2,3,0.00069,61203,14.12786,433208
4509,jacekmackiewicz,3,0.00069,61206,14.12855,433208
4510,jackiemazy,3,0.00069,61209,14.12924,433208
4511,JackSparrowGit,3,0.00069,61212,14.12993,433208
4512,Jacky2,3,0.00069,61215,14.13063,433208
4513,jadelafuente,3,0.00069,61218,14.13132,433208
4514,jaerik,3,0.00069,61221,14.13201,433208
4515,jajalcoding,3,0.00069,61224,14.13270,433208
4516,Jajcoszek,3,0.00069,61227,14.13340,433208
4517,jakesyl,3,0.00069,61230,14.13409,433208
4518,jakob-kr,3,0.00069,61233,14.13478,433208
4519,jakubbujny,3,0.00069,61236,14.13547,433208
4520,james-cccc,3,0.00069,61239,14.13617,433208
4521,Jamlee,3,0.00069,61242,14.13686,433208
4522,JanJakes,3,0.00069,61245,14.13755,433208
4523,jannis-a,3,0.00069,61248,14.13824,433208
4524,janssk1,3,0.00069,61251,14.13894,433208
4525,jaredgorski,3,0.00069,61254,14.13963,433208
4526,jasiustasiu,3,0.00069,61257,14.14032,433208
4527,Jaskaranbir,3,0.00069,61260,14.14101,433208
4528,jasonblanchard,3,0.00069,61263,14.14171,433208
4529,jasongol,3,0.00069,61266,14.14240,433208
4530,jasonmcintosh,3,0.00069,61269,14.14309,433208
4531,jasonstack,3,0.00069,61272,14.14378,433208
4532,jaswdr,3,0.00069,61275,14.14448,433208
4533,JaveriaK,3,0.00069,61278,14.14517,433208
4534,javierfar,3,0.00069,61281,14.14586,433208
4535,Jawenba,3,0.00069,61284,14.14655,433208
4536,jbagdai,3,0.00069,61287,14.14725,433208
4537,jbauerrfid,3,0.00069,61290,14.14794,433208
4538,jcdauchy-moodys,3,0.00069,61293,14.14863,433208
4539,jecnua,3,0.00069,61296,14.14932,433208
4540,jeff1985,3,0.00069,61299,14.15002,433208
4541,jeffdoolittle,3,0.00069,61302,14.15071,433208
4542,jeid64,3,0.00069,61305,14.15140,433208
4543,jemc,3,0.00069,61308,14.15209,433208
4544,jemisonf,3,0.00069,61311,14.15279,433208
4545,jerryhu1234,3,0.00069,61314,14.15348,433208
4546,JerryZhou343,3,0.00069,61317,14.15417,433208
4547,jess-edwards,3,0.00069,61320,14.15486,433208
4548,jeusdi,3,0.00069,61323,14.15556,433208
4549,jevgenimarenkov,3,0.00069,61326,14.15625,433208
4550,jfassad,3,0.00069,61329,14.15694,433208
4551,jgerry2002,3,0.00069,61332,14.15763,433208
4552,JGiola,3,0.00069,61335,14.15833,433208
4553,jgoeres,3,0.00069,61338,14.15902,433208
4554,jhagestedt,3,0.00069,61341,14.15971,433208
4555,jheyduk,3,0.00069,61344,14.16040,433208
4556,jhwbarlow,3,0.00069,61347,14.16110,433208
4557,jiajliu,3,0.00069,61350,14.16179,433208
4558,jiamine,3,0.00069,61353,14.16248,433208
4559,jimersylee,3,0.00069,61356,14.16317,433208
4560,jimethn,3,0.00069,61359,14.16387,433208
4561,jingsam,3,0.00069,61362,14.16456,433208
4562,jirib,3,0.00069,61365,14.16525,433208
4563,jiteshgupta1995,3,0.00069,61368,14.16594,433208
4564,jiyingtk,3,0.00069,61371,14.16664,433208
4565,jjgriego,3,0.00069,61374,14.16733,433208
4566,jkholtzman,3,0.00069,61377,14.16802,433208
4567,jlandowner,3,0.00069,61380,14.16871,433208
4568,j-landru,3,0.00069,61383,14.16941,433208
4569,jleloup,3,0.00069,61386,14.17010,433208
4570,jloehel,3,0.00069,61389,14.17079,433208
4571,jluhrsen,3,0.00069,61392,14.17148,433208
4572,jm241825,3,0.00069,61395,14.17218,433208
4573,jmdangelo,3,0.00069,61398,14.17287,433208
4574,jmzwcn,3,0.00069,61401,14.17356,433208
4575,jnmclarty,3,0.00069,61404,14.17425,433208
4576,jnschaeffer,3,0.00069,61407,14.17495,433208
4577,joaopdelboni,3,0.00069,61410,14.17564,433208
4578,JochenGuck,3,0.00069,61413,14.17633,433208
4579,johanneslarsson,3,0.00069,61416,14.17702,433208
4580,johnegrosjean,3,0.00069,61419,14.17772,433208
4581,johnwmstevens,3,0.00069,61422,14.17841,433208
4582,Jojoooo1,3,0.00069,61425,14.17910,433208
4583,JokerDevops,3,0.00069,61428,14.17979,433208
4584,JonathanRRogers,3,0.00069,61431,14.18049,433208
4585,jon-depop,3,0.00069,61434,14.18118,433208
4586,jonhatallasf,3,0.00069,61437,14.18187,433208
4587,jorgelbg,3,0.00069,61440,14.18256,433208
4588,jorgemansillacriado,3,0.00069,61443,14.18326,433208
4589,josejulio,3,0.00069,61446,14.18395,433208
4590,JoshBroomberg,3,0.00069,61449,14.18464,433208
4591,JoshLove-msft,3,0.00069,61452,14.18533,433208
4592,joshulyne,3,0.00069,61455,14.18603,433208
4593,jotes,3,0.00069,61458,14.18672,433208
4594,jpbelanger-mtl,3,0.00069,61461,14.18741,433208
4595,jpromnam,3,0.00069,61464,14.18810,433208
4596,jrcasso,3,0.00069,61467,14.18880,433208
4597,jsbucy,3,0.00069,61470,14.18949,433208
4598,jskrzypek,3,0.00069,61473,14.19018,433208
4599,js-timbirkett,3,0.00069,61476,14.19087,433208
4600,jstockmi,3,0.00069,61479,14.19157,433208
4601,jsubirat,3,0.00069,61482,14.19226,433208
4602,jtwill98,3,0.00069,61485,14.19295,433208
4603,julesrenaud,3,0.00069,61488,14.19364,433208
4604,julian-alarcon,3,0.00069,61491,14.19434,433208
4605,JulieLily,3,0.00069,61494,14.19503,433208
4606,JulienBreux,3,0.00069,61497,14.19572,433208
4607,julienym,3,0.00069,61500,14.19641,433208
4608,Juriy,3,0.00069,61503,14.19711,433208
4609,justgotthis,3,0.00069,61506,14.19780,433208
4610,justincely,3,0.00069,61509,14.19849,433208
4611,justinfx,3,0.00069,61512,14.19918,433208
4612,jwangyangls,3,0.00069,61515,14.19988,433208
4613,jwitrick,3,0.00069,61518,14.20057,433208
4614,jwulf,3,0.00069,61521,14.20126,433208
4615,jxhsjxhs,3,0.00069,61524,14.20195,433208
4616,jybarnes,3,0.00069,61527,14.20265,433208
4617,jzl9fOmk,3,0.00069,61530,14.20334,433208
4618,kabutz,3,0.00069,61533,14.20403,433208
4619,kadomino,3,0.00069,61536,14.20472,433208
4620,kafai97,3,0.00069,61539,14.20542,433208
4621,kagaya85,3,0.00069,61542,14.20611,433208
4622,kamek-pf,3,0.00069,61545,14.20680,433208
4623,kangshung,3,0.00069,61548,14.20749,433208
4624,kaojunsong,3,0.00069,61551,14.20819,433208
4625,kaparwan,3,0.00069,61554,14.20888,433208
4626,kapilbalwani,3,0.00069,61557,14.20957,433208
4627,karanssj4,3,0.00069,61560,14.21026,433208
4628,karthikeyanVK,3,0.00069,61563,14.21096,433208
4629,KarthikRangaraju,3,0.00069,61566,14.21165,433208
4630,kartik-moolya,3,0.00069,61569,14.21234,433208
4631,kashline-ae,3,0.00069,61572,14.21303,433208
4632,katsuhisa91,3,0.00069,61575,14.21373,433208
4633,kazishafin,3,0.00069,61578,14.21442,433208
4634,kbroos2,3,0.00069,61581,14.21511,433208
4635,kchowdhree,3,0.00069,61584,14.21580,433208
4636,kckipp,3,0.00069,61587,14.21650,433208
4637,keanlee,3,0.00069,61590,14.21719,433208
4638,keikomori,3,0.00069,61593,14.21788,433208
4639,Kerptastic,3,0.00069,61596,14.21857,433208
4640,kevingosse,3,0.00069,61599,14.21927,433208
4641,kevin-shelaga,3,0.00069,61602,14.21996,433208
4642,kevinsmithwrs,3,0.00069,61605,14.22065,433208
4643,kevtheappdev,3,0.00069,61608,14.22134,433208
4644,kewynakshlley,3,0.00069,61611,14.22204,433208
4645,khacminh,3,0.00069,61614,14.22273,433208
4646,khm,3,0.00069,61617,14.22342,433208
4647,kianmeng,3,0.00069,61620,14.22411,433208
4648,killy001,3,0.00069,61623,14.22481,433208
4649,kingaooto,3,0.00069,61626,14.22550,433208
4650,kingdonb,3,0.00069,61629,14.22619,433208
4651,kingkangyu,3,0.00069,61632,14.22688,433208
4652,kingsd041,3,0.00069,61635,14.22758,433208
4653,kintarowins,3,0.00069,61638,14.22827,433208
4654,kishan-patel,3,0.00069,61641,14.22896,433208
4655,kittylyst,3,0.00069,61644,14.22965,433208
4656,kjordy,3,0.00069,61647,14.23035,433208
4657,kkrhdd,3,0.00069,61650,14.23104,433208
4658,kkyuri0419,3,0.00069,61653,14.23173,433208
4659,korenlev,3,0.00069,61656,14.23242,433208
4660,kotlak,3,0.00069,61659,14.23312,433208
4661,koziez,3,0.00069,61662,14.23381,433208
4662,kpiyush17,3,0.00069,61665,14.23450,433208
4663,KPostOffice,3,0.00069,61668,14.23519,433208
4664,kprasad99,3,0.00069,61671,14.23589,433208
4665,Krenair,3,0.00069,61674,14.23658,433208
4666,krezovic,3,0.00069,61677,14.23727,433208
4667,kristelfung,3,0.00069,61680,14.23796,433208
4668,Kristof-Mattei,3,0.00069,61683,14.23866,433208
4669,kritika-singh3,3,0.00069,61686,14.23935,433208
4670,kr-pushpendra,3,0.00069,61689,14.24004,433208
4671,kthomas,3,0.00069,61692,14.24073,433208
4672,kubanowSKY,3,0.00069,61695,14.24143,433208
4673,kubefetch,3,0.00069,61698,14.24212,433208
4674,Kunamatata,3,0.00069,61701,14.24281,433208
4675,kvinayagamoorthy,3,0.00069,61704,14.24350,433208
4676,kwims,3,0.00069,61707,14.24420,433208
4677,L1AN0,3,0.00069,61710,14.24489,433208
4678,l1key0u,3,0.00069,61713,14.24558,433208
4679,lacebal,3,0.00069,61716,14.24627,433208
4680,lacksfish,3,0.00069,61719,14.24697,433208
4681,lahsivjar,3,0.00069,61722,14.24766,433208
4682,laimison,3,0.00069,61725,14.24835,433208
4683,LalexH,3,0.00069,61728,14.24904,433208
4684,lambda2,3,0.00069,61731,14.24974,433208
4685,lambohamp,3,0.00069,61734,14.25043,433208
4686,langlois-michael,3,0.00069,61737,14.25112,433208
4687,LarsAndreasEk,3,0.00069,61740,14.25181,433208
4688,lcotonea,3,0.00069,61743,14.25251,433208
4689,leichengkai,3,0.00069,61746,14.25320,433208
4690,leki75,3,0.00069,61749,14.25389,433208
4691,Lellansin,3,0.00069,61752,14.25458,433208
4692,leo-lb,3,0.00069,61755,14.25528,433208
4693,LeonardAukea,3,0.00069,61758,14.25597,433208
4694,leonsodhi-lf,3,0.00069,61761,14.25666,433208
4695,leowmjw,3,0.00069,61764,14.25735,433208
4696,levin-kelevra,3,0.00069,61767,14.25805,433208
4697,lexsys27,3,0.00069,61770,14.25874,433208
4698,liamsharp,3,0.00069,61773,14.25943,433208
4699,liiling,3,0.00069,61776,14.26012,433208
4700,LiMiToDriGe,3,0.00069,61779,14.26082,433208
4701,linclaus,3,0.00069,61782,14.26151,433208
4702,linecolumn,3,0.00069,61785,14.26220,433208
4703,lining2020,3,0.00069,61788,14.26289,433208
4704,linuxduduniao,3,0.00069,61791,14.26359,433208
4705,linxuyalun,3,0.00069,61794,14.26428,433208
4706,liruishan,3,0.00069,61797,14.26497,433208
4707,lmgnid,3,0.00069,61800,14.26566,433208
4708,loekalive,3,0.00069,61803,14.26636,433208
4709,lonsdale8734,3,0.00069,61806,14.26705,433208
4710,LooJee,3,0.00069,61809,14.26774,433208
4711,lopeg,3,0.00069,61812,14.26843,433208
4712,lossanarch,3,0.00069,61815,14.26913,433208
4713,lpellegr,3,0.00069,61818,14.26982,433208
4714,lthistle,3,0.00069,61821,14.27051,433208
4715,lucioveloso,3,0.00069,61824,14.27120,433208
4716,L-U-C-K-Y,3,0.00069,61827,14.27190,433208
4717,LuluGO,3,0.00069,61830,14.27259,433208
4718,luniHw,3,0.00069,61833,14.27328,433208
4719,lw8008,3,0.00069,61836,14.27397,433208
4720,lxlxok,3,0.00069,61839,14.27467,433208
4721,lych77,3,0.00069,61842,14.27536,433208
4722,lynnaloo,3,0.00069,61845,14.27605,433208
4723,lynx-coding,3,0.00069,61848,14.27674,433208
4724,lynxoid,3,0.00069,61851,14.27744,433208
4725,lyveng,3,0.00069,61854,14.27813,433208
4726,maateen,3,0.00069,61857,14.27882,433208
4727,maciejaszek,3,0.00069,61860,14.27951,433208
4728,maciejqantas,3,0.00069,61863,14.28021,433208
4729,macleanj,3,0.00069,61866,14.28090,433208
4730,madhusudhanjv,3,0.00069,61869,14.28159,433208
4731,maephisto666,3,0.00069,61872,14.28228,433208
4732,mafi81,3,0.00069,61875,14.28298,433208
4733,maghid,3,0.00069,61878,14.28367,433208
4734,magnus-larsson,3,0.00069,61881,14.28436,433208
4735,mahendrabagul,3,0.00069,61884,14.28505,433208
4736,MaheshwarReddyGade,3,0.00069,61887,14.28575,433208
4737,mailbagrahul,3,0.00069,61890,14.28644,433208
4738,mailofapideveloper,3,0.00069,61893,14.28713,433208
4739,maksim-paskal,3,0.00069,61896,14.28782,433208
4740,malmuzaini,3,0.00069,61899,14.28852,433208
4741,maneeshmehra,3,0.00069,61902,14.28921,433208
4742,mannssebastian,3,0.00069,61905,14.28990,433208
4743,mansing2,3,0.00069,61908,14.29059,433208
4744,MAnyKey,3,0.00069,61911,14.29129,433208
4745,mapdegree,3,0.00069,61914,14.29198,433208
4746,marceloavf,3,0.00069,61917,14.29267,433208
4747,marcospereira,3,0.00069,61920,14.29336,433208
4748,mareedez,3,0.00069,61923,14.29406,433208
4749,marekdano,3,0.00069,61926,14.29475,433208
4750,mariadb-zdraganov,3,0.00069,61929,14.29544,433208
4751,marizmendi,3,0.00069,61932,14.29613,433208
4752,mark-grimes,3,0.00069,61935,14.29683,433208
4753,MarkNickeson,3,0.00069,61938,14.29752,433208
4754,marko-k0,3,0.00069,61941,14.29821,433208
4755,markuman,3,0.00069,61944,14.29890,433208
4756,markuscodes1,3,0.00069,61947,14.29960,433208
4757,marlow-h,3,0.00069,61950,14.30029,433208
4758,marmelin,3,0.00069,61953,14.30098,433208
4759,marojor,3,0.00069,61956,14.30167,433208
4760,maros7,3,0.00069,61959,14.30237,433208
4761,MartijnZuijd,3,0.00069,61962,14.30306,433208
4762,MartinEmrich,3,0.00069,61965,14.30375,433208
4763,marty2bell,3,0.00069,61968,14.30444,433208
4764,martyspiewak,3,0.00069,61971,14.30514,433208
4765,mat285,3,0.00069,61974,14.30583,433208
4766,MatasMarko,3,0.00069,61977,14.30652,433208
4767,mate-szalai,3,0.00069,61980,14.30722,433208
4768,mateustanaka,3,0.00069,61983,14.30791,433208
4769,mathnitin,3,0.00069,61986,14.30860,433208
4770,matoszz,3,0.00069,61989,14.30929,433208
4771,mattdowdell,3,0.00069,61992,14.30999,433208
4772,matthewhembree,3,0.00069,61995,14.31068,433208
4773,mattsplats,3,0.00069,61998,14.31137,433208
4774,mavaa,3,0.00069,62001,14.31206,433208
4775,maxclac,3,0.00069,62004,14.31276,433208
4776,maxdevp,3,0.00069,62007,14.31345,433208
4777,mbelsky,3,0.00069,62010,14.31414,433208
4778,mbevc1,3,0.00069,62013,14.31483,433208
4779,mbs-c,3,0.00069,62016,14.31553,433208
4780,McCo0L,3,0.00069,62019,14.31622,433208
4781,mckrl,3,0.00069,62022,14.31691,433208
4782,mcouliba,3,0.00069,62025,14.31760,433208
4783,mdekoster,3,0.00069,62028,14.31830,433208
4784,meh98943,3,0.00069,62031,14.31899,433208
4785,mehmetf,3,0.00069,62034,14.31968,433208
4786,memelet,3,0.00069,62037,14.32037,433208
4787,mendiolaC79,3,0.00069,62040,14.32107,433208
4788,mengjinmm,3,0.00069,62043,14.32176,433208
4789,meticulousCraftman,3,0.00069,62046,14.32245,433208
4790,MexsonFernandes,3,0.00069,62049,14.32314,433208
4791,mezhaka,3,0.00069,62052,14.32384,433208
4792,mfld,3,0.00069,62055,14.32453,433208
4793,mgenov,3,0.00069,62058,14.32522,433208
4794,mgoltzsche,3,0.00069,62061,14.32591,433208
4795,mharini,3,0.00069,62064,14.32661,433208
4796,MichaelHirn,3,0.00069,62067,14.32730,433208
4797,MichaelRFairhurst,3,0.00069,62070,14.32799,433208
4798,michelefa1988,3,0.00069,62073,14.32868,433208
4799,mickael-ange,3,0.00069,62076,14.32938,433208
4800,micktg,3,0.00069,62079,14.33007,433208
4801,microyahoo,3,0.00069,62082,14.33076,433208
4802,midestefanis,3,0.00069,62085,14.33145,433208
4803,miguescri,3,0.00069,62088,14.33215,433208
4804,mikhailknyazev,3,0.00069,62091,14.33284,433208
4805,mikumaycry,3,0.00069,62094,14.33353,433208
4806,miloradtrninic,3,0.00069,62097,14.33422,433208
4807,MilosSlavic,3,0.00069,62100,14.33492,433208
4808,mimeie,3,0.00069,62103,14.33561,433208
4809,mimuret,3,0.00069,62106,14.33630,433208
4810,Minipada,3,0.00069,62109,14.33699,433208
4811,minix,3,0.00069,62112,14.33769,433208
4812,min-zh,3,0.00069,62115,14.33838,433208
4813,miraculixx,3,0.00069,62118,14.33907,433208
4814,mirecl,3,0.00069,62121,14.33976,433208
4815,miro-grapeup,3,0.00069,62124,14.34046,433208
4816,miron9,3,0.00069,62127,14.34115,433208
4817,misberner,3,0.00069,62130,14.34184,433208
4818,mislavcimpersak,3,0.00069,62133,14.34253,433208
4819,mixecan,3,0.00069,62136,14.34323,433208
4820,mjavier2k,3,0.00069,62139,14.34392,433208
4821,mjovanovic0,3,0.00069,62142,14.34461,433208
4822,mk7run,3,0.00069,62145,14.34530,433208
4823,mkjoerg,3,0.00069,62148,14.34600,433208
4824,mkuendig,3,0.00069,62151,14.34669,433208
4825,mlevesquedion,3,0.00069,62154,14.34738,433208
4826,mnach,3,0.00069,62157,14.34807,433208
4827,mofolactic,3,0.00069,62160,14.34877,433208
4828,mohammaddvlpr,3,0.00069,62163,14.34946,433208
4829,mohanagandlla,3,0.00069,62166,14.35015,433208
4830,mohanbabugaddam69,3,0.00069,62169,14.35084,433208
4831,mohansitaram,3,0.00069,62172,14.35154,433208
4832,MohdRashid01,3,0.00069,62175,14.35223,433208
4833,monsterxx03,3,0.00069,62178,14.35292,433208
4834,moorepatrick,3,0.00069,62181,14.35361,433208
4835,morremeyer,3,0.00069,62184,14.35431,433208
4836,mo-saeed,3,0.00069,62187,14.35500,433208
4837,motive-ray,3,0.00069,62190,14.35569,433208
4838,motyla,3,0.00069,62193,14.35638,433208
4839,mozai,3,0.00069,62196,14.35708,433208
4840,mper0003,3,0.00069,62199,14.35777,433208
4841,mquilling,3,0.00069,62202,14.35846,433208
4842,MrAmbiG,3,0.00069,62205,14.35915,433208
4843,mrfaizal,3,0.00069,62208,14.35985,433208
4844,MrFloppy,3,0.00069,62211,14.36054,433208
4845,mrmarcsmith,3,0.00069,62214,14.36123,433208
4846,mstarostik,3,0.00069,62217,14.36192,433208
4847,mtatheonly,3,0.00069,62220,14.36262,433208
4848,muench-b1,3,0.00069,62223,14.36331,433208
4849,muhyousri,3,0.00069,62226,14.36400,433208
4850,mvortizr,3,0.00069,62229,14.36469,433208
4851,my1990,3,0.00069,62232,14.36539,433208
4852,mykevinjung,3,0.00069,62235,14.36608,433208
4853,MykolaPelyp-SoftServe,3,0.00069,62238,14.36677,433208
4854,mysticaltech,3,0.00069,62241,14.36746,433208
4855,mzur-hv,3,0.00069,62244,14.36816,433208
4856,nadsat,3,0.00069,62247,14.36885,433208
4857,NagaSamyuktha,3,0.00069,62250,14.36954,433208
4858,nagukothapalli,3,0.00069,62253,14.37023,433208
4859,Naisisor,3,0.00069,62256,14.37093,433208
4860,naivcit,3,0.00069,62259,14.37162,433208
4861,namgizlat,3,0.00069,62262,14.37231,433208
4862,naor2013,3,0.00069,62265,14.37300,433208
4863,NathanBaulch,3,0.00069,62268,14.37370,433208
4864,navkmurthy,3,0.00069,62271,14.37439,433208
4865,ndavidson-pulse,3,0.00069,62274,14.37508,433208
4866,ndemeshchenko,3,0.00069,62277,14.37577,433208
4867,neatherweb,3,0.00069,62280,14.37647,433208
4868,neboduus,3,0.00069,62283,14.37716,433208
4869,Nebojsa92,3,0.00069,62286,14.37785,433208
4870,nee1esh,3,0.00069,62289,14.37854,433208
4871,nehzata,3,0.00069,62292,14.37924,433208
4872,neilschelly,3,0.00069,62295,14.37993,433208
4873,Nelias,3,0.00069,62298,14.38062,433208
4874,nelsonflorez11,3,0.00069,62301,14.38131,433208
4875,neufeldtech,3,0.00069,62304,14.38201,433208
4876,neuliuyin,3,0.00069,62307,14.38270,433208
4877,Neustradamus,3,0.00069,62310,14.38339,433208
4878,Nexus-GT-One,3,0.00069,62313,14.38408,433208
4879,nfickas,3,0.00069,62316,14.38478,433208
4880,nfisher,3,0.00069,62319,14.38547,433208
4881,ngc104,3,0.00069,62322,14.38616,433208
4882,ngetahun,3,0.00069,62325,14.38685,433208
4883,nick-cloudnatix,3,0.00069,62328,14.38755,433208
4884,NICK-DUAN,3,0.00069,62331,14.38824,433208
4885,nicolai92,3,0.00069,62334,14.38893,433208
4886,nightmared,3,0.00069,62337,14.38962,433208
4887,nikals99,3,0.00069,62340,14.39032,433208
4888,nikclayton-dfinity,3,0.00069,62343,14.39101,433208
4889,nikolaistraessle,3,0.00069,62346,14.39170,433208
4890,nilsga,3,0.00069,62349,14.39239,433208
4891,nimamahmoudi,3,0.00069,62352,14.39309,433208
4892,nimi-d,3,0.00069,62355,14.39378,433208
4893,nirroz93,3,0.00069,62358,14.39447,433208
4894,nityanandagohain,3,0.00069,62361,14.39516,433208
4895,NityanDesai,3,0.00069,62364,14.39586,433208
4896,niuyueyang1996,3,0.00069,62367,14.39655,433208
4897,N-lucky,3,0.00069,62370,14.39724,433208
4898,nniehoff,3,0.00069,62373,14.39793,433208
4899,nnz1024,3,0.00069,62376,14.39863,433208
4900,nohaapav,3,0.00069,62379,14.39932,433208
4901,norman-kern,3,0.00069,62382,14.40001,433208
4902,norswap,3,0.00069,62385,14.40070,433208
4903,novalagung,3,0.00069,62388,14.40140,433208
4904,novi,3,0.00069,62391,14.40209,433208
4905,Nowaker,3,0.00069,62394,14.40278,433208
4906,nrutigs,3,0.00069,62397,14.40347,433208
4907,nsvijay04b1,3,0.00069,62400,14.40417,433208
4908,nugored,3,0.00069,62403,14.40486,433208
4909,nunokisc,3,0.00069,62406,14.40555,433208
4910,nvh0412,3,0.00069,62409,14.40624,433208
4911,o0-o0,3,0.00069,62412,14.40694,433208
4912,oana-s,3,0.00069,62415,14.40763,433208
4913,obiesmans,3,0.00069,62418,14.40832,433208
4914,Obleskar,3,0.00069,62421,14.40901,433208
4915,oceaneLonneux,3,0.00069,62424,14.40971,433208
4916,Octateam,3,0.00069,62427,14.41040,433208
4917,offthewall123,3,0.00069,62430,14.41109,433208
4918,ofsaleem,3,0.00069,62433,14.41178,433208
4919,old-code-monkey,3,0.00069,62436,14.41248,433208
4920,olivernadj,3,0.00069,62439,14.41317,433208
4921,OlivierMary,3,0.00069,62442,14.41386,433208
4922,ollipa,3,0.00069,62445,14.41455,433208
4923,omitrowski,3,0.00069,62448,14.41525,433208
4924,onkarganjewar,3,0.00069,62451,14.41594,433208
4925,opensourceonly,3,0.00069,62454,14.41663,433208
4926,oscni,3,0.00069,62457,14.41732,433208
4927,osirisstar-hub,3,0.00069,62460,14.41802,433208
4928,Osuichiro,3,0.00069,62463,14.41871,433208
4929,OuesFa,3,0.00069,62466,14.41940,433208
4930,Overbryd,3,0.00069,62469,14.42009,433208
4931,OvervCW,3,0.00069,62472,14.42079,433208
4932,Owpac,3,0.00069,62475,14.42148,433208
4933,ozerovandrei,3,0.00069,62478,14.42217,433208
4934,ozhuang,3,0.00069,62481,14.42286,433208
4935,pablomg92z,3,0.00069,62484,14.42356,433208
4936,packyzbq,3,0.00069,62487,14.42425,433208
4937,pag6606,3,0.00069,62490,14.42494,433208
4938,pagarwal-tibco,3,0.00069,62493,14.42563,433208
4939,pagdot,3,0.00069,62496,14.42633,433208
4940,page4,3,0.00069,62499,14.42702,433208
4941,paikwiki,3,0.00069,62502,14.42771,433208
4942,pantianying,3,0.00069,62505,14.42840,433208
4943,PapaYofen,3,0.00069,62508,14.42910,433208
4944,papovyr,3,0.00069,62511,14.42979,433208
4945,parberge,3,0.00069,62514,14.43048,433208
4946,paulfairless,3,0.00069,62517,14.43117,433208
4947,paulmchen,3,0.00069,62520,14.43187,433208
4948,paulsinai,3,0.00069,62523,14.43256,433208
4949,pausa,3,0.00069,62526,14.43325,433208
4950,pawpy,3,0.00069,62529,14.43394,433208
4951,Payback159,3,0.00069,62532,14.43464,433208
4952,pburgisser-c2c,3,0.00069,62535,14.43533,433208
4953,peakle,3,0.00069,62538,14.43602,433208
4954,pedjak,3,0.00069,62541,14.43671,433208
4955,peetasan,3,0.00069,62544,14.43741,433208
4956,perkins4j2,3,0.00069,62547,14.43810,433208
4957,perkons,3,0.00069,62550,14.43879,433208
4958,permentmemory,3,0.00069,62553,14.43948,433208
4959,pestebogdan,3,0.00069,62556,14.44018,433208
4960,PeterCorless,3,0.00069,62559,14.44087,433208
4961,PeterJD,3,0.00069,62562,14.44156,433208
4962,petermicuch,3,0.00069,62565,14.44225,433208
4963,petr-motejlek,3,0.00069,62568,14.44295,433208
4964,pgoyal01,3,0.00069,62571,14.44364,433208
4965,phal0r,3,0.00069,62574,14.44433,433208
4966,phamvh,3,0.00069,62577,14.44502,433208
4967,phat1234,3,0.00069,62580,14.44572,433208
4968,philippe-boyd-3r,3,0.00069,62583,14.44641,433208
4969,philjb,3,0.00069,62586,14.44710,433208
4970,phillc,3,0.00069,62589,14.44779,433208
4971,phin1x,3,0.00069,62592,14.44849,433208
4972,phntom,3,0.00069,62595,14.44918,433208
4973,phoenix-bjoern,3,0.00069,62598,14.44987,433208
4974,phpHavok,3,0.00069,62601,14.45056,433208
4975,pianeko,3,0.00069,62604,14.45126,433208
4976,piaoliangkb,3,0.00069,62607,14.45195,433208
4977,pikrzysztof,3,0.00069,62610,14.45264,433208
4978,PinchasLev,3,0.00069,62613,14.45333,433208
4979,pingcrosby,3,0.00069,62616,14.45403,433208
4980,piotrrybicki,3,0.00069,62619,14.45472,433208
4981,pipaliyajaydip,3,0.00069,62622,14.45541,433208
4982,pkorobeinikov-ebt,3,0.00069,62625,14.45610,433208
4983,plusices,3,0.00069,62628,14.45680,433208
4984,plutzilla,3,0.00069,62631,14.45749,433208
4985,pmartin-lvmh,3,0.00069,62634,14.45818,433208
4986,PmcFizz,3,0.00069,62637,14.45887,433208
4987,pm-energid,3,0.00069,62640,14.45957,433208
4988,posteingang,3,0.00069,62643,14.46026,433208
4989,povils,3,0.00069,62646,14.46095,433208
4990,ppiccolo,3,0.00069,62649,14.46164,433208
4991,PQMISSCMP,3,0.00069,62652,14.46234,433208
4992,prairiewolf-by,3,0.00069,62655,14.46303,433208
4993,prakashrj,3,0.00069,62658,14.46372,433208
4994,prakharshreyash15,3,0.00069,62661,14.46441,433208
4995,PranjaliSoni,3,0.00069,62664,14.46511,433208
4996,prathapar,3,0.00069,62667,14.46580,433208
4997,prbprbprb,3,0.00069,62670,14.46649,433208
4998,pretendhigh,3,0.00069,62673,14.46718,433208
4999,princekumar294,3,0.00069,62676,14.46788,433208
5000,probenx,3,0.00069,62679,14.46857,433208
5001,ProZsolt,3,0.00069,62682,14.46926,433208
5002,psarossy,3,0.00069,62685,14.46995,433208
5003,PSjoe,3,0.00069,62688,14.47065,433208
5004,PSTobiasMueller,3,0.00069,62691,14.47134,433208
5005,psykulsk,3,0.00069,62694,14.47203,433208
5006,PureW,3,0.00069,62697,14.47272,433208
5007,Purushotham233,3,0.00069,62700,14.47342,433208
5008,pwang7,3,0.00069,62703,14.47411,433208
5009,qaifshaikh,3,0.00069,62706,14.47480,433208
5010,qhb1001,3,0.00069,62709,14.47549,433208
5011,qian2501,3,0.00069,62712,14.47619,433208
5012,qinghui-xu,3,0.00069,62715,14.47688,433208
5013,qingwave,3,0.00069,62718,14.47757,433208
5014,qinxx108,3,0.00069,62721,14.47826,433208
5015,qlyoung,3,0.00069,62724,14.47896,433208
5016,rachfop,3,0.00069,62727,14.47965,433208
5017,radut,3,0.00069,62730,14.48034,433208
5018,rafael-rosseto,3,0.00069,62733,14.48103,433208
5019,raffis,3,0.00069,62736,14.48173,433208
5020,rafi-greenberg,3,0.00069,62739,14.48242,433208
5021,RagniGarg97,3,0.00069,62742,14.48311,433208
5022,raidancampbell,3,0.00069,62745,14.48380,433208
5023,Rajalakshmi-Girish,3,0.00069,62748,14.48450,433208
5024,rajesh0therascal,3,0.00069,62751,14.48519,433208
5025,RajPathare,3,0.00069,62754,14.48588,433208
5026,rajugpt6-coder,3,0.00069,62757,14.48657,433208
5027,rakhbari,3,0.00069,62760,14.48727,433208
5028,rakshith-ponnappa,3,0.00069,62763,14.48796,433208
5029,rakshit-simha,3,0.00069,62766,14.48865,433208
5030,RamyasreeChakka,3,0.00069,62769,14.48934,433208
5031,RanadeepPolavarapu,3,0.00069,62772,14.49004,433208
5032,randomnoise,3,0.00069,62775,14.49073,433208
5033,Ranguo956,3,0.00069,62778,14.49142,433208
5034,raonadeem,3,0.00069,62781,14.49211,433208
5035,RaptorLjung,3,0.00069,62784,14.49281,433208
5036,raul-te,3,0.00069,62787,14.49350,433208
5037,raveltan,3,0.00069,62790,14.49419,433208
5038,ravens,3,0.00069,62793,14.49488,433208
5039,Ravi19967,3,0.00069,62796,14.49558,433208
5040,rayandas,3,0.00069,62799,14.49627,433208
5041,rbabyuk,3,0.00069,62802,14.49696,433208
5042,rbjorklin,3,0.00069,62805,14.49765,433208
5043,rbkaspr,3,0.00069,62808,14.49835,433208
5044,rbudiharso,3,0.00069,62811,14.49904,433208
5045,rcjsuen,3,0.00069,62814,14.49973,433208
5046,rcontreras-te,3,0.00069,62817,14.50042,433208
5047,rdgacarvalho,3,0.00069,62820,14.50112,433208
5048,reddysrikesh,3,0.00069,62823,14.50181,433208
5049,reinvantveer,3,0.00069,62826,14.50250,433208
5050,remal,3,0.00069,62829,14.50319,433208
5051,renanramos,3,0.00069,62832,14.50389,433208
5052,RenaShahMSFT,3,0.00069,62835,14.50458,433208
5053,reschex,3,0.00069,62838,14.50527,433208
5054,ResDiaryLewis,3,0.00069,62841,14.50596,433208
5055,rez0n,3,0.00069,62844,14.50666,433208
5056,RicCu,3,0.00069,62847,14.50735,433208
5057,rieger-jared,3,0.00069,62850,14.50804,433208
5058,riking,3,0.00069,62853,14.50873,433208
5059,rizekmWWT,3,0.00069,62856,14.50943,433208
5060,rleiwang,3,0.00069,62859,14.51012,433208
5061,rlisewski,3,0.00069,62862,14.51081,433208
5062,rngy,3,0.00069,62865,14.51150,433208
5063,RoadRunnr,3,0.00069,62868,14.51220,433208
5064,robertjahn,3,0.00069,62871,14.51289,433208
5065,robertmujica,3,0.00069,62874,14.51358,433208
5066,robert-redshield,3,0.00069,62877,14.51427,433208
5067,robfig,3,0.00069,62880,14.51497,433208
5068,robgordon89,3,0.00069,62883,14.51566,433208
5069,robinMcA,3,0.00069,62886,14.51635,433208
5070,robin-wayve,3,0.00069,62889,14.51704,433208
5071,robpou,3,0.00069,62892,14.51774,433208
5072,rockholla,3,0.00069,62895,14.51843,433208
5073,rockspore,3,0.00069,62898,14.51912,433208
5074,rodolfo-picoreti,3,0.00069,62901,14.51981,433208
5075,rohitnayak,3,0.00069,62904,14.52051,433208
5076,rojarasigan,3,0.00069,62907,14.52120,433208
5077,rollerd,3,0.00069,62910,14.52189,433208
5078,RomanBurdiuzha,3,0.00069,62913,14.52258,433208
5079,rparvizian-rbx,3,0.00069,62916,14.52328,433208
5080,rtang03,3,0.00069,62919,14.52397,433208
5081,ruanxingbaozi,3,0.00069,62922,14.52466,433208
5082,ruinshe,3,0.00069,62925,14.52536,433208
5083,rushivarun,3,0.00069,62928,14.52605,433208
5084,rutgerbrf,3,0.00069,62931,14.52674,433208
5085,rvakash,3,0.00069,62934,14.52743,433208
5086,rverchere,3,0.00069,62937,14.52813,433208
5087,rvkamath,3,0.00069,62940,14.52882,433208
5088,rvowles,3,0.00069,62943,14.52951,433208
5089,RyanSquared,3,0.00069,62946,14.53020,433208
5090,sab24,3,0.00069,62949,14.53090,433208
5091,sabbatum,3,0.00069,62952,14.53159,433208
5092,saberkan,3,0.00069,62955,14.53228,433208
5093,sagile1,3,0.00069,62958,14.53297,433208
5094,sahilsharma011,3,0.00069,62961,14.53367,433208
5095,saidghamra,3,0.00069,62964,14.53436,433208
5096,saikishore143,3,0.00069,62967,14.53505,433208
5097,saintdle,3,0.00069,62970,14.53574,433208
5098,saintube,3,0.00069,62973,14.53644,433208
5099,saltybaker,3,0.00069,62976,14.53713,433208
5100,Sam123ben,3,0.00069,62979,14.53782,433208
5101,sam-celer,3,0.00069,62982,14.53851,433208
5102,samdulam,3,0.00069,62985,14.53921,433208
5103,samirotiv,3,0.00069,62988,14.53990,433208
5104,Sampson2016,3,0.00069,62991,14.54059,433208
5105,samschlegel,3,0.00069,62994,14.54128,433208
5106,SamuelMarks,3,0.00069,62997,14.54198,433208
5107,sanfx,3,0.00069,63000,14.54267,433208
5108,SanjayVas,3,0.00069,63003,14.54336,433208
5109,sankarshvittal,3,0.00069,63006,14.54405,433208
5110,sanwishe,3,0.00069,63009,14.54475,433208
5111,sarahbx,3,0.00069,63012,14.54544,433208
5112,sarahhenkens,3,0.00069,63015,14.54613,433208
5113,sarunask,3,0.00069,63018,14.54682,433208
5114,sasumaki,3,0.00069,63021,14.54752,433208
5115,satishmane,3,0.00069,63024,14.54821,433208
5116,sbocinec,3,0.00069,63027,14.54890,433208
5117,Schachte,3,0.00069,63030,14.54959,433208
5118,schlueter,3,0.00069,63033,14.55029,433208
5119,schosterbarak,3,0.00069,63036,14.55098,433208
5120,schpliz,3,0.00069,63039,14.55167,433208
5121,SchroterQuentin,3,0.00069,63042,14.55236,433208
5122,schybbkoh,3,0.00069,63045,14.55306,433208
5123,scopej,3,0.00069,63048,14.55375,433208
5124,scottrangerio,3,0.00069,63051,14.55444,433208
5125,scottwallacesh,3,0.00069,63054,14.55513,433208
5126,sdorra,3,0.00069,63057,14.55583,433208
5127,seanmcconkey,3,0.00069,63060,14.55652,433208
5128,seblu,3,0.00069,63063,14.55721,433208
5129,secretandanon,3,0.00069,63066,14.55790,433208
5130,septyy,3,0.00069,63069,14.55860,433208
5131,sergelogvinov,3,0.00069,63072,14.55929,433208
5132,sergioarmgpl,3,0.00069,63075,14.55998,433208
5133,sethjones,3,0.00069,63078,14.56067,433208
5134,sgrzebieta,3,0.00069,63081,14.56137,433208
5135,sguidos,3,0.00069,63084,14.56206,433208
5136,Shahard2,3,0.00069,63087,14.56275,433208
5137,Shakihassan,3,0.00069,63090,14.56344,433208
5138,Shalucik,3,0.00069,63093,14.56414,433208
5139,shamilpd,3,0.00069,63096,14.56483,433208
5140,shankgan,3,0.00069,63099,14.56552,433208
5141,shaonkabir8,3,0.00069,63102,14.56621,433208
5142,shapeofarchitect,3,0.00069,63105,14.56691,433208
5143,ShaPoHun,3,0.00069,63108,14.56760,433208
5144,Sharathnasa,3,0.00069,63111,14.56829,433208
5145,sharmaansh21,3,0.00069,63114,14.56898,433208
5146,sharvii,3,0.00069,63117,14.56968,433208
5147,shashank-k,3,0.00069,63120,14.57037,433208
5148,shashankkoppar,3,0.00069,63123,14.57106,433208
5149,shasti86,3,0.00069,63126,14.57175,433208
5150,shbhshs,3,0.00069,63129,14.57245,433208
5151,shea-hawkins,3,0.00069,63132,14.57314,433208
5152,shellwedance,3,0.00069,63135,14.57383,433208
5153,shmel1k,3,0.00069,63138,14.57452,433208
5154,shreyas-badiger,3,0.00069,63141,14.57522,433208
5155,shreyasHpandya,3,0.00069,63144,14.57591,433208
5156,shuu05,3,0.00069,63147,14.57660,433208
5157,ShuzZzle,3,0.00069,63150,14.57729,433208
5158,ShyamGit01,3,0.00069,63153,14.57799,433208
5159,ShyamPraveenSingh,3,0.00069,63156,14.57868,433208
5160,shyamradhakrishnan,3,0.00069,63159,14.57937,433208
5161,siadat,3,0.00069,63162,14.58006,433208
5162,sidprak,3,0.00069,63165,14.58076,433208
5163,simitt,3,0.00069,63168,14.58145,433208
5164,SimoneFalzone,3,0.00069,63171,14.58214,433208
5165,simontoens,3,0.00069,63174,14.58283,433208
5166,singhswg,3,0.00069,63177,14.58353,433208
5167,sirkkalap,3,0.00069,63180,14.58422,433208
5168,sjoerd-dijkstra,3,0.00069,63183,14.58491,433208
5169,sjohag,3,0.00069,63186,14.58560,433208
5170,sk-,3,0.00069,63189,14.58630,433208
5171,Skaronator,3,0.00069,63192,14.58699,433208
5172,skiptomyliu,3,0.00069,63195,14.58768,433208
5173,skmansfield,3,0.00069,63198,14.58837,433208
5174,sl4dy,3,0.00069,63201,14.58907,433208
5175,sluetze,3,0.00069,63204,14.58976,433208
5176,smacdav,3,0.00069,63207,14.59045,433208
5177,Smith-Anthony-CH,3,0.00069,63210,14.59114,433208
5178,smorel-plenty,3,0.00069,63213,14.59184,433208
5179,smsilva,3,0.00069,63216,14.59253,433208
5180,smuramshetty,3,0.00069,63219,14.59322,433208
5181,smveloso,3,0.00069,63222,14.59391,433208
5182,snahelou,3,0.00069,63225,14.59461,433208
5183,Snake4life,3,0.00069,63228,14.59530,433208
5184,snicoll,3,0.00069,63231,14.59599,433208
5185,snsg,3,0.00069,63234,14.59668,433208
5186,snyderdb,3,0.00069,63237,14.59738,433208
5187,sober-wang,3,0.00069,63240,14.59807,433208
5188,sodabrew,3,0.00069,63243,14.59876,433208
5189,sohamsshah,3,0.00069,63246,14.59945,433208
5190,solidaeon,3,0.00069,63249,14.60015,433208
5191,SomaticIT,3,0.00069,63252,14.60084,433208
5192,sonam1412,3,0.00069,63255,14.60153,433208
5193,SongJiyeon,3,0.00069,63258,14.60222,433208
5194,soopanova,3,0.00069,63261,14.60292,433208
5195,sorenbronsted,3,0.00069,63264,14.60361,433208
5196,sourav-jha,3,0.00069,63267,14.60430,433208
5197,sp0cket,3,0.00069,63270,14.60499,433208
5198,Spartanrohit,3,0.00069,63273,14.60569,433208
5199,spommerening,3,0.00069,63276,14.60638,433208
5200,squidboylan,3,0.00069,63279,14.60707,433208
5201,sreejith421,3,0.00069,63282,14.60776,433208
5202,sreenureddyy,3,0.00069,63285,14.60846,433208
5203,sresthas,3,0.00069,63288,14.60915,433208
5204,srinvasdevop,3,0.00069,63291,14.60984,433208
5205,srirammageswarank,3,0.00069,63294,14.61053,433208
5206,srkunze,3,0.00069,63297,14.61123,433208
5207,ssen13,3,0.00069,63300,14.61192,433208
5208,stanislaw55,3,0.00069,63303,14.61261,433208
5209,STASiAN,3,0.00069,63306,14.61330,433208
5210,stefanhenseler,3,0.00069,63309,14.61400,433208
5211,stephengrice,3,0.00069,63312,14.61469,433208
5212,stephenpope,3,0.00069,63315,14.61538,433208
5213,stevesim101,3,0.00069,63318,14.61607,433208
5214,ston1th,3,0.00069,63321,14.61677,433208
5215,stoneshi-yunify,3,0.00069,63324,14.61746,433208
5216,ststeiger,3,0.00069,63327,14.61815,433208
5217,stuart-mclaren-hpe,3,0.00069,63330,14.61884,433208
5218,Subham-Pratap,3,0.00069,63333,14.61954,433208
5219,sudarshntn,3,0.00069,63336,14.62023,433208
5220,sujil02,3,0.00069,63339,14.62092,433208
5221,sunface,3,0.00069,63342,14.62161,433208
5222,sunlianqiang,3,0.00069,63345,14.62231,433208
5223,sunnoy,3,0.00069,63348,14.62300,433208
5224,sunstonesecure-robert,3,0.00069,63351,14.62369,433208
5225,superlzs0476,3,0.00069,63354,14.62438,433208
5226,supermario1990,3,0.00069,63357,14.62508,433208
5227,surfdog,3,0.00069,63360,14.62577,433208
5228,svdba,3,0.00069,63363,14.62646,433208
5229,swapmat-f5,3,0.00069,63366,14.62715,433208
5230,swisspol,3,0.00069,63369,14.62785,433208
5231,swrap,3,0.00069,63372,14.62854,433208
5232,Sykes-P,3,0.00069,63375,14.62923,433208
5233,Sytten,3,0.00069,63378,14.62992,433208
5234,t3hmrman,3,0.00069,63381,14.63062,433208
5235,taegyunkim,3,0.00069,63384,14.63131,433208
5236,Taehoon-terry-Kim,3,0.00069,63387,14.63200,433208
5237,takyon77,3,0.00069,63390,14.63269,433208
5238,tallaxes,3,0.00069,63393,14.63339,433208
5239,TalZiv,3,0.00069,63396,14.63408,433208
5240,tangyibo,3,0.00069,63399,14.63477,433208
5241,tanjacky,3,0.00069,63402,14.63546,433208
5242,tarun-wadhwa-mmt,3,0.00069,63405,14.63616,433208
5243,taskit-deichhorn,3,0.00069,63408,14.63685,433208
5244,tavin,3,0.00069,63411,14.63754,433208
5245,Tayjahney,3,0.00069,63414,14.63823,433208
5246,TAYTS,3,0.00069,63417,14.63893,433208
5247,tburschka,3,0.00069,63420,14.63962,433208
5248,tcmichael,3,0.00069,63423,14.64031,433208
5249,techknowlogick,3,0.00069,63426,14.64100,433208
5250,Teemoe76,3,0.00069,63429,14.64170,433208
5251,tehbrut,3,0.00069,63432,14.64239,433208
5252,tejaskumark,3,0.00069,63435,14.64308,433208
5253,tejendrab,3,0.00069,63438,14.64377,433208
5254,teoincontatto,3,0.00069,63441,14.64447,433208
5255,Terrones-Oscar,3,0.00069,63444,14.64516,433208
5256,th3n3xtg3n3ration,3,0.00069,63447,14.64585,433208
5257,thedewpoint,3,0.00069,63450,14.64654,433208
5258,ThePumpingLemma,3,0.00069,63453,14.64724,433208
5259,theunisbotha,3,0.00069,63456,14.64793,433208
5260,ThilinaManamgoda,3,0.00069,63459,14.64862,433208
5261,thisismz,3,0.00069,63462,14.64931,433208
5262,thomasrepnik,3,0.00069,63465,14.65001,433208
5263,threestoneliu,3,0.00069,63468,14.65070,433208
5264,thucnd55,3,0.00069,63471,14.65139,433208
5265,TimPansino,3,0.00069,63474,14.65208,433208
5266,timricese,3,0.00069,63477,14.65278,433208
5267,timschneider,3,0.00069,63480,14.65347,433208
5268,tinhkyaw,3,0.00069,63483,14.65416,433208
5269,tkgregory,3,0.00069,63486,14.65485,433208
5270,tkovacs-2,3,0.00069,63489,14.65555,433208
5271,tkukushkin,3,0.00069,63492,14.65624,433208
5272,tkzkno520,3,0.00069,63495,14.65693,433208
5273,Toasterson,3,0.00069,63498,14.65762,433208
5274,tomghuang,3,0.00069,63501,14.65832,433208
5275,tonsV2,3,0.00069,63504,14.65901,433208
5276,tonybaines,3,0.00069,63507,14.65970,433208
5277,tonyC2016,3,0.00069,63510,14.66039,433208
5278,tony-liuliu,3,0.00069,63513,14.66109,433208
5279,trink-ilan,3,0.00069,63516,14.66178,433208
5280,troeger,3,0.00069,63519,14.66247,433208
5281,troodes,3,0.00069,63522,14.66316,433208
5282,tschirmer,3,0.00069,63525,14.66386,433208
5283,tsubasaxZZZ,3,0.00069,63528,14.66455,433208
5284,tulanian,3,0.00069,63531,14.66524,433208
5285,turbanoff,3,0.00069,63534,14.66593,433208
5286,twenzel,3,0.00069,63537,14.66663,433208
5287,twghu,3,0.00069,63540,14.66732,433208
5288,tylergohl,3,0.00069,63543,14.66801,433208
5289,udaymadu,3,0.00069,63546,14.66870,433208
5290,Ufoton,3,0.00069,63549,14.66940,433208
5291,unstubbable,3,0.00069,63552,14.67009,433208
5292,urmet,3,0.00069,63555,14.67078,433208
5293,useiichi,3,0.00069,63558,14.67147,433208
5294,usertree,3,0.00069,63561,14.67217,433208
5295,uveta,3,0.00069,63564,14.67286,433208
5296,v1468k,3,0.00069,63567,14.67355,433208
5297,vab2048,3,0.00069,63570,14.67424,433208
5298,valaymerick,3,0.00069,63573,14.67494,433208
5299,ValeriiVozniuk,3,0.00069,63576,14.67563,433208
5300,valiantljk,3,0.00069,63579,14.67632,433208
5301,varkey,3,0.00069,63582,14.67701,433208
5302,Vashiru,3,0.00069,63585,14.67771,433208
5303,VassoSof,3,0.00069,63588,14.67840,433208
5304,vchitai,3,0.00069,63591,14.67909,433208
5305,vchrisb,3,0.00069,63594,14.67978,433208
5306,Vedrillan,3,0.00069,63597,14.68048,433208
5307,velkhatib,3,0.00069,63600,14.68117,433208
5308,vemod,3,0.00069,63603,14.68186,433208
5309,venkatalolla,3,0.00069,63606,14.68255,433208
5310,venomone,3,0.00069,63609,14.68325,433208
5311,ventifus,3,0.00069,63612,14.68394,433208
5312,vflong,3,0.00069,63615,14.68463,433208
5313,vhuang0501,3,0.00069,63618,14.68532,433208
5314,vibridi,3,0.00069,63621,14.68602,433208
5315,vicmania2007,3,0.00069,63624,14.68671,433208
5316,vidushv,3,0.00069,63627,14.68740,433208
5317,vijayakumarbathini,3,0.00069,63630,14.68809,433208
5318,VijayRod,3,0.00069,63633,14.68879,433208
5319,vikashsurin,3,0.00069,63636,14.68948,433208
5320,vinayGudi,3,0.00069,63639,14.69017,433208
5321,vinayus,3,0.00069,63642,14.69086,433208
5322,vinayvenkat,3,0.00069,63645,14.69156,433208
5323,vincentjocodes,3,0.00069,63648,14.69225,433208
5324,vincentnawrocki,3,0.00069,63651,14.69294,433208
5325,vinnyzhaowenyu,3,0.00069,63654,14.69363,433208
5326,Viperoo,3,0.00069,63657,14.69433,433208
5327,vj98,3,0.00069,63660,14.69502,433208
5328,vkassingh,3,0.00069,63663,14.69571,433208
5329,vladfr,3,0.00069,63666,14.69640,433208
5330,vniche,3,0.00069,63669,14.69710,433208
5331,Vowan,3,0.00069,63672,14.69779,433208
5332,vpsvpnvip,3,0.00069,63675,14.69848,433208
5333,vrabbi,3,0.00069,63678,14.69917,433208
5334,vsellier,3,0.00069,63681,14.69987,433208
5335,Vytiss,3,0.00069,63684,14.70056,433208
5336,waisbrot,3,0.00069,63687,14.70125,433208
5337,wanghq,3,0.00069,63690,14.70194,433208
5338,wasker,3,0.00069,63693,14.70264,433208
5339,wasosa,3,0.00069,63696,14.70333,433208
5340,waterdrop01,3,0.00069,63699,14.70402,433208
5341,wcjohnson,3,0.00069,63702,14.70471,433208
5342,wcs1only,3,0.00069,63705,14.70541,433208
5343,wcurry,3,0.00069,63708,14.70610,433208
5344,weflee,3,0.00069,63711,14.70679,433208
5345,westonplatter,3,0.00069,63714,14.70748,433208
5346,whaber,3,0.00069,63717,14.70818,433208
5347,whuang8,3,0.00069,63720,14.70887,433208
5348,willemodendaal,3,0.00069,63723,14.70956,433208
5349,WillNilges,3,0.00069,63726,14.71025,433208
5350,WillsonHG,3,0.00069,63729,14.71095,433208
5351,windowsrefund,3,0.00069,63732,14.71164,433208
5352,wiperpaul,3,0.00069,63735,14.71233,433208
5353,wireknight,3,0.00069,63738,14.71302,433208
5354,witchbutter,3,0.00069,63741,14.71372,433208
5355,withlin,3,0.00069,63744,14.71441,433208
5356,wjam,3,0.00069,63747,14.71510,433208
5357,wolandr,3,0.00069,63750,14.71579,433208
5358,wolf99,3,0.00069,63753,14.71649,433208
5359,wongdu,3,0.00069,63756,14.71718,433208
5360,wouter2397,3,0.00069,63759,14.71787,433208
5361,wrbbz,3,0.00069,63762,14.71856,433208
5362,wscheele,3,0.00069,63765,14.71926,433208
5363,wshelley,3,0.00069,63768,14.71995,433208
5364,wu105,3,0.00069,63771,14.72064,433208
5365,wuestkamp,3,0.00069,63774,14.72133,433208
5366,wukong1992,3,0.00069,63777,14.72203,433208
5367,wwwlookformetop,3,0.00069,63780,14.72272,433208
5368,WXM99,3,0.00069,63783,14.72341,433208
5369,wym42,3,0.00069,63786,14.72410,433208
5370,wzshiming,3,0.00069,63789,14.72480,433208
5371,x-bytes,3,0.00069,63792,14.72549,433208
5372,xcrezd,3,0.00069,63795,14.72618,433208
5373,XD-DENG,3,0.00069,63798,14.72687,433208
5374,xescugc,3,0.00069,63801,14.72757,433208
5375,XiaoConstantine,3,0.00069,63804,14.72826,433208
5376,xiaopeng-han,3,0.00069,63807,14.72895,433208
5377,xiaozhongliu,3,0.00069,63810,14.72964,433208
5378,Xietaiy,3,0.00069,63813,14.73034,433208
5379,xilu0,3,0.00069,63816,14.73103,433208
5380,XinruZhang,3,0.00069,63819,14.73172,433208
5381,XJangel,3,0.00069,63822,14.73241,433208
5382,xmapst,3,0.00069,63825,14.73311,433208
5383,xring,3,0.00069,63828,14.73380,433208
5384,xsim,3,0.00069,63831,14.73449,433208
5385,xunchangguo,3,0.00069,63834,14.73518,433208
5386,xv-james-d,3,0.00069,63837,14.73588,433208
5387,Xyders,3,0.00069,63840,14.73657,433208
5388,yaa110,3,0.00069,63843,14.73726,433208
5389,yaariyuval,3,0.00069,63846,14.73795,433208
5390,yabetsu93,3,0.00069,63849,14.73865,433208
5391,yahorse,3,0.00069,63852,14.73934,433208
5392,yakirch,3,0.00069,63855,14.74003,433208
5393,yangguoandresolution,3,0.00069,63858,14.74073,433208
5394,YangMuye,3,0.00069,63861,14.74142,433208
5395,YanlongLi,3,0.00069,63864,14.74211,433208
5396,yannalf,3,0.00069,63867,14.74280,433208
5397,yashcho,3,0.00069,63870,14.74350,433208
5398,yassun,3,0.00069,63873,14.74419,433208
5399,yasuflatland-lf,3,0.00069,63876,14.74488,433208
5400,yatinmaan,3,0.00069,63879,14.74557,433208
5401,yborovikov,3,0.00069,63882,14.74627,433208
5402,yeldiRium,3,0.00069,63885,14.74696,433208
5403,yihezkel,3,0.00069,63888,14.74765,433208
5404,yli186,3,0.00069,63891,14.74834,433208
5405,ylz-at,3,0.00069,63894,14.74904,433208
5406,yoms,3,0.00069,63897,14.74973,433208
5407,yonglam,3,0.00069,63900,14.75042,433208
5408,YouAnCao,3,0.00069,63903,14.75111,433208
5409,youzipi,3,0.00069,63906,14.75181,433208
5410,yueliang9527,3,0.00069,63909,14.75250,433208
5411,Yuggupta27,3,0.00069,63912,14.75319,433208
5412,yurivict,3,0.00069,63915,14.75388,433208
5413,Yuriy6735,3,0.00069,63918,14.75458,433208
5414,yuseinishiyama,3,0.00069,63921,14.75527,433208
5415,yuta1979,3,0.00069,63924,14.75596,433208
5416,yuyanto,3,0.00069,63927,14.75665,433208
5417,yuyuvn,3,0.00069,63930,14.75735,433208
5418,yves-vogl,3,0.00069,63933,14.75804,433208
5419,z0r0,3,0.00069,63936,14.75873,433208
5420,ZabbensX,3,0.00069,63939,14.75942,433208
5421,zbrookle,3,0.00069,63942,14.76012,433208
5422,zebraincognito,3,0.00069,63945,14.76081,433208
5423,zebralight,3,0.00069,63948,14.76150,433208
5424,Zelinzky,3,0.00069,63951,14.76219,433208
5425,zhangweidongyyl,3,0.00069,63954,14.76289,433208
5426,zhangwm1987,3,0.00069,63957,14.76358,433208
5427,zhnxin,3,0.00069,63960,14.76427,433208
5428,zhouwenb,3,0.00069,63963,14.76496,433208
5429,ZiQiLN,3,0.00069,63966,14.76566,433208
5430,zming,3,0.00069,63969,14.76635,433208
5431,zongke,3,0.00069,63972,14.76704,433208
5432,zoranpopovic,3,0.00069,63975,14.76773,433208
5433,zs1621,3,0.00069,63978,14.76843,433208
5434,zulhfreelancer,3,0.00069,63981,14.76912,433208
5435,zwangsh,3,0.00069,63984,14.76981,433208
5436,zygiss,3,0.00069,63987,14.77050,433208
5437,zzzkl,3,0.00069,63990,14.77120,433208
5438,0gajun,2,0.00046,63992,14.77166,433208
5439,0x9060,2,0.00046,63994,14.77212,433208
5440,0xa0ax0,2,0.00046,63996,14.77258,433208
5441,0xdabbad00,2,0.00046,63998,14.77304,433208
5442,1053226965,2,0.00046,64000,14.77350,433208
5443,123Manoz,2,0.00046,64002,14.77397,433208
5444,14032,2,0.00046,64004,14.77443,433208
5445,2044smile,2,0.00046,64006,14.77489,433208
5446,21ki,2,0.00046,64008,14.77535,433208
5447,2build,2,0.00046,64010,14.77581,433208
5448,2dev2,2,0.00046,64012,14.77627,433208
5449,3dmagicus,2,0.00046,64014,14.77674,433208
5450,4ndris,2,0.00046,64016,14.77720,433208
5451,4pits,2,0.00046,64018,14.77766,433208
5452,6aKa,2,0.00046,64020,14.77812,433208
5453,a2z-ice,2,0.00046,64022,14.77858,433208
5454,a5a5a9,2,0.00046,64024,14.77904,433208
5455,aaaaahaaaaa,2,0.00046,64026,14.77951,433208
5456,aabrams,2,0.00046,64028,14.77997,433208
5457,aafishman,2,0.00046,64030,14.78043,433208
5458,aakejiang,2,0.00046,64032,14.78089,433208
5459,aaronjheng,2,0.00046,64034,14.78135,433208
5460,aauren,2,0.00046,64036,14.78181,433208
5461,aayushrangwala,2,0.00046,64038,14.78228,433208
5462,AbacusHu,2,0.00046,64040,14.78274,433208
5463,abaehreMC,2,0.00046,64042,14.78320,433208
5464,abangser,2,0.00046,64044,14.78366,433208
5465,abaymar,2,0.00046,64046,14.78412,433208
5466,abinashkd,2,0.00046,64048,14.78458,433208
5467,abuethe,2,0.00046,64050,14.78505,433208
5468,aceqbaceq,2,0.00046,64052,14.78551,433208
5469,acesaro,2,0.00046,64054,14.78597,433208
5470,act28,2,0.00046,64056,14.78643,433208
5471,AdallomRoy,2,0.00046,64058,14.78689,433208
5472,adam-burns,2,0.00046,64060,14.78735,433208
5473,adamegyed,2,0.00046,64062,14.78782,433208
5474,adam-resdiary,2,0.00046,64064,14.78828,433208
5475,Adamseyer,2,0.00046,64066,14.78874,433208
5476,AdamSzendrei,2,0.00046,64068,14.78920,433208
5477,adam-thg,2,0.00046,64070,14.78966,433208
5478,adamzhoul,2,0.00046,64072,14.79012,433208
5479,adasari,2,0.00046,64074,14.79059,433208
5480,addprs,2,0.00046,64076,14.79105,433208
5481,addyess,2,0.00046,64078,14.79151,433208
5482,adeelx,2,0.00046,64080,14.79197,433208
5483,adhaamehab,2,0.00046,64082,14.79243,433208
5484,AdityaJ7,2,0.00046,64084,14.79289,433208
5485,adityakumar48,2,0.00046,64086,14.79336,433208
5486,adityats2020,2,0.00046,64088,14.79382,433208
5487,admilazz,2,0.00046,64090,14.79428,433208
5488,adnan-kamili,2,0.00046,64092,14.79474,433208
5489,adnankobir,2,0.00046,64094,14.79520,433208
5490,adrian555,2,0.00046,64096,14.79566,433208
5491,adriangb,2,0.00046,64098,14.79613,433208
5492,adrian-gierakowski,2,0.00046,64100,14.79659,433208
5493,adriank-convoy,2,0.00046,64102,14.79705,433208
5494,adrijshikhar,2,0.00046,64104,14.79751,433208
5495,AEGQ,2,0.00046,64106,14.79797,433208
5496,aejeet,2,0.00046,64108,14.79843,433208
5497,aekrohn,2,0.00046,64110,14.79890,433208
5498,aendeavor,2,0.00046,64112,14.79936,433208
5499,afadhitya,2,0.00046,64114,14.79982,433208
5500,afeiszli,2,0.00046,64116,14.80028,433208
5501,aflag,2,0.00046,64118,14.80074,433208
5502,AFriemann,2,0.00046,64120,14.80120,433208
5503,aggrand,2,0.00046,64122,14.80167,433208
5504,AghaSaad04,2,0.00046,64124,14.80213,433208
5505,agoallikmaa,2,0.00046,64126,14.80259,433208
5506,agracey,2,0.00046,64128,14.80305,433208
5507,agreatfool,2,0.00046,64130,14.80351,433208
5508,agung-kargo,2,0.00046,64132,14.80397,433208
5509,agustinvinao,2,0.00046,64134,14.80444,433208
5510,ahes,2,0.00046,64136,14.80490,433208
5511,ahmedmahmood153,2,0.00046,64138,14.80536,433208
5512,ai2017,2,0.00046,64140,14.80582,433208
5513,aidan-plenert-macdonald,2,0.00046,64142,14.80628,433208
5514,aido,2,0.00046,64144,14.80674,433208
5515,aido93,2,0.00046,64146,14.80721,433208
5516,aishvaryaps,2,0.00046,64148,14.80767,433208
5517,ajay1206,2,0.00046,64150,14.80813,433208
5518,ajayanaj,2,0.00046,64152,14.80859,433208
5519,ajoysinha,2,0.00046,64154,14.80905,433208
5520,A-Kamaee,2,0.00046,64156,14.80951,433208
5521,AkarshES,2,0.00046,64158,14.80998,433208
5522,akcrisp,2,0.00046,64160,14.81044,433208
5523,akoumjian,2,0.00046,64162,14.81090,433208
5524,akushsky,2,0.00046,64164,14.81136,433208
5525,alanmoment,2,0.00046,64166,14.81182,433208
5526,albertrdixon,2,0.00046,64168,14.81228,433208
5527,AlbinoDrought,2,0.00046,64170,14.81275,433208
5528,alefhar,2,0.00046,64172,14.81321,433208
5529,aleksey005,2,0.00046,64174,14.81367,433208
5530,aleksey-hariton,2,0.00046,64176,14.81413,433208
5531,aleneum,2,0.00046,64178,14.81459,433208
5532,alewitt2,2,0.00046,64180,14.81505,433208
5533,alexakr,2,0.00046,64182,14.81552,433208
5534,AlexanderChen1989,2,0.00046,64184,14.81598,433208
5535,alexanderturner,2,0.00046,64186,14.81644,433208
5536,AlexeiScherbakov,2,0.00046,64188,14.81690,433208
5537,alexklibisz,2,0.00046,64190,14.81736,433208
5538,alexsmith15,2,0.00046,64192,14.81782,433208
5539,AlexZalyalowa,2,0.00046,64194,14.81829,433208
5540,alfsch,2,0.00046,64196,14.81875,433208
5541,algestam,2,0.00046,64198,14.81921,433208
5542,aliaugmenta,2,0.00046,64200,14.81967,433208
5543,alicekop,2,0.00046,64202,14.82013,433208
5544,alireza1371,2,0.00046,64204,14.82059,433208
5545,alisachen,2,0.00046,64206,14.82106,433208
5546,allen-mlnx,2,0.00046,64208,14.82152,433208
5547,aloisio31,2,0.00046,64210,14.82198,433208
5548,AlterGu,2,0.00046,64212,14.82244,433208
5549,alvarodelvalle,2,0.00046,64214,14.82290,433208
5550,AlvinRamoutar,2,0.00046,64216,14.82336,433208
5551,alwaysastudent,2,0.00046,64218,14.82383,433208
5552,alxn,2,0.00046,64220,14.82429,433208
5553,amaheshwari21,2,0.00046,64222,14.82475,433208
5554,amalaruja,2,0.00046,64224,14.82521,433208
5555,AmanMishra1321,2,0.00046,64226,14.82567,433208
5556,amar1728,2,0.00046,64228,14.82613,433208
5557,amatosg,2,0.00046,64230,14.82660,433208
5558,ameir,2,0.00046,64232,14.82706,433208
5559,amiga23,2,0.00046,64234,14.82752,433208
5560,ammario,2,0.00046,64236,14.82798,433208
5561,Amos-85,2,0.00046,64238,14.82844,433208
5562,amr-mokhtar,2,0.00046,64240,14.82890,433208
5563,amrynsky,2,0.00046,64242,14.82937,433208
5564,Anandnatraj,2,0.00046,64244,14.82983,433208
5565,ananya-code,2,0.00046,64246,14.83029,433208
5566,Anda-JasonSu,2,0.00046,64248,14.83075,433208
5567,AndiKu,2,0.00046,64250,14.83121,433208
5568,andizzle,2,0.00046,64252,14.83167,433208
5569,andradedpg,2,0.00046,64254,14.83214,433208
5570,andrecp,2,0.00046,64256,14.83260,433208
5571,andredasilvapinto,2,0.00046,64258,14.83306,433208
5572,andrelugomes,2,0.00046,64260,14.83352,433208
5573,andresb39,2,0.00046,64262,14.83398,433208
5574,AndresBott,2,0.00046,64264,14.83444,433208
5575,AndrewBedscastle,2,0.00046,64266,14.83491,433208
5576,AndrewGearhart,2,0.00046,64268,14.83537,433208
5577,andrisak,2,0.00046,64270,14.83583,433208
5578,andywinslow,2,0.00046,64272,14.83629,433208
5579,angkorthomwdd,2,0.00046,64274,14.83675,433208
5580,angryninja48,2,0.00046,64276,14.83721,433208
5581,angularsen,2,0.00046,64278,14.83768,433208
5582,angwangiot,2,0.00046,64280,14.83814,433208
5583,Anhui-tqhuang,2,0.00046,64282,14.83860,433208
5584,anmol,2,0.00046,64284,14.83906,433208
5585,AnnatarHe,2,0.00046,64286,14.83952,433208
5586,anosmhazo,2,0.00046,64288,14.83998,433208
5587,AnshuTrivedi,2,0.00046,64290,14.84045,433208
5588,an-tex,2,0.00046,64292,14.84091,433208
5589,antonLebiedyntsev,2,0.00046,64294,14.84137,433208
5590,antonsmelyanskiy,2,0.00046,64296,14.84183,433208
5591,anuanju89,2,0.00046,64298,14.84229,433208
5592,anusricorp,2,0.00046,64300,14.84275,433208
5593,anz-ecp,2,0.00046,64302,14.84322,433208
5594,aofekiko,2,0.00046,64304,14.84368,433208
5595,aperkins1310,2,0.00046,64306,14.84414,433208
5596,apr1809,2,0.00046,64308,14.84460,433208
5597,apratina,2,0.00046,64310,14.84506,433208
5598,april4,2,0.00046,64312,14.84552,433208
5599,aquariuslt,2,0.00046,64314,14.84599,433208
5600,arash-bizcover,2,0.00046,64316,14.84645,433208
5601,archi13,2,0.00046,64318,14.84691,433208
5602,argha-c,2,0.00046,64320,14.84737,433208
5603,arghyadip01,2,0.00046,64322,14.84783,433208
5604,AriannaDel,2,0.00046,64324,14.84829,433208
5605,arifwn,2,0.00046,64326,14.84876,433208
5606,arindamdat,2,0.00046,64328,14.84922,433208
5607,arizvisa,2,0.00046,64330,14.84968,433208
5608,arjun024,2,0.00046,64332,14.85014,433208
5609,arjunkendr-e,2,0.00046,64334,14.85060,433208
5610,armandgrillet,2,0.00046,64336,14.85106,433208
5611,arnediekmann,2,0.00046,64338,14.85153,433208
5612,arniraghu,2,0.00046,64340,14.85199,433208
5613,arnovl-kul,2,0.00046,64342,14.85245,433208
5614,arobert-delfingen,2,0.00046,64344,14.85291,433208
5615,arocki7,2,0.00046,64346,14.85337,433208
5616,aromalsbabu,2,0.00046,64348,14.85383,433208
5617,Arpit1496,2,0.00046,64350,14.85430,433208
5618,arren-ru,2,0.00046,64352,14.85476,433208
5619,ArseniiPetrovich,2,0.00046,64354,14.85522,433208
5620,arthuryangcs,2,0.00046,64356,14.85568,433208
5621,ArtusCanisLupus,2,0.00046,64358,14.85614,433208
5622,arul24ar,2,0.00046,64360,14.85660,433208
5623,arunj78,2,0.00046,64362,14.85707,433208
5624,arvin6msd,2,0.00046,64364,14.85753,433208
5625,Arxcis,2,0.00046,64366,14.85799,433208
5626,As9530272755,2,0.00046,64368,14.85845,433208
5627,asaintsever,2,0.00046,64370,14.85891,433208
5628,asbiin,2,0.00046,64372,14.85937,433208
5629,aseovic,2,0.00046,64374,14.85984,433208
5630,asetty,2,0.00046,64376,14.86030,433208
5631,asgoel,2,0.00046,64378,14.86076,433208
5632,asharonbaltazar,2,0.00046,64380,14.86122,433208
5633,Ashish12106,2,0.00046,64382,14.86168,433208
5634,ashish-singh-kr,2,0.00046,64384,14.86214,433208
5635,ashley-3r,2,0.00046,64386,14.86261,433208
5636,asobti,2,0.00046,64388,14.86307,433208
5637,asoltesz,2,0.00046,64390,14.86353,433208
5638,asos-dominicjomaa,2,0.00046,64392,14.86399,433208
5639,AssafKatz3,2,0.00046,64394,14.86445,433208
5640,atantawi,2,0.00046,64396,14.86491,433208
5641,attritionorg,2,0.00046,64398,14.86538,433208
5642,auduny,2,0.00046,64400,14.86584,433208
5643,austincollinpena,2,0.00046,64402,14.86630,433208
5644,AustinSchuh,2,0.00046,64404,14.86676,433208
5645,austin-zhu,2,0.00046,64406,14.86722,433208
5646,auvipy,2,0.00046,64408,14.86768,433208
5647,avadhut007,2,0.00046,64410,14.86815,433208
5648,avbanks,2,0.00046,64412,14.86861,433208
5649,aviorma,2,0.00046,64414,14.86907,433208
5650,aviramha,2,0.00046,64416,14.86953,433208
5651,Awoocado,2,0.00046,64418,14.86999,433208
5652,ayalam26,2,0.00046,64420,14.87045,433208
5653,aychang95,2,0.00046,64422,14.87092,433208
5654,aymenwerg,2,0.00046,64424,14.87138,433208
5655,ayush9000,2,0.00046,64426,14.87184,433208
5656,AyushCoding,2,0.00046,64428,14.87230,433208
5657,ayushnawal,2,0.00046,64430,14.87276,433208
5658,ayushsatyam146,2,0.00046,64432,14.87322,433208
5659,Ayush-Singhal28,2,0.00046,64434,14.87369,433208
5660,azalio,2,0.00046,64436,14.87415,433208
5661,azenk,2,0.00046,64438,14.87461,433208
5662,b10s,2,0.00046,64440,14.87507,433208
5663,bahtou,2,0.00046,64442,14.87553,433208
5664,balasenthil-d,2,0.00046,64444,14.87599,433208
5665,BangShinChul,2,0.00046,64446,14.87646,433208
5666,baojr,2,0.00046,64448,14.87692,433208
5667,bartebor,2,0.00046,64450,14.87738,433208
5668,bartjkdp,2,0.00046,64452,14.87784,433208
5669,BartoszZawadzki,2,0.00046,64454,14.87830,433208
5670,barucoh,2,0.00046,64456,14.87876,433208
5671,bashims,2,0.00046,64458,14.87923,433208
5672,bastienbc,2,0.00046,64460,14.87969,433208
5673,batas,2,0.00046,64462,14.88015,433208
5674,Baykonur,2,0.00046,64464,14.88061,433208
5675,bb3333bb,2,0.00046,64466,14.88107,433208
5676,bbehnke,2,0.00046,64468,14.88153,433208
5677,bbobrov,2,0.00046,64470,14.88200,433208
5678,bcouetil,2,0.00046,64472,14.88246,433208
5679,BcTpe4HbIu,2,0.00046,64474,14.88292,433208
5680,bdomars,2,0.00046,64476,14.88338,433208
5681,bdresser,2,0.00046,64478,14.88384,433208
5682,beelzbozo,2,0.00046,64480,14.88430,433208
5683,benagricola,2,0.00046,64482,14.88477,433208
5684,benemon,2,0.00046,64484,14.88523,433208
5685,BenoitKnecht,2,0.00046,64486,14.88569,433208
5686,bentastic27,2,0.00046,64488,14.88615,433208
5687,Berbe,2,0.00046,64490,14.88661,433208
5688,bergmannf,2,0.00046,64492,14.88708,433208
5689,berlin-ab,2,0.00046,64494,14.88754,433208
5690,berndbausch,2,0.00046,64496,14.88800,433208
5691,betabandido,2,0.00046,64498,14.88846,433208
5692,betermieux,2,0.00046,64500,14.88892,433208
5693,betworks,2,0.00046,64502,14.88938,433208
5694,bgeesaman,2,0.00046,64504,14.88985,433208
5695,bh90210,2,0.00046,64506,14.89031,433208
5696,Bhard27,2,0.00046,64508,14.89077,433208
5697,bibarrav,2,0.00046,64510,14.89123,433208
5698,biels,2,0.00046,64512,14.89169,433208
5699,BikashSingh44,2,0.00046,64514,14.89215,433208
5700,birdkiller,2,0.00046,64516,14.89262,433208
5701,BirgerK,2,0.00046,64518,14.89308,433208
5702,biuboombiuboom,2,0.00046,64520,14.89354,433208
5703,bivald,2,0.00046,64522,14.89400,433208
5704,biwenxu,2,0.00046,64524,14.89446,433208
5705,biyanisuraj,2,0.00046,64526,14.89492,433208
5706,bizso,2,0.00046,64528,14.89539,433208
5707,bjung82,2,0.00046,64530,14.89585,433208
5708,bkc,2,0.00046,64532,14.89631,433208
5709,Blaumer,2,0.00046,64534,14.89677,433208
5710,blessedwithsins,2,0.00046,64536,14.89723,433208
5711,blhagadorn,2,0.00046,64538,14.89769,433208
5712,BLOODButter,2,0.00046,64540,14.89816,433208
5713,bmorelli25,2,0.00046,64542,14.89862,433208
5714,bmv126,2,0.00046,64544,14.89908,433208
5715,bnied,2,0.00046,64546,14.89954,433208
5716,bobotu,2,0.00046,64548,14.90000,433208
5717,bobuntu,2,0.00046,64550,14.90046,433208
5718,bochencwx,2,0.00046,64552,14.90093,433208
5719,bogdan-matei,2,0.00046,64554,14.90139,433208
5720,bo-quan,2,0.00046,64556,14.90185,433208
5721,bor8,2,0.00046,64558,14.90231,433208
5722,bordeuax,2,0.00046,64560,14.90277,433208
5723,borkod,2,0.00046,64562,14.90323,433208
5724,bowang-666,2,0.00046,64564,14.90370,433208
5725,bpaduch,2,0.00046,64566,14.90416,433208
5726,Br0wnHammer,2,0.00046,64568,14.90462,433208
5727,brandonbell,2,0.00046,64570,14.90508,433208
5728,braxtone,2,0.00046,64572,14.90554,433208
5729,brechtvalcke,2,0.00046,64574,14.90600,433208
5730,brettcurtis,2,0.00046,64576,14.90647,433208
5731,brews,2,0.00046,64578,14.90693,433208
5732,brianczapiga,2,0.00046,64580,14.90739,433208
5733,brianwolfe,2,0.00046,64582,14.90785,433208
5734,brointhemix,2,0.00046,64584,14.90831,433208
5735,brucehuynh-ct,2,0.00046,64586,14.90877,433208
5736,Brucius,2,0.00046,64588,14.90924,433208
5737,brylex418,2,0.00046,64590,14.90970,433208
5738,brysonshepherd,2,0.00046,64592,14.91016,433208
5739,bshishir,2,0.00046,64594,14.91062,433208
5740,B-Souty,2,0.00046,64596,14.91108,433208
5741,btsken,2,0.00046,64598,14.91154,433208
5742,bugzyz,2,0.00046,64600,14.91201,433208
5743,bukito-ops,2,0.00046,64602,14.91247,433208
5744,Bunnikins,2,0.00046,64604,14.91293,433208
5745,buptliuwei,2,0.00046,64606,14.91339,433208
5746,buzz-b,2,0.00046,64608,14.91385,433208
5747,bviswana101,2,0.00046,64610,14.91431,433208
5748,bwkerbow,2,0.00046,64612,14.91478,433208
5749,by-maxx,2,0.00046,64614,14.91524,433208
5750,BytesGuy,2,0.00046,64616,14.91570,433208
5751,byteshiva,2,0.00046,64618,14.91616,433208
5752,c100k,2,0.00046,64620,14.91662,433208
5753,cadaats,2,0.00046,64622,14.91708,433208
5754,cakoose,2,0.00046,64624,14.91755,433208
5755,cakuros,2,0.00046,64626,14.91801,433208
5756,camelx1,2,0.00046,64628,14.91847,433208
5757,cameronkerrnz,2,0.00046,64630,14.91893,433208
5758,cannium,2,0.00046,64632,14.91939,433208
5759,canozyurt,2,0.00046,64634,14.91985,433208
5760,CaptainTy,2,0.00046,64636,14.92032,433208
5761,cardil,2,0.00046,64638,14.92078,433208
5762,carlbraganza,2,0.00046,64640,14.92124,433208
5763,carlosdoordash,2,0.00046,64642,14.92170,433208
5764,carlwoodhouse,2,0.00046,64644,14.92216,433208
5765,CarolineTeicher,2,0.00046,64646,14.92262,433208
5766,case,2,0.00046,64648,14.92309,433208
5767,cblackuk,2,0.00046,64650,14.92355,433208
5768,cccs-kevin,2,0.00046,64652,14.92401,433208
5769,ccll,2,0.00046,64654,14.92447,433208
5770,cedarkuo,2,0.00046,64656,14.92493,433208
5771,cedricroijakkers,2,0.00046,64658,14.92539,433208
5772,Cenness,2,0.00046,64660,14.92586,433208
5773,ceteongvanness,2,0.00046,64662,14.92632,433208
5774,cetiberiojr,2,0.00046,64664,14.92678,433208
5775,cfecherolle,2,0.00046,64666,14.92724,433208
5776,cforce,2,0.00046,64668,14.92770,433208
5777,cglacet,2,0.00046,64670,14.92816,433208
5778,ch0mik,2,0.00046,64672,14.92863,433208
5779,ch1771dr0b0,2,0.00046,64674,14.92909,433208
5780,chamilad,2,0.00046,64676,14.92955,433208
5781,CHANDAN2271,2,0.00046,64678,14.93001,433208
5782,ChandrewR,2,0.00046,64680,14.93047,433208
5783,chanduarava,2,0.00046,64682,14.93093,433208
5784,charneykaye,2,0.00046,64684,14.93140,433208
5785,cheloitguy,2,0.00046,64686,14.93186,433208
5786,ChenjunZou,2,0.00046,64688,14.93232,433208
5787,chenxuc,2,0.00046,64690,14.93278,433208
5788,chiehpower,2,0.00046,64692,14.93324,433208
5789,chihaiaalex,2,0.00046,64694,14.93370,433208
5790,choffmeister,2,0.00046,64696,14.93417,433208
5791,choose27,2,0.00046,64698,14.93463,433208
5792,ChoppinBlockParty,2,0.00046,64700,14.93509,433208
5793,chounry,2,0.00046,64702,14.93555,433208
5794,ChrisCooney1,2,0.00046,64704,14.93601,433208
5795,chris-durbin,2,0.00046,64706,14.93647,433208
5796,chrisse74,2,0.00046,64708,14.93694,433208
5797,christhegrand,2,0.00046,64710,14.93740,433208
5798,christophschnabl,2,0.00046,64712,14.93786,433208
5799,chrisw-instaclustr,2,0.00046,64714,14.93832,433208
5800,chudytom,2,0.00046,64716,14.93878,433208
5801,chughts,2,0.00046,64718,14.93924,433208
5802,chuong-dao,2,0.00046,64720,14.93971,433208
5803,cin,2,0.00046,64722,14.94017,433208
5804,cinder-fish,2,0.00046,64724,14.94063,433208
5805,citizenken,2,0.00046,64726,14.94109,433208
5806,cjjb,2,0.00046,64728,14.94155,433208
5807,cjreyn,2,0.00046,64730,14.94201,433208
5808,cjroebuck,2,0.00046,64732,14.94248,433208
5809,ckdarby,2,0.00046,64734,14.94294,433208
5810,ckranz,2,0.00046,64736,14.94340,433208
5811,ClemOzil,2,0.00046,64738,14.94386,433208
5812,click2cloud-vivekg,2,0.00046,64740,14.94432,433208
5813,climent,2,0.00046,64742,14.94478,433208
5814,cloudpea,2,0.00046,64744,14.94525,433208
5815,CLS-CLS,2,0.00046,64746,14.94571,433208
5816,cmars,2,0.00046,64748,14.94617,433208
5817,cmillani,2,0.00046,64750,14.94663,433208
5818,cmontemuino,2,0.00046,64752,14.94709,433208
5819,CN317910,2,0.00046,64754,14.94755,433208
5820,cncal,2,0.00046,64756,14.94802,433208
5821,cnicy,2,0.00046,64758,14.94848,433208
5822,cnuber,2,0.00046,64760,14.94894,433208
5823,cochiseruhulessin,2,0.00046,64762,14.94940,433208
5824,Coconut105,2,0.00046,64764,14.94986,433208
5825,codeanyway11,2,0.00046,64766,14.95032,433208
5826,codeclassifiers,2,0.00046,64768,14.95079,433208
5827,code-pablo2,2,0.00046,64770,14.95125,433208
5828,cometta,2,0.00046,64772,14.95171,433208
5829,comjf,2,0.00046,64774,14.95217,433208
5830,confiq,2,0.00046,64776,14.95263,433208
5831,connect2satz,2,0.00046,64778,14.95309,433208
5832,conradkleinespel,2,0.00046,64780,14.95356,433208
5833,contrerasluisd,2,0.00046,64782,14.95402,433208
5834,coufalja,2,0.00046,64784,14.95448,433208
5835,cp38510,2,0.00046,64786,14.95494,433208
5836,cphl,2,0.00046,64788,14.95540,433208
5837,crak-mmarcoux,2,0.00046,64790,14.95586,433208
5838,crawforde,2,0.00046,64792,14.95633,433208
5839,Crayeth,2,0.00046,64794,14.95679,433208
5840,crazycreak,2,0.00046,64796,14.95725,433208
5841,CrazyMushu,2,0.00046,64798,14.95771,433208
5842,crazytom1988,2,0.00046,64800,14.95817,433208
5843,crsandeep,2,0.00046,64802,14.95863,433208
5844,crudemandarin,2,0.00046,64804,14.95910,433208
5845,cryptoluks,2,0.00046,64806,14.95956,433208
5846,CSberger,2,0.00046,64808,14.96002,433208
5847,cseader,2,0.00046,64810,14.96048,433208
5848,csh995426531,2,0.00046,64812,14.96094,433208
5849,csucu,2,0.00046,64814,14.96140,433208
5850,ctalledo,2,0.00046,64816,14.96187,433208
5851,cten,2,0.00046,64818,14.96233,433208
5852,cthulhu666,2,0.00046,64820,14.96279,433208
5853,ctmuthu,2,0.00046,64822,14.96325,433208
5854,ctr06,2,0.00046,64824,14.96371,433208
5855,cubed-it,2,0.00046,64826,14.96417,433208
5856,cuonglm,2,0.00046,64828,14.96464,433208
5857,cuprumpea,2,0.00046,64830,14.96510,433208
5858,cwtrsld,2,0.00046,64832,14.96556,433208
5859,Cyanopus,2,0.00046,64834,14.96602,433208
5860,Cyn0sure,2,0.00046,64836,14.96648,433208
5861,cypher0n3,2,0.00046,64838,14.96694,433208
5862,cyrilix,2,0.00046,64840,14.96741,433208
5863,cytown,2,0.00046,64842,14.96787,433208
5864,Cytram,2,0.00046,64844,14.96833,433208
5865,czerasz,2,0.00046,64846,14.96879,433208
5866,czysl,2,0.00046,64848,14.96925,433208
5867,D1abloRUS,2,0.00046,64850,14.96971,433208
5868,DaDummy,2,0.00046,64852,14.97018,433208
5869,daganida88,2,0.00046,64854,14.97064,433208
5870,dagorka,2,0.00046,64856,14.97110,433208
5871,daikikatsuragawa,2,0.00046,64858,14.97156,433208
5872,daisuke0131,2,0.00046,64860,14.97202,433208
5873,dal00,2,0.00046,64862,14.97248,433208
5874,dalefwillis,2,0.00046,64864,14.97295,433208
5875,damonbarry,2,0.00046,64866,14.97341,433208
5876,damonkey2,2,0.00046,64868,14.97387,433208
5877,danc,2,0.00046,64870,14.97433,433208
5878,danieleades,2,0.00046,64872,14.97479,433208
5879,danielefranceschi,2,0.00046,64874,14.97525,433208
5880,danielmoore,2,0.00046,64876,14.97572,433208
5881,danielwegener,2,0.00046,64878,14.97618,433208
5882,danijak,2,0.00046,64880,14.97664,433208
5883,daniyalrayn,2,0.00046,64882,14.97710,433208
5884,danmrichards,2,0.00046,64884,14.97756,433208
5885,dano0b,2,0.00046,64886,14.97802,433208
5886,DanOfir,2,0.00046,64888,14.97849,433208
5887,DanSotirakisUol,2,0.00046,64890,14.97895,433208
5888,DanTulovsky,2,0.00046,64892,14.97941,433208
5889,danwey,2,0.00046,64894,14.97987,433208
5890,danylohetmantsev,2,0.00046,64896,14.98033,433208
5891,darjanbogdan,2,0.00046,64898,14.98079,433208
5892,DarkWanderer,2,0.00046,64900,14.98126,433208
5893,darlenya,2,0.00046,64902,14.98172,433208
5894,daroga0002,2,0.00046,64904,14.98218,433208
5895,dasabhisek,2,0.00046,64906,14.98264,433208
5896,datavisorerzuozhou,2,0.00046,64908,14.98310,433208
5897,dave93cab,2,0.00046,64910,14.98356,433208
5898,davenemeth,2,0.00046,64912,14.98403,433208
5899,davidbtucker,2,0.00046,64914,14.98449,433208
5900,Davidde94,2,0.00046,64916,14.98495,433208
5901,daviddetorres,2,0.00046,64918,14.98541,433208
5902,davidknezic,2,0.00046,64920,14.98587,433208
5903,davidrfreeman,2,0.00046,64922,14.98633,433208
5904,davidsbond,2,0.00046,64924,14.98680,433208
5905,davidshen84,2,0.00046,64926,14.98726,433208
5906,davidstrauss,2,0.00046,64928,14.98772,433208
5907,davidwitten,2,0.00046,64930,14.98818,433208
5908,davidxianggao,2,0.00046,64932,14.98864,433208
5909,DavitSo,2,0.00046,64934,14.98910,433208
5910,daxwang,2,0.00046,64936,14.98957,433208
5911,dazdaz,2,0.00046,64938,14.99003,433208
5912,dazoakley,2,0.00046,64940,14.99049,433208
5913,dblate,2,0.00046,64942,14.99095,433208
5914,dcnsakthi,2,0.00046,64944,14.99141,433208
5915,dctrwatson,2,0.00046,64946,14.99187,433208
5916,ddiaz-relativity,2,0.00046,64948,14.99234,433208
5917,ddiiwoong,2,0.00046,64950,14.99280,433208
5918,DdMad,2,0.00046,64952,14.99326,433208
5919,dds-pwr,2,0.00046,64954,14.99372,433208
5920,dds-sysu,2,0.00046,64956,14.99418,433208
5921,De1taE1even,2,0.00046,64958,14.99464,433208
5922,deano91230,2,0.00046,64960,14.99511,433208
5923,deathname,2,0.00046,64962,14.99557,433208
5924,debarshibasak,2,0.00046,64964,14.99603,433208
5925,debop,2,0.00046,64966,14.99649,433208
5926,DebugAgrawal,2,0.00046,64968,14.99695,433208
5927,debugthings,2,0.00046,64970,14.99741,433208
5928,dec14,2,0.00046,64972,14.99788,433208
5929,decaz,2,0.00046,64974,14.99834,433208
5930,deepakkrishnak,2,0.00046,64976,14.99880,433208
5931,deepaksharma17,2,0.00046,64978,14.99926,433208
5932,dellkeji,2,0.00046,64980,14.99972,433208
5933,demcaNative,2,0.00046,64982,15.00018,433208
5934,demiangmz,2,0.00046,64984,15.00065,433208
5935,denisok,2,0.00046,64986,15.00111,433208
5936,Denissa89,2,0.00046,64988,15.00157,433208
5937,DennisdeBest,2,0.00046,64990,15.00203,433208
5938,dennisjac,2,0.00046,64992,15.00249,433208
5939,DennisKehrig,2,0.00046,64994,15.00295,433208
5940,derzufall,2,0.00046,64996,15.00342,433208
5941,DevHan2020,2,0.00046,64998,15.00388,433208
5942,devniel,2,0.00046,65000,15.00434,433208
5943,DevOpserzhao,2,0.00046,65002,15.00480,433208
5944,devopsmd,2,0.00046,65004,15.00526,433208
5945,devopstales,2,0.00046,65006,15.00572,433208
5946,DevsAnon,2,0.00046,65008,15.00619,433208
5947,devSolo,2,0.00046,65010,15.00665,433208
5948,dexterhu,2,0.00046,65012,15.00711,433208
5949,Dhaval08,2,0.00046,65014,15.00757,433208
5950,dhcn,2,0.00046,65016,15.00803,433208
5951,dhirencsharma,2,0.00046,65018,15.00849,433208
5952,dholleran-lendico,2,0.00046,65020,15.00896,433208
5953,DhruvM1994,2,0.00046,65022,15.00942,433208
5954,diazan791,2,0.00046,65024,15.00988,433208
5955,dikaso,2,0.00046,65026,15.01034,433208
5956,dikshant,2,0.00046,65028,15.01080,433208
5957,dilshad18,2,0.00046,65030,15.01126,433208
5958,dimitarKiryakov,2,0.00046,65032,15.01173,433208
5959,dinesh4747,2,0.00046,65034,15.01219,433208
5960,Dinesh-Balakrishnan,2,0.00046,65036,15.01265,433208
5961,DinshKW44,2,0.00046,65038,15.01311,433208
5962,directionless,2,0.00046,65040,15.01357,433208
5963,disconnect3d,2,0.00046,65042,15.01403,433208
5964,disparo13,2,0.00046,65044,15.01450,433208
5965,divyavit,2,0.00046,65046,15.01496,433208
5966,DjangoCalendar,2,0.00046,65048,15.01542,433208
5967,djerraballi,2,0.00046,65050,15.01588,433208
5968,Djiit,2,0.00046,65052,15.01634,433208
5969,djvongola,2,0.00046,65054,15.01680,433208
5970,DKImprowised,2,0.00046,65056,15.01727,433208
5971,dk-lockdown,2,0.00046,65058,15.01773,433208
5972,dkuzmianok-sc,2,0.00046,65060,15.01819,433208
5973,dlandtwing,2,0.00046,65062,15.01865,433208
5974,dlunch,2,0.00046,65064,15.01911,433208
5975,Dmitry1987,2,0.00046,65066,15.01957,433208
5976,dmoiseenko,2,0.00046,65068,15.02004,433208
5977,dnalborczyk,2,0.00046,65070,15.02050,433208
5978,dnbllglm,2,0.00046,65072,15.02096,433208
5979,dntj,2,0.00046,65074,15.02142,433208
5980,docapotamus,2,0.00046,65076,15.02188,433208
5981,dol,2,0.00046,65078,15.02234,433208
5982,dominikmessner,2,0.00046,65080,15.02281,433208
5983,domminiks,2,0.00046,65082,15.02327,433208
5984,DonPerera,2,0.00046,65084,15.02373,433208
5985,dopelsunce,2,0.00046,65086,15.02419,433208
5986,doryanmzr,2,0.00046,65088,15.02465,433208
5987,dotmaster,2,0.00046,65090,15.02511,433208
5988,doublegrey,2,0.00046,65092,15.02558,433208
5989,doug-papenthien-by,2,0.00046,65094,15.02604,433208
5990,douzizuibang,2,0.00046,65096,15.02650,433208
5991,doy,2,0.00046,65098,15.02696,433208
5992,dpennell,2,0.00046,65100,15.02742,433208
5993,dpolicastro,2,0.00046,65102,15.02788,433208
5994,DragonStuff,2,0.00046,65104,15.02835,433208
5995,drazul,2,0.00046,65106,15.02881,433208
5996,Dr-Cox,2,0.00046,65108,15.02927,433208
5997,drehpehs,2,0.00046,65110,15.02973,433208
5998,drewbowering,2,0.00046,65112,15.03019,433208
5999,Drewster727,2,0.00046,65114,15.03066,433208
6000,drodic,2,0.00046,65116,15.03112,433208
6001,dr-shim,2,0.00046,65118,15.03158,433208
6002,drunkirishcoder,2,0.00046,65120,15.03204,433208
6003,dschmo,2,0.00046,65122,15.03250,433208
6004,dsnet,2,0.00046,65124,15.03296,433208
6005,dspruell,2,0.00046,65126,15.03343,433208
6006,dstoreng,2,0.00046,65128,15.03389,433208
6007,dubauski,2,0.00046,65130,15.03435,433208
6008,ducoppa,2,0.00046,65132,15.03481,433208
6009,duguniu85,2,0.00046,65134,15.03527,433208
6010,dujiulun,2,0.00046,65136,15.03573,433208
6011,dumez-k,2,0.00046,65138,15.03620,433208
6012,Dunning-Kruger,2,0.00046,65140,15.03666,433208
6013,dupatel000,2,0.00046,65142,15.03712,433208
6014,dustinrue,2,0.00046,65144,15.03758,433208
6015,duyet,2,0.00046,65146,15.03804,433208
6016,dvattaka,2,0.00046,65148,15.03850,433208
6017,dw250304,2,0.00046,65150,15.03897,433208
6018,dyipon,2,0.00046,65152,15.03943,433208
6019,dykow,2,0.00046,65154,15.03989,433208
6020,DylanLange,2,0.00046,65156,15.04035,433208
6021,eafzali,2,0.00046,65158,15.04081,433208
6022,eamonryan,2,0.00046,65160,15.04127,433208
6023,easy999000,2,0.00046,65162,15.04174,433208
6024,easyCZ,2,0.00046,65164,15.04220,433208
6025,ebcarty,2,0.00046,65166,15.04266,433208
6026,ebdxflr,2,0.00046,65168,15.04312,433208
6027,ecktom,2,0.00046,65170,15.04358,433208
6028,ecourtial,2,0.00046,65172,15.04404,433208
6029,ecusnir,2,0.00046,65174,15.04451,433208
6030,edernucci,2,0.00046,65176,15.04497,433208
6031,edobry,2,0.00046,65178,15.04543,433208
6032,eds-wzc,2,0.00046,65180,15.04589,433208
6033,Eduard-Voiculescu,2,0.00046,65182,15.04635,433208
6034,edwardmoon,2,0.00046,65184,15.04681,433208
6035,egmkang,2,0.00046,65186,15.04728,433208
6036,ehafidi,2,0.00046,65188,15.04774,433208
6037,Ehekatl,2,0.00046,65190,15.04820,433208
6038,ehlesp,2,0.00046,65192,15.04866,433208
6039,eightnoteight,2,0.00046,65194,15.04912,433208
6040,ejacobhayes,2,0.00046,65196,15.04958,433208
6041,Eji4h,2,0.00046,65198,15.05005,433208
6042,ekuric,2,0.00046,65200,15.05051,433208
6043,eladhar,2,0.00046,65202,15.05097,433208
6044,elelel,2,0.00046,65204,15.05143,433208
6045,EliCDavis,2,0.00046,65206,15.05189,433208
6046,elnebuloso,2,0.00046,65208,15.05235,433208
6047,ELTEGANI,2,0.00046,65210,15.05282,433208
6048,Elven-coder,2,0.00046,65212,15.05328,433208
6049,EmilyEmily,2,0.00046,65214,15.05374,433208
6050,emkornfield,2,0.00046,65216,15.05420,433208
6051,emrocha,2,0.00046,65218,15.05466,433208
6052,enajeeb,2,0.00046,65220,15.05512,433208
6053,engnakagawa,2,0.00046,65222,15.05559,433208
6054,enif-lee,2,0.00046,65224,15.05605,433208
6055,EnzoJuan,2,0.00046,65226,15.05651,433208
6056,eox-dev,2,0.00046,65228,15.05697,433208
6057,epicfaace,2,0.00046,65230,15.05743,433208
6058,eric-aops,2,0.00046,65232,15.05789,433208
6059,Eric-CENGN,2,0.00046,65234,15.05836,433208
6060,ericdstein,2,0.00046,65236,15.05882,433208
6061,ericgrings-asapp,2,0.00046,65238,15.05928,433208
6062,eric-heihei,2,0.00046,65240,15.05974,433208
6063,erick-thompson,2,0.00046,65242,15.06020,433208
6064,ericleu,2,0.00046,65244,15.06066,433208
6065,ericrrath,2,0.00046,65246,15.06113,433208
6066,eric-sellers,2,0.00046,65248,15.06159,433208
6067,erlichmen,2,0.00046,65250,15.06205,433208
6068,es1o,2,0.00046,65252,15.06251,433208
6069,eschultz17,2,0.00046,65254,15.06297,433208
6070,Eslamanwar,2,0.00046,65256,15.06343,433208
6071,eternally123,2,0.00046,65258,15.06390,433208
6072,etrochim,2,0.00046,65260,15.06436,433208
6073,eugene-chernyshenko,2,0.00046,65262,15.06482,433208
6074,eugenesotnikov,2,0.00046,65264,15.06528,433208
6075,evanfuller,2,0.00046,65266,15.06574,433208
6076,EvansFW,2,0.00046,65268,15.06620,433208
6077,evguenig,2,0.00046,65270,15.06667,433208
6078,eyakimov-bbg,2,0.00046,65272,15.06713,433208
6079,eyeezzi,2,0.00046,65274,15.06759,433208
6080,f41gh7,2,0.00046,65276,15.06805,433208
6081,f7753,2,0.00046,65278,15.06851,433208
6082,fabquenneville,2,0.00046,65280,15.06897,433208
6083,FaezeAzimi,2,0.00046,65282,15.06944,433208
6084,fagossa,2,0.00046,65284,15.06990,433208
6085,fai555,2,0.00046,65286,15.07036,433208
6086,failytaler,2,0.00046,65288,15.07082,433208
6087,Falconx1000,2,0.00046,65290,15.07128,433208
6088,FallenWarrior2k,2,0.00046,65292,15.07174,433208
6089,FancyXun,2,0.00046,65294,15.07221,433208
6090,fandayrockworld,2,0.00046,65296,15.07267,433208
6091,fanjunwei,2,0.00046,65298,15.07313,433208
6092,fans3210,2,0.00046,65300,15.07359,433208
6093,fantapsody,2,0.00046,65302,15.07405,433208
6094,faraonc,2,0.00046,65304,15.07451,433208
6095,farbgit,2,0.00046,65306,15.07498,433208
6096,farhank3389,2,0.00046,65308,15.07544,433208
6097,farookhus,2,0.00046,65310,15.07590,433208
6098,farooqdevops,2,0.00046,65312,15.07636,433208
6099,faruryo,2,0.00046,65314,15.07682,433208
6100,fashing,2,0.00046,65316,15.07728,433208
6101,fastlorenzo,2,0.00046,65318,15.07775,433208
6102,fckbo,2,0.00046,65320,15.07821,433208
6103,fcrespofastly,2,0.00046,65322,15.07867,433208
6104,fdpeiter,2,0.00046,65324,15.07913,433208
6105,FearTheBadger,2,0.00046,65326,15.07959,433208
6106,felipemouradev,2,0.00046,65328,15.08005,433208
6107,feliu,2,0.00046,65330,15.08052,433208
6108,felixhummel,2,0.00046,65332,15.08098,433208
6109,fengerzh,2,0.00046,65334,15.08144,433208
6110,fengpf,2,0.00046,65336,15.08190,433208
6111,fengyinqiao,2,0.00046,65338,15.08236,433208
6112,ffftwo,2,0.00046,65340,15.08282,433208
6113,fimbulvetr,2,0.00046,65342,15.08329,433208
6114,fjammes,2,0.00046,65344,15.08375,433208
6115,fjcloud,2,0.00046,65346,15.08421,433208
6116,flabatut,2,0.00046,65348,15.08467,433208
6117,flenoir,2,0.00046,65350,15.08513,433208
6118,flowbehappy,2,0.00046,65352,15.08559,433208
6119,flyingfang,2,0.00046,65354,15.08606,433208
6120,fnl,2,0.00046,65356,15.08652,433208
6121,Fossil01,2,0.00046,65358,15.08698,433208
6122,fragkakis,2,0.00046,65360,15.08744,433208
6123,frankdavidcorona,2,0.00046,65362,15.08790,433208
6124,frasercobb,2,0.00046,65364,15.08836,433208
6125,FreeGuwop,2,0.00046,65366,15.08883,433208
6126,freeloyerkick,2,0.00046,65368,15.08929,433208
6127,frelon,2,0.00046,65370,15.08975,433208
6128,friedrich-at-adobe,2,0.00046,65372,15.09021,433208
6129,Frondall,2,0.00046,65374,15.09067,433208
6130,frouioui,2,0.00046,65376,15.09113,433208
6131,Fryuni,2,0.00046,65378,15.09160,433208
6132,fsladkey,2,0.00046,65380,15.09206,433208
6133,FunkyYang,2,0.00046,65382,15.09252,433208
6134,g1bl3t,2,0.00046,65384,15.09298,433208
6135,g9rga,2,0.00046,65386,15.09344,433208
6136,Gabb-c,2,0.00046,65388,15.09390,433208
6137,gaetanars,2,0.00046,65390,15.09437,433208
6138,gajananan,2,0.00046,65392,15.09483,433208
6139,gangyi89,2,0.00046,65394,15.09529,433208
6140,gaobinzhan,2,0.00046,65396,15.09575,433208
6141,gaodan-fang,2,0.00046,65398,15.09621,433208
6142,GaohangPuppy,2,0.00046,65400,15.09667,433208
6143,gaoshuai2020,2,0.00046,65402,15.09714,433208
6144,gaosong030431207,2,0.00046,65404,15.09760,433208
6145,gar0t0,2,0.00046,65406,15.09806,433208
6146,gardnerdev,2,0.00046,65408,15.09852,433208
6147,garimakemwal,2,0.00046,65410,15.09898,433208
6148,gauravachatrath,2,0.00046,65412,15.09944,433208
6149,gaurav-ackotech,2,0.00046,65414,15.09991,433208
6150,GauravTiwarii,2,0.00046,65416,15.10037,433208
6151,gavinshark,2,0.00046,65418,15.10083,433208
6152,gayatri-maker,2,0.00046,65420,15.10129,433208
6153,ge79so,2,0.00046,65422,15.10175,433208
6154,geekette86,2,0.00046,65424,15.10221,433208
6155,GeoffMahugu,2,0.00046,65426,15.10268,433208
6156,GeorgeMac,2,0.00046,65428,15.10314,433208
6157,gerasym,2,0.00046,65430,15.10360,433208
6158,ggogel,2,0.00046,65432,15.10406,433208
6159,ghelyar,2,0.00046,65434,15.10452,433208
6160,gholliday100,2,0.00046,65436,15.10498,433208
6161,ghostiam,2,0.00046,65438,15.10545,433208
6162,ghudgins,2,0.00046,65440,15.10591,433208
6163,gigi-at-zymergen,2,0.00046,65442,15.10637,433208
6164,giladk1221,2,0.00046,65444,15.10683,433208
6165,ginni-gidwani,2,0.00046,65446,15.10729,433208
6166,giovanni-ferrari,2,0.00046,65448,15.10775,433208
6167,gireeshpunathil,2,0.00046,65450,15.10822,433208
6168,githubbot-eric,2,0.00046,65452,15.10868,433208
6169,Gladskih,2,0.00046,65454,15.10914,433208
6170,Glarme,2,0.00046,65456,15.10960,433208
6171,gmale,2,0.00046,65458,15.11006,433208
6172,gmarkley-VI,2,0.00046,65460,15.11052,433208
6173,gmcchessney,2,0.00046,65462,15.11099,433208
6174,GoaMind,2,0.00046,65464,15.11145,433208
6175,gogainda,2,0.00046,65466,15.11191,433208
6176,gogolok,2,0.00046,65468,15.11237,433208
6177,gokussx4,2,0.00046,65470,15.11283,433208
6178,golance-mightydevops,2,0.00046,65472,15.11329,433208
6179,golgoth31,2,0.00046,65474,15.11376,433208
6180,goodspark,2,0.00046,65476,15.11422,433208
6181,Goxiaoy,2,0.00046,65478,15.11468,433208
6182,gp42,2,0.00046,65480,15.11514,433208
6183,gprossliner,2,0.00046,65482,15.11560,433208
6184,gracewang510,2,0.00046,65484,15.11606,433208
6185,gravis,2,0.00046,65486,15.11653,433208
6186,GreaTdANie1,2,0.00046,65488,15.11699,433208
6187,greglanthier,2,0.00046,65490,15.11745,433208
6188,gromgit,2,0.00046,65492,15.11791,433208
6189,grv-trip,2,0.00046,65494,15.11837,433208
6190,gsmith-sas,2,0.00046,65496,15.11883,433208
6191,gturbat,2,0.00046,65498,15.11930,433208
6192,guidoffm,2,0.00046,65500,15.11976,433208
6193,guigo2k,2,0.00046,65502,15.12022,433208
6194,guimou,2,0.00046,65504,15.12068,433208
6195,gumbo2k,2,0.00046,65506,15.12114,433208
6196,guojianyu,2,0.00046,65508,15.12160,433208
6197,guojingcheng,2,0.00046,65510,15.12207,433208
6198,guptamahcl,2,0.00046,65512,15.12253,433208
6199,guyelia,2,0.00046,65514,15.12299,433208
6200,GuyLewin,2,0.00046,65516,15.12345,433208
6201,guzj11,2,0.00046,65518,15.12391,433208
6202,GWillmann,2,0.00046,65520,15.12437,433208
6203,gy-lehel,2,0.00046,65522,15.12484,433208
6204,gyohuangxin,2,0.00046,65524,15.12530,433208
6205,gzur,2,0.00046,65526,15.12576,433208
6206,h3po,2,0.00046,65528,15.12622,433208
6207,h8h,2,0.00046,65530,15.12668,433208
6208,haarchri,2,0.00046,65532,15.12714,433208
6209,haines,2,0.00046,65534,15.12761,433208
6210,hakengineer,2,0.00046,65536,15.12807,433208
6211,hakoerber,2,0.00046,65538,15.12853,433208
6212,hamiltont,2,0.00046,65540,15.12899,433208
6213,hammzaza,2,0.00046,65542,15.12945,433208
6214,hamzabll5858,2,0.00046,65544,15.12991,433208
6215,hanjm,2,0.00046,65546,15.13038,433208
6216,hanjx27,2,0.00046,65548,15.13084,433208
6217,hanxinimm,2,0.00046,65550,15.13130,433208
6218,haojingma,2,0.00046,65552,15.13176,433208
6219,hardvintage,2,0.00046,65554,15.13222,433208
6220,harmdewit,2,0.00046,65556,15.13268,433208
6221,harrisa1,2,0.00046,65558,15.13315,433208
6222,harry671003,2,0.00046,65560,15.13361,433208
6223,harsh4870,2,0.00046,65562,15.13407,433208
6224,harsha-s,2,0.00046,65564,15.13453,433208
6225,harskum,2,0.00046,65566,15.13499,433208
6226,hasan4791,2,0.00046,65568,15.13545,433208
6227,hazemm96,2,0.00046,65570,15.13592,433208
6228,Heath68,2,0.00046,65572,15.13638,433208
6229,hellogdc,2,0.00046,65574,15.13684,433208
6230,helmus,2,0.00046,65576,15.13730,433208
6231,HemantJoshi11,2,0.00046,65578,15.13776,433208
6232,hengyunabc,2,0.00046,65580,15.13822,433208
6233,herbguo,2,0.00046,65582,15.13869,433208
6234,HerHde,2,0.00046,65584,15.13915,433208
6235,herland,2,0.00046,65586,15.13961,433208
6236,herrsergio,2,0.00046,65588,15.14007,433208
6237,herrywen-nanj,2,0.00046,65590,15.14053,433208
6238,heydonovan,2,0.00046,65592,15.14099,433208
6239,hfuss,2,0.00046,65594,15.14146,433208
6240,hfutwangfei,2,0.00046,65596,15.14192,433208
6241,hgliu1985,2,0.00046,65598,15.14238,433208
6242,hhamalai,2,0.00046,65600,15.14284,433208
6243,hi1280,2,0.00046,65602,15.14330,433208
6244,hijamoya,2,0.00046,65604,15.14376,433208
6245,himbeles,2,0.00046,65606,15.14423,433208
6246,himslm01,2,0.00046,65608,15.14469,433208
6247,hinling-sonder,2,0.00046,65610,15.14515,433208
6248,hiraken-w,2,0.00046,65612,15.14561,433208
6249,hiramf,2,0.00046,65614,15.14607,433208
6250,hiroyuki-kamei,2,0.00046,65616,15.14653,433208
6251,hisa-tanaka,2,0.00046,65618,15.14700,433208
6252,hixichen,2,0.00046,65620,15.14746,433208
6253,hjanuschka,2,0.00046,65622,15.14792,433208
6254,H-Kz,2,0.00046,65624,15.14838,433208
6255,hle2,2,0.00046,65626,15.14884,433208
6256,hmsvigle,2,0.00046,65628,15.14930,433208
6257,hmthoo,2,0.00046,65630,15.14977,433208
6258,hnts,2,0.00046,65632,15.15023,433208
6259,hognala,2,0.00046,65634,15.15069,433208
6260,honi,2,0.00046,65636,15.15115,433208
6261,honnix,2,0.00046,65638,15.15161,433208
6262,hopper-signifyd,2,0.00046,65640,15.15207,433208
6263,horovits,2,0.00046,65642,15.15254,433208
6264,houseofcat,2,0.00046,65644,15.15300,433208
6265,hrishikeshnikam2000,2,0.00046,65646,15.15346,433208
6266,hskang9,2,0.00046,65648,15.15392,433208
6267,huangzhiran,2,0.00046,65650,15.15438,433208
6268,huats,2,0.00046,65652,15.15484,433208
6269,hudson741,2,0.00046,65654,15.15531,433208
6270,huide9,2,0.00046,65656,15.15577,433208
6271,hulucc,2,0.00046,65658,15.15623,433208
6272,Humbertzhang,2,0.00046,65660,15.15669,433208
6273,Humza277,2,0.00046,65662,15.15715,433208
6274,hunkeelin,2,0.00046,65664,15.15761,433208
6275,huyutuo,2,0.00046,65666,15.15808,433208
6276,huzhou520,2,0.00046,65668,15.15854,433208
6277,hwacookie,2,0.00046,65670,15.15900,433208
6278,hydave25,2,0.00046,65672,15.15946,433208
6279,hyoung-90,2,0.00046,65674,15.15992,433208
6280,i2dcarrasco,2,0.00046,65676,15.16038,433208
6281,iammuho,2,0.00046,65678,15.16085,433208
6282,iamtheindian,2,0.00046,65680,15.16131,433208
6283,Ianmward,2,0.00046,65682,15.16177,433208
6284,iAnomaly,2,0.00046,65684,15.16223,433208
6285,IanWoods1993,2,0.00046,65686,15.16269,433208
6286,Icedroid,2,0.00046,65688,15.16315,433208
6287,IdanAdar,2,0.00046,65690,15.16362,433208
6288,if6was9,2,0.00046,65692,15.16408,433208
6289,ifilonenko,2,0.00046,65694,15.16454,433208
6290,igcherkaev,2,0.00046,65696,15.16500,433208
6291,iggyvolz,2,0.00046,65698,15.16546,433208
6292,igoratencompass,2,0.00046,65700,15.16592,433208
6293,igorcezar,2,0.00046,65702,15.16639,433208
6294,igorpalant,2,0.00046,65704,15.16685,433208
6295,ikenchina,2,0.00046,65706,15.16731,433208
6296,ikirker,2,0.00046,65708,15.16777,433208
6297,ildikov,2,0.00046,65710,15.16823,433208
6298,ilhaan,2,0.00046,65712,15.16869,433208
6299,imalandu,2,0.00046,65714,15.16916,433208
6300,imgroot1391,2,0.00046,65716,15.16962,433208
6301,imrishabh18,2,0.00046,65718,15.17008,433208
6302,infearOnTheWay,2,0.00046,65720,15.17054,433208
6303,InfluencerNGZK,2,0.00046,65722,15.17100,433208
6304,ing8ar,2,0.00046,65724,15.17146,433208
6305,inistor,2,0.00046,65726,15.17193,433208
6306,insectengine,2,0.00046,65728,15.17239,433208
6307,insidewhy,2,0.00046,65730,15.17285,433208
6308,int3l,2,0.00046,65732,15.17331,433208
6309,ipince,2,0.00046,65734,15.17377,433208
6310,ipochi,2,0.00046,65736,15.17424,433208
6311,Iracinder,2,0.00046,65738,15.17470,433208
6312,irajdip99,2,0.00046,65740,15.17516,433208
6313,irajtaghlidi,2,0.00046,65742,15.17562,433208
6314,irmomanie,2,0.00046,65744,15.17608,433208
6315,irniaxsep,2,0.00046,65746,15.17654,433208
6316,ironhalik,2,0.00046,65748,15.17701,433208
6317,ischenkomari,2,0.00046,65750,15.17747,433208
6318,ishan16696,2,0.00046,65752,15.17793,433208
6319,ishansd94,2,0.00046,65754,15.17839,433208
6320,IsuruDilhan,2,0.00046,65756,15.17885,433208
6321,itchyny,2,0.00046,65758,15.17931,433208
6322,iTechsTR,2,0.00046,65760,15.17978,433208
6323,itninja-hue,2,0.00046,65762,15.18024,433208
6324,its-dave,2,0.00046,65764,15.18070,433208
6325,itsvishu25,2,0.00046,65766,15.18116,433208
6326,ittennull,2,0.00046,65768,15.18162,433208
6327,ivanangelov,2,0.00046,65770,15.18208,433208
6328,ivanfoo,2,0.00046,65772,15.18255,433208
6329,ivangreene,2,0.00046,65774,15.18301,433208
6330,ivanrezic-maistra,2,0.00046,65776,15.18347,433208
6331,ivanthelad,2,0.00046,65778,15.18393,433208
6332,Iverson-lena,2,0.00046,65780,15.18439,433208
6333,iyurev,2,0.00046,65782,15.18485,433208
6334,J0WI,2,0.00046,65784,15.18532,433208
6335,ja8zyjits,2,0.00046,65786,15.18578,433208
6336,jabley,2,0.00046,65788,15.18624,433208
6337,jaceksan,2,0.00046,65790,15.18670,433208
6338,JACKCHEN96,2,0.00046,65792,15.18716,433208
6339,JackieWu1219,2,0.00046,65794,15.18762,433208
6340,jackonelli,2,0.00046,65796,15.18809,433208
6341,jacky12,2,0.00046,65798,15.18855,433208
6342,jackzzj,2,0.00046,65800,15.18901,433208
6343,JacobHenner,2,0.00046,65802,15.18947,433208
6344,jacobhjkim,2,0.00046,65804,15.18993,433208
6345,JadeQin,2,0.00046,65806,15.19039,433208
6346,jagobagascon,2,0.00046,65808,15.19086,433208
6347,jainbhavya65,2,0.00046,65810,15.19132,433208
6348,Jakob3xD,2,0.00046,65812,15.19178,433208
6349,jakupovic,2,0.00046,65814,15.19224,433208
6350,jam0cam,2,0.00046,65816,15.19270,433208
6351,james64,2,0.00046,65818,15.19316,433208
6352,jamesdill,2,0.00046,65820,15.19363,433208
6353,JamesDowning,2,0.00046,65822,15.19409,433208
6354,jamesikanos,2,0.00046,65824,15.19455,433208
6355,jamesstow,2,0.00046,65826,15.19501,433208
6356,jamisonhyatt,2,0.00046,65828,15.19547,433208
6357,Jammicus,2,0.00046,65830,15.19593,433208
6358,jan0ski,2,0.00046,65832,15.19640,433208
6359,janchochol,2,0.00046,65834,15.19686,433208
6360,janotav,2,0.00046,65836,15.19732,433208
6361,jansci621,2,0.00046,65838,15.19778,433208
6362,jaricftw,2,0.00046,65840,15.19824,433208
6363,jarnfast,2,0.00046,65842,15.19870,433208
6364,jarrettprosser,2,0.00046,65844,15.19917,433208
6365,jarsantos,2,0.00046,65846,15.19963,433208
6366,jasonjkeller,2,0.00046,65848,15.20009,433208
6367,JasonMorgan,2,0.00046,65850,15.20055,433208
6368,jasonrogena,2,0.00046,65852,15.20101,433208
6369,jaurestchoffo,2,0.00046,65854,15.20147,433208
6370,javendo,2,0.00046,65856,15.20194,433208
6371,Jaydee94,2,0.00046,65858,15.20240,433208
6372,jaypoulz,2,0.00046,65860,15.20286,433208
6373,JayselDC,2,0.00046,65862,15.20332,433208
6374,jaythamke,2,0.00046,65864,15.20378,433208
6375,JBaltika,2,0.00046,65866,15.20424,433208
6376,jcambronero,2,0.00046,65868,15.20471,433208
6377,jclulow,2,0.00046,65870,15.20517,433208
6378,jcmcken,2,0.00046,65872,15.20563,433208
6379,jcwang84,2,0.00046,65874,15.20609,433208
6380,jdamata,2,0.00046,65876,15.20655,433208
6381,jd-carroll,2,0.00046,65878,15.20701,433208
6382,jddcarreira,2,0.00046,65880,15.20748,433208
6383,jdmaguire,2,0.00046,65882,15.20794,433208
6384,jdomag,2,0.00046,65884,15.20840,433208
6385,jeanfabrice,2,0.00046,65886,15.20886,433208
6386,jeanluclariviere,2,0.00046,65888,15.20932,433208
6387,jederfreitas,2,0.00046,65890,15.20978,433208
6388,jeffspahr,2,0.00046,65892,15.21025,433208
6389,Jenniferstrej,2,0.00046,65894,15.21071,433208
6390,jensfr,2,0.00046,65896,15.21117,433208
6391,jeschkies,2,0.00046,65898,15.21163,433208
6392,Jeskz0rd,2,0.00046,65900,15.21209,433208
6393,Jess3Jane,2,0.00046,65902,15.21255,433208
6394,JessieAMorris,2,0.00046,65904,15.21302,433208
6395,jfb74,2,0.00046,65906,15.21348,433208
6396,JfeedZ,2,0.00046,65908,15.21394,433208
6397,jflaflamme,2,0.00046,65910,15.21440,433208
6398,jfrabaute,2,0.00046,65912,15.21486,433208
6399,jg-26,2,0.00046,65914,15.21532,433208
6400,jgalliers,2,0.00046,65916,15.21579,433208
6401,jgulick48,2,0.00046,65918,15.21625,433208
6402,jharmison-redhat,2,0.00046,65920,15.21671,433208
6403,jhbabon,2,0.00046,65922,15.21717,433208
6404,jheaff1,2,0.00046,65924,15.21763,433208
6405,jhfeng,2,0.00046,65926,15.21809,433208
6406,jhgoodwin,2,0.00046,65928,15.21856,433208
6407,jiacai2050,2,0.00046,65930,15.21902,433208
6408,jiafujiang,2,0.00046,65932,15.21948,433208
6409,Jiajing-Hu,2,0.00046,65934,15.21994,433208
6410,Jiangting1,2,0.00046,65936,15.22040,433208
6411,jiaxunsongucb,2,0.00046,65938,15.22086,433208
6412,jicanghaixb,2,0.00046,65940,15.22133,433208
6413,jicki,2,0.00046,65942,15.22179,433208
6414,jickor,2,0.00046,65944,15.22225,433208
6415,JieZeng1993,2,0.00046,65946,15.22271,433208
6416,JimHaughwout,2,0.00046,65948,15.22317,433208
6417,JimHume,2,0.00046,65950,15.22363,433208
6418,JimLarson,2,0.00046,65952,15.22410,433208
6419,Jimmyjim123,2,0.00046,65954,15.22456,433208
6420,jinlongchen,2,0.00046,65956,15.22502,433208
6421,JinsPeter,2,0.00046,65958,15.22548,433208
6422,JiyeYu,2,0.00046,65960,15.22594,433208
6423,jj891070,2,0.00046,65962,15.22640,433208
6424,JKerwood,2,0.00046,65964,15.22687,433208
6425,jlarriba,2,0.00046,65966,15.22733,433208
6426,jlehtimaki,2,0.00046,65968,15.22779,433208
6427,jmcelwain,2,0.00046,65970,15.22825,433208
6428,jmf0526,2,0.00046,65972,15.22871,433208
6429,jmhoeft,2,0.00046,65974,15.22917,433208
6430,jngo2,2,0.00046,65976,15.22964,433208
6431,jnsrikanth,2,0.00046,65978,15.23010,433208
6432,joaosilva15,2,0.00046,65980,15.23056,433208
6433,joearul09,2,0.00046,65982,15.23102,433208
6434,joebowbeer,2,0.00046,65984,15.23148,433208
6435,joe-farro,2,0.00046,65986,15.23194,433208
6436,joelhoisko,2,0.00046,65988,15.23241,433208
6437,joelmccracken,2,0.00046,65990,15.23287,433208
6438,joerg-walter-de,2,0.00046,65992,15.23333,433208
6439,JoeSchr,2,0.00046,65994,15.23379,433208
6440,johan1252,2,0.00046,65996,15.23425,433208
6441,johanfleury,2,0.00046,65998,15.23471,433208
6442,johannes-darms,2,0.00046,66000,15.23518,433208
6443,johannwagner,2,0.00046,66002,15.23564,433208
6444,johnkeates,2,0.00046,66004,15.23610,433208
6445,johnlane,2,0.00046,66006,15.23656,433208
6446,johnnyaug,2,0.00046,66008,15.23702,433208
6447,johnnylei,2,0.00046,66010,15.23748,433208
6448,johnreytanquinco,2,0.00046,66012,15.23795,433208
6449,JohnRusk,2,0.00046,66014,15.23841,433208
6450,johnyii0216,2,0.00046,66016,15.23887,433208
6451,johny-mnemonic,2,0.00046,66018,15.23933,433208
6452,jojodaser,2,0.00046,66020,15.23979,433208
6453,JoKeR-88,2,0.00046,66022,15.24025,433208
6454,jonasbeyer,2,0.00046,66024,15.24072,433208
6455,jonasi-resideo,2,0.00046,66026,15.24118,433208
6456,jonathan-innis,2,0.00046,66028,15.24164,433208
6457,JonEngle,2,0.00046,66030,15.24210,433208
6458,jongio,2,0.00046,66032,15.24256,433208
6459,jordan-huangwei,2,0.00046,66034,15.24302,433208
6460,JordyBaylac,2,0.00046,66036,15.24349,433208
6461,jorrizza,2,0.00046,66038,15.24395,433208
6462,josejayesh,2,0.00046,66040,15.24441,433208
6463,JoshKCarroll,2,0.00046,66042,15.24487,433208
6464,JoshSinghEscreen,2,0.00046,66044,15.24533,433208
6465,JoshuaSmeda,2,0.00046,66046,15.24579,433208
6466,joulaud,2,0.00046,66048,15.24626,433208
6467,jpantsjoha,2,0.00046,66050,15.24672,433208
6468,JParkinson1991,2,0.00046,66052,15.24718,433208
6469,jpmantuano,2,0.00046,66054,15.24764,433208
6470,jpmelos,2,0.00046,66056,15.24810,433208
6471,jpVm5jYYRE1VIKL,2,0.00046,66058,15.24856,433208
6472,JRial95,2,0.00046,66060,15.24903,433208
6473,jrRibeiro,2,0.00046,66062,15.24949,433208
6474,JScrivanich,2,0.00046,66064,15.24995,433208
6475,jshah,2,0.00046,66066,15.25041,433208
6476,jshin47,2,0.00046,66068,15.25087,433208
6477,jstewmon,2,0.00046,66070,15.25133,433208
6478,jtakakura,2,0.00046,66072,15.25180,433208
6479,jthinking,2,0.00046,66074,15.25226,433208
6480,jtzwu,2,0.00046,66076,15.25272,433208
6481,juan-chan,2,0.00046,66078,15.25318,433208
6482,Juanezm,2,0.00046,66080,15.25364,433208
6483,juan-vg,2,0.00046,66082,15.25410,433208
6484,judgeaxl,2,0.00046,66084,15.25457,433208
6485,Juhyeok,2,0.00046,66086,15.25503,433208
6486,juju4,2,0.00046,66088,15.25549,433208
6487,jukops,2,0.00046,66090,15.25595,433208
6488,JulianHBuecher,2,0.00046,66092,15.25641,433208
6489,junsaw,2,0.00046,66094,15.25687,433208
6490,junyer,2,0.00046,66096,15.25734,433208
6491,juzhao,2,0.00046,66098,15.25780,433208
6492,k9ert,2,0.00046,66100,15.25826,433208
6493,KACAH,2,0.00046,66102,15.25872,433208
6494,kaganmersin,2,0.00046,66104,15.25918,433208
6495,Kaggggggga,2,0.00046,66106,15.25964,433208
6496,kailinwei,2,0.00046,66108,15.26011,433208
6497,kaitaklam,2,0.00046,66110,15.26057,433208
6498,kalpita28,2,0.00046,66112,15.26103,433208
6499,KamalaRamas,2,0.00046,66114,15.26149,433208
6500,kanak-kabara,2,0.00046,66116,15.26195,433208
6501,kanishk98,2,0.00046,66118,15.26241,433208
6502,KapilTeotia1,2,0.00046,66120,15.26288,433208
6503,kardithSingh,2,0.00046,66122,15.26334,433208
6504,KarlCF,2,0.00046,66124,15.26380,433208
6505,karllhughes,2,0.00046,66126,15.26426,433208
6506,kashish2909,2,0.00046,66128,15.26472,433208
6507,kasini3000,2,0.00046,66130,15.26518,433208
6508,katjur,2,0.00046,66132,15.26565,433208
6509,katzj,2,0.00046,66134,15.26611,433208
6510,kaushikb11,2,0.00046,66136,15.26657,433208
6511,kavirajk,2,0.00046,66138,15.26703,433208
6512,kayrosik,2,0.00046,66140,15.26749,433208
6513,kedrzu91,2,0.00046,66142,15.26795,433208
6514,keithnull,2,0.00046,66144,15.26842,433208
6515,kemra102,2,0.00046,66146,15.26888,433208
6516,kennytrytek-wf,2,0.00046,66148,15.26934,433208
6517,keshav-kumar-noc,2,0.00046,66150,15.26980,433208
6518,KestutisMa,2,0.00046,66152,15.27026,433208
6519,Kevin-Bannier,2,0.00046,66154,15.27072,433208
6520,kevindong,2,0.00046,66156,15.27119,433208
6521,kevinleturc,2,0.00046,66158,15.27165,433208
6522,kgaurav2,2,0.00046,66160,15.27211,433208
6523,kgorin8,2,0.00046,66162,15.27257,433208
6524,khakunin,2,0.00046,66164,15.27303,433208
6525,khalfan123,2,0.00046,66166,15.27349,433208
6526,kifeo,2,0.00046,66168,15.27396,433208
6527,kim-nguyenkhn,2,0.00046,66170,15.27442,433208
6528,kimormiston,2,0.00046,66172,15.27488,433208
6529,kinderyj,2,0.00046,66174,15.27534,433208
6530,King-of-Spades,2,0.00046,66176,15.27580,433208
6531,kirillta,2,0.00046,66178,15.27626,433208
6532,kislitsyn,2,0.00046,66180,15.27673,433208
6533,kitenko,2,0.00046,66182,15.27719,433208
6534,kjenney,2,0.00046,66184,15.27765,433208
6535,kjw3,2,0.00046,66186,15.27811,433208
6536,k-kinzal,2,0.00046,66188,15.27857,433208
6537,kkso3838,2,0.00046,66190,15.27903,433208
6538,klml,2,0.00046,66192,15.27950,433208
6539,Klohto,2,0.00046,66194,15.27996,433208
6540,k-mckinney,2,0.00046,66196,15.28042,433208
6541,KMFtcy,2,0.00046,66198,15.28088,433208
6542,kmjung,2,0.00046,66200,15.28134,433208
6543,knepe,2,0.00046,66202,15.28180,433208
6544,knyttl,2,0.00046,66204,15.28227,433208
6545,koalado,2,0.00046,66206,15.28273,433208
6546,kobayashi,2,0.00046,66208,15.28319,433208
6547,kochetov-dmitrij,2,0.00046,66210,15.28365,433208
6548,koji117,2,0.00046,66212,15.28411,433208
6549,konduktor4ik,2,0.00046,66214,15.28457,433208
6550,konokimo,2,0.00046,66216,15.28504,433208
6551,konstantin-kornienko,2,0.00046,66218,15.28550,433208
6552,korkin25,2,0.00046,66220,15.28596,433208
6553,koshkarov,2,0.00046,66222,15.28642,433208
6554,kostrahb,2,0.00046,66224,15.28688,433208
6555,kpucynski,2,0.00046,66226,15.28734,433208
6556,kqzh,2,0.00046,66228,15.28781,433208
6557,kranjcec,2,0.00046,66230,15.28827,433208
6558,krish7919,2,0.00046,66232,15.28873,433208
6559,krishnadasari610,2,0.00046,66234,15.28919,433208
6560,krishnakvall,2,0.00046,66236,15.28965,433208
6561,krsri,2,0.00046,66238,15.29011,433208
6562,kruettlip,2,0.00046,66240,15.29058,433208
6563,kschu91,2,0.00046,66242,15.29104,433208
6564,ksdeepak93,2,0.00046,66244,15.29150,433208
6565,kshamajain99,2,0.00046,66246,15.29196,433208
6566,kspviswa,2,0.00046,66248,15.29242,433208
6567,ktarplee,2,0.00046,66250,15.29288,433208
6568,K-Titan,2,0.00046,66252,15.29335,433208
6569,ktlcove,2,0.00046,66254,15.29381,433208
6570,kubaj,2,0.00046,66256,15.29427,433208
6571,kubeeeee,2,0.00046,66258,15.29473,433208
6572,KubeLouis,2,0.00046,66260,15.29519,433208
6573,kumy,2,0.00046,66262,15.29565,433208
6574,kvaradhan3,2,0.00046,66264,15.29612,433208
6575,kvp-cs,2,0.00046,66266,15.29658,433208
6576,kyfelipe,2,0.00046,66268,15.29704,433208
6577,KyleGobel,2,0.00046,66270,15.29750,433208
6578,kyprifog,2,0.00046,66272,15.29796,433208
6579,kzcPo,2,0.00046,66274,15.29842,433208
6580,l0nax,2,0.00046,66276,15.29889,433208
6581,l1ch40,2,0.00046,66278,15.29935,433208
6582,l30006821,2,0.00046,66280,15.29981,433208
6583,L3o-pold,2,0.00046,66282,15.30027,433208
6584,laci84,2,0.00046,66284,15.30073,433208
6585,lackstein,2,0.00046,66286,15.30119,433208
6586,laike9m,2,0.00046,66288,15.30166,433208
6587,lamaxiyali,2,0.00046,66290,15.30212,433208
6588,Lamercho,2,0.00046,66292,15.30258,433208
6589,lamungu,2,0.00046,66294,15.30304,433208
6590,lanmarti,2,0.00046,66296,15.30350,433208
6591,laplasz,2,0.00046,66298,15.30396,433208
6592,larryrun,2,0.00046,66300,15.30443,433208
6593,larsrnielsen,2,0.00046,66302,15.30489,433208
6594,larytet,2,0.00046,66304,15.30535,433208
6595,LasseChi,2,0.00046,66306,15.30581,433208
6596,lateparty,2,0.00046,66308,15.30627,433208
6597,Laurianti,2,0.00046,66310,15.30673,433208
6598,lazy-always,2,0.00046,66312,15.30720,433208
6599,lazystone,2,0.00046,66314,15.30766,433208
6600,ldynia,2,0.00046,66316,15.30812,433208
6601,leahneukirchen,2,0.00046,66318,15.30858,433208
6602,leewardbound,2,0.00046,66320,15.30904,433208
6603,lefelys,2,0.00046,66322,15.30950,433208
6604,legaspi7,2,0.00046,66324,15.30997,433208
6605,Legion2,2,0.00046,66326,15.31043,433208
6606,Leinad0033,2,0.00046,66328,15.31089,433208
6607,leiyanggz,2,0.00046,66330,15.31135,433208
6608,LelandSindt,2,0.00046,66332,15.31181,433208
6609,lemaxw,2,0.00046,66334,15.31227,433208
6610,lemon-simple,2,0.00046,66336,15.31274,433208
6611,leonfibal,2,0.00046,66338,15.31320,433208
6612,leovigna,2,0.00046,66340,15.31366,433208
6613,LeoWenxiang,2,0.00046,66342,15.31412,433208
6614,Lepird,2,0.00046,66344,15.31458,433208
6615,leyvReyn,2,0.00046,66346,15.31504,433208
6616,lfdominguez,2,0.00046,66348,15.31551,433208
6617,lfe135,2,0.00046,66350,15.31597,433208
6618,lfzyx,2,0.00046,66352,15.31643,433208
6619,lgy1027,2,0.00046,66354,15.31689,433208
6620,liarco,2,0.00046,66356,15.31735,433208
6621,LiBingtao,2,0.00046,66358,15.31781,433208
6622,lidavidm,2,0.00046,66360,15.31828,433208
6623,lightoze,2,0.00046,66362,15.31874,433208
6624,lijiapengsa,2,0.00046,66364,15.31920,433208
6625,likhithadevi,2,0.00046,66366,15.31966,433208
6626,Limonkufu,2,0.00046,66368,15.32012,433208
6627,linuxjumper,2,0.00046,66370,15.32059,433208
6628,linuxzha,2,0.00046,66372,15.32105,433208
6629,linww,2,0.00046,66374,15.32151,433208
6630,linzj3,2,0.00046,66376,15.32197,433208
6631,listepo,2,0.00046,66378,15.32243,433208
6632,litengfei-zz,2,0.00046,66380,15.32289,433208
6633,liugangnhm,2,0.00046,66382,15.32336,433208
6634,liulangwa,2,0.00046,66384,15.32382,433208
6635,liuming50,2,0.00046,66386,15.32428,433208
6636,liuxin95,2,0.00046,66388,15.32474,433208
6637,liu-xuewen,2,0.00046,66390,15.32520,433208
6638,liyahui2012,2,0.00046,66392,15.32566,433208
6639,llhhbc,2,0.00046,66394,15.32613,433208
6640,llnformer,2,0.00046,66396,15.32659,433208
6641,LM-LM,2,0.00046,66398,15.32705,433208
6642,lodejard,2,0.00046,66400,15.32751,433208
6643,logikone,2,0.00046,66402,15.32797,433208
6644,loint,2,0.00046,66404,15.32843,433208
6645,lokeshjava28,2,0.00046,66406,15.32890,433208
6646,lopezc184,2,0.00046,66408,15.32936,433208
6647,lordk911,2,0.00046,66410,15.32982,433208
6648,loreleimccollum-work,2,0.00046,66412,15.33028,433208
6649,LotharKAtt,2,0.00046,66414,15.33074,433208
6650,louiemiranda,2,0.00046,66416,15.33120,433208
6651,LS80,2,0.00046,66418,15.33167,433208
6652,lsarangi1,2,0.00046,66420,15.33213,433208
6653,lsh0357,2,0.00046,66422,15.33259,433208
6654,lsylusiyao,2,0.00046,66424,15.33305,433208
6655,ltamasi,2,0.00046,66426,15.33351,433208
6656,lucasbittencourt02,2,0.00046,66428,15.33397,433208
6657,luisfmcalado,2,0.00046,66430,15.33444,433208
6658,lukasgit,2,0.00046,66432,15.33490,433208
6659,LukaszRacon,2,0.00046,66434,15.33536,433208
6660,lunkaleung,2,0.00046,66436,15.33582,433208
6661,Lwxiang,2,0.00046,66438,15.33628,433208
6662,lzeng27,2,0.00046,66440,15.33674,433208
6663,m0nstermind,2,0.00046,66442,15.33721,433208
6664,m287867,2,0.00046,66444,15.33767,433208
6665,machine424,2,0.00046,66446,15.33813,433208
6666,MaConch,2,0.00046,66448,15.33859,433208
6667,Macrame,2,0.00046,66450,15.33905,433208
6668,maelboutin,2,0.00046,66452,15.33951,433208
6669,magthe,2,0.00046,66454,15.33998,433208
6670,Mahesh9000,2,0.00046,66456,15.34044,433208
6671,Mais316,2,0.00046,66458,15.34090,433208
6672,maja42,2,0.00046,66460,15.34136,433208
6673,MaksymTrykur,2,0.00046,66462,15.34182,433208
6674,maltfield,2,0.00046,66464,15.34228,433208
6675,mampfes,2,0.00046,66466,15.34275,433208
6676,manderson23,2,0.00046,66468,15.34321,433208
6677,mangotron,2,0.00046,66470,15.34367,433208
6678,ManiacDC,2,0.00046,66472,15.34413,433208
6679,manikandanrapyder,2,0.00046,66474,15.34459,433208
6680,manishdangi98,2,0.00046,66476,15.34505,433208
6681,manish-eros,2,0.00046,66478,15.34552,433208
6682,ManojGoel2020,2,0.00046,66480,15.34598,433208
6683,manpreetrathore,2,0.00046,66482,15.34644,433208
6684,mantshar1990,2,0.00046,66484,15.34690,433208
6685,mantuliu,2,0.00046,66486,15.34736,433208
6686,marco69,2,0.00046,66488,15.34782,433208
6687,marcoacarvalho,2,0.00046,66490,15.34829,433208
6688,marcoklaassen,2,0.00046,66492,15.34875,433208
6689,marcorighi,2,0.00046,66494,15.34921,433208
6690,marcuz,2,0.00046,66496,15.34967,433208
6691,margaretgorguissian,2,0.00046,66498,15.35013,433208
6692,mariusmarais,2,0.00046,66500,15.35059,433208
6693,mariusmotea,2,0.00046,66502,15.35106,433208
6694,MarkAJanney,2,0.00046,66504,15.35152,433208
6695,MarkAtwood,2,0.00046,66506,15.35198,433208
6696,markmaas,2,0.00046,66508,15.35244,433208
6697,markthebault,2,0.00046,66510,15.35290,433208
6698,markusdresch,2,0.00046,66512,15.35336,433208
6699,markushinz,2,0.00046,66514,15.35383,433208
6700,markvr,2,0.00046,66516,15.35429,433208
6701,marnovo,2,0.00046,66518,15.35475,433208
6702,marsqing,2,0.00046,66520,15.35521,433208
6703,Marswin,2,0.00046,66522,15.35567,433208
6704,marthydavid,2,0.00046,66524,15.35613,433208
6705,Marx2,2,0.00046,66526,15.35660,433208
6706,maryamklabib,2,0.00046,66528,15.35706,433208
6707,maryoush,2,0.00046,66530,15.35752,433208
6708,mash1t,2,0.00046,66532,15.35798,433208
6709,maskarb,2,0.00046,66534,15.35844,433208
6710,masterthefly,2,0.00046,66536,15.35890,433208
6711,mathias-ewald,2,0.00046,66538,15.35937,433208
6712,mathiasxx,2,0.00046,66540,15.35983,433208
6713,mathieubodin,2,0.00046,66542,15.36029,433208
6714,matthaywardwebdesign,2,0.00046,66544,15.36075,433208
6715,matthewi,2,0.00046,66546,15.36121,433208
6716,matthew-mcdermott,2,0.00046,66548,15.36167,433208
6717,matthiaslee,2,0.00046,66550,15.36214,433208
6718,mattjw,2,0.00046,66552,15.36260,433208
6719,mattparkes,2,0.00046,66554,15.36306,433208
6720,mattsanta,2,0.00046,66556,15.36352,433208
6721,mattskone,2,0.00046,66558,15.36398,433208
6722,maulikjs,2,0.00046,66560,15.36444,433208
6723,Mauratay,2,0.00046,66562,15.36491,433208
6724,mavenishere,2,0.00046,66564,15.36537,433208
6725,max70-root,2,0.00046,66566,15.36583,433208
6726,maximestevenot,2,0.00046,66568,15.36629,433208
6727,MaxNosov,2,0.00046,66570,15.36675,433208
6728,Max-Sum,2,0.00046,66572,15.36721,433208
6729,mayurvpatil,2,0.00046,66574,15.36768,433208
6730,mbacchi,2,0.00046,66576,15.36814,433208
6731,mbettsteller,2,0.00046,66578,15.36860,433208
6732,mbuccini,2,0.00046,66580,15.36906,433208
6733,mcanaves,2,0.00046,66582,15.36952,433208
6734,mcarbonneaux,2,0.00046,66584,15.36998,433208
6735,mchiang-goo,2,0.00046,66586,15.37045,433208
6736,mcieplak,2,0.00046,66588,15.37091,433208
6737,mdebarros,2,0.00046,66590,15.37137,433208
6738,mds1455975151,2,0.00046,66592,15.37183,433208
6739,megabreit,2,0.00046,66594,15.37229,433208
6740,meghnapr,2,0.00046,66596,15.37275,433208
6741,mehuled,2,0.00046,66598,15.37322,433208
6742,mehyedes,2,0.00046,66600,15.37368,433208
6743,memory,2,0.00046,66602,15.37414,433208
6744,MengSunS,2,0.00046,66604,15.37460,433208
6745,metost,2,0.00046,66606,15.37506,433208
6746,mfateev,2,0.00046,66608,15.37552,433208
6747,mformetal,2,0.00046,66610,15.37599,433208
6748,mfvanek,2,0.00046,66612,15.37645,433208
6749,MG2R,2,0.00046,66614,15.37691,433208
6750,mhaddon,2,0.00046,66616,15.37737,433208
6751,mhoad,2,0.00046,66618,15.37783,433208
6752,mhoyer,2,0.00046,66620,15.37829,433208
6753,mhuangpivotal,2,0.00046,66622,15.37876,433208
6754,mibaboo,2,0.00046,66624,15.37922,433208
6755,mic4ael,2,0.00046,66626,15.37968,433208
6756,MicDeDuiwel,2,0.00046,66628,15.38014,433208
6757,michaelstoica,2,0.00046,66630,15.38060,433208
6758,michalrubaj,2,0.00046,66632,15.38106,433208
6759,michelgokan,2,0.00046,66634,15.38153,433208
6760,mickeahlinder,2,0.00046,66636,15.38199,433208
6761,mickstevenson,2,0.00046,66638,15.38245,433208
6762,micnguyen266,2,0.00046,66640,15.38291,433208
6763,mihaimyh,2,0.00046,66642,15.38337,433208
6764,mijkathegreat,2,0.00046,66644,15.38383,433208
6765,mikador,2,0.00046,66646,15.38430,433208
6766,MikailBag,2,0.00046,66648,15.38476,433208
6767,mikeandersen,2,0.00046,66650,15.38522,433208
6768,mikeh2020,2,0.00046,66652,15.38568,433208
6769,mikehardenize,2,0.00046,66654,15.38614,433208
6770,mikesplainsonos,2,0.00046,66656,15.38660,433208
6771,minayko,2,0.00046,66658,15.38707,433208
6772,mingqing,2,0.00046,66660,15.38753,433208
6773,mini1989,2,0.00046,66662,15.38799,433208
6774,MirkoRuggiero,2,0.00046,66664,15.38845,433208
6775,misbah9105,2,0.00046,66666,15.38891,433208
6776,miso231,2,0.00046,66668,15.38937,433208
6777,Misosooup,2,0.00046,66670,15.38984,433208
6778,missingcharacter,2,0.00046,66672,15.39030,433208
6779,mixalako,2,0.00046,66674,15.39076,433208
6780,mjwilkerson-strateos,2,0.00046,66676,15.39122,433208
6781,mKaloer,2,0.00046,66678,15.39168,433208
6782,mkjpryor-stfc,2,0.00046,66680,15.39214,433208
6783,m-kostrzewa,2,0.00046,66682,15.39261,433208
6784,mlboy,2,0.00046,66684,15.39307,433208
6785,Mldhun,2,0.00046,66686,15.39353,433208
6786,mmanciop,2,0.00046,66688,15.39399,433208
6787,mmiranda,2,0.00046,66690,15.39445,433208
6788,MnifR,2,0.00046,66692,15.39491,433208
6789,mnorrsken,2,0.00046,66694,15.39538,433208
6790,mnpenner,2,0.00046,66696,15.39584,433208
6791,moh-abk,2,0.00046,66698,15.39630,433208
6792,mohameddahrouj,2,0.00046,66700,15.39676,433208
6793,mohamedelbahr,2,0.00046,66702,15.39722,433208
6794,mohdahmad17,2,0.00046,66704,15.39768,433208
6795,mokainos,2,0.00046,66706,15.39815,433208
6796,montrivo,2,0.00046,66708,15.39861,433208
6797,mooperd,2,0.00046,66710,15.39907,433208
6798,moorara,2,0.00046,66712,15.39953,433208
6799,moosahmed,2,0.00046,66714,15.39999,433208
6800,morarucostel,2,0.00046,66716,15.40045,433208
6801,MordFustang21,2,0.00046,66718,15.40092,433208
6802,morhook,2,0.00046,66720,15.40138,433208
6803,morinap,2,0.00046,66722,15.40184,433208
6804,moritzboth,2,0.00046,66724,15.40230,433208
6805,Moshem123,2,0.00046,66726,15.40276,433208
6806,Mosibi,2,0.00046,66728,15.40322,433208
6807,mostafahussein,2,0.00046,66730,15.40369,433208
6808,mpritter76,2,0.00046,66732,15.40415,433208
6809,mprzygrodzki,2,0.00046,66734,15.40461,433208
6810,mpsq,2,0.00046,66736,15.40507,433208
6811,mrak,2,0.00046,66738,15.40553,433208
6812,mrclki,2,0.00046,66740,15.40599,433208
6813,mrjoesm,2,0.00046,66742,15.40646,433208
6814,mrlesmithjr,2,0.00046,66744,15.40692,433208
6815,mr-maksimov,2,0.00046,66746,15.40738,433208
6816,mrunalvilas,2,0.00046,66748,15.40784,433208
6817,MrVentzi,2,0.00046,66750,15.40830,433208
6818,mrward,2,0.00046,66752,15.40876,433208
6819,MrZhaoAtBJ,2,0.00046,66754,15.40923,433208
6820,msatyan,2,0.00046,66756,15.40969,433208
6821,msfrucht,2,0.00046,66758,15.41015,433208
6822,mskrocki,2,0.00046,66760,15.41061,433208
6823,MStausberg,2,0.00046,66762,15.41107,433208
6824,msunilkumar,2,0.00046,66764,15.41153,433208
6825,Msutapalli,2,0.00046,66766,15.41200,433208
6826,msvechla,2,0.00046,66768,15.41246,433208
6827,mszacillo,2,0.00046,66770,15.41292,433208
6828,mtryfoss,2,0.00046,66772,15.41338,433208
6829,muety,2,0.00046,66774,15.41384,433208
6830,mujibishola,2,0.00046,66776,15.41430,433208
6831,mulatinho,2,0.00046,66778,15.41477,433208
6832,Muratbucak,2,0.00046,66780,15.41523,433208
6833,murex971,2,0.00046,66782,15.41569,433208
6834,muzammil360,2,0.00046,66784,15.41615,433208
6835,Muzry,2,0.00046,66786,15.41661,433208
6836,mveitas,2,0.00046,66788,15.41707,433208
6837,mvertes,2,0.00046,66790,15.41754,433208
6838,mwasilew2,2,0.00046,66792,15.41800,433208
6839,mwconceicao,2,0.00046,66794,15.41846,433208
6840,mwhipple,2,0.00046,66796,15.41892,433208
6841,myersjustinc,2,0.00046,66798,15.41938,433208
6842,mykola-ivadolabs,2,0.00046,66800,15.41984,433208
6843,myonlyzzy,2,0.00046,66802,15.42031,433208
6844,mythreyi1905,2,0.00046,66804,15.42077,433208
6845,myvelcn,2,0.00046,66806,15.42123,433208
6846,mzohreva,2,0.00046,66808,15.42169,433208
6847,n27051538,2,0.00046,66810,15.42215,433208
6848,nabam,2,0.00046,66812,15.42261,433208
6849,nachoparodi,2,0.00046,66814,15.42308,433208
6850,nagajagan,2,0.00046,66816,15.42354,433208
6851,nagaprabhu,2,0.00046,66818,15.42400,433208
6852,nagesh4193,2,0.00046,66820,15.42446,433208
6853,nagisa,2,0.00046,66822,15.42492,433208
6854,nagromLobo,2,0.00046,66824,15.42538,433208
6855,nagulvali,2,0.00046,66826,15.42585,433208
6856,nahidupa,2,0.00046,66828,15.42631,433208
6857,nakamume,2,0.00046,66830,15.42677,433208
6858,nakkoh,2,0.00046,66832,15.42723,433208
6859,nalbam,2,0.00046,66834,15.42769,433208
6860,namliz,2,0.00046,66836,15.42815,433208
6861,NaraVen,2,0.00046,66838,15.42862,433208
6862,NarendranathPanda,2,0.00046,66840,15.42908,433208
6863,nashpaz123,2,0.00046,66842,15.42954,433208
6864,nathanbudd-geotab,2,0.00046,66844,15.43000,433208
6865,nathantfrank,2,0.00046,66846,15.43046,433208
6866,nbenaglia,2,0.00046,66848,15.43092,433208
6867,ndipebot,2,0.00046,66850,15.43139,433208
6868,ndlygaSyr,2,0.00046,66852,15.43185,433208
6869,ndragon798,2,0.00046,66854,15.43231,433208
6870,ne1000,2,0.00046,66856,15.43277,433208
6871,nealmcb,2,0.00046,66858,15.43323,433208
6872,neargle,2,0.00046,66860,15.43369,433208
6873,neel229,2,0.00046,66862,15.43416,433208
6874,nehap4,2,0.00046,66864,15.43462,433208
6875,neil-greenwood,2,0.00046,66866,15.43508,433208
6876,nemanjasymphony,2,0.00046,66868,15.43554,433208
6877,neoEvol,2,0.00046,66870,15.43600,433208
6878,neubieser,2,0.00046,66872,15.43646,433208
6879,nevill,2,0.00046,66874,15.43693,433208
6880,newly12,2,0.00046,66876,15.43739,433208
6881,newtoniumx3,2,0.00046,66878,15.43785,433208
6882,neyugnluan,2,0.00046,66880,15.43831,433208
6883,nfrush,2,0.00046,66882,15.43877,433208
6884,nguyenquannnn,2,0.00046,66884,15.43923,433208
6885,nibooy,2,0.00046,66886,15.43970,433208
6886,nick-cromwell,2,0.00046,66888,15.44016,433208
6887,nickhalden,2,0.00046,66890,15.44062,433208
6888,nickhiggs,2,0.00046,66892,15.44108,433208
6889,nick-oconnor,2,0.00046,66894,15.44154,433208
6890,nicolacdnll,2,0.00046,66896,15.44200,433208
6891,nightwolfz,2,0.00046,66898,15.44247,433208
6892,nikhilkathare,2,0.00046,66900,15.44293,433208
6893,nikitakalyanov,2,0.00046,66902,15.44339,433208
6894,NikNikM,2,0.00046,66904,15.44385,433208
6895,nimrodishi,2,0.00046,66906,15.44431,433208
6896,NingPekin,2,0.00046,66908,15.44477,433208
6897,niroopj,2,0.00046,66910,15.44524,433208
6898,NirvanaZA,2,0.00046,66912,15.44570,433208
6899,NisheekaNynan1,2,0.00046,66914,15.44616,433208
6900,nishpa214,2,0.00046,66916,15.44662,433208
6901,nkol,2,0.00046,66918,15.44708,433208
6902,nkukard,2,0.00046,66920,15.44754,433208
6903,nlloyd-invitae,2,0.00046,66922,15.44801,433208
6904,nlzv,2,0.00046,66924,15.44847,433208
6905,nmeyerhans,2,0.00046,66926,15.44893,433208
6906,n-n1ks,2,0.00046,66928,15.44939,433208
6907,NoelDavies,2,0.00046,66930,15.44985,433208
6908,noelleleigh,2,0.00046,66932,15.45031,433208
6909,noggi,2,0.00046,66934,15.45078,433208
6910,nomecks,2,0.00046,66936,15.45124,433208
6911,nomeelnoj,2,0.00046,66938,15.45170,433208
6912,nomis-rzp,2,0.00046,66940,15.45216,433208
6913,npiganeau,2,0.00046,66942,15.45262,433208
6914,nrjohnstone,2,0.00046,66944,15.45308,433208
6915,nrvmodi,2,0.00046,66946,15.45355,433208
6916,nsharma1231,2,0.00046,66948,15.45401,433208
6917,ns-kvaradhan,2,0.00046,66950,15.45447,433208
6918,ntorba,2,0.00046,66952,15.45493,433208
6919,NuckChorris,2,0.00046,66954,15.45539,433208
6920,nuharaf,2,0.00046,66956,15.45585,433208
6921,NW-MLakin,2,0.00046,66958,15.45632,433208
6922,nyarly,2,0.00046,66960,15.45678,433208
6923,o6uoq,2,0.00046,66962,15.45724,433208
6924,obiwanjacobi,2,0.00046,66964,15.45770,433208
6925,ocroz,2,0.00046,66966,15.45816,433208
6926,OctavioCore,2,0.00046,66968,15.45862,433208
6927,octonato,2,0.00046,66970,15.45909,433208
6928,oikomi,2,0.00046,66972,15.45955,433208
6929,oiricaud,2,0.00046,66974,15.46001,433208
6930,okia,2,0.00046,66976,15.46047,433208
6931,okwunna,2,0.00046,66978,15.46093,433208
6932,OleksandrGavryliukTR,2,0.00046,66980,15.46139,433208
6933,OliverCole,2,0.00046,66982,15.46186,433208
6934,olivier-jobert,2,0.00046,66984,15.46232,433208
6935,Olli64,2,0.00046,66986,15.46278,433208
6936,olljanat,2,0.00046,66988,15.46324,433208
6937,OmegaRogue,2,0.00046,66990,15.46370,433208
6938,omerozery,2,0.00046,66992,15.46417,433208
6939,omwbennett,2,0.00046,66994,15.46463,433208
6940,Onewaysidewalks,2,0.00046,66996,15.46509,433208
6941,onpaws,2,0.00046,66998,15.46555,433208
6942,operatorequals,2,0.00046,67000,15.46601,433208
6943,ophum,2,0.00046,67002,15.46647,433208
6944,Orabig,2,0.00046,67004,15.46694,433208
6945,orirawlings,2,0.00046,67006,15.46740,433208
6946,otri,2,0.00046,67008,15.46786,433208
6947,OuSatoru,2,0.00046,67010,15.46832,433208
6948,ovidiuf,2,0.00046,67012,15.46878,433208
6949,owengo,2,0.00046,67014,15.46924,433208
6950,oymo,2,0.00046,67016,15.46971,433208
6951,oze4,2,0.00046,67018,15.47017,433208
6952,P1ng-W1n,2,0.00046,67020,15.47063,433208
6953,Pa3cia07,2,0.00046,67022,15.47109,433208
6954,paltaa,2,0.00046,67024,15.47155,433208
6955,panashka,2,0.00046,67026,15.47201,433208
6956,paneq,2,0.00046,67028,15.47248,433208
6957,PangQingcheng,2,0.00046,67030,15.47294,433208
6958,pankaj02,2,0.00046,67032,15.47340,433208
6959,panos73,2,0.00046,67034,15.47386,433208
6960,ParagNetApp,2,0.00046,67036,15.47432,433208
6961,Paragon1970,2,0.00046,67038,15.47478,433208
6962,paravatha,2,0.00046,67040,15.47525,433208
6963,pareshpateldfw,2,0.00046,67042,15.47571,433208
6964,parsifal-47,2,0.00046,67044,15.47617,433208
6965,ParthasarathySubburaj,2,0.00046,67046,15.47663,433208
6966,parthpower,2,0.00046,67048,15.47709,433208
6967,ParvJain,2,0.00046,67050,15.47755,433208
6968,pascapascapascapasca,2,0.00046,67052,15.47802,433208
6969,pather87,2,0.00046,67054,15.47848,433208
6970,patrick-orca,2,0.00046,67056,15.47894,433208
6971,PaulFurtado,2,0.00046,67058,15.47940,433208
6972,paull25,2,0.00046,67060,15.47986,433208
6973,paullaffitte,2,0.00046,67062,15.48032,433208
6974,paulroche,2,0.00046,67064,15.48079,433208
6975,paurosello,2,0.00046,67066,15.48125,433208
6976,pavankumarkatakam,2,0.00046,67068,15.48171,433208
6977,PavanVasist,2,0.00046,67070,15.48217,433208
6978,pavel-kurnosov,2,0.00046,67072,15.48263,433208
6979,payall4u,2,0.00046,67074,15.48309,433208
6980,pbd-axa,2,0.00046,67076,15.48356,433208
6981,pbisen,2,0.00046,67078,15.48402,433208
6982,pcfens,2,0.00046,67080,15.48448,433208
6983,pchugh79,2,0.00046,67082,15.48494,433208
6984,Pcosmin,2,0.00046,67084,15.48540,433208
6985,pc-rnukala1,2,0.00046,67086,15.48586,433208
6986,pdf,2,0.00046,67088,15.48633,433208
6987,pdmars,2,0.00046,67090,15.48679,433208
6988,pdrakeweb,2,0.00046,67092,15.48725,433208
6989,peacememories,2,0.00046,67094,15.48771,433208
6990,peco8,2,0.00046,67096,15.48817,433208
6991,pelevinma,2,0.00046,67098,15.48863,433208
6992,penumbra23,2,0.00046,67100,15.48910,433208
6993,peppy,2,0.00046,67102,15.48956,433208
6994,perestoronin,2,0.00046,67104,15.49002,433208
6995,perljusback,2,0.00046,67106,15.49048,433208
6996,perosb,2,0.00046,67108,15.49094,433208
6997,petrkr,2,0.00046,67110,15.49140,433208
6998,pettersv,2,0.00046,67112,15.49187,433208
6999,pgpx,2,0.00046,67114,15.49233,433208
7000,phanhuy1502,2,0.00046,67116,15.49279,433208
7001,pharthiphan,2,0.00046,67118,15.49325,433208
7002,phatboyg,2,0.00046,67120,15.49371,433208
7003,Pheenoh,2,0.00046,67122,15.49417,433208
7004,philipp1992,2,0.00046,67124,15.49464,433208
7005,Philippe-Bailer-ck,2,0.00046,67126,15.49510,433208
7006,philippeLepage,2,0.00046,67128,15.49556,433208
7007,phillip-ops,2,0.00046,67130,15.49602,433208
7008,philomory,2,0.00046,67132,15.49648,433208
7009,philwelz,2,0.00046,67134,15.49694,433208
7010,phuongleeo,2,0.00046,67136,15.49741,433208
7011,pie-r,2,0.00046,67138,15.49787,433208
7012,pikot,2,0.00046,67140,15.49833,433208
7013,pinglin,2,0.00046,67142,15.49879,433208
7014,pinzhourk,2,0.00046,67144,15.49925,433208
7015,PiotrKlimczak,2,0.00046,67146,15.49971,433208
7016,Pippinuk,2,0.00046,67148,15.50018,433208
7017,pjaitken,2,0.00046,67150,15.50064,433208
7018,pjan,2,0.00046,67152,15.50110,433208
7019,pkosiec,2,0.00046,67154,15.50156,433208
7020,pkoushik,2,0.00046,67156,15.50202,433208
7021,PlatanoBailando,2,0.00046,67158,15.50248,433208
7022,platoputhur,2,0.00046,67160,15.50295,433208
7023,plod,2,0.00046,67162,15.50341,433208
7024,pmorelli92,2,0.00046,67164,15.50387,433208
7025,pnavais,2,0.00046,67166,15.50433,433208
7026,PoeBlu,2,0.00046,67168,15.50479,433208
7027,poga,2,0.00046,67170,15.50525,433208
7028,poldueta,2,0.00046,67172,15.50572,433208
7029,policeman-kh,2,0.00046,67174,15.50618,433208
7030,PoojaChandak,2,0.00046,67176,15.50664,433208
7031,prablr79,2,0.00046,67178,15.50710,433208
7032,prafull11,2,0.00046,67180,15.50756,433208
7033,prakasa-tkpd,2,0.00046,67182,15.50802,433208
7034,prakashshp92,2,0.00046,67184,15.50849,433208
7035,prathap-pft,2,0.00046,67186,15.50895,433208
7036,pratik5156,2,0.00046,67188,15.50941,433208
7037,predakanga,2,0.00046,67190,15.50987,433208
7038,previ,2,0.00046,67192,15.51033,433208
7039,prince286,2,0.00046,67194,15.51079,433208
7040,printfshen,2,0.00046,67196,15.51126,433208
7041,PriyaKaushik890,2,0.00046,67198,15.51172,433208
7042,ProcedureMonkeyB,2,0.00046,67200,15.51218,433208
7043,procodr,2,0.00046,67202,15.51264,433208
7044,proserie,2,0.00046,67204,15.51310,433208
7045,provPaulBrousseau,2,0.00046,67206,15.51356,433208
7046,Pryz,2,0.00046,67208,15.51403,433208
7047,ps142020,2,0.00046,67210,15.51449,433208
7048,pschulten,2,0.00046,67212,15.51495,433208
7049,pugangxa,2,0.00046,67214,15.51541,433208
7050,pugkung,2,0.00046,67216,15.51587,433208
7051,pulkitmehra,2,0.00046,67218,15.51633,433208
7052,purDgr8,2,0.00046,67220,15.51680,433208
7053,pure-zero,2,0.00046,67222,15.51726,433208
7054,pvyaka01,2,0.00046,67224,15.51772,433208
7055,pw24,2,0.00046,67226,15.51818,433208
7056,pwall-tyro,2,0.00046,67228,15.51864,433208
7057,pyssling,2,0.00046,67230,15.51910,433208
7058,pzmi,2,0.00046,67232,15.51957,433208
7059,qcastel,2,0.00046,67234,15.52003,433208
7060,qinggniq,2,0.00046,67236,15.52049,433208
7061,Qquanwei,2,0.00046,67238,15.52095,433208
7062,quanbisen,2,0.00046,67240,15.52141,433208
7063,Quarky9,2,0.00046,67242,15.52187,433208
7064,quentinalbertone,2,0.00046,67244,15.52234,433208
7065,quyettv-1583,2,0.00046,67246,15.52280,433208
7066,RaeShelly,2,0.00046,67248,15.52326,433208
7067,rafael-brandao,2,0.00046,67250,15.52372,433208
7068,rafedramzi,2,0.00046,67252,15.52418,433208
7069,Raffa50,2,0.00046,67254,15.52464,433208
7070,Rafficer,2,0.00046,67256,15.52511,433208
7071,RageZBla,2,0.00046,67258,15.52557,433208
7072,ragyibrahimRNA,2,0.00046,67260,15.52603,433208
7073,rahul342,2,0.00046,67262,15.52649,433208
7074,rahullalwani2717,2,0.00046,67264,15.52695,433208
7075,rahulshivan05,2,0.00046,67266,15.52741,433208
7076,rainahtdm,2,0.00046,67268,15.52788,433208
7077,rainlake,2,0.00046,67270,15.52834,433208
7078,rajasaur,2,0.00046,67272,15.52880,433208
7079,rajeshdevops87,2,0.00046,67274,15.52926,433208
7080,rajma,2,0.00046,67276,15.52972,433208
7081,ramachaitanyak,2,0.00046,67278,15.53018,433208
7082,ramandeep-singh-1983,2,0.00046,67280,15.53065,433208
7083,ramanenka,2,0.00046,67282,15.53111,433208
7084,Ramblurr,2,0.00046,67284,15.53157,433208
7085,rameshpitchaiah,2,0.00046,67286,15.53203,433208
7086,ramrodo,2,0.00046,67288,15.53249,433208
7087,ranand20,2,0.00046,67290,15.53295,433208
7088,ranchersvet,2,0.00046,67292,15.53342,433208
7089,Rand01ph,2,0.00046,67294,15.53388,433208
7090,randomchance,2,0.00046,67296,15.53434,433208
7091,raosumanth,2,0.00046,67298,15.53480,433208
7092,rasenplanscher,2,0.00046,67300,15.53526,433208
7093,ravigude,2,0.00046,67302,15.53572,433208
7094,ravikumarmistry,2,0.00046,67304,15.53619,433208
7095,ravilach,2,0.00046,67306,15.53665,433208
7096,ravindrabhargava,2,0.00046,67308,15.53711,433208
7097,rayanebel,2,0.00046,67310,15.53757,433208
7098,RaymondAudet,2,0.00046,67312,15.53803,433208
7099,rbenzair,2,0.00046,67314,15.53849,433208
7100,rbissey-axway,2,0.00046,67316,15.53896,433208
7101,rboal,2,0.00046,67318,15.53942,433208
7102,rbrishabh,2,0.00046,67320,15.53988,433208
7103,rchenzheng,2,0.00046,67322,15.54034,433208
7104,rdagnelie,2,0.00046,67324,15.54080,433208
7105,recurlybrad,2,0.00046,67326,15.54126,433208
7106,redbeard0x0a,2,0.00046,67328,15.54173,433208
7107,rediphone,2,0.00046,67330,15.54219,433208
7108,redtex,2,0.00046,67332,15.54265,433208
7109,redthor,2,0.00046,67334,15.54311,433208
7110,rektide,2,0.00046,67336,15.54357,433208
7111,renanqts,2,0.00046,67338,15.54403,433208
7112,renatosuero,2,0.00046,67340,15.54450,433208
7113,renier,2,0.00046,67342,15.54496,433208
7114,rerime,2,0.00046,67344,15.54542,433208
7115,reselbobasg,2,0.00046,67346,15.54588,433208
7116,reubit,2,0.00046,67348,15.54634,433208
7117,reza-shamsi-monaef,2,0.00046,67350,15.54680,433208
7118,rficcaglia,2,0.00046,67352,15.54727,433208
7119,rgachet,2,0.00046,67354,15.54773,433208
7120,rgo3,2,0.00046,67356,15.54819,433208
7121,rgstephens,2,0.00046,67358,15.54865,433208
7122,rhthaakkar,2,0.00046,67360,15.54911,433208
7123,rhtyd,2,0.00046,67362,15.54957,433208
7124,RhynoVDS,2,0.00046,67364,15.55004,433208
7125,rhzs,2,0.00046,67366,15.55050,433208
7126,riccardomurri,2,0.00046,67368,15.55096,433208
7127,rickdonato,2,0.00046,67370,15.55142,433208
7128,rickwebiii,2,0.00046,67372,15.55188,433208
7129,rikkuness,2,0.00046,67374,15.55234,433208
7130,Rimjhim-Dey,2,0.00046,67376,15.55281,433208
7131,Rishi-coder11,2,0.00046,67378,15.55327,433208
7132,ritwik12,2,0.00046,67380,15.55373,433208
7133,Riyan-Rickson,2,0.00046,67382,15.55419,433208
7134,rjean-gilles,2,0.00046,67384,15.55465,433208
7135,rjl79,2,0.00046,67386,15.55511,433208
7136,rlabrecque,2,0.00046,67388,15.55558,433208
7137,rmontenegroo,2,0.00046,67390,15.55604,433208
7138,rmorampudi,2,0.00046,67392,15.55650,433208
7139,rnkhouse,2,0.00046,67394,15.55696,433208
7140,rnwolfe,2,0.00046,67396,15.55742,433208
7141,robber-chan,2,0.00046,67398,15.55788,433208
7142,RobbieMcKinstry,2,0.00046,67400,15.55835,433208
7143,robbo10,2,0.00046,67402,15.55881,433208
7144,Roberdvs,2,0.00046,67404,15.55927,433208
7145,robermar23,2,0.00046,67406,15.55973,433208
7146,robertb724,2,0.00046,67408,15.56019,433208
7147,roberttco,2,0.00046,67410,15.56065,433208
7148,robertvanloenhout,2,0.00046,67412,15.56112,433208
7149,robhunt3r,2,0.00046,67414,15.56158,433208
7150,robinp-tw,2,0.00046,67416,15.56204,433208
7151,robjtede,2,0.00046,67418,15.56250,433208
7152,rockettomatooo,2,0.00046,67420,15.56296,433208
7153,rodnymolina,2,0.00046,67422,15.56342,433208
7154,rodrigopandini,2,0.00046,67424,15.56389,433208
7155,rofra,2,0.00046,67426,15.56435,433208
7156,rogerioefonseca,2,0.00046,67428,15.56481,433208
7157,rohan2794,2,0.00046,67430,15.56527,433208
7158,rohanmangal,2,0.00046,67432,15.56573,433208
7159,rohansadale,2,0.00046,67434,15.56619,433208
7160,rojomisin,2,0.00046,67436,15.56666,433208
7161,RolandMa1986,2,0.00046,67438,15.56712,433208
7162,RomanKisilenko,2,0.00046,67440,15.56758,433208
7163,Romiko,2,0.00046,67442,15.56804,433208
7164,romnnn,2,0.00046,67444,15.56850,433208
7165,ron1,2,0.00046,67446,15.56896,433208
7166,RossyWhite,2,0.00046,67448,15.56943,433208
7167,rpthms,2,0.00046,67450,15.56989,433208
7168,rrichardson,2,0.00046,67452,15.57035,433208
7169,rsandhu2,2,0.00046,67454,15.57081,433208
7170,rsicart,2,0.00046,67456,15.57127,433208
7171,rsjohn,2,0.00046,67458,15.57173,433208
7172,RSMIT01,2,0.00046,67460,15.57220,433208
7173,rstefan1,2,0.00046,67462,15.57266,433208
7174,rtchinnachot,2,0.00046,67464,15.57312,433208
7175,ruanchen,2,0.00046,67466,15.57358,433208
7176,ruben-ojeda-mednax,2,0.00046,67468,15.57404,433208
7177,rubensayshi,2,0.00046,67470,15.57450,433208
7178,ruchikaguptaa,2,0.00046,67472,15.57497,433208
7179,rudo-thomas,2,0.00046,67474,15.57543,433208
7180,rudym,2,0.00046,67476,15.57589,433208
7181,ruettere,2,0.00046,67478,15.57635,433208
7182,rugved-mahamune,2,0.00046,67480,15.57681,433208
7183,Ruide,2,0.00046,67482,15.57727,433208
7184,ruirui9,2,0.00046,67484,15.57774,433208
7185,rupang790,2,0.00046,67486,15.57820,433208
7186,RussellTaylor83,2,0.00046,67488,15.57866,433208
7187,rustyx,2,0.00046,67490,15.57912,433208
7188,ruudvanderweijde,2,0.00046,67492,15.57958,433208
7189,rvaidya,2,0.00046,67494,15.58004,433208
7190,rwrr,2,0.00046,67496,15.58051,433208
7191,ryan-a-baker,2,0.00046,67498,15.58097,433208
7192,RyanAoh,2,0.00046,67500,15.58143,433208
7193,rybbchao,2,0.00046,67502,15.58189,433208
7194,RyPeck,2,0.00046,67504,15.58235,433208
7195,ryuichi1208,2,0.00046,67506,15.58281,433208
7196,s97712,2,0.00046,67508,15.58328,433208
7197,saadlu,2,0.00046,67510,15.58374,433208
7198,sabarnwa,2,0.00046,67512,15.58420,433208
7199,sabbadino,2,0.00046,67514,15.58466,433208
7200,sabriel27,2,0.00046,67516,15.58512,433208
7201,sachinkumarsingh092,2,0.00046,67518,15.58558,433208
7202,sachrajneesh,2,0.00046,67520,15.58605,433208
7203,Saddamus,2,0.00046,67522,15.58651,433208
7204,sadedil,2,0.00046,67524,15.58697,433208
7205,saggzz,2,0.00046,67526,15.58743,433208
7206,saithejareddy,2,0.00046,67528,15.58789,433208
7207,sajtrus,2,0.00046,67530,15.58835,433208
7208,sakaia-test,2,0.00046,67532,15.58882,433208
7209,salonigoyal2309,2,0.00046,67534,15.58928,433208
7210,sam-2200,2,0.00046,67536,15.58974,433208
7211,SamDecrock,2,0.00046,67538,15.59020,433208
7212,SamsonNelson,2,0.00046,67540,15.59066,433208
7213,samstride,2,0.00046,67542,15.59112,433208
7214,SandeepGamot,2,0.00046,67544,15.59159,433208
7215,sandrogiacom,2,0.00046,67546,15.59205,433208
7216,sandstroms,2,0.00046,67548,15.59251,433208
7217,SangtaniAryan,2,0.00046,67550,15.59297,433208
7218,sanigo,2,0.00046,67552,15.59343,433208
7219,santhosh256,2,0.00046,67554,15.59389,433208
7220,SanyamGulati,2,0.00046,67556,15.59436,433208
7221,sardella,2,0.00046,67558,15.59482,433208
7222,sarialem,2,0.00046,67560,15.59528,433208
7223,sarkarsaurabh27,2,0.00046,67562,15.59574,433208
7224,sarthakvarshney8081,2,0.00046,67564,15.59620,433208
7225,sarvaniy,2,0.00046,67566,15.59666,433208
7226,satyasure,2,0.00046,67568,15.59713,433208
7227,SatyKrish,2,0.00046,67570,15.59759,433208
7228,sauber,2,0.00046,67572,15.59805,433208
7229,saumas,2,0.00046,67574,15.59851,433208
7230,SaveethaRavi,2,0.00046,67576,15.59897,433208
7231,savind,2,0.00046,67578,15.59943,433208
7232,sayanibhattacharjee,2,0.00046,67580,15.59990,433208
7233,Sayanta66,2,0.00046,67582,15.60036,433208
7234,sazzle2611,2,0.00046,67584,15.60082,433208
7235,sbalinen,2,0.00046,67586,15.60128,433208
7236,sbhaita,2,0.00046,67588,15.60174,433208
7237,SBNTT,2,0.00046,67590,15.60220,433208
7238,sccalabr,2,0.00046,67592,15.60267,433208
7239,schewara,2,0.00046,67594,15.60313,433208
7240,schmichri,2,0.00046,67596,15.60359,433208
7241,schmurfy,2,0.00046,67598,15.60405,433208
7242,sclark39,2,0.00046,67600,15.60451,433208
7243,scodeman,2,0.00046,67602,15.60497,433208
7244,Scong,2,0.00046,67604,15.60544,433208
7245,scott-grimes,2,0.00046,67606,15.60590,433208
7246,scottmalkie,2,0.00046,67608,15.60636,433208
7247,scuzhanglei,2,0.00046,67610,15.60682,433208
7248,sdanieru,2,0.00046,67612,15.60728,433208
7249,sdjdd,2,0.00046,67614,15.60775,433208
7250,sdsantos,2,0.00046,67616,15.60821,433208
7251,sdwerwed,2,0.00046,67618,15.60867,433208
7252,se7en102,2,0.00046,67620,15.60913,433208
7253,Seabizkit,2,0.00046,67622,15.60959,433208
7254,SeagleLiu,2,0.00046,67624,15.61005,433208
7255,seankhliao,2,0.00046,67626,15.61052,433208
7256,SeanKnight,2,0.00046,67628,15.61098,433208
7257,seanschade,2,0.00046,67630,15.61144,433208
7258,sean-zou,2,0.00046,67632,15.61190,433208
7259,sebastianguzera,2,0.00046,67634,15.61236,433208
7260,SebastienHo,2,0.00046,67636,15.61282,433208
7261,Selikoff,2,0.00046,67638,15.61329,433208
7262,selinsezi,2,0.00046,67640,15.61375,433208
7263,serain,2,0.00046,67642,15.61421,433208
7264,sergey-onanchenko,2,0.00046,67644,15.61467,433208
7265,sergkkaltura,2,0.00046,67646,15.61513,433208
7266,Serrvosky,2,0.00046,67648,15.61559,433208
7267,serverglen,2,0.00046,67650,15.61606,433208
7268,sethbergman,2,0.00046,67652,15.61652,433208
7269,sethgrid,2,0.00046,67654,15.61698,433208
7270,sevaho,2,0.00046,67656,15.61744,433208
7271,sfc-gh-mgarda,2,0.00046,67658,15.61790,433208
7272,sf-eng,2,0.00046,67660,15.61836,433208
7273,sfwtoms2030,2,0.00046,67662,15.61883,433208
7274,sgloutnikov,2,0.00046,67664,15.61929,433208
7275,sgreene570,2,0.00046,67666,15.61975,433208
7276,Shadrocks,2,0.00046,67668,15.62021,433208
7277,shaggygi,2,0.00046,67670,15.62067,433208
7278,shahaf600,2,0.00046,67672,15.62113,433208
7279,shaharr-ma,2,0.00046,67674,15.62160,433208
7280,shailegu,2,0.00046,67676,15.62206,433208
7281,shane-yuan,2,0.00046,67678,15.62252,433208
7282,shankar95raju,2,0.00046,67680,15.62298,433208
7283,shankar96,2,0.00046,67682,15.62344,433208
7284,shanmukha511,2,0.00046,67684,15.62390,433208
7285,Shaofa,2,0.00046,67686,15.62437,433208
7286,sharvilak11,2,0.00046,67688,15.62483,433208
7287,shashiik,2,0.00046,67690,15.62529,433208
7288,shaunofneuron,2,0.00046,67692,15.62575,433208
7289,shayan09,2,0.00046,67694,15.62621,433208
7290,shayanjalil,2,0.00046,67696,15.62667,433208
7291,shayfisher,2,0.00046,67698,15.62714,433208
7292,shekarchandra,2,0.00046,67700,15.62760,433208
7293,shekhar-d,2,0.00046,67702,15.62806,433208
7294,Sherlock-Harden,2,0.00046,67704,15.62852,433208
7295,Sherman-Chata,2,0.00046,67706,15.62898,433208
7296,shivamSharmaMWP,2,0.00046,67708,15.62944,433208
7297,shivaniarbat,2,0.00046,67710,15.62991,433208
7298,sho-abe,2,0.00046,67712,15.63037,433208
7299,shogo82148,2,0.00046,67714,15.63083,433208
7300,Shohou,2,0.00046,67716,15.63129,433208
7301,ShotaKitazawa,2,0.00046,67718,15.63175,433208
7302,shotu,2,0.00046,67720,15.63221,433208
7303,showsmall,2,0.00046,67722,15.63268,433208
7304,Shraddhak22,2,0.00046,67724,15.63314,433208
7305,shrikantumadi,2,0.00046,67726,15.63360,433208
7306,shrivastavshubham34,2,0.00046,67728,15.63406,433208
7307,shuaichang,2,0.00046,67730,15.63452,433208
7308,shubhamdang,2,0.00046,67732,15.63498,433208
7309,shubhrajoy2109,2,0.00046,67734,15.63545,433208
7310,shuijing198799,2,0.00046,67736,15.63591,433208
7311,shumiao,2,0.00046,67738,15.63637,433208
7312,shyimo,2,0.00046,67740,15.63683,433208
7313,siadark,2,0.00046,67742,15.63729,433208
7314,siddheshbhasme,2,0.00046,67744,15.63775,433208
7315,sidhantbhayana,2,0.00046,67746,15.63822,433208
7316,sigfridh,2,0.00046,67748,15.63868,433208
7317,sikasam,2,0.00046,67750,15.63914,433208
7318,simhnna,2,0.00046,67752,15.63960,433208
7319,SimonHeimberg,2,0.00046,67754,15.64006,433208
7320,simon-swanson-leapyear,2,0.00046,67756,15.64052,433208
7321,SimonWang2007,2,0.00046,67758,15.64099,433208
7322,simonxmh,2,0.00046,67760,15.64145,433208
7323,simox-83,2,0.00046,67762,15.64191,433208
7324,SimpCosm,2,0.00046,67764,15.64237,433208
7325,sinycn,2,0.00046,67766,15.64283,433208
7326,siqusoft,2,0.00046,67768,15.64329,433208
7327,sirkubax,2,0.00046,67770,15.64376,433208
7328,sithembiso,2,0.00046,67772,15.64422,433208
7329,sivaguru-nathan,2,0.00046,67774,15.64468,433208
7330,sivaswami,2,0.00046,67776,15.64514,433208
7331,sixcorners,2,0.00046,67778,15.64560,433208
7332,siying,2,0.00046,67780,15.64606,433208
7333,sjentzsch,2,0.00046,67782,15.64653,433208
7334,sk2991,2,0.00046,67784,15.64699,433208
7335,skashyap7,2,0.00046,67786,15.64745,433208
7336,ske5074,2,0.00046,67788,15.64791,433208
7337,skogta,2,0.00046,67790,15.64837,433208
7338,sl805,2,0.00046,67792,15.64883,433208
7339,slapula,2,0.00046,67794,15.64930,433208
7340,SlashTeen,2,0.00046,67796,15.64976,433208
7341,slayer,2,0.00046,67798,15.65022,433208
7342,SleepyBrett,2,0.00046,67800,15.65068,433208
7343,Sleepy-GH,2,0.00046,67802,15.65114,433208
7344,slimm609,2,0.00046,67804,15.65160,433208
7345,sljeff,2,0.00046,67806,15.65207,433208
7346,sl-maximevendrand,2,0.00046,67808,15.65253,433208
7347,slnnk,2,0.00046,67810,15.65299,433208
7348,smartkuk,2,0.00046,67812,15.65345,433208
7349,smax48,2,0.00046,67814,15.65391,433208
7350,smg-bg,2,0.00046,67816,15.65437,433208
7351,SmileCaoJ,2,0.00046,67818,15.65484,433208
7352,snehalbiju12,2,0.00046,67820,15.65530,433208
7353,snevilleshinn,2,0.00046,67822,15.65576,433208
7354,snowmansora,2,0.00046,67824,15.65622,433208
7355,snuglove,2,0.00046,67826,15.65668,433208
7356,socketpair,2,0.00046,67828,15.65714,433208
7357,Soha-Albaghdady,2,0.00046,67830,15.65761,433208
7358,soilerl,2,0.00046,67832,15.65807,433208
7359,som2014,2,0.00046,67834,15.65853,433208
7360,somnathpawar,2,0.00046,67836,15.65899,433208
7361,sonisaurabh19,2,0.00046,67838,15.65945,433208
7362,soslan,2,0.00046,67840,15.65991,433208
7363,sourabhsingh282,2,0.00046,67842,15.66038,433208
7364,sowhat7,2,0.00046,67844,15.66084,433208
7365,sownak,2,0.00046,67846,15.66130,433208
7366,spacem,2,0.00046,67848,15.66176,433208
7367,speed2048,2,0.00046,67850,15.66222,433208
7368,spencergibb,2,0.00046,67852,15.66268,433208
7369,SpencerHehl,2,0.00046,67854,15.66315,433208
7370,spikewang,2,0.00046,67856,15.66361,433208
7371,spiritedfang,2,0.00046,67858,15.66407,433208
7372,spiritman1990,2,0.00046,67860,15.66453,433208
7373,sppakal,2,0.00046,67862,15.66499,433208
7374,spynode,2,0.00046,67864,15.66545,433208
7375,sramek5,2,0.00046,67866,15.66592,433208
7376,srearnold,2,0.00046,67868,15.66638,433208
7377,srikanthcs,2,0.00046,67870,15.66684,433208
7378,srikaratstrings,2,0.00046,67872,15.66730,433208
7379,srilumpa,2,0.00046,67874,15.66776,433208
7380,Srini-B-GIT,2,0.00046,67876,15.66822,433208
7381,SrishT,2,0.00046,67878,15.66869,433208
7382,ssesha,2,0.00046,67880,15.66915,433208
7383,sshaikh,2,0.00046,67882,15.66961,433208
7384,stanxing,2,0.00046,67884,15.67007,433208
7385,steevi,2,0.00046,67886,15.67053,433208
7386,stefan301,2,0.00046,67888,15.67099,433208
7387,stefanbirkner,2,0.00046,67890,15.67146,433208
7388,stefanhengl,2,0.00046,67892,15.67192,433208
7389,stefanolczak,2,0.00046,67894,15.67238,433208
7390,stephen-dexda,2,0.00046,67896,15.67284,433208
7391,stephenharris,2,0.00046,67898,15.67330,433208
7392,stephenwolfe1,2,0.00046,67900,15.67376,433208
7393,stig,2,0.00046,67902,15.67423,433208
7394,StingyJack,2,0.00046,67904,15.67469,433208
7395,Stogrammus,2,0.00046,67906,15.67515,433208
7396,s-tokutake,2,0.00046,67908,15.67561,433208
7397,strakh-alex,2,0.00046,67910,15.67607,433208
7398,sudevva,2,0.00046,67912,15.67653,433208
7399,sudheshpn,2,0.00046,67914,15.67700,433208
7400,sudhinm,2,0.00046,67916,15.67746,433208
7401,SudoBrendan,2,0.00046,67918,15.67792,433208
7402,sufferpriest,2,0.00046,67920,15.67838,433208
7403,SuganJoe,2,0.00046,67922,15.67884,433208
7404,sujata-sharma,2,0.00046,67924,15.67930,433208
7405,sulenn,2,0.00046,67926,15.67977,433208
7406,Sumindar,2,0.00046,67928,15.68023,433208
7407,sunng87,2,0.00046,67930,15.68069,433208
7408,SunRunAway,2,0.00046,67932,15.68115,433208
7409,superbeer,2,0.00046,67934,15.68161,433208
7410,support-capensis,2,0.00046,67936,15.68207,433208
7411,surajr3,2,0.00046,67938,15.68254,433208
7412,Surajv311,2,0.00046,67940,15.68300,433208
7413,sureshkvl,2,0.00046,67942,15.68346,433208
7414,SurjitCS,2,0.00046,67944,15.68392,433208
7415,Suryanshsasi,2,0.00046,67946,15.68438,433208
7416,sushilsuresh,2,0.00046,67948,15.68484,433208
7417,sutaakar,2,0.00046,67950,15.68531,433208
7418,SuvratAgrawal,2,0.00046,67952,15.68577,433208
7419,svshvets,2,0.00046,67954,15.68623,433208
7420,svswaminathan,2,0.00046,67956,15.68669,433208
7421,swamymsft,2,0.00046,67958,15.68715,433208
7422,swhan91,2,0.00046,67960,15.68761,433208
7423,syl-163,2,0.00046,67962,15.68808,433208
7424,SymbioTekGit,2,0.00046,67964,15.68854,433208
7425,syurchenko,2,0.00046,67966,15.68900,433208
7426,szalapski,2,0.00046,67968,15.68946,433208
7427,szhnet,2,0.00046,67970,15.68992,433208
7428,sztupy,2,0.00046,67972,15.69038,433208
7429,tabka,2,0.00046,67974,15.69085,433208
7430,TaborKelly,2,0.00046,67976,15.69131,433208
7431,tafkam,2,0.00046,67978,15.69177,433208
7432,TagadaPoe,2,0.00046,67980,15.69223,433208
7433,tagoro9,2,0.00046,67982,15.69269,433208
7434,taisph,2,0.00046,67984,15.69315,433208
7435,takryo00,2,0.00046,67986,15.69362,433208
7436,takuhiro,2,0.00046,67988,15.69408,433208
7437,takutakahashi,2,0.00046,67990,15.69454,433208
7438,talmarco,2,0.00046,67992,15.69500,433208
7439,tan31989,2,0.00046,67994,15.69546,433208
7440,tangx,2,0.00046,67996,15.69592,433208
7441,tanrobotix,2,0.00046,67998,15.69639,433208
7442,tanujd11,2,0.00046,68000,15.69685,433208
7443,tanzeelrana,2,0.00046,68002,15.69731,433208
7444,taoyuanyuan,2,0.00046,68004,15.69777,433208
7445,tarasmatsyk,2,0.00046,68006,15.69823,433208
7446,tatodorov,2,0.00046,68008,15.69869,433208
7447,Tatsinnit,2,0.00046,68010,15.69916,433208
7448,taybur43,2,0.00046,68012,15.69962,433208
7449,tbrannam,2,0.00046,68014,15.70008,433208
7450,tcdowney,2,0.00046,68016,15.70054,433208
7451,tcoln,2,0.00046,68018,15.70100,433208
7452,tculp,2,0.00046,68020,15.70146,433208
7453,tdesmet,2,0.00046,68022,15.70193,433208
7454,tdk-github,2,0.00046,68024,15.70239,433208
7455,teamsun-cloud-system,2,0.00046,68026,15.70285,433208
7456,tecoholic,2,0.00046,68028,15.70331,433208
7457,tehho,2,0.00046,68030,15.70377,433208
7458,tehleet,2,0.00046,68032,15.70423,433208
7459,TemaSM,2,0.00046,68034,15.70470,433208
7460,tempacct4q,2,0.00046,68036,15.70516,433208
7461,teng1,2,0.00046,68038,15.70562,433208
7462,TeruakiNoyama,2,0.00046,68040,15.70608,433208
7463,teruyam,2,0.00046,68042,15.70654,433208
7464,Th0masL,2,0.00046,68044,15.70700,433208
7465,thanhlong9x,2,0.00046,68046,15.70747,433208
7466,thanhvoquang,2,0.00046,68048,15.70793,433208
7467,thapakazi,2,0.00046,68050,15.70839,433208
7468,thardie,2,0.00046,68052,15.70885,433208
7469,thefuyang,2,0.00046,68054,15.70931,433208
7470,theis188,2,0.00046,68056,15.70977,433208
7471,thejasbabu,2,0.00046,68058,15.71024,433208
7472,TheKangaroo,2,0.00046,68060,15.71070,433208
7473,thekey78,2,0.00046,68062,15.71116,433208
7474,thekovach,2,0.00046,68064,15.71162,433208
7475,theobarberbany,2,0.00046,68066,15.71208,433208
7476,thesamet,2,0.00046,68068,15.71254,433208
7477,thestarmaker,2,0.00046,68070,15.71301,433208
7478,Thesykan,2,0.00046,68072,15.71347,433208
7479,thgao,2,0.00046,68074,15.71393,433208
7480,thiDucTran,2,0.00046,68076,15.71439,433208
7481,thisisabhishek,2,0.00046,68078,15.71485,433208
7482,thlassche,2,0.00046,68080,15.71531,433208
7483,thomasdanan,2,0.00046,68082,15.71578,433208
7484,thomasjo,2,0.00046,68084,15.71624,433208
7485,thomasstorm,2,0.00046,68086,15.71670,433208
7486,thsnr,2,0.00046,68088,15.71716,433208
7487,tianxiaoliang,2,0.00046,68090,15.71762,433208
7488,tibers,2,0.00046,68092,15.71808,433208
7489,tibin-mfl,2,0.00046,68094,15.71855,433208
7490,Ticiano-mw,2,0.00046,68096,15.71901,433208
7491,TieSKey,2,0.00046,68098,15.71947,433208
7492,timecast,2,0.00046,68100,15.71993,433208
7493,TimothyMothra,2,0.00046,68102,15.72039,433208
7494,tinder-jonathanmayehobbs,2,0.00046,68104,15.72085,433208
7495,tinder-mattheworlove,2,0.00046,68106,15.72132,433208
7496,tinder-yukisawa,2,0.00046,68108,15.72178,433208
7497,Tirano2150,2,0.00046,68110,15.72224,433208
7498,tiyto,2,0.00046,68112,15.72270,433208
7499,tjkirch,2,0.00046,68114,15.72316,433208
7500,tkdp,2,0.00046,68116,15.72362,433208
7501,tle209,2,0.00046,68118,15.72409,433208
7502,tlex,2,0.00046,68120,15.72455,433208
7503,tmegow,2,0.00046,68122,15.72501,433208
7504,tmella,2,0.00046,68124,15.72547,433208
7505,tmiklu,2,0.00046,68126,15.72593,433208
7506,tnimni,2,0.00046,68128,15.72639,433208
7507,tnixa,2,0.00046,68130,15.72686,433208
7508,tnxgalaxy,2,0.00046,68132,15.72732,433208
7509,tobiasdziekanowski,2,0.00046,68134,15.72778,433208
7510,tobylo,2,0.00046,68136,15.72824,433208
7511,tocy1,2,0.00046,68138,15.72870,433208
7512,todaywasawesome,2,0.00046,68140,15.72916,433208
7513,tomas321,2,0.00046,68142,15.72963,433208
7514,tomhouweling1987,2,0.00046,68144,15.73009,433208
7515,tomjones2a,2,0.00046,68146,15.73055,433208
7516,tomkivlin,2,0.00046,68148,15.73101,433208
7517,TomL-dev,2,0.00046,68150,15.73147,433208
7518,toneill818,2,0.00046,68152,15.73193,433208
7519,tongying123456,2,0.00046,68154,15.73240,433208
7520,tonyredondo,2,0.00046,68156,15.73286,433208
7521,tooooots,2,0.00046,68158,15.73332,433208
7522,tordsson,2,0.00046,68160,15.73378,433208
7523,tores1,2,0.00046,68162,15.73424,433208
7524,torilabs,2,0.00046,68164,15.73470,433208
7525,torjue,2,0.00046,68166,15.73517,433208
7526,TothFerenc,2,0.00046,68168,15.73563,433208
7527,Tovi163,2,0.00046,68170,15.73609,433208
7528,towens,2,0.00046,68172,15.73655,433208
7529,tpihl,2,0.00046,68174,15.73701,433208
7530,tpppppub,2,0.00046,68176,15.73747,433208
7531,TPX01,2,0.00046,68178,15.73794,433208
7532,tranquyetdev,2,0.00046,68180,15.73840,433208
7533,trentis,2,0.00046,68182,15.73886,433208
7534,tretos53,2,0.00046,68184,15.73932,433208
7535,Treyone,2,0.00046,68186,15.73978,433208
7536,troygraben,2,0.00046,68188,15.74024,433208
7537,troytop,2,0.00046,68190,15.74071,433208
7538,truealex81,2,0.00046,68192,15.74117,433208
7539,tskdsb,2,0.00046,68194,15.74163,433208
7540,tsunamishaun,2,0.00046,68196,15.74209,433208
7541,tsunny,2,0.00046,68198,15.74255,433208
7542,ttreuthardt,2,0.00046,68200,15.74301,433208
7543,tuannh99,2,0.00046,68202,15.74348,433208
7544,tugtugtug,2,0.00046,68204,15.74394,433208
7545,tulequ,2,0.00046,68206,15.74440,433208
7546,tw666,2,0.00046,68208,15.74486,433208
7547,twendt,2,0.00046,68210,15.74532,433208
7548,TwoStone,2,0.00046,68212,15.74578,433208
7549,twothumbs,2,0.00046,68214,15.74625,433208
7550,txr150430,2,0.00046,68216,15.74671,433208
7551,txynidakis,2,0.00046,68218,15.74717,433208
7552,typecampo,2,0.00046,68220,15.74763,433208
7553,Tyrael,2,0.00046,68222,15.74809,433208
7554,tzehetner,2,0.00046,68224,15.74855,433208
7555,uberspot,2,0.00046,68226,15.74902,433208
7556,uGiFarukh,2,0.00046,68228,15.74948,433208
7557,UkonnRa,2,0.00046,68230,15.74994,433208
7558,Ulanmax,2,0.00046,68232,15.75040,433208
7559,ulm0,2,0.00046,68234,15.75086,433208
7560,ultraji,2,0.00046,68236,15.75132,433208
7561,umangj28,2,0.00046,68238,15.75179,433208
7562,umezawatakeshi,2,0.00046,68240,15.75225,433208
7563,Unichron,2,0.00046,68242,15.75271,433208
7564,unikzforce,2,0.00046,68244,15.75317,433208
7565,unixlab,2,0.00046,68246,15.75363,433208
7566,unludo,2,0.00046,68248,15.75410,433208
7567,unonasoft,2,0.00046,68250,15.75456,433208
7568,upsuper,2,0.00046,68252,15.75502,433208
7569,uselessscat,2,0.00046,68254,15.75548,433208
7570,Usharaniaswa,2,0.00046,68256,15.75594,433208
7571,Va1,2,0.00046,68258,15.75640,433208
7572,vadbluedata,2,0.00046,68260,15.75687,433208
7573,Vadim-Zenin,2,0.00046,68262,15.75733,433208
7574,Vaibhavipadamwar,2,0.00046,68264,15.75779,433208
7575,vainkop,2,0.00046,68266,15.75825,433208
7576,vamc19,2,0.00046,68268,15.75871,433208
7577,Vanclief,2,0.00046,68270,15.75917,433208
7578,vardans6,2,0.00046,68272,15.75964,433208
7579,vctrferreira,2,0.00046,68274,15.76010,433208
7580,vd-rd,2,0.00046,68276,15.76056,433208
7581,vdups,2,0.00046,68278,15.76102,433208
7582,Vedadiyan,2,0.00046,68280,15.76148,433208
7583,vedvarshith,2,0.00046,68282,15.76194,433208
7584,veer123prathap,2,0.00046,68284,15.76241,433208
7585,veggiemonk,2,0.00046,68286,15.76287,433208
7586,VengefulAncient,2,0.00046,68288,15.76333,433208
7587,VenkateshSrini,2,0.00046,68290,15.76379,433208
7588,venkattech3889,2,0.00046,68292,15.76425,433208
7589,venksel,2,0.00046,68294,15.76471,433208
7590,vepatel,2,0.00046,68296,15.76518,433208
7591,verysonglaa,2,0.00046,68298,15.76564,433208
7592,VGerris,2,0.00046,68300,15.76610,433208
7593,viacheslave,2,0.00046,68302,15.76656,433208
7594,ViBiOh,2,0.00046,68304,15.76702,433208
7595,VictorRobellini,2,0.00046,68306,15.76748,433208
7596,victorv587,2,0.00046,68308,15.76795,433208
7597,victorvarias,2,0.00046,68310,15.76841,433208
7598,vijay-veeranki,2,0.00046,68312,15.76887,433208
7599,vijesh12,2,0.00046,68314,15.76933,433208
7600,vikas28km1,2,0.00046,68316,15.76979,433208
7601,vikashyy08961,2,0.00046,68318,15.77025,433208
7602,vikaslaad,2,0.00046,68320,15.77072,433208
7603,vikas-shaw,2,0.00046,68322,15.77118,433208
7604,Vinay328,2,0.00046,68324,15.77164,433208
7605,vinayak017,2,0.00046,68326,15.77210,433208
7606,vinaykv1991,2,0.00046,68328,15.77256,433208
7607,vinaymorkar,2,0.00046,68330,15.77302,433208
7608,vince329,2,0.00046,68332,15.77349,433208
7609,VincentGuoCQ,2,0.00046,68334,15.77395,433208
7610,vincenzoSantonastasoGithub,2,0.00046,68336,15.77441,433208
7611,viorelflorian,2,0.00046,68338,15.77487,433208
7612,vip30,2,0.00046,68340,15.77533,433208
7613,vip8439,2,0.00046,68342,15.77579,433208
7614,virgosnail,2,0.00046,68344,15.77626,433208
7615,vishalcs05,2,0.00046,68346,15.77672,433208
7616,vishalk663,2,0.00046,68348,15.77718,433208
7617,VishalYesurkar02,2,0.00046,68350,15.77764,433208
7618,visortelle,2,0.00046,68352,15.77810,433208
7619,VivekMittals,2,0.00046,68354,15.77856,433208
7620,vk-cmd,2,0.00046,68356,15.77903,433208
7621,vladdy,2,0.00046,68358,15.77949,433208
7622,vladh91,2,0.00046,68360,15.77995,433208
7623,Vlli,2,0.00046,68362,15.78041,433208
7624,vmohariya,2,0.00046,68364,15.78087,433208
7625,vmorris,2,0.00046,68366,15.78133,433208
7626,vnline,2,0.00046,68368,15.78180,433208
7627,voldemortensen,2,0.00046,68370,15.78226,433208
7628,volezheng,2,0.00046,68372,15.78272,433208
7629,volmab,2,0.00046,68374,15.78318,433208
7630,vsinghal13,2,0.00046,68376,15.78364,433208
7631,vugardzhamalov,2,0.00046,68378,15.78410,433208
7632,vvngmn,2,0.00046,68380,15.78457,433208
7633,vzoom96,2,0.00046,68382,15.78503,433208
7634,w1593950,2,0.00046,68384,15.78549,433208
7635,walkerdu,2,0.00046,68386,15.78595,433208
7636,wangdwcsd,2,0.00046,68388,15.78641,433208
7637,wangggong,2,0.00046,68390,15.78687,433208
7638,wanghaifeng,2,0.00046,68392,15.78734,433208
7639,wanghe-fit2cloud,2,0.00046,68394,15.78780,433208
7640,wangjia184,2,0.00046,68396,15.78826,433208
7641,wangkai1994,2,0.00046,68398,15.78872,433208
7642,wangrzneu,2,0.00046,68400,15.78918,433208
7643,wangweihong,2,0.00046,68402,15.78964,433208
7644,wavezhang,2,0.00046,68404,15.79011,433208
7645,waynr,2,0.00046,68406,15.79057,433208
7646,Weasy666,2,0.00046,68408,15.79103,433208
7647,wenjiehs,2,0.00046,68410,15.79149,433208
7648,wgebis,2,0.00046,68412,15.79195,433208
7649,Whazor,2,0.00046,68414,15.79241,433208
7650,wheelpharaoh,2,0.00046,68416,15.79288,433208
7651,whiskerch,2,0.00046,68418,15.79334,433208
7652,whitecolor,2,0.00046,68420,15.79380,433208
7653,whitlaaa,2,0.00046,68422,15.79426,433208
7654,whwalter,2,0.00046,68424,15.79472,433208
7655,wiesa1,2,0.00046,68426,15.79518,433208
7656,WilliamABradley,2,0.00046,68428,15.79565,433208
7657,williamaronli,2,0.00046,68430,15.79611,433208
7658,willie-hsueh-666,2,0.00046,68432,15.79657,433208
7659,Willjay90,2,0.00046,68434,15.79703,433208
7660,win5do,2,0.00046,68436,15.79749,433208
7661,winds6206,2,0.00046,68438,15.79795,433208
7662,winkee01,2,0.00046,68440,15.79842,433208
7663,winster,2,0.00046,68442,15.79888,433208
7664,winternet,2,0.00046,68444,15.79934,433208
7665,WJay-tec,2,0.00046,68446,15.79980,433208
7666,wjn,2,0.00046,68448,15.80026,433208
7667,wknapik,2,0.00046,68450,15.80072,433208
7668,wlopes39,2,0.00046,68452,15.80119,433208
7669,wmcnamee-tunein,2,0.00046,68454,15.80165,433208
7670,WojciechKarpiel,2,0.00046,68456,15.80211,433208
7671,wolfwatch,2,0.00046,68458,15.80257,433208
7672,woniuzhang,2,0.00046,68460,15.80303,433208
7673,wonko,2,0.00046,68462,15.80349,433208
7674,WorldIsM,2,0.00046,68464,15.80396,433208
7675,woto,2,0.00046,68466,15.80442,433208
7676,wtask,2,0.00046,68468,15.80488,433208
7677,wubigo,2,0.00046,68470,15.80534,433208
7678,wuminsure,2,0.00046,68472,15.80580,433208
7679,wxxxx123456,2,0.00046,68474,15.80626,433208
7680,wyaopeng,2,0.00046,68476,15.80673,433208
7681,wylazy,2,0.00046,68478,15.80719,433208
7682,wyzksp,2,0.00046,68480,15.80765,433208
7683,xander-sh,2,0.00046,68482,15.80811,433208
7684,xbmono,2,0.00046,68484,15.80857,433208
7685,Xenon341,2,0.00046,68486,15.80903,433208
7686,xiangwangcheng,2,0.00046,68488,15.80950,433208
7687,XiaochenCui,2,0.00046,68490,15.80996,433208
7688,xiaodongw,2,0.00046,68492,15.81042,433208
7689,xiaoyan-jin,2,0.00046,68494,15.81088,433208
7690,xiechen0692,2,0.00046,68496,15.81134,433208
7691,XinLin,2,0.00046,68498,15.81180,433208
7692,xkeyideal,2,0.00046,68500,15.81227,433208
7693,xlliu,2,0.00046,68502,15.81273,433208
7694,X-Mars,2,0.00046,68504,15.81319,433208
7695,xopham,2,0.00046,68506,15.81365,433208
7696,xuanyunhui,2,0.00046,68508,15.81411,433208
7697,Xunzhuo,2,0.00046,68510,15.81457,433208
7698,xxiao93,2,0.00046,68512,15.81504,433208
7699,xxwassyxx,2,0.00046,68514,15.81550,433208
7700,yacinelazaar,2,0.00046,68516,15.81596,433208
7701,Yalafeg,2,0.00046,68518,15.81642,433208
7702,yamagai,2,0.00046,68520,15.81688,433208
7703,YanChii,2,0.00046,68522,15.81734,433208
7704,Yapcheekian,2,0.00046,68524,15.81781,433208
7705,yardensachs,2,0.00046,68526,15.81827,433208
7706,yaroslava-serdiuk,2,0.00046,68528,15.81873,433208
7707,yash97,2,0.00046,68530,15.81919,433208
7708,yashwanthkalva,2,0.00046,68532,15.81965,433208
7709,yene,2,0.00046,68534,15.82011,433208
7710,YesterdayxD,2,0.00046,68536,15.82058,433208
7711,yingfengxiaowangzi,2,0.00046,68538,15.82104,433208
7712,yingjieLi01,2,0.00046,68540,15.82150,433208
7713,yiye93,2,0.00046,68542,15.82196,433208
7714,ykcilborw,2,0.00046,68544,15.82242,433208
7715,YLonely,2,0.00046,68546,15.82288,433208
7716,ynsta,2,0.00046,68548,15.82335,433208
7717,yoavo-datricks,2,0.00046,68550,15.82381,433208
7718,yogo1212,2,0.00046,68552,15.82427,433208
7719,yoichiwo7,2,0.00046,68554,15.82473,433208
7720,yoninl2,2,0.00046,68556,15.82519,433208
7721,yoni-taranis,2,0.00046,68558,15.82565,433208
7722,yosezky,2,0.00046,68560,15.82612,433208
7723,yosshi825,2,0.00046,68562,15.82658,433208
7724,yoursmanish,2,0.00046,68564,15.82704,433208
7725,ysam12345,2,0.00046,68566,15.82750,433208
7726,ysksuzuki,2,0.00046,68568,15.82796,433208
7727,yteraoka,2,0.00046,68570,15.82842,433208
7728,ythsu,2,0.00046,68572,15.82889,433208
7729,yuanfeilv,2,0.00046,68574,15.82935,433208
7730,yuguorui,2,0.00046,68576,15.82981,433208
7731,yujhe,2,0.00046,68578,15.83027,433208
7732,YujiShen,2,0.00046,68580,15.83073,433208
7733,YunSeongKim7,2,0.00046,68582,15.83119,433208
7734,YuraHrunyk,2,0.00046,68584,15.83166,433208
7735,yuvarajhere,2,0.00046,68586,15.83212,433208
7736,yzargari,2,0.00046,68588,15.83258,433208
7737,YZherebukh,2,0.00046,68590,15.83304,433208
7738,yzz-ihep,2,0.00046,68592,15.83350,433208
7739,ZachCheung,2,0.00046,68594,15.83396,433208
7740,Zachery2008,2,0.00046,68596,15.83443,433208
7741,zachradtka,2,0.00046,68598,15.83489,433208
7742,zaisongz,2,0.00046,68600,15.83535,433208
7743,Zajozor,2,0.00046,68602,15.83581,433208
7744,ZaMaZaN4iK,2,0.00046,68604,15.83627,433208
7745,ZaphodB,2,0.00046,68606,15.83673,433208
7746,zasherif,2,0.00046,68608,15.83720,433208
7747,zatamine,2,0.00046,68610,15.83766,433208
7748,zcchew1202,2,0.00046,68612,15.83812,433208
7749,zdhamasha,2,0.00046,68614,15.83858,433208
7750,Zeencaal,2,0.00046,68616,15.83904,433208
7751,zeevolution,2,0.00046,68618,15.83950,433208
7752,zen-chetan,2,0.00046,68620,15.83997,433208
7753,zenion,2,0.00046,68622,15.84043,433208
7754,zenovicharis,2,0.00046,68624,15.84089,433208
7755,zeodtr,2,0.00046,68626,15.84135,433208
7756,Zetanova,2,0.00046,68628,15.84181,433208
7757,zhanghe9702,2,0.00046,68630,15.84227,433208
7758,zhangkuo1110,2,0.00046,68632,15.84274,433208
7759,ZhangLei-cn,2,0.00046,68634,15.84320,433208
7760,zhangwenwork,2,0.00046,68636,15.84366,433208
7761,zhangxiaogang01,2,0.00046,68638,15.84412,433208
7762,zhaojizhuang,2,0.00046,68640,15.84458,433208
7763,zhouhaibing,2,0.00046,68642,15.84504,433208
7764,zhuboshuai,2,0.00046,68644,15.84551,433208
7765,zhugejingcheng,2,0.00046,68646,15.84597,433208
7766,zhuyanxi,2,0.00046,68648,15.84643,433208
7767,zhxqgithub,2,0.00046,68650,15.84689,433208
7768,zi-l,2,0.00046,68652,15.84735,433208
7769,ZilRan,2,0.00046,68654,15.84781,433208
7770,zizon,2,0.00046,68656,15.84828,433208
7771,ZolotarevIgor-mail-ru,2,0.00046,68658,15.84874,433208
7772,zoltan-fedor,2,0.00046,68660,15.84920,433208
7773,ZongbaoLiu,2,0.00046,68662,15.84966,433208
7774,zs-dima,2,0.00046,68664,15.85012,433208
7775,Zsolt-LazarZsolt,2,0.00046,68666,15.85058,433208
7776,zsyzsqyxc,2,0.00046,68668,15.85105,433208
7777,zw0610,2,0.00046,68670,15.85151,433208
7778,zwj13513118235,2,0.00046,68672,15.85197,433208
7779,zwobill,2,0.00046,68674,15.85243,433208
7780,zx8,2,0.00046,68676,15.85289,433208
7781,zxyxz,2,0.00046,68678,15.85335,433208
7782,zyc-ai,2,0.00046,68680,15.85382,433208
7783,zyf0411,2,0.00046,68682,15.85428,433208
7784,zyjhtangtang,2,0.00046,68684,15.85474,433208
7785,zyxue,2,0.00046,68686,15.85520,433208
7786,00r2,1,0.00023,68687,15.85543,433208
7787,071300726,1,0.00023,68688,15.85566,433208
7788,0902horn,1,0.00023,68689,15.85589,433208
7789,0x1a0b,1,0.00023,68690,15.85612,433208
7790,0x74616e,1,0.00023,68691,15.85636,433208
7791,0xCipher-max,1,0.00023,68692,15.85659,433208
7792,0xFr0zen,1,0.00023,68693,15.85682,433208
7793,0xlen,1,0.00023,68694,15.85705,433208
7794,0xtyls,1,0.00023,68695,15.85728,433208
7795,111andre111,1,0.00023,68696,15.85751,433208
7796,11399371,1,0.00023,68697,15.85774,433208
7797,11xor6,1,0.00023,68698,15.85797,433208
7798,1-23-Soum,1,0.00023,68699,15.85820,433208
7799,13567436138,1,0.00023,68700,15.85843,433208
7800,15bcs019,1,0.00023,68701,15.85866,433208
7801,18056371002,1,0.00023,68702,15.85889,433208
7802,1996Shubh,1,0.00023,68703,15.85913,433208
7803,1yc,1,0.00023,68704,15.85936,433208
7804,2020testuser,1,0.00023,68705,15.85959,433208
7805,21appleceo,1,0.00023,68706,15.85982,433208
7806,27claudia,1,0.00023,68707,15.86005,433208
7807,2qif49lt,1,0.00023,68708,15.86028,433208
7808,3j0s,1,0.00023,68709,15.86051,433208
7809,4admin2root,1,0.00023,68710,15.86074,433208
7810,573009114,1,0.00023,68711,15.86097,433208
7811,6174495,1,0.00023,68712,15.86120,433208
7812,6ecuk,1,0.00023,68713,15.86143,433208
7813,839928622,1,0.00023,68714,15.86166,433208
7814,85danf,1,0.00023,68715,15.86190,433208
7815,a0s,1,0.00023,68716,15.86213,433208
7816,a1046149428,1,0.00023,68717,15.86236,433208
7817,a121984376,1,0.00023,68718,15.86259,433208
7818,a393060727,1,0.00023,68719,15.86282,433208
7819,a85302543,1,0.00023,68720,15.86305,433208
7820,aaaaalbert,1,0.00023,68721,15.86328,433208
7821,Aadhyaan,1,0.00023,68722,15.86351,433208
7822,aaditya0909,1,0.00023,68723,15.86374,433208
7823,aajain-com,1,0.00023,68724,15.86397,433208
7824,aakarshgupta97,1,0.00023,68725,15.86420,433208
7825,aakashgarg-19,1,0.00023,68726,15.86443,433208
7826,aamirmalek,1,0.00023,68727,15.86467,433208
7827,aapjeisbaas,1,0.00023,68728,15.86490,433208
7828,aaraodeo,1,0.00023,68729,15.86513,433208
7829,aaronhenshaw,1,0.00023,68730,15.86536,433208
7830,AaronLeeIV,1,0.00023,68731,15.86559,433208
7831,aaronRancher,1,0.00023,68732,15.86582,433208
7832,aaronsssya,1,0.00023,68733,15.86605,433208
7833,Aarush-Goyal,1,0.00023,68734,15.86628,433208
7834,AashishChughHome,1,0.00023,68735,15.86651,433208
7835,Abandonsun,1,0.00023,68736,15.86674,433208
7836,abdelhajji,1,0.00023,68737,15.86697,433208
7837,abdou91,1,0.00023,68738,15.86720,433208
7838,abdulsalama,1,0.00023,68739,15.86744,433208
7839,Abelard0,1,0.00023,68740,15.86767,433208
7840,abelbarrera15,1,0.00023,68741,15.86790,433208
7841,AbelHu,1,0.00023,68742,15.86813,433208
7842,abenokraitis,1,0.00023,68743,15.86836,433208
7843,abhayJava,1,0.00023,68744,15.86859,433208
7844,abhianand09,1,0.00023,68745,15.86882,433208
7845,abhijeetnijampurkar,1,0.00023,68746,15.86905,433208
7846,abhijitherekar,1,0.00023,68747,15.86928,433208
7847,Abhinandan-Purkait,1,0.00023,68748,15.86951,433208
7848,abhinavg97,1,0.00023,68749,15.86974,433208
7849,AbhiPrasad,1,0.00023,68750,15.86997,433208
7850,Abhishek0408,1,0.00023,68751,15.87021,433208
7851,Abhishek-Dev09,1,0.00023,68752,15.87044,433208
7852,Abhishek-kumar09,1,0.00023,68753,15.87067,433208
7853,abhya944,1,0.00023,68754,15.87090,433208
7854,abierbaum,1,0.00023,68755,15.87113,433208
7855,abirdZendesk,1,0.00023,68756,15.87136,433208
7856,ABNER-1,1,0.00023,68757,15.87159,433208
7857,abowloflrf,1,0.00023,68758,15.87182,433208
7858,abraaojs,1,0.00023,68759,15.87205,433208
7859,abrahamfathman,1,0.00023,68760,15.87228,433208
7860,Abu0108,1,0.00023,68761,15.87251,433208
7861,abuango,1,0.00023,68762,15.87274,433208
7862,abuckenheimer,1,0.00023,68763,15.87298,433208
7863,ABVitaliAUSY,1,0.00023,68764,15.87321,433208
7864,academey,1,0.00023,68765,15.87344,433208
7865,acarsercan,1,0.00023,68766,15.87367,433208
7866,aceslick911,1,0.00023,68767,15.87390,433208
7867,achetal01,1,0.00023,68768,15.87413,433208
7868,acidmind,1,0.00023,68769,15.87436,433208
7869,acidwars,1,0.00023,68770,15.87459,433208
7870,Ackar,1,0.00023,68771,15.87482,433208
7871,adalfa,1,0.00023,68772,15.87505,433208
7872,adambabik,1,0.00023,68773,15.87528,433208
7873,adamretter,1,0.00023,68774,15.87551,433208
7874,adamrushuk,1,0.00023,68775,15.87575,433208
7875,adchang,1,0.00023,68776,15.87598,433208
7876,Addiyali1,1,0.00023,68777,15.87621,433208
7877,ademariag,1,0.00023,68778,15.87644,433208
7878,ademidun,1,0.00023,68779,15.87667,433208
7879,adhilcodes,1,0.00023,68780,15.87690,433208
7880,AdhitiS,1,0.00023,68781,15.87713,433208
7881,adisong,1,0.00023,68782,15.87736,433208
7882,adithyaakrishna,1,0.00023,68783,15.87759,433208
7883,aditya1503,1,0.00023,68784,15.87782,433208
7884,adityagoel123,1,0.00023,68785,15.87805,433208
7885,adityajaltade,1,0.00023,68786,15.87828,433208
7886,adityasundaramurthy-maersk,1,0.00023,68787,15.87852,433208
7887,adityavikasd,1,0.00023,68788,15.87875,433208
7888,adnxn,1,0.00023,68789,15.87898,433208
7889,adream307,1,0.00023,68790,15.87921,433208
7890,adriananeci,1,0.00023,68791,15.87944,433208
7891,adrianmiron,1,0.00023,68792,15.87967,433208
7892,adriantabirta,1,0.00023,68793,15.87990,433208
7893,AdrienKuhn,1,0.00023,68794,15.88013,433208
7894,adrienluitot,1,0.00023,68795,15.88036,433208
7895,adrien-mg,1,0.00023,68796,15.88059,433208
7896,ADustyOldMuffin,1,0.00023,68797,15.88082,433208
7897,advra,1,0.00023,68798,15.88105,433208
7898,adw1n,1,0.00023,68799,15.88129,433208
7899,aeciopires,1,0.00023,68800,15.88152,433208
7900,aelmanaa,1,0.00023,68801,15.88175,433208
7901,aeneaswiener,1,0.00023,68802,15.88198,433208
7902,Aenima4six2,1,0.00023,68803,15.88221,433208
7903,afoltzm,1,0.00023,68804,15.88244,433208
7904,afrancoc2000,1,0.00023,68805,15.88267,433208
7905,Afshin-Ofx,1,0.00023,68806,15.88290,433208
7906,agardiman,1,0.00023,68807,15.88313,433208
7907,agarwalpradeep123,1,0.00023,68808,15.88336,433208
7908,agascon,1,0.00023,68809,15.88359,433208
7909,agaudreault-jive,1,0.00023,68810,15.88382,433208
7910,agentreno,1,0.00023,68811,15.88406,433208
7911,AGH0RI,1,0.00023,68812,15.88429,433208
7912,aghandoura,1,0.00023,68813,15.88452,433208
7913,agoloAbbas,1,0.00023,68814,15.88475,433208
7914,agoodgithubname,1,0.00023,68815,15.88498,433208
7915,agowa338,1,0.00023,68816,15.88521,433208
7916,Agreon,1,0.00023,68817,15.88544,433208
7917,agudpp,1,0.00023,68818,15.88567,433208
7918,agupta-cb,1,0.00023,68819,15.88590,433208
7919,ahachete,1,0.00023,68820,15.88613,433208
7920,ahamtat,1,0.00023,68821,15.88636,433208
7921,ahanafy,1,0.00023,68822,15.88659,433208
7922,Ahmadabed83,1,0.00023,68823,15.88683,433208
7923,ahmadidev,1,0.00023,68824,15.88706,433208
7924,AhmedELShafaie,1,0.00023,68825,15.88729,433208
7925,ahmsb8884,1,0.00023,68826,15.88752,433208
7926,ahoka,1,0.00023,68827,15.88775,433208
7927,ahuffman,1,0.00023,68828,15.88798,433208
7928,aidansteele,1,0.00023,68829,15.88821,433208
7929,aidapsibr,1,0.00023,68830,15.88844,433208
7930,aim8526,1,0.00023,68831,15.88867,433208
7931,aisrael,1,0.00023,68832,15.88890,433208
7932,Ajay2307,1,0.00023,68833,15.88913,433208
7933,ajaydubeyy,1,0.00023,68834,15.88936,433208
7934,ajaygm,1,0.00023,68835,15.88960,433208
7935,ajf,1,0.00023,68836,15.88983,433208
7936,ajfriesen,1,0.00023,68837,15.89006,433208
7937,ajgajg1134,1,0.00023,68838,15.89029,433208
7938,aji-suprana,1,0.00023,68839,15.89052,433208
7939,ajithkumar-natarajan,1,0.00023,68840,15.89075,433208
7940,ajitkumar2797,1,0.00023,68841,15.89098,433208
7941,AjohnsonLS,1,0.00023,68842,15.89121,433208
7942,Ak-12343994967,1,0.00023,68843,15.89144,433208
7943,ak800i,1,0.00023,68844,15.89167,433208
7944,ak895912,1,0.00023,68845,15.89190,433208
7945,akafazov,1,0.00023,68846,15.89213,433208
7946,akai257,1,0.00023,68847,15.89237,433208
7947,akang0,1,0.00023,68848,15.89260,433208
7948,AKarbas,1,0.00023,68849,15.89283,433208
7949,akaRem,1,0.00023,68850,15.89306,433208
7950,akashpatel2,1,0.00023,68851,15.89329,433208
7951,Akatsuki-123,1,0.00023,68852,15.89352,433208
7952,akefirad,1,0.00023,68853,15.89375,433208
7953,akettmann-e24,1,0.00023,68854,15.89398,433208
7954,akgunjal,1,0.00023,68855,15.89421,433208
7955,akhfa,1,0.00023,68856,15.89444,433208
7956,Akhil88328832,1,0.00023,68857,15.89467,433208
7957,akhilkochuveedu,1,0.00023,68858,15.89490,433208
7958,akhilkumar438,1,0.00023,68859,15.89514,433208
7959,akhilsanker,1,0.00023,68860,15.89537,433208
7960,Akhisar,1,0.00023,68861,15.89560,433208
7961,akhlaqhossain,1,0.00023,68862,15.89583,433208
7962,akhmadfld,1,0.00023,68863,15.89606,433208
7963,akira-kuriyama,1,0.00023,68864,15.89629,433208
7964,aklinkert,1,0.00023,68865,15.89652,433208
7965,akoita,1,0.00023,68866,15.89675,433208
7966,akp2603,1,0.00023,68867,15.89698,433208
7967,AkshayBabbar,1,0.00023,68868,15.89721,433208
7968,akshaybhatt14495,1,0.00023,68869,15.89744,433208
7969,AkshayDubey29,1,0.00023,68870,15.89768,433208
7970,akshay-sri123,1,0.00023,68871,15.89791,433208
7971,akulkarni,1,0.00023,68872,15.89814,433208
7972,akunszt,1,0.00023,68873,15.89837,433208
7973,akuzni2,1,0.00023,68874,15.89860,433208
7974,akv3132,1,0.00023,68875,15.89883,433208
7975,Al3x4n,1,0.00023,68876,15.89906,433208
7976,alalakum,1,0.00023,68877,15.89929,433208
7977,alam7865,1,0.00023,68878,15.89952,433208
7978,alan-copeland-keysight,1,0.00023,68879,15.89975,433208
7979,alandiegosantos,1,0.00023,68880,15.89998,433208
7980,alanpurple,1,0.00023,68881,15.90021,433208
7981,alanreboucas,1,0.00023,68882,15.90045,433208
7982,Alanthur,1,0.00023,68883,15.90068,433208
7983,Alb0t,1,0.00023,68884,15.90091,433208
7984,albanm,1,0.00023,68885,15.90114,433208
7985,albertmichaelj,1,0.00023,68886,15.90137,433208
7986,albertollamaso,1,0.00023,68887,15.90160,433208
7987,alburthoffman,1,0.00023,68888,15.90183,433208
7988,alcyxob,1,0.00023,68889,15.90206,433208
7989,aleafboat,1,0.00023,68890,15.90229,433208
7990,alebsack,1,0.00023,68891,15.90252,433208
7991,alegma,1,0.00023,68892,15.90275,433208
7992,alejandrojnm,1,0.00023,68893,15.90298,433208
7993,aleksandrmetik,1,0.00023,68894,15.90322,433208
7994,aleksandrov,1,0.00023,68895,15.90345,433208
7995,aLekSer,1,0.00023,68896,15.90368,433208
7996,AlekseyKalinin,1,0.00023,68897,15.90391,433208
7997,aleksf,1,0.00023,68898,15.90414,433208
7998,alena-ait,1,0.00023,68899,15.90437,433208
7999,aleonnet,1,0.00023,68900,15.90460,433208
8000,Alex2357,1,0.00023,68901,15.90483,433208
8001,alexanderGalushka,1,0.00023,68902,15.90506,433208
8002,alexander-knezevic-luetke-gcx,1,0.00023,68903,15.90529,433208
8003,AlexanderRasmussen,1,0.00023,68904,15.90552,433208
8004,AlexandreBrach,1,0.00023,68905,15.90575,433208
8005,alexandregomes-acceptto,1,0.00023,68906,15.90599,433208
8006,AlexandrSvetliy,1,0.00023,68907,15.90622,433208
8007,alexandru-tetelea,1,0.00023,68908,15.90645,433208
8008,alexbreath,1,0.00023,68909,15.90668,433208
8009,alexclear,1,0.00023,68910,15.90691,433208
8010,alexd88,1,0.00023,68911,15.90714,433208
8011,alexey-gavrilov-flant,1,0.00023,68912,15.90737,433208
8012,alexeyostrovsky-rabove,1,0.00023,68913,15.90760,433208
8013,alexfrolov,1,0.00023,68914,15.90783,433208
8014,alexgleason,1,0.00023,68915,15.90806,433208
8015,Alexjr977,1,0.00023,68916,15.90829,433208
8016,alexjuchina,1,0.00023,68917,15.90852,433208
8017,alex-klimov,1,0.00023,68918,15.90876,433208
8018,alexlokotochek,1,0.00023,68919,15.90899,433208
8019,AlexMorreale,1,0.00023,68920,15.90922,433208
8020,alexmsu,1,0.00023,68921,15.90945,433208
8021,alexnoz,1,0.00023,68922,15.90968,433208
8022,alexon1234,1,0.00023,68923,15.90991,433208
8023,alexsandro-xpt,1,0.00023,68924,15.91014,433208
8024,alex-shpak,1,0.00023,68925,15.91037,433208
8025,Alex-Sizov,1,0.00023,68926,15.91060,433208
8026,AlexStasko,1,0.00023,68927,15.91083,433208
8027,Alexx-G,1,0.00023,68928,15.91106,433208
8028,alexykot,1,0.00023,68929,15.91129,433208
8029,alexzerd,1,0.00023,68930,15.91153,433208
8030,alfredopalhares,1,0.00023,68931,15.91176,433208
8031,aliakbar-hemmati,1,0.00023,68932,15.91199,433208
8032,aliasmee,1,0.00023,68933,15.91222,433208
8033,aliencrash,1,0.00023,68934,15.91245,433208
8034,alienvspredator,1,0.00023,68935,15.91268,433208
8035,alifpay,1,0.00023,68936,15.91291,433208
8036,aligandi,1,0.00023,68937,15.91314,433208
8037,alikaba,1,0.00023,68938,15.91337,433208
8038,alikhil,1,0.00023,68939,15.91360,433208
8039,Ali-Mbacho,1,0.00023,68940,15.91383,433208
8040,alireza-esmaeeli,1,0.00023,68941,15.91406,433208
8041,alivinshiva,1,0.00023,68942,15.91430,433208
8042,aljaxus,1,0.00023,68943,15.91453,433208
8043,alkov-ibm,1,0.00023,68944,15.91476,433208
8044,allanchua101,1,0.00023,68945,15.91499,433208
8045,allanitis,1,0.00023,68946,15.91522,433208
8046,allanvmat,1,0.00023,68947,15.91545,433208
8047,allenwei,1,0.00023,68948,15.91568,433208
8048,allenyinx,1,0.00023,68949,15.91591,433208
8049,Allyn69,1,0.00023,68950,15.91614,433208
8050,almog27,1,0.00023,68951,15.91637,433208
8051,almogh52,1,0.00023,68952,15.91660,433208
8052,alok15ee,1,0.00023,68953,15.91683,433208
8053,alonlong,1,0.00023,68954,15.91707,433208
8054,alparslanozturk,1,0.00023,68955,15.91730,433208
8055,alphara,1,0.00023,68956,15.91753,433208
8056,alpozcan,1,0.00023,68957,15.91776,433208
8057,alsoft27,1,0.00023,68958,15.91799,433208
8058,alt4,1,0.00023,68959,15.91822,433208
8059,althati,1,0.00023,68960,15.91845,433208
8060,al-the-x,1,0.00023,68961,15.91868,433208
8061,alukyan,1,0.00023,68962,15.91891,433208
8062,aluwala,1,0.00023,68963,15.91914,433208
8063,alvioshki,1,0.00023,68964,15.91937,433208
8064,AmaanC,1,0.00023,68965,15.91960,433208
8065,amado-saladino,1,0.00023,68966,15.91984,433208
8066,aman7heaven,1,0.00023,68967,15.92007,433208
8067,Amanpatel13,1,0.00023,68968,15.92030,433208
8068,amansarpal,1,0.00023,68969,15.92053,433208
8069,amarlearning,1,0.00023,68970,15.92076,433208
8070,Ambrose12Silveira,1,0.00023,68971,15.92099,433208
8071,amgads,1,0.00023,68972,15.92122,433208
8072,aminhjz-bux,1,0.00023,68973,15.92145,433208
8073,amirsoleimanii,1,0.00023,68974,15.92168,433208
8074,amit1411,1,0.00023,68975,15.92191,433208
8075,amitainz,1,0.00023,68976,15.92214,433208
8076,AmitBaranes,1,0.00023,68977,15.92237,433208
8077,amithapa,1,0.00023,68978,15.92261,433208
8078,amorozov87,1,0.00023,68979,15.92284,433208
8079,Amyth07,1,0.00023,68980,15.92307,433208
8080,An0nymous0,1,0.00023,68981,15.92330,433208
8081,anabih,1,0.00023,68982,15.92353,433208
8082,anagarjunr,1,0.00023,68983,15.92376,433208
8083,anandgbhat,1,0.00023,68984,15.92399,433208
8084,anandprabhakar0507,1,0.00023,68985,15.92422,433208
8085,ananglesmana,1,0.00023,68986,15.92445,433208
8086,Ananth-kr,1,0.00023,68987,15.92468,433208
8087,ananthulasrikar,1,0.00023,68988,15.92491,433208
8088,anarkiwi,1,0.00023,68989,15.92514,433208
8089,AnatoliiStepaniuk,1,0.00023,68990,15.92538,433208
8090,anborg,1,0.00023,68991,15.92561,433208
8091,anchal-chaudhary,1,0.00023,68992,15.92584,433208
8092,andersbo87,1,0.00023,68993,15.92607,433208
8093,anders-olofsson,1,0.00023,68994,15.92630,433208
8094,anderspetersson,1,0.00023,68995,15.92653,433208
8095,andk,1,0.00023,68996,15.92676,433208
8096,andras-gerendas,1,0.00023,68997,15.92699,433208
8097,andrea-82,1,0.00023,68998,15.92722,433208
8098,AndreasMueller-SAP,1,0.00023,68999,15.92745,433208
8099,andredrumond1995,1,0.00023,69000,15.92768,433208
8100,andrei-dascalu,1,0.00023,69001,15.92791,433208
8101,andrejs-sisojevs-accenture,1,0.00023,69002,15.92815,433208
8102,AndreKapraty,1,0.00023,69003,15.92838,433208
8103,AndreKoepke,1,0.00023,69004,15.92861,433208
8104,Andres-Escalante,1,0.00023,69005,15.92884,433208
8105,andreswebs,1,0.00023,69006,15.92907,433208
8106,andrew-aladev,1,0.00023,69007,15.92930,433208
8107,andrew-bolin,1,0.00023,69008,15.92953,433208
8108,AndrewDryga,1,0.00023,69009,15.92976,433208
8109,andrewdunai,1,0.00023,69010,15.92999,433208
8110,andrewl3wis,1,0.00023,69011,15.93022,433208
8111,andrew-nds,1,0.00023,69012,15.93045,433208
8112,AndrewNeudegg,1,0.00023,69013,15.93068,433208
8113,AndrewPanov,1,0.00023,69014,15.93092,433208
8114,andrewschmidt-a,1,0.00023,69015,15.93115,433208
8115,andrewvaughan,1,0.00023,69016,15.93138,433208
8116,andrewward,1,0.00023,69017,15.93161,433208
8117,andrey-admin,1,0.00023,69018,15.93184,433208
8118,andriymarchuk,1,0.00023,69019,15.93207,433208
8119,andronux,1,0.00023,69020,15.93230,433208
8120,andy812,1,0.00023,69021,15.93253,433208
8121,andy-betin,1,0.00023,69022,15.93276,433208
8122,andyfcx,1,0.00023,69023,15.93299,433208
8123,andy-g,1,0.00023,69024,15.93322,433208
8124,andyjcooperuk,1,0.00023,69025,15.93345,433208
8125,andymcmahan,1,0.00023,69026,15.93369,433208
8126,AndyPook,1,0.00023,69027,15.93392,433208
8127,anesterov-joom,1,0.00023,69028,15.93415,433208
8128,AngelOnFira,1,0.00023,69029,15.93438,433208
8129,angerico-carino-betsson,1,0.00023,69030,15.93461,433208
8130,angulito,1,0.00023,69031,15.93484,433208
8131,anhaya,1,0.00023,69032,15.93507,433208
8132,aniekgul,1,0.00023,69033,15.93530,433208
8133,Anikei,1,0.00023,69034,15.93553,433208
8134,Aniket1923,1,0.00023,69035,15.93576,433208
8135,anil503rgpv,1,0.00023,69036,15.93599,433208
8136,anilbdevops,1,0.00023,69037,15.93622,433208
8137,anildhingra,1,0.00023,69038,15.93646,433208
8138,Anil-kattoju,1,0.00023,69039,15.93669,433208
8139,anilkusc,1,0.00023,69040,15.93692,433208
8140,anirudhr95,1,0.00023,69041,15.93715,433208
8141,AnishAnil,1,0.00023,69042,15.93738,433208
8142,Anish-kumar7641,1,0.00023,69043,15.93761,433208
8143,anishnagaraj,1,0.00023,69044,15.93784,433208
8144,AnjanaAK,1,0.00023,69045,15.93807,433208
8145,anjanitsip,1,0.00023,69046,15.93830,433208
8146,ankit8sri,1,0.00023,69047,15.93853,433208
8147,ankitgulati24,1,0.00023,69048,15.93876,433208
8148,ankit-kamboj,1,0.00023,69049,15.93899,433208
8149,Ankitnaudiyal,1,0.00023,69050,15.93923,433208
8150,ankitthakwani,1,0.00023,69051,15.93946,433208
8151,anklei,1,0.00023,69052,15.93969,433208
8152,ankur1305,1,0.00023,69053,15.93992,433208
8153,Ankur7890,1,0.00023,69054,15.94015,433208
8154,Ankurmarkam,1,0.00023,69055,15.94038,433208
8155,ankushganatra,1,0.00023,69056,15.94061,433208
8156,anlsergio,1,0.00023,69057,15.94084,433208
8157,annakulakrishna,1,0.00023,69058,15.94107,433208
8158,annmanvel,1,0.00023,69059,15.94130,433208
8159,annymsMthd,1,0.00023,69060,15.94153,433208
8160,anokun7,1,0.00023,69061,15.94176,433208
8161,anoncam,1,0.00023,69062,15.94200,433208
8162,anoop2503,1,0.00023,69063,15.94223,433208
8163,anoop2811,1,0.00023,69064,15.94246,433208
8164,anooppb,1,0.00023,69065,15.94269,433208
8165,anooshcnayak,1,0.00023,69066,15.94292,433208
8166,anopheles,1,0.00023,69067,15.94315,433208
8167,anotherandi,1,0.00023,69068,15.94338,433208
8168,AnshulPorwal1,1,0.00023,69069,15.94361,433208
8169,ansilh,1,0.00023,69070,15.94384,433208
8170,anthonyrouseau,1,0.00023,69071,15.94407,433208
8171,AnthonyRuffinoDH,1,0.00023,69072,15.94430,433208
8172,antimack,1,0.00023,69073,15.94453,433208
8173,antje,1,0.00023,69074,15.94477,433208
8174,antoinne85,1,0.00023,69075,15.94500,433208
8175,anto-n,1,0.00023,69076,15.94523,433208
8176,anton-chuhunou,1,0.00023,69077,15.94546,433208
8177,antong,1,0.00023,69078,15.94569,433208
8178,antonincms,1,0.00023,69079,15.94592,433208
8179,antonioberben,1,0.00023,69080,15.94615,433208
8180,AntonioGonz,1,0.00023,69081,15.94638,433208
8181,antoniomrfranco,1,0.00023,69082,15.94661,433208
8182,antoniomuso,1,0.00023,69083,15.94684,433208
8183,antonionappi88,1,0.00023,69084,15.94707,433208
8184,antoniotamer,1,0.00023,69085,15.94730,433208
8185,antonyfray,1,0.00023,69086,15.94754,433208
8186,anu4love,1,0.00023,69087,15.94777,433208
8187,Anu-9518,1,0.00023,69088,15.94800,433208
8188,Anuj2512,1,0.00023,69089,15.94823,433208
8189,anujbiyani,1,0.00023,69090,15.94846,433208
8190,AnumSheraz,1,0.00023,69091,15.94869,433208
8191,anupam587,1,0.00023,69092,15.94892,433208
8192,anupash147,1,0.00023,69093,15.94915,433208
8193,anupriya17,1,0.00023,69094,15.94938,433208
8194,anuragtr,1,0.00023,69095,15.94961,433208
8195,anusha5695,1,0.00023,69096,15.94984,433208
8196,anykao,1,0.00023,69097,15.95007,433208
8197,anywherepilot,1,0.00023,69098,15.95031,433208
8198,aogonevskiy,1,0.00023,69099,15.95054,433208
8199,aoighost,1,0.00023,69100,15.95077,433208
8200,AOne-T,1,0.00023,69101,15.95100,433208
8201,ap185395,1,0.00023,69102,15.95123,433208
8202,apache23,1,0.00023,69103,15.95146,433208
8203,apacoco9861,1,0.00023,69104,15.95169,433208
8204,apagac2,1,0.00023,69105,15.95192,433208
8205,apazvantov-td,1,0.00023,69106,15.95215,433208
8206,apenjag,1,0.00023,69107,15.95238,433208
8207,apetrovYa,1,0.00023,69108,15.95261,433208
8208,apettinen,1,0.00023,69109,15.95284,433208
8209,appanycd,1,0.00023,69110,15.95308,433208
8210,apple77y,1,0.00023,69111,15.95331,433208
8211,apptut,1,0.00023,69112,15.95354,433208
8212,appunni-dishq,1,0.00023,69113,15.95377,433208
8213,apsraj01,1,0.00023,69114,15.95400,433208
8214,aqua-terra,1,0.00023,69115,15.95423,433208
8215,aradyaron,1,0.00023,69116,15.95446,433208
8216,aramhakobyan,1,0.00023,69117,15.95469,433208
8217,arazmj,1,0.00023,69118,15.95492,433208
8218,arbitrage-world,1,0.00023,69119,15.95515,433208
8219,archonic,1,0.00023,69120,15.95538,433208
8220,arctiqjacob,1,0.00023,69121,15.95561,433208
8221,ardylin,1,0.00023,69122,15.95585,433208
8222,Arefer,1,0.00023,69123,15.95608,433208
8223,aresares,1,0.00023,69124,15.95631,433208
8224,aretakisv,1,0.00023,69125,15.95654,433208
8225,arhea,1,0.00023,69126,15.95677,433208
8226,arjuin,1,0.00023,69127,15.95700,433208
8227,arjunprasad2143,1,0.00023,69128,15.95723,433208
8228,arjunrv88,1,0.00023,69129,15.95746,433208
8229,Armegone,1,0.00023,69130,15.95769,433208
8230,armin-th,1,0.00023,69131,15.95792,433208
8231,armisz,1,0.00023,69132,15.95815,433208
8232,Armmegon,1,0.00023,69133,15.95838,433208
8233,arms11,1,0.00023,69134,15.95862,433208
8234,ArnabMukherjee1991,1,0.00023,69135,15.95885,433208
8235,Arnold1,1,0.00023,69136,15.95908,433208
8236,arnoldas500,1,0.00023,69137,15.95931,433208
8237,arno-snop,1,0.00023,69138,15.95954,433208
8238,aronip,1,0.00023,69139,15.95977,433208
8239,aroute,1,0.00023,69140,15.96000,433208
8240,arpankapoor,1,0.00023,69141,15.96023,433208
8241,arpit456jain,1,0.00023,69142,15.96046,433208
8242,arpitaashu,1,0.00023,69143,15.96069,433208
8243,Arpitpatel2618,1,0.00023,69144,15.96092,433208
8244,ArronaxKP,1,0.00023,69145,15.96115,433208
8245,arroo,1,0.00023,69146,15.96139,433208
8246,arseniy-sychev,1,0.00023,69147,15.96162,433208
8247,arshadsiddique-jfl,1,0.00023,69148,15.96185,433208
8248,arshamsedaghatbin,1,0.00023,69149,15.96208,433208
8249,arshchimni,1,0.00023,69150,15.96231,433208
8250,Arshdeep88,1,0.00023,69151,15.96254,433208
8251,artazar,1,0.00023,69152,15.96277,433208
8252,artemkoslenkov,1,0.00023,69153,15.96300,433208
8253,artem-nefedov,1,0.00023,69154,15.96323,433208
8254,arthurcgc,1,0.00023,69155,15.96346,433208
8255,arthur-tacca,1,0.00023,69156,15.96369,433208
8256,artiship,1,0.00023,69157,15.96392,433208
8257,artisticman,1,0.00023,69158,15.96416,433208
8258,arttobe,1,0.00023,69159,15.96439,433208
8259,arturslogins,1,0.00023,69160,15.96462,433208
8260,artvichi,1,0.00023,69161,15.96485,433208
8261,arvin-a,1,0.00023,69162,15.96508,433208
8262,ArvinSiChuan,1,0.00023,69163,15.96531,433208
8263,aryehb,1,0.00023,69164,15.96554,433208
8264,arzarif,1,0.00023,69165,15.96577,433208
8265,asad7452,1,0.00023,69166,15.96600,433208
8266,asada931,1,0.00023,69167,15.96623,433208
8267,asafdav2,1,0.00023,69168,15.96646,433208
8268,asafdl,1,0.00023,69169,15.96669,433208
8269,ASAPHAANING,1,0.00023,69170,15.96693,433208
8270,asencis,1,0.00023,69171,15.96716,433208
8271,Asgoret,1,0.00023,69172,15.96739,433208
8272,ash7985,1,0.00023,69173,15.96762,433208
8273,ashish199912,1,0.00023,69174,15.96785,433208
8274,ashleyfreeth,1,0.00023,69175,15.96808,433208
8275,ashnehete,1,0.00023,69176,15.96831,433208
8276,ashoke-cube,1,0.00023,69177,15.96854,433208
8277,ashokspeelyaal,1,0.00023,69178,15.96877,433208
8278,ashu2286,1,0.00023,69179,15.96900,433208
8279,ashu8912,1,0.00023,69180,15.96923,433208
8280,ashwin027,1,0.00023,69181,15.96947,433208
8281,Ashwin-ks,1,0.00023,69182,15.96970,433208
8282,AshwinNS,1,0.00023,69183,15.96993,433208
8283,ashwinpagarkhed,1,0.00023,69184,15.97016,433208
8284,asingh014,1,0.00023,69185,15.97039,433208
8285,ask-github,1,0.00023,69186,15.97062,433208
8286,askingcat,1,0.00023,69187,15.97085,433208
8287,Ask-Subhasmita,1,0.00023,69188,15.97108,433208
8288,ASLavanya,1,0.00023,69189,15.97131,433208
8289,asm76,1,0.00023,69190,15.97154,433208
8290,asmith030,1,0.00023,69191,15.97177,433208
8291,Asmodeusss,1,0.00023,69192,15.97200,433208
8292,asmoljo,1,0.00023,69193,15.97224,433208
8293,ass-coder,1,0.00023,69194,15.97247,433208
8294,a-staebler,1,0.00023,69195,15.97270,433208
8295,astitva3107,1,0.00023,69196,15.97293,433208
8296,astorath,1,0.00023,69197,15.97316,433208
8297,AstraLuma,1,0.00023,69198,15.97339,433208
8298,AsynchronousResource,1,0.00023,69199,15.97362,433208
8299,atamgp,1,0.00023,69200,15.97385,433208
8300,AT-Fieldless,1,0.00023,69201,15.97408,433208
8301,atihkin,1,0.00023,69202,15.97431,433208
8302,atlemann,1,0.00023,69203,15.97454,433208
8303,AtosNicoS,1,0.00023,69204,15.97477,433208
8304,Atreus-Technologies,1,0.00023,69205,15.97501,433208
8305,atsai1220,1,0.00023,69206,15.97524,433208
8306,atsikham,1,0.00023,69207,15.97547,433208
8307,atuk721,1,0.00023,69208,15.97570,433208
8308,atul10864,1,0.00023,69209,15.97593,433208
8309,audriusrudalevicius,1,0.00023,69210,15.97616,433208
8310,audunsolemdal,1,0.00023,69211,15.97639,433208
8311,austinbv,1,0.00023,69212,15.97662,433208
8312,AustinCooper79,1,0.00023,69213,15.97685,433208
8313,AutonomicMattRoy,1,0.00023,69214,15.97708,433208
8314,autopwn,1,0.00023,69215,15.97731,433208
8315,av1430,1,0.00023,69216,15.97754,433208
8316,avamonitoring,1,0.00023,69217,15.97778,433208
8317,avasani,1,0.00023,69218,15.97801,433208
8318,avgalani,1,0.00023,69219,15.97824,433208
8319,avielb,1,0.00023,69220,15.97847,433208
8320,avi-jain-08,1,0.00023,69221,15.97870,433208
8321,avik-so,1,0.00023,69222,15.97893,433208
8322,avinash-0-singh,1,0.00023,69223,15.97916,433208
8323,avinashs24,1,0.00023,69224,15.97939,433208
8324,avkudryashov,1,0.00023,69225,15.97962,433208
8325,awaiken,1,0.00023,69226,15.97985,433208
8326,awangc,1,0.00023,69227,15.98008,433208
8327,AWKIF,1,0.00023,69228,15.98031,433208
8328,awltux,1,0.00023,69229,15.98055,433208
8329,awssandra,1,0.00023,69230,15.98078,433208
8330,axelinux,1,0.00023,69231,15.98101,433208
8331,Ayan123430,1,0.00023,69232,15.98124,433208
8332,aydanjiwani,1,0.00023,69233,15.98147,433208
8333,AYDEV-FR,1,0.00023,69234,15.98170,433208
8334,ayoubbensakhria,1,0.00023,69235,15.98193,433208
8335,aysuh2003,1,0.00023,69236,15.98216,433208
8336,ayushjhanwar,1,0.00023,69237,15.98239,433208
8337,ayush-sharma-devops,1,0.00023,69238,15.98262,433208
8338,azbpa,1,0.00023,69239,15.98285,433208
8339,azhar22k,1,0.00023,69240,15.98308,433208
8340,AzharMithani,1,0.00023,69241,15.98332,433208
8341,azimjohn,1,0.00023,69242,15.98355,433208
8342,b23prodtm,1,0.00023,69243,15.98378,433208
8343,b2cbre,1,0.00023,69244,15.98401,433208
8344,b2jude,1,0.00023,69245,15.98424,433208
8345,B45man,1,0.00023,69246,15.98447,433208
8346,b802,1,0.00023,69247,15.98470,433208
8347,babulalsph,1,0.00023,69248,15.98493,433208
8348,BABYYYLOVEEEEEEEE,1,0.00023,69249,15.98516,433208
8349,Badkul77,1,0.00023,69250,15.98539,433208
8350,baejinsoo,1,0.00023,69251,15.98562,433208
8351,baens,1,0.00023,69252,15.98585,433208
8352,Bajix,1,0.00023,69253,15.98609,433208
8353,BalassaMarton,1,0.00023,69254,15.98632,433208
8354,Banck,1,0.00023,69255,15.98655,433208
8355,bangbangjim,1,0.00023,69256,15.98678,433208
8356,bangwu,1,0.00023,69257,15.98701,433208
8357,bankershours,1,0.00023,69258,15.98724,433208
8358,banpei-dbart,1,0.00023,69259,15.98747,433208
8359,bansalrajat,1,0.00023,69260,15.98770,433208
8360,banyejinghungui,1,0.00023,69261,15.98793,433208
8361,Banzy666,1,0.00023,69262,15.98816,433208
8362,baosen,1,0.00023,69263,15.98839,433208
8363,baptiste-dauphin,1,0.00023,69264,15.98862,433208
8364,BarakStout,1,0.00023,69265,15.98886,433208
8365,BarberEngineering,1,0.00023,69266,15.98909,433208
8366,BarmBamos,1,0.00023,69267,15.98932,433208
8367,barnettZQG,1,0.00023,69268,15.98955,433208
8368,barryz,1,0.00023,69269,15.98978,433208
8369,barthy1,1,0.00023,69270,15.99001,433208
8370,bartosz-r-o-l-l,1,0.00023,69271,15.99024,433208
8371,bartweber,1,0.00023,69272,15.99047,433208
8372,BasBenIk,1,0.00023,69273,15.99070,433208
8373,basch255,1,0.00023,69274,15.99093,433208
8374,basroovers,1,0.00023,69275,15.99116,433208
8375,bastibrunner,1,0.00023,69276,15.99139,433208
8376,basvdlei,1,0.00023,69277,15.99163,433208
8377,baturorkun,1,0.00023,69278,15.99186,433208
8378,BaudouinH,1,0.00023,69279,15.99209,433208
8379,bayudwiyansatria,1,0.00023,69280,15.99232,433208
8380,bbdimitriu,1,0.00023,69281,15.99255,433208
8381,bbgobie,1,0.00023,69282,15.99278,433208
8382,bbhenry,1,0.00023,69283,15.99301,433208
8383,bbhupati,1,0.00023,69284,15.99324,433208
8384,bbkgh,1,0.00023,69285,15.99347,433208
8385,bcbrockway,1,0.00023,69286,15.99370,433208
8386,bcha,1,0.00023,69287,15.99393,433208
8387,bcharron,1,0.00023,69288,15.99416,433208
8388,bcheronn,1,0.00023,69289,15.99440,433208
8389,bclaise,1,0.00023,69290,15.99463,433208
8390,bclouser,1,0.00023,69291,15.99486,433208
8391,bdfoster,1,0.00023,69292,15.99509,433208
8392,bduisenov,1,0.00023,69293,15.99532,433208
8393,bdurrow,1,0.00023,69294,15.99555,433208
8394,be1be1,1,0.00023,69295,15.99578,433208
8395,beawolf,1,0.00023,69296,15.99601,433208
8396,beckyjmcdabq,1,0.00023,69297,15.99624,433208
8397,beef3333,1,0.00023,69298,15.99647,433208
8398,BegoneRaven,1,0.00023,69299,15.99670,433208
8399,Beheadedstraw,1,0.00023,69300,15.99693,433208
8400,beilber,1,0.00023,69301,15.99717,433208
8401,Belorus,1,0.00023,69302,15.99740,433208
8402,ben11211,1,0.00023,69303,15.99763,433208
8403,BenCoughlan15,1,0.00023,69304,15.99786,433208
8404,benderillo,1,0.00023,69305,15.99809,433208
8405,Bengreen,1,0.00023,69306,15.99832,433208
8406,benhemp,1,0.00023,69307,15.99855,433208
8407,beni20,1,0.00023,69308,15.99878,433208
8408,benjamincao,1,0.00023,69309,15.99901,433208
8409,benjick,1,0.00023,69310,15.99924,433208
8410,benmezger,1,0.00023,69311,15.99947,433208
8411,bennyscetbun,1,0.00023,69312,15.99970,433208
8412,benpoulson,1,0.00023,69313,15.99994,433208
8413,benvdh,1,0.00023,69314,16.00017,433208
8414,benyanke,1,0.00023,69315,16.00040,433208
8415,benzman81,1,0.00023,69316,16.00063,433208
8416,bergeron,1,0.00023,69317,16.00086,433208
8417,Berndinox,1,0.00023,69318,16.00109,433208
8418,bernielomax,1,0.00023,69319,16.00132,433208
8419,bertbesser,1,0.00023,69320,16.00155,433208
8420,BertelBB,1,0.00023,69321,16.00178,433208
8421,bertux,1,0.00023,69322,16.00201,433208
8422,betNevS,1,0.00023,69323,16.00224,433208
8423,bettdouglas,1,0.00023,69324,16.00247,433208
8424,Better-Boy,1,0.00023,69325,16.00271,433208
8425,Bevisy,1,0.00023,69326,16.00294,433208
8426,beyondmars3,1,0.00023,69327,16.00317,433208
8427,BFrancisA,1,0.00023,69328,16.00340,433208
8428,bfrost2893,1,0.00023,69329,16.00363,433208
8429,bfznj,1,0.00023,69330,16.00386,433208
8430,bgaechter,1,0.00023,69331,16.00409,433208
8431,bgaillard,1,0.00023,69332,16.00432,433208
8432,bgehman,1,0.00023,69333,16.00455,433208
8433,Bghd34,1,0.00023,69334,16.00478,433208
8434,bgilmore,1,0.00023,69335,16.00501,433208
8435,bgutjahr,1,0.00023,69336,16.00524,433208
8436,bhabermaas,1,0.00023,69337,16.00548,433208
8437,bhainesva,1,0.00023,69338,16.00571,433208
8438,bhakiyakalimuthu,1,0.00023,69339,16.00594,433208
8439,bhaktiagrawal088,1,0.00023,69340,16.00617,433208
8440,bharath-12345,1,0.00023,69341,16.00640,433208
8441,bharathguvvala,1,0.00023,69342,16.00663,433208
8442,Bhashitha123,1,0.00023,69343,16.00686,433208
8443,Bhavesh-Joshi,1,0.00023,69344,16.00709,433208
8444,bhavya901,1,0.00023,69345,16.00732,433208
8445,Bheesma,1,0.00023,69346,16.00755,433208
8446,bhkamath,1,0.00023,69347,16.00778,433208
8447,bhupesh-sf,1,0.00023,69348,16.00801,433208
8448,bibincatchme,1,0.00023,69349,16.00825,433208
8449,Bibob7,1,0.00023,69350,16.00848,433208
8450,bidipeppercrap,1,0.00023,69351,16.00871,433208
8451,biggnou,1,0.00023,69352,16.00894,433208
8452,bignova,1,0.00023,69353,16.00917,433208
8453,biharkagaurav,1,0.00023,69354,16.00940,433208
8454,Bikraji,1,0.00023,69355,16.00963,433208
8455,bilaltahirx,1,0.00023,69356,16.00986,433208
8456,billcrook,1,0.00023,69357,16.01009,433208
8457,BillSchumacher,1,0.00023,69358,16.01032,433208
8458,Billy99,1,0.00023,69359,16.01055,433208
8459,billysutomo,1,0.00023,69360,16.01078,433208
8460,binarytrails,1,0.00023,69361,16.01102,433208
8461,bingerambo,1,0.00023,69362,16.01125,433208
8462,bini7301,1,0.00023,69363,16.01148,433208
8463,binlab,1,0.00023,69364,16.01171,433208
8464,binnie268,1,0.00023,69365,16.01194,433208
8465,Binyamse,1,0.00023,69366,16.01217,433208
8466,biofool,1,0.00023,69367,16.01240,433208
8467,BioSin,1,0.00023,69368,16.01263,433208
8468,birenroy,1,0.00023,69369,16.01286,433208
8469,bitdancer,1,0.00023,69370,16.01309,433208
8470,bitflingr,1,0.00023,69371,16.01332,433208
8471,bitsofinfo,1,0.00023,69372,16.01355,433208
8472,bittner,1,0.00023,69373,16.01379,433208
8473,bj9306,1,0.00023,69374,16.01402,433208
8474,bjaworski3,1,0.00023,69375,16.01425,433208
8475,Bjego,1,0.00023,69376,16.01448,433208
8476,bjorn3,1,0.00023,69377,16.01471,433208
8477,bjorndarri,1,0.00023,69378,16.01494,433208
8478,bjorndemicoli,1,0.00023,69379,16.01517,433208
8479,BlackCrowned,1,0.00023,69380,16.01540,433208
8480,Blackening999,1,0.00023,69381,16.01563,433208
8481,blackntech,1,0.00023,69382,16.01586,433208
8482,blacksab,1,0.00023,69383,16.01609,433208
8483,BlackThor555,1,0.00023,69384,16.01632,433208
8484,BlackTX,1,0.00023,69385,16.01656,433208
8485,blackwood821,1,0.00023,69386,16.01679,433208
8486,blame19,1,0.00023,69387,16.01702,433208
8487,blankhang,1,0.00023,69388,16.01725,433208
8488,Blanko2,1,0.00023,69389,16.01748,433208
8489,blencoff,1,0.00023,69390,16.01771,433208
8490,BlendUnityPy,1,0.00023,69391,16.01794,433208
8491,Bliamoh,1,0.00023,69392,16.01817,433208
8492,bliles,1,0.00023,69393,16.01840,433208
8493,blingster7,1,0.00023,69394,16.01863,433208
8494,blitzd,1,0.00023,69395,16.01886,433208
8495,blodan,1,0.00023,69396,16.01909,433208
8496,bluebrown,1,0.00023,69397,16.01933,433208
8497,bluestealth,1,0.00023,69398,16.01956,433208
8498,blueviggen,1,0.00023,69399,16.01979,433208
8499,blukhand,1,0.00023,69400,16.02002,433208
8500,blut,1,0.00023,69401,16.02025,433208
8501,bmangesh,1,0.00023,69402,16.02048,433208
8502,bmarkowww,1,0.00023,69403,16.02071,433208
8503,bmaupin,1,0.00023,69404,16.02094,433208
8504,bmfp,1,0.00023,69405,16.02117,433208
8505,bmgeek,1,0.00023,69406,16.02140,433208
8506,bnason,1,0.00023,69407,16.02163,433208
8507,boatmisser,1,0.00023,69408,16.02186,433208
8508,Bobalou622,1,0.00023,69409,16.02210,433208
8509,bob-bn,1,0.00023,69410,16.02233,433208
8510,bobbywatson3,1,0.00023,69411,16.02256,433208
8511,bobo333,1,0.00023,69412,16.02279,433208
8512,Bobonium,1,0.00023,69413,16.02302,433208
8513,bobsaintcool,1,0.00023,69414,16.02325,433208
8514,bodduv,1,0.00023,69415,16.02348,433208
8515,bodymindarts,1,0.00023,69416,16.02371,433208
8516,boenr1,1,0.00023,69417,16.02394,433208
8517,bogdanpetrea,1,0.00023,69418,16.02417,433208
8518,bohdantverdyi,1,0.00023,69419,16.02440,433208
8519,bokysan,1,0.00023,69420,16.02463,433208
8520,bolipereira,1,0.00023,69421,16.02487,433208
8521,BON4,1,0.00023,69422,16.02510,433208
8522,bonucki,1,0.00023,69423,16.02533,433208
8523,BookChan,1,0.00023,69424,16.02556,433208
8524,booooh,1,0.00023,69425,16.02579,433208
8525,bordunosp,1,0.00023,69426,16.02602,433208
8526,boreBoar,1,0.00023,69427,16.02625,433208
8527,BorjaEst,1,0.00023,69428,16.02648,433208
8528,BorntraegerMarc,1,0.00023,69429,16.02671,433208
8529,borzozoo,1,0.00023,69430,16.02694,433208
8530,BossSuricate,1,0.00023,69431,16.02717,433208
8531,BostjanBozic,1,0.00023,69432,16.02740,433208
8532,BoxuanChen,1,0.00023,69433,16.02764,433208
8533,Boy-TianHen,1,0.00023,69434,16.02787,433208
8534,bpereto,1,0.00023,69435,16.02810,433208
8535,bpjok21cn,1,0.00023,69436,16.02833,433208
8536,bpleines,1,0.00023,69437,16.02856,433208
8537,bpottier,1,0.00023,69438,16.02879,433208
8538,bradjones1,1,0.00023,69439,16.02902,433208
8539,bradmwilliams,1,0.00023,69440,16.02925,433208
8540,braghettos,1,0.00023,69441,16.02948,433208
8541,brainerazer,1,0.00023,69442,16.02971,433208
8542,braino15,1,0.00023,69443,16.02994,433208
8543,brandonkrull,1,0.00023,69444,16.03017,433208
8544,brasmith-ms,1,0.00023,69445,16.03041,433208
8545,bregenspan,1,0.00023,69446,16.03064,433208
8546,breizh5729,1,0.00023,69447,16.03087,433208
8547,brendarearden,1,0.00023,69448,16.03110,433208
8548,BrentChesny,1,0.00023,69449,16.03133,433208
8549,brenwhyte,1,0.00023,69450,16.03156,433208
8550,BrettPhilip,1,0.00023,69451,16.03179,433208
8551,breunigs,1,0.00023,69452,16.03202,433208
8552,brianasz,1,0.00023,69453,16.03225,433208
8553,brian-groux-hs,1,0.00023,69454,16.03248,433208
8554,BrianKevinson,1,0.00023,69455,16.03271,433208
8555,brianlmoon,1,0.00023,69456,16.03294,433208
8556,brianmay,1,0.00023,69457,16.03318,433208
8557,briend,1,0.00023,69458,16.03341,433208
8558,BrijJhala,1,0.00023,69459,16.03364,433208
8559,brkykan,1,0.00023,69460,16.03387,433208
8560,BROGVOIDOVO,1,0.00023,69461,16.03410,433208
8561,brokencode64,1,0.00023,69462,16.03433,433208
8562,brondum,1,0.00023,69463,16.03456,433208
8563,brouberol,1,0.00023,69464,16.03479,433208
8564,brpaz,1,0.00023,69465,16.03502,433208
8565,brtduvally,1,0.00023,69466,16.03525,433208
8566,brucetony,1,0.00023,69467,16.03548,433208
8567,brunobcfum,1,0.00023,69468,16.03571,433208
8568,bryanhanner,1,0.00023,69469,16.03595,433208
8569,bryanmacfarlane,1,0.00023,69470,16.03618,433208
8570,bryce-larson,1,0.00023,69471,16.03641,433208
8571,brychcy,1,0.00023,69472,16.03664,433208
8572,bryeung,1,0.00023,69473,16.03687,433208
8573,brylor,1,0.00023,69474,16.03710,433208
8574,bseabra,1,0.00023,69475,16.03733,433208
8575,bshephar,1,0.00023,69476,16.03756,433208
8576,b-slim,1,0.00023,69477,16.03779,433208
8577,bslotbot,1,0.00023,69478,16.03802,433208
8578,bsuchorowski,1,0.00023,69479,16.03825,433208
8579,btai24,1,0.00023,69480,16.03848,433208
8580,btnguyen2k,1,0.00023,69481,16.03872,433208
8581,btomasini,1,0.00023,69482,16.03895,433208
8582,btoonk,1,0.00023,69483,16.03918,433208
8583,bu3ny,1,0.00023,69484,16.03941,433208
8584,bubba,1,0.00023,69485,16.03964,433208
8585,Bugs-Resolver,1,0.00023,69486,16.03987,433208
8586,buni-rock,1,0.00023,69487,16.04010,433208
8587,burrsutter,1,0.00023,69488,16.04033,433208
8588,BusiPlay,1,0.00023,69489,16.04056,433208
8589,bw512,1,0.00023,69490,16.04079,433208
8590,ByteCommander,1,0.00023,69491,16.04102,433208
8591,BZakir,1,0.00023,69492,16.04126,433208
8592,bzeitler69,1,0.00023,69493,16.04149,433208
8593,bzumby,1,0.00023,69494,16.04172,433208
8594,c10l,1,0.00023,69495,16.04195,433208
8595,CadenGuo,1,0.00023,69496,16.04218,433208
8596,cafegoci,1,0.00023,69497,16.04241,433208
8597,cah-prakash-kalaiarasu01,1,0.00023,69498,16.04264,433208
8598,cainelli,1,0.00023,69499,16.04287,433208
8599,caiolopes,1,0.00023,69500,16.04310,433208
8600,caleidos-yoshieki1992,1,0.00023,69501,16.04333,433208
8601,calen3,1,0.00023,69502,16.04356,433208
8602,cal-pratt,1,0.00023,69503,16.04379,433208
8603,CandiedCode,1,0.00023,69504,16.04403,433208
8604,caozhiyuan,1,0.00023,69505,16.04426,433208
8605,capcom923,1,0.00023,69506,16.04449,433208
8606,cape-man,1,0.00023,69507,16.04472,433208
8607,capsali,1,0.00023,69508,16.04495,433208
8608,captnbp,1,0.00023,69509,16.04518,433208
8609,carlbordum,1,0.00023,69510,16.04541,433208
8610,Carles-Figuerola,1,0.00023,69511,16.04564,433208
8611,carlmacdiarmada,1,0.00023,69512,16.04587,433208
8612,carloscao0928,1,0.00023,69513,16.04610,433208
8613,CarlosPerdomo,1,0.00023,69514,16.04633,433208
8614,carpemonf,1,0.00023,69515,16.04656,433208
8615,CarwynNelson,1,0.00023,69516,16.04680,433208
8616,casey-robertson,1,0.00023,69517,16.04703,433208
8617,casret,1,0.00023,69518,16.04726,433208
8618,castor91,1,0.00023,69519,16.04749,433208
8619,catac,1,0.00023,69520,16.04772,433208
8620,catacgc,1,0.00023,69521,16.04795,433208
8621,cb1234,1,0.00023,69522,16.04818,433208
8622,cbighea,1,0.00023,69523,16.04841,433208
8623,cblomart,1,0.00023,69524,16.04864,433208
8624,cchongXD,1,0.00023,69525,16.04887,433208
8625,ccmanito,1,0.00023,69526,16.04910,433208
8626,ccremer,1,0.00023,69527,16.04933,433208
8627,cczz12345,1,0.00023,69528,16.04957,433208
8628,cde0,1,0.00023,69529,16.04980,433208
8629,cdennison,1,0.00023,69530,16.05003,433208
8630,cdlcs,1,0.00023,69531,16.05026,433208
8631,cdloh,1,0.00023,69532,16.05049,433208
8632,CDP14,1,0.00023,69533,16.05072,433208
8633,cdunford,1,0.00023,69534,16.05095,433208
8634,cede87,1,0.00023,69535,16.05118,433208
8635,cedricboesiger,1,0.00023,69536,16.05141,433208
8636,ceenam,1,0.00023,69537,16.05164,433208
8637,celestialorb,1,0.00023,69538,16.05187,433208
8638,cer,1,0.00023,69539,16.05210,433208
8639,cerebrate,1,0.00023,69540,16.05234,433208
8640,ceroloy,1,0.00023,69541,16.05257,433208
8641,CEVERY,1,0.00023,69542,16.05280,433208
8642,cezeno2s,1,0.00023,69543,16.05303,433208
8643,cfarrend,1,0.00023,69544,16.05326,433208
8644,CFR0901,1,0.00023,69545,16.05349,433208
8645,cf-sewe,1,0.00023,69546,16.05372,433208
8646,cg110,1,0.00023,69547,16.05395,433208
8647,cgorman,1,0.00023,69548,16.05418,433208
8648,cgrant,1,0.00023,69549,16.05441,433208
8649,chabater,1,0.00023,69550,16.05464,433208
8650,chacha923,1,0.00023,69551,16.05487,433208
8651,chache35,1,0.00023,69552,16.05511,433208
8652,chad-barensfeld-exa,1,0.00023,69553,16.05534,433208
8653,chadnash,1,0.00023,69554,16.05557,433208
8654,chaets,1,0.00023,69555,16.05580,433208
8655,chaimk-als,1,0.00023,69556,16.05603,433208
8656,chaitan94,1,0.00023,69557,16.05626,433208
8657,chaitrachandrashekar,1,0.00023,69558,16.05649,433208
8658,chakrabandla,1,0.00023,69559,16.05672,433208
8659,chalcrow,1,0.00023,69560,16.05695,433208
8660,chaliy,1,0.00023,69561,16.05718,433208
8661,challett,1,0.00023,69562,16.05741,433208
8662,chancejin,1,0.00023,69563,16.05764,433208
8663,ChandaniM123,1,0.00023,69564,16.05788,433208
8664,chandras-xl,1,0.00023,69565,16.05811,433208
8665,chandrureddy,1,0.00023,69566,16.05834,433208
8666,chang90,1,0.00023,69567,16.05857,433208
8667,ChangjunZhao,1,0.00023,69568,16.05880,433208
8668,changkun,1,0.00023,69569,16.05903,433208
8669,changli6,1,0.00023,69570,16.05926,433208
8670,changlidong68,1,0.00023,69571,16.05949,433208
8671,channeladam,1,0.00023,69572,16.05972,433208
8672,chaoyebugao,1,0.00023,69573,16.05995,433208
8673,chaozgz,1,0.00023,69574,16.06018,433208
8674,charandas,1,0.00023,69575,16.06041,433208
8675,charlely,1,0.00023,69576,16.06065,433208
8676,charlesguo404,1,0.00023,69577,16.06088,433208
8677,CharlesMasson,1,0.00023,69578,16.06111,433208
8678,CharlieBrownMx,1,0.00023,69579,16.06134,433208
8679,charlielito,1,0.00023,69580,16.06157,433208
8680,CharlKlein,1,0.00023,69581,16.06180,433208
8681,CharlyRipp,1,0.00023,69582,16.06203,433208
8682,chasewalden,1,0.00023,69583,16.06226,433208
8683,chatii,1,0.00023,69584,16.06249,433208
8684,chatwithruben,1,0.00023,69585,16.06272,433208
8685,chauffer,1,0.00023,69586,16.06295,433208
8686,chaumifan,1,0.00023,69587,16.06318,433208
8687,chdeepak,1,0.00023,69588,16.06342,433208
8688,chearmstrong,1,0.00023,69589,16.06365,433208
8689,cheeseyeah,1,0.00023,69590,16.06388,433208
8690,chen-ABC,1,0.00023,69591,16.06411,433208
8691,chengtong321,1,0.00023,69592,16.06434,433208
8692,chengzhycn,1,0.00023,69593,16.06457,433208
8693,chen-jie,1,0.00023,69594,16.06480,433208
8694,chenyosef,1,0.00023,69595,16.06503,433208
8695,chenzhijun,1,0.00023,69596,16.06526,433208
8696,chenzhikang,1,0.00023,69597,16.06549,433208
8697,cherubic,1,0.00023,69598,16.06572,433208
8698,chetansawant462,1,0.00023,69599,16.06595,433208
8699,chichunhua,1,0.00023,69600,16.06619,433208
8700,Chickaloo,1,0.00023,69601,16.06642,433208
8701,chilicat,1,0.00023,69602,16.06665,433208
8702,chinazzb,1,0.00023,69603,16.06688,433208
8703,chinmayb,1,0.00023,69604,16.06711,433208
8704,chinnasamyb,1,0.00023,69605,16.06734,433208
8705,chinvelski,1,0.00023,69606,16.06757,433208
8706,chirayus25,1,0.00023,69607,16.06780,433208
8707,chnaveen112,1,0.00023,69608,16.06803,433208
8708,Cho1409,1,0.00023,69609,16.06826,433208
8709,ChocolatePadmanaban,1,0.00023,69610,16.06849,433208
8710,chokhareganesh,1,0.00023,69611,16.06872,433208
8711,chongkong,1,0.00023,69612,16.06896,433208
8712,chongyangshi,1,0.00023,69613,16.06919,433208
8713,chornlgscout,1,0.00023,69614,16.06942,433208
8714,chphong,1,0.00023,69615,16.06965,433208
8715,Chris92ch,1,0.00023,69616,16.06988,433208
8716,chrisahl,1,0.00023,69617,16.07011,433208
8717,chris-downs,1,0.00023,69618,16.07034,433208
8718,chriskite,1,0.00023,69619,16.07057,433208
8719,chrispatmore,1,0.00023,69620,16.07080,433208
8720,chrisstafford,1,0.00023,69621,16.07103,433208
8721,christian-2,1,0.00023,69622,16.07126,433208
8722,christianang,1,0.00023,69623,16.07149,433208
8723,ChristianKlass,1,0.00023,69624,16.07173,433208
8724,christian-korneck,1,0.00023,69625,16.07196,433208
8725,christian-oudard,1,0.00023,69626,16.07219,433208
8726,christofferjerrebo,1,0.00023,69627,16.07242,433208
8727,ChristosKa,1,0.00023,69628,16.07265,433208
8728,christosploutarchou,1,0.00023,69629,16.07288,433208
8729,ChrisUnityArto,1,0.00023,69630,16.07311,433208
8730,ChrisWeissNike,1,0.00023,69631,16.07334,433208
8731,chromko,1,0.00023,69632,16.07357,433208
8732,chroth7,1,0.00023,69633,16.07380,433208
8733,chruss2,1,0.00023,69634,16.07403,433208
8734,chsatyap,1,0.00023,69635,16.07426,433208
8735,chuang-lyft,1,0.00023,69636,16.07450,433208
8736,chukmunnlee,1,0.00023,69637,16.07473,433208
8737,churma,1,0.00023,69638,16.07496,433208
8738,chyj607,1,0.00023,69639,16.07519,433208
8739,Cicatrice,1,0.00023,69640,16.07542,433208
8740,CiCi503,1,0.00023,69641,16.07565,433208
8741,cickes,1,0.00023,69642,16.07588,433208
8742,cihantunali,1,0.00023,69643,16.07611,433208
8743,cihatyildiz,1,0.00023,69644,16.07634,433208
8744,ciiiii,1,0.00023,69645,16.07657,433208
8745,cindykimxp,1,0.00023,69646,16.07680,433208
8746,CJCShadowsan,1,0.00023,69647,16.07703,433208
8747,cjgibson,1,0.00023,69648,16.07727,433208
8748,cjrpriest,1,0.00023,69649,16.07750,433208
8749,ckanner,1,0.00023,69650,16.07773,433208
8750,cknakal,1,0.00023,69651,16.07796,433208
8751,c-koell,1,0.00023,69652,16.07819,433208
8752,claas-fridtjof-lisowski,1,0.00023,69653,16.07842,433208
8753,claudioscatoli,1,0.00023,69654,16.07865,433208
8754,claui,1,0.00023,69655,16.07888,433208
8755,clearbjli,1,0.00023,69656,16.07911,433208
8756,ClementIV,1,0.00023,69657,16.07934,433208
8757,cleverjam,1,0.00023,69658,16.07957,433208
8758,clhuang,1,0.00023,69659,16.07980,433208
8759,clickatsachin,1,0.00023,69660,16.08004,433208
8760,clienthax,1,0.00023,69661,16.08027,433208
8761,cliff-wakefield-acurus,1,0.00023,69662,16.08050,433208
8762,cliles,1,0.00023,69663,16.08073,433208
8763,cljk,1,0.00023,69664,16.08096,433208
8764,ClosingBracket,1,0.00023,69665,16.08119,433208
8765,cloutiertyler,1,0.00023,69666,16.08142,433208
8766,clrxbl,1,0.00023,69667,16.08165,433208
8767,ClumsyPotato,1,0.00023,69668,16.08188,433208
8768,clydevassallo,1,0.00023,69669,16.08211,433208
8769,cmagorian,1,0.00023,69670,16.08234,433208
8770,CMCDragonkai,1,0.00023,69671,16.08257,433208
8771,CmeherGit,1,0.00023,69672,16.08281,433208
8772,cmrajiv,1,0.00023,69673,16.08304,433208
8773,cmsxbc,1,0.00023,69674,16.08327,433208
8774,cmurray47,1,0.00023,69675,16.08350,433208
8775,CNG,1,0.00023,69676,16.08373,433208
8776,cnkens,1,0.00023,69677,16.08396,433208
8777,cnlong,1,0.00023,69678,16.08419,433208
8778,coadler,1,0.00023,69679,16.08442,433208
8779,CoaxVex,1,0.00023,69680,16.08465,433208
8780,codapus-co,1,0.00023,69681,16.08488,433208
8781,codeasashu,1,0.00023,69682,16.08511,433208
8782,codeBehindMe,1,0.00023,69683,16.08534,433208
8783,CodeClinch,1,0.00023,69684,16.08558,433208
8784,codejamninja,1,0.00023,69685,16.08581,433208
8785,codeonix,1,0.00023,69686,16.08604,433208
8786,coderajat24,1,0.00023,69687,16.08627,433208
8787,coderatchet,1,0.00023,69688,16.08650,433208
8788,coderaven,1,0.00023,69689,16.08673,433208
8789,CoderPoet,1,0.00023,69690,16.08696,433208
8790,coders-i,1,0.00023,69691,16.08719,433208
8791,CodeStaple,1,0.00023,69692,16.08742,433208
8792,codestorycooked,1,0.00023,69693,16.08765,433208
8793,codewithkanishq,1,0.00023,69694,16.08788,433208
8794,CodingSpiderFox,1,0.00023,69695,16.08811,433208
8795,codinl,1,0.00023,69696,16.08835,433208
8796,Cogniser,1,0.00023,69697,16.08858,433208
8797,cojocaru-dragos-alexandru,1,0.00023,69698,16.08881,433208
8798,colangelo,1,0.00023,69699,16.08904,433208
8799,colceagus,1,0.00023,69700,16.08927,433208
8800,colearendt,1,0.00023,69701,16.08950,433208
8801,colek319,1,0.00023,69702,16.08973,433208
8802,cole-myers,1,0.00023,69703,16.08996,433208
8803,colin-higgins,1,0.00023,69704,16.09019,433208
8804,collinticer,1,0.00023,69705,16.09042,433208
8805,conet,1,0.00023,69706,16.09065,433208
8806,conhumi,1,0.00023,69707,16.09088,433208
8807,connorlwilkes,1,0.00023,69708,16.09112,433208
8808,connorworkman,1,0.00023,69709,16.09135,433208
8809,constantinpr,1,0.00023,69710,16.09158,433208
8810,coolpalani,1,0.00023,69711,16.09181,433208
8811,corbanvilla,1,0.00023,69712,16.09204,433208
8812,Cordius,1,0.00023,69713,16.09227,433208
8813,corestackdev,1,0.00023,69714,16.09250,433208
8814,coreyzzp,1,0.00023,69715,16.09273,433208
8815,cormacArt,1,0.00023,69716,16.09296,433208
8816,coro,1,0.00023,69717,16.09319,433208
8817,corporateselect,1,0.00023,69718,16.09342,433208
8818,Cosmoplat-edge,1,0.00023,69719,16.09365,433208
8819,costap,1,0.00023,69720,16.09389,433208
8820,coultenholt,1,0.00023,69721,16.09412,433208
8821,cpiment,1,0.00023,69722,16.09435,433208
8822,cpmoore,1,0.00023,69723,16.09458,433208
8823,cpxPratik,1,0.00023,69724,16.09481,433208
8824,cr4igo,1,0.00023,69725,16.09504,433208
8825,CRASH-Tech,1,0.00023,69726,16.09527,433208
8826,crd477,1,0.00023,69727,16.09550,433208
8827,cre8ivejp,1,0.00023,69728,16.09573,433208
8828,CreativeCoder786,1,0.00023,69729,16.09596,433208
8829,cristalink,1,0.00023,69730,16.09619,433208
8830,cristichiru,1,0.00023,69731,16.09642,433208
8831,crlane,1,0.00023,69732,16.09666,433208
8832,croensch,1,0.00023,69733,16.09689,433208
8833,crpotter,1,0.00023,69734,16.09712,433208
8834,crucialfelix,1,0.00023,69735,16.09735,433208
8835,Cryptonewsmedia,1,0.00023,69736,16.09758,433208
8836,cschuet,1,0.00023,69737,16.09781,433208
8837,cSDes1gn,1,0.00023,69738,16.09804,433208
8838,csilcock,1,0.00023,69739,16.09827,433208
8839,cskinfill,1,0.00023,69740,16.09850,433208
8840,csou812,1,0.00023,69741,16.09873,433208
8841,CSP197,1,0.00023,69742,16.09896,433208
8842,csturgess93,1,0.00023,69743,16.09919,433208
8843,cthumuluru,1,0.00023,69744,16.09943,433208
8844,ctrahey,1,0.00023,69745,16.09966,433208
8845,CtrlZvi,1,0.00023,69746,16.09989,433208
8846,ctrysbita,1,0.00023,69747,16.10012,433208
8847,Cuite21,1,0.00023,69748,16.10035,433208
8848,Culip,1,0.00023,69749,16.10058,433208
8849,curiousleo,1,0.00023,69750,16.10081,433208
8850,cviebig,1,0.00023,69751,16.10104,433208
8851,cwchoe,1,0.00023,69752,16.10127,433208
8852,cwegener,1,0.00023,69753,16.10150,433208
8853,cwlowder,1,0.00023,69754,16.10173,433208
8854,c-x-berger,1,0.00023,69755,16.10196,433208
8855,cyang49,1,0.00023,69756,16.10220,433208
8856,CyberPoison,1,0.00023,69757,16.10243,433208
8857,cyberSJ,1,0.00023,69758,16.10266,433208
8858,cycwll,1,0.00023,69759,16.10289,433208
8859,cydonknight,1,0.00023,69760,16.10312,433208
8860,cyngus84,1,0.00023,69761,16.10335,433208
8861,cypris,1,0.00023,69762,16.10358,433208
8862,CyshallChan,1,0.00023,69763,16.10381,433208
8863,cyt3ea,1,0.00023,69764,16.10404,433208
8864,CzBiX,1,0.00023,69765,16.10427,433208
8865,czhfe,1,0.00023,69766,16.10450,433208
8866,cz-it,1,0.00023,69767,16.10473,433208
8867,d270624,1,0.00023,69768,16.10497,433208
8868,d2dyno,1,0.00023,69769,16.10520,433208
8869,daastek,1,0.00023,69770,16.10543,433208
8870,dabde,1,0.00023,69771,16.10566,433208
8871,dable-mj111,1,0.00023,69772,16.10589,433208
8872,dadav,1,0.00023,69773,16.10612,433208
8873,daddonpa,1,0.00023,69774,16.10635,433208
8874,daddy-joseph97,1,0.00023,69775,16.10658,433208
8875,DafuSHI,1,0.00023,69776,16.10681,433208
8876,Daggy1234,1,0.00023,69777,16.10704,433208
8877,daghaian,1,0.00023,69778,16.10727,433208
8878,daheige,1,0.00023,69779,16.10750,433208
8879,daicoden,1,0.00023,69780,16.10774,433208
8880,daiguanglin,1,0.00023,69781,16.10797,433208
8881,dalbani,1,0.00023,69782,16.10820,433208
8882,dalemarchand,1,0.00023,69783,16.10843,433208
8883,DaleyKD,1,0.00023,69784,16.10866,433208
8884,damduck01,1,0.00023,69785,16.10889,433208
8885,damon09273,1,0.00023,69786,16.10912,433208
8886,damonYuan,1,0.00023,69787,16.10935,433208
8887,damoon,1,0.00023,69788,16.10958,433208
8888,damusix,1,0.00023,69789,16.10981,433208
8889,danfromtitan,1,0.00023,69790,16.11004,433208
8890,DaniDD,1,0.00023,69791,16.11027,433208
8891,DanielArthurUK,1,0.00023,69792,16.11051,433208
8892,danieledivito,1,0.00023,69793,16.11074,433208
8893,danieljkemp,1,0.00023,69794,16.11097,433208
8894,DanielJonesEB,1,0.00023,69795,16.11120,433208
8895,danielolabanji,1,0.00023,69796,16.11143,433208
8896,danjagnow,1,0.00023,69797,16.11166,433208
8897,dan-katz,1,0.00023,69798,16.11189,433208
8898,dankegel,1,0.00023,69799,16.11212,433208
8899,danmutblix,1,0.00023,69800,16.11235,433208
8900,dannyburke1,1,0.00023,69801,16.11258,433208
8901,danopia,1,0.00023,69802,16.11281,433208
8902,danrspencer,1,0.00023,69803,16.11305,433208
8903,dantman,1,0.00023,69804,16.11328,433208
8904,danyalxahid,1,0.00023,69805,16.11351,433208
8905,daocloudplf,1,0.00023,69806,16.11374,433208
8906,daozhao,1,0.00023,69807,16.11397,433208
8907,daparthi001,1,0.00023,69808,16.11420,433208
8908,dara-na,1,0.00023,69809,16.11443,433208
8909,dare-darryl,1,0.00023,69810,16.11466,433208
8910,darioneto,1,0.00023,69811,16.11489,433208
8911,dariuszbz,1,0.00023,69812,16.11512,433208
8912,dariuszkuc,1,0.00023,69813,16.11535,433208
8913,Darkest,1,0.00023,69814,16.11558,433208
8914,darkpixel,1,0.00023,69815,16.11582,433208
8915,darkpssngr,1,0.00023,69816,16.11605,433208
8916,darksinge,1,0.00023,69817,16.11628,433208
8917,darktempla,1,0.00023,69818,16.11651,433208
8918,Darkvenomback,1,0.00023,69819,16.11674,433208
8919,darrais,1,0.00023,69820,16.11697,433208
8920,darrenfurr,1,0.00023,69821,16.11720,433208
8921,Darren-wh,1,0.00023,69822,16.11743,433208
8922,darsh-b88,1,0.00023,69823,16.11766,433208
8923,Darsh-Dev,1,0.00023,69824,16.11789,433208
8924,daseth,1,0.00023,69825,16.11812,433208
8925,dasJ,1,0.00023,69826,16.11835,433208
8926,dasl-,1,0.00023,69827,16.11859,433208
8927,dastergon,1,0.00023,69828,16.11882,433208
8928,DASXCE,1,0.00023,69829,16.11905,433208
8929,DasyDong,1,0.00023,69830,16.11928,433208
8930,datamattsson,1,0.00023,69831,16.11951,433208
8931,datavisorwenjiehuang,1,0.00023,69832,16.11974,433208
8932,daudtacto,1,0.00023,69833,16.11997,433208
8933,daveey,1,0.00023,69834,16.12020,433208
8934,davejhahn,1,0.00023,69835,16.12043,433208
8935,davekassel,1,0.00023,69836,16.12066,433208
8936,davemt,1,0.00023,69837,16.12089,433208
8937,DaveWHarvey,1,0.00023,69838,16.12112,433208
8938,davidblondeau,1,0.00023,69839,16.12136,433208
8939,davidcorbin,1,0.00023,69840,16.12159,433208
8940,daviddelucca,1,0.00023,69841,16.12182,433208
8941,daviddenton,1,0.00023,69842,16.12205,433208
8942,davidedmonds,1,0.00023,69843,16.12228,433208
8943,davidegiunchi,1,0.00023,69844,16.12251,433208
8944,davidfetter,1,0.00023,69845,16.12274,433208
8945,davidghiurco,1,0.00023,69846,16.12297,433208
8946,davidhiendl,1,0.00023,69847,16.12320,433208
8947,davidjsherman,1,0.00023,69848,16.12343,433208
8948,davidmateos,1,0.00023,69849,16.12366,433208
8949,davidMcneil,1,0.00023,69850,16.12389,433208
8950,davidnewhall,1,0.00023,69851,16.12413,433208
8951,davidsielert,1,0.00023,69852,16.12436,433208
8952,davinkevin,1,0.00023,69853,16.12459,433208
8953,davlloyd,1,0.00023,69854,16.12482,433208
8954,daweim0,1,0.00023,69855,16.12505,433208
8955,DawidIzydor,1,0.00023,69856,16.12528,433208
8956,dayongi,1,0.00023,69857,16.12551,433208
8957,dazinator,1,0.00023,69858,16.12574,433208
8958,dazza76,1,0.00023,69859,16.12597,433208
8959,dbabits,1,0.00023,69860,16.12620,433208
8960,dba-git,1,0.00023,69861,16.12643,433208
8961,dbasinge,1,0.00023,69862,16.12666,433208
8962,dbaskakov,1,0.00023,69863,16.12690,433208
8963,dbenoit17,1,0.00023,69864,16.12713,433208
8964,dbonino,1,0.00023,69865,16.12736,433208
8965,dbousquet,1,0.00023,69866,16.12759,433208
8966,dcepelik,1,0.00023,69867,16.12782,433208
8967,dcristolovean,1,0.00023,69868,16.12805,433208
8968,d-cs,1,0.00023,69869,16.12828,433208
8969,ddelange,1,0.00023,69870,16.12851,433208
8970,ddfreyne,1,0.00023,69871,16.12874,433208
8971,ddljdd,1,0.00023,69872,16.12897,433208
8972,d-dmitry,1,0.00023,69873,16.12920,433208
8973,ddonnen,1,0.00023,69874,16.12943,433208
8974,ddy86,1,0.00023,69875,16.12967,433208
8975,deadanon,1,0.00023,69876,16.12990,433208
8976,dean2021,1,0.00023,69877,16.13013,433208
8977,DeathBorn,1,0.00023,69878,16.13036,433208
8978,debugleader,1,0.00023,69879,16.13059,433208
8979,deciojr,1,0.00023,69880,16.13082,433208
8980,deedf,1,0.00023,69881,16.13105,433208
8981,deejvince,1,0.00023,69882,16.13128,433208
8982,Deepak1100,1,0.00023,69883,16.13151,433208
8983,deepakarchinnova,1,0.00023,69884,16.13174,433208
8984,deepakpate07,1,0.00023,69885,16.13197,433208
8985,deepakrbharadwaj,1,0.00023,69886,16.13220,433208
8986,deepflame,1,0.00023,69887,16.13244,433208
8987,deerjoe,1,0.00023,69888,16.13267,433208
8988,defyjoy,1,0.00023,69889,16.13290,433208
8989,dejwsz,1,0.00023,69890,16.13313,433208
8990,dekelev,1,0.00023,69891,16.13336,433208
8991,deleted,1,0.00023,69892,16.13359,433208
8992,delulu,1,0.00023,69893,16.13382,433208
8993,demon,1,0.00023,69894,16.13405,433208
8994,dengqiangloveju,1,0.00023,69895,16.13428,433208
8995,dengyongfu,1,0.00023,69896,16.13451,433208
8996,DenisRazinkin,1,0.00023,69897,16.13474,433208
8997,denisrohr,1,0.00023,69898,16.13497,433208
8998,dennisahuja,1,0.00023,69899,16.13521,433208
8999,DennisGlindhart,1,0.00023,69900,16.13544,433208
9000,dennisroche,1,0.00023,69901,16.13567,433208
9001,dequis,1,0.00023,69902,16.13590,433208
9002,derekbedwards,1,0.00023,69903,16.13613,433208
9003,derit,1,0.00023,69904,16.13636,433208
9004,derklauer-ocean,1,0.00023,69905,16.13659,433208
9005,deromemont,1,0.00023,69906,16.13682,433208
9006,DerTiedemann,1,0.00023,69907,16.13705,433208
9007,deshui123,1,0.00023,69908,16.13728,433208
9008,deusnefum,1,0.00023,69909,16.13751,433208
9009,Dev25,1,0.00023,69910,16.13774,433208
9010,devdattakulkarni,1,0.00023,69911,16.13798,433208
9011,devdesai16,1,0.00023,69912,16.13821,433208
9012,devdev606,1,0.00023,69913,16.13844,433208
9013,Developer513,1,0.00023,69914,16.13867,433208
9014,develop-mental,1,0.00023,69915,16.13890,433208
9015,devgig,1,0.00023,69916,16.13913,433208
9016,Devik225,1,0.00023,69917,16.13936,433208
9017,devinrsmith,1,0.00023,69918,16.13959,433208
9018,dev-io-yasir,1,0.00023,69919,16.13982,433208
9019,devkishanJoshi,1,0.00023,69920,16.14005,433208
9020,dev-korr,1,0.00023,69921,16.14028,433208
9021,devlifealways,1,0.00023,69922,16.14051,433208
9022,devopsix,1,0.00023,69923,16.14075,433208
9023,devopsjonas,1,0.00023,69924,16.14098,433208
9024,devopskaran,1,0.00023,69925,16.14121,433208
9025,devopskid,1,0.00023,69926,16.14144,433208
9026,devopsspiral,1,0.00023,69927,16.14167,433208
9027,devtech0101,1,0.00023,69928,16.14190,433208
9028,devwinner-sek,1,0.00023,69929,16.14213,433208
9029,Devyadav1994,1,0.00023,69930,16.14236,433208
9030,dewanymca,1,0.00023,69931,16.14259,433208
9031,dex80526,1,0.00023,69932,16.14282,433208
9032,dexter-hwang,1,0.00023,69933,16.14305,433208
9033,dfbingo,1,0.00023,69934,16.14328,433208
9034,dfluff,1,0.00023,69935,16.14352,433208
9035,dfsdevops,1,0.00023,69936,16.14375,433208
9036,dFurman,1,0.00023,69937,16.14398,433208
9037,dfurtado,1,0.00023,69938,16.14421,433208
9038,dg-jwmera,1,0.00023,69939,16.14444,433208
9039,DhanashriPalodkar,1,0.00023,69940,16.14467,433208
9040,dhaneesht,1,0.00023,69941,16.14490,433208
9041,dheerujava,1,0.00023,69942,16.14513,433208
9042,dhrida,1,0.00023,69943,16.14536,433208
9043,DhruvBarot,1,0.00023,69944,16.14559,433208
9044,dhruvit01,1,0.00023,69945,16.14582,433208
9045,diabloxenon,1,0.00023,69946,16.14605,433208
9046,DiCanio,1,0.00023,69947,16.14629,433208
9047,didevlab,1,0.00023,69948,16.14652,433208
9048,didil,1,0.00023,69949,16.14675,433208
9049,didiplus,1,0.00023,69950,16.14698,433208
9050,diegofps,1,0.00023,69951,16.14721,433208
9051,DiegoLelis,1,0.00023,69952,16.14744,433208
9052,diegoxro,1,0.00023,69953,16.14767,433208
9053,dieucao,1,0.00023,69954,16.14790,433208
9054,digitalronin,1,0.00023,69955,16.14813,433208
9055,digitalsanctum,1,0.00023,69956,16.14836,433208
9056,dileep-p,1,0.00023,69957,16.14859,433208
9057,dilipk8,1,0.00023,69958,16.14882,433208
9058,dimitrez,1,0.00023,69959,16.14906,433208
9059,DimitrijeManic,1,0.00023,69960,16.14929,433208
9060,Dinesh558,1,0.00023,69961,16.14952,433208
9061,dineshkumar181094,1,0.00023,69962,16.14975,433208
9062,diogomurta,1,0.00023,69963,16.14998,433208
9063,diogonborges,1,0.00023,69964,16.15021,433208
9064,dio-trinny,1,0.00023,69965,16.15044,433208
9065,Dipenduroy,1,0.00023,69966,16.15067,433208
9066,dipu-bd,1,0.00023,69967,16.15090,433208
9067,DirkTheDaring,1,0.00023,69968,16.15113,433208
9068,Dirrk,1,0.00023,69969,16.15136,433208
9069,dirtyearl,1,0.00023,69970,16.15159,433208
9070,disaster37,1,0.00023,69971,16.15183,433208
9071,discordiaZA,1,0.00023,69972,16.15206,433208
9072,distributethe6ix,1,0.00023,69973,16.15229,433208
9073,DiveInto,1,0.00023,69974,16.15252,433208
9074,divya144,1,0.00023,69975,16.15275,433208
9075,divyhshah,1,0.00023,69976,16.15298,433208
9076,dj80hd,1,0.00023,69977,16.15321,433208
9077,djaax,1,0.00023,69978,16.15344,433208
9078,djamaile,1,0.00023,69979,16.15367,433208
9079,djanku,1,0.00023,69980,16.15390,433208
9080,djeverett,1,0.00023,69981,16.15413,433208
9081,djhoese,1,0.00023,69982,16.15436,433208
9082,DjinNO,1,0.00023,69983,16.15460,433208
9083,djm457,1,0.00023,69984,16.15483,433208
9084,djpbessems,1,0.00023,69985,16.15506,433208
9085,djrollins,1,0.00023,69986,16.15529,433208
9086,djupudga,1,0.00023,69987,16.15552,433208
9087,djvasquezvm,1,0.00023,69988,16.15575,433208
9088,dka23,1,0.00023,69989,16.15598,433208
9089,dkeightley,1,0.00023,69990,16.15621,433208
9090,dkwakkel,1,0.00023,69991,16.15644,433208
9091,dleumann,1,0.00023,69992,16.15667,433208
9092,dlfoo,1,0.00023,69993,16.15690,433208
9093,dlmorais-pbh,1,0.00023,69994,16.15713,433208
9094,Dlougach,1,0.00023,69995,16.15737,433208
9095,dlut2,1,0.00023,69996,16.15760,433208
9096,d-luu,1,0.00023,69997,16.15783,433208
9097,dmarsh19,1,0.00023,69998,16.15806,433208
9098,dmarupov,1,0.00023,69999,16.15829,433208
9099,dmeatriy,1,0.00023,70000,16.15852,433208
9100,dmellstrom,1,0.00023,70001,16.15875,433208
9101,dmeytin,1,0.00023,70002,16.15898,433208
9102,dmitry-saprykin,1,0.00023,70003,16.15921,433208
9103,dmitry-semenov-rtl,1,0.00023,70004,16.15944,433208
9104,DmitrySergeyev,1,0.00023,70005,16.15967,433208
9105,dmnemec,1,0.00023,70006,16.15990,433208
9106,DMW007,1,0.00023,70007,16.16014,433208
9107,dmytro-pryvedeniuk,1,0.00023,70008,16.16037,433208
9108,dnasir,1,0.00023,70009,16.16060,433208
9109,dnd,1,0.00023,70010,16.16083,433208
9110,dnl-wlf,1,0.00023,70011,16.16106,433208
9111,dobharweim,1,0.00023,70012,16.16129,433208
9112,doctorpangloss,1,0.00023,70013,16.16152,433208
9113,DocX,1,0.00023,70014,16.16175,433208
9114,dodtsair,1,0.00023,70015,16.16198,433208
9115,dogfei,1,0.00023,70016,16.16221,433208
9116,dogzzdogzz,1,0.00023,70017,16.16244,433208
9117,dojci,1,0.00023,70018,16.16267,433208
9118,dolly22,1,0.00023,70019,16.16291,433208
9119,dombeck,1,0.00023,70020,16.16314,433208
9120,domhdp,1,0.00023,70021,16.16337,433208
9121,DomHoney,1,0.00023,70022,16.16360,433208
9122,dominik-bln,1,0.00023,70023,16.16383,433208
9123,dominiquehunziker,1,0.00023,70024,16.16406,433208
9124,dominthomas,1,0.00023,70025,16.16429,433208
9125,donaldgifford,1,0.00023,70026,16.16452,433208
9126,donatelloOo,1,0.00023,70027,16.16475,433208
9127,don-code,1,0.00023,70028,16.16498,433208
9128,dongxijia,1,0.00023,70029,16.16521,433208
9129,donhuvy,1,0.00023,70030,16.16544,433208
9130,donnlee,1,0.00023,70031,16.16568,433208
9131,donomur,1,0.00023,70032,16.16591,433208
9132,dontreboot,1,0.00023,70033,16.16614,433208
9133,DontWorry33,1,0.00023,70034,16.16637,433208
9134,DoomGerbil,1,0.00023,70035,16.16660,433208
9135,doremigithub,1,0.00023,70036,16.16683,433208
9136,dosuken123,1,0.00023,70037,16.16706,433208
9137,dotbalo,1,0.00023,70038,16.16729,433208
9138,dotdc,1,0.00023,70039,16.16752,433208
9139,dougbertwashere,1,0.00023,70040,16.16775,433208
9140,douglasquintanilha,1,0.00023,70041,16.16798,433208
9141,dpaks,1,0.00023,70042,16.16821,433208
9142,dpantic,1,0.00023,70043,16.16845,433208
9143,dpappmako,1,0.00023,70044,16.16868,433208
9144,DPM97,1,0.00023,70045,16.16891,433208
9145,dr460neye,1,0.00023,70046,16.16914,433208
9146,dragonly,1,0.00023,70047,16.16937,433208
9147,Dragonnblack,1,0.00023,70048,16.16960,433208
9148,dratler,1,0.00023,70049,16.16983,433208
9149,drbugfinder,1,0.00023,70050,16.17006,433208
9150,drc-agasser,1,0.00023,70051,16.17029,433208
9151,drduker,1,0.00023,70052,16.17052,433208
9152,dreisel,1,0.00023,70053,16.17075,433208
9153,drequena,1,0.00023,70054,16.17098,433208
9154,drewblas,1,0.00023,70055,16.17122,433208
9155,Drew-Jay,1,0.00023,70056,16.17145,433208
9156,drewp,1,0.00023,70057,16.17168,433208
9157,drewpca,1,0.00023,70058,16.17191,433208
9158,drgorb,1,0.00023,70059,16.17214,433208
9159,DrHardReset,1,0.00023,70060,16.17237,433208
9160,drogus,1,0.00023,70061,16.17260,433208
9161,dron-alterpost,1,0.00023,70062,16.17283,433208
9162,drurenia,1,0.00023,70063,16.17306,433208
9163,dsabsay,1,0.00023,70064,16.17329,433208
9164,dsalaza4,1,0.00023,70065,16.17352,433208
9165,dsalcedolab,1,0.00023,70066,16.17375,433208
9166,dsayling,1,0.00023,70067,16.17399,433208
9167,dsbos,1,0.00023,70068,16.17422,433208
9168,dschunack,1,0.00023,70069,16.17445,433208
9169,dsindatry,1,0.00023,70070,16.17468,433208
9170,dswiecki,1,0.00023,70071,16.17491,433208
9171,dtyctrl,1,0.00023,70072,16.17514,433208
9172,du86796922,1,0.00023,70073,16.17537,433208
9173,duanwei33,1,0.00023,70074,16.17560,433208
9174,dubbadhar,1,0.00023,70075,16.17583,433208
9175,Dudssource,1,0.00023,70076,16.17606,433208
9176,dudubis,1,0.00023,70077,16.17629,433208
9177,duedal,1,0.00023,70078,16.17652,433208
9178,duhongyu,1,0.00023,70079,16.17676,433208
9179,dullasuresh37,1,0.00023,70080,16.17699,433208
9180,dunefro,1,0.00023,70081,16.17722,433208
9181,dunjoye4real,1,0.00023,70082,16.17745,433208
9182,dunxiii,1,0.00023,70083,16.17768,433208
9183,duongnt,1,0.00023,70084,16.17791,433208
9184,durera,1,0.00023,70085,16.17814,433208
9185,duritong,1,0.00023,70086,16.17837,433208
9186,Durveshpal,1,0.00023,70087,16.17860,433208
9187,DustinJSilk,1,0.00023,70088,16.17883,433208
9188,dustinmm80,1,0.00023,70089,16.17906,433208
9189,dustinvanbuskirk,1,0.00023,70090,16.17929,433208
9190,dustman9000,1,0.00023,70091,16.17953,433208
9191,dustyjump,1,0.00023,70092,16.17976,433208
9192,dvabuzyarov,1,0.00023,70093,16.17999,433208
9193,dvonessen,1,0.00023,70094,16.18022,433208
9194,dvp3010,1,0.00023,70095,16.18045,433208
9195,dvzubarev,1,0.00023,70096,16.18068,433208
9196,dwhiteddsoft,1,0.00023,70097,16.18091,433208
9197,dwmarshall,1,0.00023,70098,16.18114,433208
9198,dxvgef,1,0.00023,70099,16.18137,433208
9199,dylandjian,1,0.00023,70100,16.18160,433208
9200,Dylan-Feith,1,0.00023,70101,16.18183,433208
9201,dylanpiergies,1,0.00023,70102,16.18206,433208
9202,Dyllaann,1,0.00023,70103,16.18230,433208
9203,dylwylie,1,0.00023,70104,16.18253,433208
9204,Dymanik,1,0.00023,70105,16.18276,433208
9205,dzintars,1,0.00023,70106,16.18299,433208
9206,e10101,1,0.00023,70107,16.18322,433208
9207,eagleboatblue,1,0.00023,70108,16.18345,433208
9208,eaglebush,1,0.00023,70109,16.18368,433208
9209,Eagle-One1,1,0.00023,70110,16.18391,433208
9210,eakurdyukov,1,0.00023,70111,16.18414,433208
9211,EarlYan,1,0.00023,70112,16.18437,433208
9212,east4ming,1,0.00023,70113,16.18460,433208
9213,eastlunar,1,0.00023,70114,16.18483,433208
9214,easvera,1,0.00023,70115,16.18507,433208
9215,eaterm,1,0.00023,70116,16.18530,433208
9216,ebartz,1,0.00023,70117,16.18553,433208
9217,ebauman,1,0.00023,70118,16.18576,433208
9218,ebrainte,1,0.00023,70119,16.18599,433208
9219,ebrevdo,1,0.00023,70120,16.18622,433208
9220,eclipselu,1,0.00023,70121,16.18645,433208
9221,ecoughlan,1,0.00023,70122,16.18668,433208
9222,ecrousseau,1,0.00023,70123,16.18691,433208
9223,edeNFed,1,0.00023,70124,16.18714,433208
9224,Edge94,1,0.00023,70125,16.18737,433208
9225,edify42,1,0.00023,70126,16.18761,433208
9226,edijsdrezovs,1,0.00023,70127,16.18784,433208
9227,edkreepio,1,0.00023,70128,16.18807,433208
9228,edsoncelio,1,0.00023,70129,16.18830,433208
9229,Eduardo1911,1,0.00023,70130,16.18853,433208
9230,eduardo-lago-aguilar,1,0.00023,70131,16.18876,433208
9231,eduardoramirez,1,0.00023,70132,16.18899,433208
9232,educatux,1,0.00023,70133,16.18922,433208
9233,edwardflo,1,0.00023,70134,16.18945,433208
9234,edwardmonteiro,1,0.00023,70135,16.18968,433208
9235,Eelis,1,0.00023,70136,16.18991,433208
9236,eengelking,1,0.00023,70137,16.19014,433208
9237,eero-t,1,0.00023,70138,16.19038,433208
9238,eesperi,1,0.00023,70139,16.19061,433208
9239,EgorSysoev,1,0.00023,70140,16.19084,433208
9240,ehdieunguyen,1,0.00023,70141,16.19107,433208
9241,EHJ-52n,1,0.00023,70142,16.19130,433208
9242,EhsanSarshar,1,0.00023,70143,16.19153,433208
9243,eifelmicha,1,0.00023,70144,16.19176,433208
9244,Eifoen,1,0.00023,70145,16.19199,433208
9245,eisig,1,0.00023,70146,16.19222,433208
9246,eiswind,1,0.00023,70147,16.19245,433208
9247,ejose19,1,0.00023,70148,16.19268,433208
9248,ejschoen,1,0.00023,70149,16.19291,433208
9249,ejsuncy,1,0.00023,70150,16.19315,433208
9250,ekanufrienko,1,0.00023,70151,16.19338,433208
9251,ekbfh,1,0.00023,70152,16.19361,433208
9252,ekimekim,1,0.00023,70153,16.19384,433208
9253,eklee,1,0.00023,70154,16.19407,433208
9254,eklockare,1,0.00023,70155,16.19430,433208
9255,ekpdt,1,0.00023,70156,16.19453,433208
9256,ekremney,1,0.00023,70157,16.19476,433208
9257,eladcandroid,1,0.00023,70158,16.19499,433208
9258,EladDolev,1,0.00023,70159,16.19522,433208
9259,elanv,1,0.00023,70160,16.19545,433208
9260,elavenrac,1,0.00023,70161,16.19568,433208
9261,eldondevat,1,0.00023,70162,16.19592,433208
9262,eleni-salamani,1,0.00023,70163,16.19615,433208
9263,elftech,1,0.00023,70164,16.19638,433208
9264,eli-halych,1,0.00023,70165,16.19661,433208
9265,eli-rh,1,0.00023,70166,16.19684,433208
9266,EliseAzure,1,0.00023,70167,16.19707,433208
9267,eliw00d,1,0.00023,70168,16.19730,433208
9268,eljoth,1,0.00023,70169,16.19753,433208
9269,elkbullwinkle,1,0.00023,70170,16.19776,433208
9270,elocke,1,0.00023,70171,16.19799,433208
9271,elpaquete,1,0.00023,70172,16.19822,433208
9272,elucus,1,0.00023,70173,16.19845,433208
9273,elvin-wong,1,0.00023,70174,16.19869,433208
9274,elwood218,1,0.00023,70175,16.19892,433208
9275,EmAlexander,1,0.00023,70176,16.19915,433208
9276,EmanElsaban,1,0.00023,70177,16.19938,433208
9277,emanuelr93,1,0.00023,70178,16.19961,433208
9278,emasyakin,1,0.00023,70179,16.19984,433208
9279,eMGabriel,1,0.00023,70180,16.20007,433208
9280,emilianoorengo,1,0.00023,70181,16.20030,433208
9281,eminaktas,1,0.00023,70182,16.20053,433208
9282,emirot,1,0.00023,70183,16.20076,433208
9283,Emixam23-FCMS,1,0.00023,70184,16.20099,433208
9284,emrax,1,0.00023,70185,16.20122,433208
9285,emreberber,1,0.00023,70186,16.20146,433208
9286,emreyokur,1,0.00023,70187,16.20169,433208
9287,eNettMattD,1,0.00023,70188,16.20192,433208
9288,EngAlaaEmad,1,0.00023,70189,16.20215,433208
9289,enkelprifti98,1,0.00023,70190,16.20238,433208
9290,enricomeneghel,1,0.00023,70191,16.20261,433208
9291,enyinna1234,1,0.00023,70192,16.20284,433208
9292,Eo300,1,0.00023,70193,16.20307,433208
9293,eobermuhlner,1,0.00023,70194,16.20330,433208
9294,eoprede,1,0.00023,70195,16.20353,433208
9295,eph6666,1,0.00023,70196,16.20376,433208
9296,ephemeral,1,0.00023,70197,16.20399,433208
9297,epicvinny,1,0.00023,70198,16.20423,433208
9298,erdun,1,0.00023,70199,16.20446,433208
9299,eregon,1,0.00023,70200,16.20469,433208
9300,ErezAlster,1,0.00023,70201,16.20492,433208
9301,erganzi,1,0.00023,70202,16.20515,433208
9302,erhhung,1,0.00023,70203,16.20538,433208
9303,ericandrewmeadows,1,0.00023,70204,16.20561,433208
9304,ericdum,1,0.00023,70205,16.20584,433208
9305,eric-gunn,1,0.00023,70206,16.20607,433208
9306,erichiller,1,0.00023,70207,16.20630,433208
9307,eric-intuit,1,0.00023,70208,16.20653,433208
9308,ericmandm,1,0.00023,70209,16.20676,433208
9309,EricoCartmanez,1,0.00023,70210,16.20700,433208
9310,ericsmithfboston,1,0.00023,70211,16.20723,433208
9311,erikrenberg,1,0.00023,70212,16.20746,433208
9312,erkum,1,0.00023,70213,16.20769,433208
9313,ErnestoIslas,1,0.00023,70214,16.20792,433208
9314,ernsheong,1,0.00023,70215,16.20815,433208
9315,erohini,1,0.00023,70216,16.20838,433208
9316,erosennin9002,1,0.00023,70217,16.20861,433208
9317,erpel,1,0.00023,70218,16.20884,433208
9318,error10,1,0.00023,70219,16.20907,433208
9319,erSitzt,1,0.00023,70220,16.20930,433208
9320,Esardes,1,0.00023,70221,16.20953,433208
9321,escoffier,1,0.00023,70222,16.20977,433208
9322,EslamElHusseiny,1,0.00023,70223,16.21000,433208
9323,esteban1983cl,1,0.00023,70224,16.21023,433208
9324,estets2,1,0.00023,70225,16.21046,433208
9325,estherlyoon,1,0.00023,70226,16.21069,433208
9326,esys,1,0.00023,70227,16.21092,433208
9327,ethicalaakash,1,0.00023,70228,16.21115,433208
9328,Etienne-Carriere,1,0.00023,70229,16.21138,433208
9329,etotientz,1,0.00023,70230,16.21161,433208
9330,EugenFo,1,0.00023,70231,16.21184,433208
9331,eugeniaguerrero,1,0.00023,70232,16.21207,433208
9332,EvanCarroll,1,0.00023,70233,16.21230,433208
9333,evanelias,1,0.00023,70234,16.21254,433208
9334,evanmcclure,1,0.00023,70235,16.21277,433208
9335,evanniedojadlo,1,0.00023,70236,16.21300,433208
9336,evanrich,1,0.00023,70237,16.21323,433208
9337,everflux,1,0.00023,70238,16.21346,433208
9338,evertmulder,1,0.00023,70239,16.21369,433208
9339,evertonevaristo,1,0.00023,70240,16.21392,433208
9340,EvgenyKhaliper,1,0.00023,70241,16.21415,433208
9341,evgenyvaganov,1,0.00023,70242,16.21438,433208
9342,evo-arni,1,0.00023,70243,16.21461,433208
9343,evoio,1,0.00023,70244,16.21484,433208
9344,evredinka,1,0.00023,70245,16.21507,433208
9345,ewypych,1,0.00023,70246,16.21531,433208
9346,exagil,1,0.00023,70247,16.21554,433208
9347,Excpt0r,1,0.00023,70248,16.21577,433208
9348,existme,1,0.00023,70249,16.21600,433208
9349,exp-dev-dj,1,0.00023,70250,16.21623,433208
9350,explorer855,1,0.00023,70251,16.21646,433208
9351,Extant-1,1,0.00023,70252,16.21669,433208
9352,eyalengel-pagaya,1,0.00023,70253,16.21692,433208
9353,eyalzek,1,0.00023,70254,16.21715,433208
9354,ezeeyahoo,1,0.00023,70255,16.21738,433208
9355,ezkol,1,0.00023,70256,16.21761,433208
9356,f1-outsourcing,1,0.00023,70257,16.21784,433208
9357,f4nha,1,0.00023,70258,16.21808,433208
9358,fabien-sarcel,1,0.00023,70259,16.21831,433208
9359,fabifrank,1,0.00023,70260,16.21854,433208
9360,FabioAntunes,1,0.00023,70261,16.21877,433208
9361,fabstao,1,0.00023,70262,16.21900,433208
9362,fabtrompet,1,0.00023,70263,16.21923,433208
9363,Faceless28,1,0.00023,70264,16.21946,433208
9364,fach,1,0.00023,70265,16.21969,433208
9365,fahimghl,1,0.00023,70266,16.21992,433208
9366,faisal-basha,1,0.00023,70267,16.22015,433208
9367,faizanu,1,0.00023,70268,16.22038,433208
9368,FakeCode,1,0.00023,70269,16.22061,433208
9369,falau,1,0.00023,70270,16.22085,433208
9370,fancyerii,1,0.00023,70271,16.22108,433208
9371,FANMixco,1,0.00023,70272,16.22131,433208
9372,fantasy4z,1,0.00023,70273,16.22154,433208
9373,Faraz743,1,0.00023,70274,16.22177,433208
9374,farconada,1,0.00023,70275,16.22200,433208
9375,farisbacker,1,0.00023,70276,16.22223,433208
9376,Farkal,1,0.00023,70277,16.22246,433208
9377,farodin91,1,0.00023,70278,16.22269,433208
9378,farvour,1,0.00023,70279,16.22292,433208
9379,fatahnuram,1,0.00023,70280,16.22315,433208
9380,fatherlinux,1,0.00023,70281,16.22338,433208
9381,fatihusta,1,0.00023,70282,16.22362,433208
9382,favas0,1,0.00023,70283,16.22385,433208
9383,fawadkhaliq,1,0.00023,70284,16.22408,433208
9384,fbaier-fn,1,0.00023,70285,16.22431,433208
9385,fbalicchia,1,0.00023,70286,16.22454,433208
9386,fbartnitzek,1,0.00023,70287,16.22477,433208
9387,fclerg,1,0.00023,70288,16.22500,433208
9388,fctoibm,1,0.00023,70289,16.22523,433208
9389,fd,1,0.00023,70290,16.22546,433208
9390,fdimuccio,1,0.00023,70291,16.22569,433208
9391,FedericoLaurianti-ScaiConsulting,1,0.00023,70292,16.22592,433208
9392,fefe982,1,0.00023,70293,16.22615,433208
9393,Fefer-Ivan,1,0.00023,70294,16.22639,433208
9394,feilengcui008,1,0.00023,70295,16.22662,433208
9395,feixiaohuijava,1,0.00023,70296,16.22685,433208
9396,felipeeeantunes,1,0.00023,70297,16.22708,433208
9397,felipeschossler,1,0.00023,70298,16.22731,433208
9398,felixkrohn,1,0.00023,70299,16.22754,433208
9399,FengFees,1,0.00023,70300,16.22777,433208
9400,fengyehong,1,0.00023,70301,16.22800,433208
9401,fennnec,1,0.00023,70302,16.22823,433208
9402,Ferenc-,1,0.00023,70303,16.22846,433208
9403,Ferlonas,1,0.00023,70304,16.22869,433208
9404,fernandolozano,1,0.00023,70305,16.22892,433208
9405,FernFerret,1,0.00023,70306,16.22916,433208
9406,ferrandinand,1,0.00023,70307,16.22939,433208
9407,ffjlabo,1,0.00023,70308,16.22962,433208
9408,fheinonen,1,0.00023,70309,16.22985,433208
9409,fifthpostulate,1,0.00023,70310,16.23008,433208
9410,filip-lebiecki,1,0.00023,70311,16.23031,433208
9411,fillerInk,1,0.00023,70312,16.23054,433208
9412,Fillo22,1,0.00023,70313,16.23077,433208
9413,FinalDes,1,0.00023,70314,16.23100,433208
9414,FinnStutzenstein,1,0.00023,70315,16.23123,433208
9415,fire,1,0.00023,70316,16.23146,433208
9416,fireba11,1,0.00023,70317,16.23169,433208
9417,fivezerosix,1,0.00023,70318,16.23193,433208
9418,fizzyduck,1,0.00023,70319,16.23216,433208
9419,fkleedorfer,1,0.00023,70320,16.23239,433208
9420,Fl0pZz,1,0.00023,70321,16.23262,433208
9421,flacatus,1,0.00023,70322,16.23285,433208
9422,Flamefire,1,0.00023,70323,16.23308,433208
9423,flarely,1,0.00023,70324,16.23331,433208
9424,flarno11,1,0.00023,70325,16.23354,433208
9425,flavio-lemos-farfetch-com,1,0.00023,70326,16.23377,433208
9426,flipstone42,1,0.00023,70327,16.23400,433208
9427,flomontl,1,0.00023,70328,16.23423,433208
9428,flowers99,1,0.00023,70329,16.23446,433208
9429,flutt13,1,0.00023,70330,16.23470,433208
9430,Flux99,1,0.00023,70331,16.23493,433208
9431,fly3366,1,0.00023,70332,16.23516,433208
9432,flyfoxCI,1,0.00023,70333,16.23539,433208
9433,fmedery,1,0.00023,70334,16.23562,433208
9434,fmhwong,1,0.00023,70335,16.23585,433208
9435,FNSdev,1,0.00023,70336,16.23608,433208
9436,foldleft,1,0.00023,70337,16.23631,433208
9437,fool-wang,1,0.00023,70338,16.23654,433208
9438,foosinn,1,0.00023,70339,16.23677,433208
9439,forestm,1,0.00023,70340,16.23700,433208
9440,forestsword,1,0.00023,70341,16.23723,433208
9441,forgems,1,0.00023,70342,16.23747,433208
9442,Formartha,1,0.00023,70343,16.23770,433208
9443,fortek-123,1,0.00023,70344,16.23793,433208
9444,forty,1,0.00023,70345,16.23816,433208
9445,FpsGameProgrammer,1,0.00023,70346,16.23839,433208
9446,frafra,1,0.00023,70347,16.23862,433208
9447,framegrace,1,0.00023,70348,16.23885,433208
9448,franklevering,1,0.00023,70349,16.23908,433208
9449,FrankMormino,1,0.00023,70350,16.23931,433208
9450,fransoaardi,1,0.00023,70351,16.23954,433208
9451,franviera92,1,0.00023,70352,16.23977,433208
9452,frbio,1,0.00023,70353,16.24000,433208
9453,FreakTheMighty,1,0.00023,70354,16.24024,433208
9454,freehck,1,0.00023,70355,16.24047,433208
9455,freehck-codefresh,1,0.00023,70356,16.24070,433208
9456,freelancerlucas,1,0.00023,70357,16.24093,433208
9457,fregdee,1,0.00023,70358,16.24116,433208
9458,frenkye,1,0.00023,70359,16.24139,433208
9459,FriendshipBridge,1,0.00023,70360,16.24162,433208
9460,fritzstauff,1,0.00023,70361,16.24185,433208
9461,Frizlab,1,0.00023,70362,16.24208,433208
9462,frizzr,1,0.00023,70363,16.24231,433208
9463,frozzenn,1,0.00023,70364,16.24254,433208
9464,fschoell,1,0.00023,70365,16.24277,433208
9465,fsschmitt,1,0.00023,70366,16.24301,433208
9466,fstien,1,0.00023,70367,16.24324,433208
9467,ftvkyo,1,0.00023,70368,16.24347,433208
9468,fuadhasni,1,0.00023,70369,16.24370,433208
9469,FUDCo,1,0.00023,70370,16.24393,433208
9470,fuhrmannb,1,0.00023,70371,16.24416,433208
9471,fweep,1,0.00023,70372,16.24439,433208
9472,fyqls,1,0.00023,70373,16.24462,433208
9473,g0dA,1,0.00023,70374,16.24485,433208
9474,g3kk0,1,0.00023,70375,16.24508,433208
9475,g3kr,1,0.00023,70376,16.24531,433208
9476,gabegorelick,1,0.00023,70377,16.24554,433208
9477,gabrielbahniuk,1,0.00023,70378,16.24578,433208
9478,gabrielbcn,1,0.00023,70379,16.24601,433208
9479,GabrielMenescal,1,0.00023,70380,16.24624,433208
9480,gabriel-milan,1,0.00023,70381,16.24647,433208
9481,gabrielthunig,1,0.00023,70382,16.24670,433208
9482,gaffneyd4,1,0.00023,70383,16.24693,433208
9483,gaima8,1,0.00023,70384,16.24716,433208
9484,gaizeror,1,0.00023,70385,16.24739,433208
9485,galaxypandathatsalsoaunicorn,1,0.00023,70386,16.24762,433208
9486,Galileo1,1,0.00023,70387,16.24785,433208
9487,Gallardo994,1,0.00023,70388,16.24808,433208
9488,galsimantov,1,0.00023,70389,16.24831,433208
9489,GameCharmer,1,0.00023,70390,16.24855,433208
9490,Gandem,1,0.00023,70391,16.24878,433208
9491,ganesanarun,1,0.00023,70392,16.24901,433208
9492,ganpatagarwal,1,0.00023,70393,16.24924,433208
9493,ganto,1,0.00023,70394,16.24947,433208
9494,Gaploid,1,0.00023,70395,16.24970,433208
9495,garaghav,1,0.00023,70396,16.24993,433208
9496,gargabhay1999,1,0.00023,70397,16.25016,433208
9497,gargeesuresh,1,0.00023,70398,16.25039,433208
9498,garmes-gdev,1,0.00023,70399,16.25062,433208
9499,GarretSidzaka,1,0.00023,70400,16.25085,433208
9500,garrett,1,0.00023,70401,16.25108,433208
9501,GarrettGeorge,1,0.00023,70402,16.25132,433208
9502,GaruGaru,1,0.00023,70403,16.25155,433208
9503,garydevenay,1,0.00023,70404,16.25178,433208
9504,garyyang85,1,0.00023,70405,16.25201,433208
9505,GasimGasimzada,1,0.00023,70406,16.25224,433208
9506,gaulzhw,1,0.00023,70407,16.25247,433208
9507,gaurav137,1,0.00023,70408,16.25270,433208
9508,GauravAsthana1,1,0.00023,70409,16.25293,433208
9509,gaurav-gupta-gtm,1,0.00023,70410,16.25316,433208
9510,gauravkhare,1,0.00023,70411,16.25339,433208
9511,gauravkohli,1,0.00023,70412,16.25362,433208
9512,gauravpatel2016,1,0.00023,70413,16.25385,433208
9513,gauscian,1,0.00023,70414,16.25409,433208
9514,gautham678,1,0.00023,70415,16.25432,433208
9515,gavinservai,1,0.00023,70416,16.25455,433208
9516,gawarz,1,0.00023,70417,16.25478,433208
9517,gayatri-sa,1,0.00023,70418,16.25501,433208
9518,gbergere,1,0.00023,70419,16.25524,433208
9519,gbonnefille,1,0.00023,70420,16.25547,433208
9520,GCHQDeveloper0985,1,0.00023,70421,16.25570,433208
9521,gdetrez,1,0.00023,70422,16.25593,433208
9522,gdraganic,1,0.00023,70423,16.25616,433208
9523,GeckoSplinter,1,0.00023,70424,16.25639,433208
9524,gecube,1,0.00023,70425,16.25662,433208
9525,geekq,1,0.00023,70426,16.25686,433208
9526,geenva,1,0.00023,70427,16.25709,433208
9527,geertn,1,0.00023,70428,16.25732,433208
9528,genevieve,1,0.00023,70429,16.25755,433208
9529,genisysram,1,0.00023,70430,16.25778,433208
9530,gennady-voronkov,1,0.00023,70431,16.25801,433208
9531,geokb,1,0.00023,70432,16.25824,433208
9532,georambo,1,0.00023,70433,16.25847,433208
9533,george-qian,1,0.00023,70434,16.25870,433208
9534,geota,1,0.00023,70435,16.25893,433208
9535,geotransformer,1,0.00023,70436,16.25916,433208
9536,geppetto89,1,0.00023,70437,16.25940,433208
9537,geraldoramos,1,0.00023,70438,16.25963,433208
9538,gerhardgossen,1,0.00023,70439,16.25986,433208
9539,gerhardlr,1,0.00023,70440,16.26009,433208
9540,german1608,1,0.00023,70441,16.26032,433208
9541,germanafro,1,0.00023,70442,16.26055,433208
9542,gerome-github-gromeg-website,1,0.00023,70443,16.26078,433208
9543,Geronium,1,0.00023,70444,16.26101,433208
9544,gerrnot,1,0.00023,70445,16.26124,433208
9545,GertjanBijl,1,0.00023,70446,16.26147,433208
9546,gerysz,1,0.00023,70447,16.26170,433208
9547,getjack,1,0.00023,70448,16.26193,433208
9548,gevorg15,1,0.00023,70449,16.26217,433208
9549,ggardet,1,0.00023,70450,16.26240,433208
9550,ggavrilov,1,0.00023,70451,16.26263,433208
9551,gggin,1,0.00023,70452,16.26286,433208
9552,ggilley,1,0.00023,70453,16.26309,433208
9553,ggwpp,1,0.00023,70454,16.26332,433208
9554,ghahramani,1,0.00023,70455,16.26355,433208
9555,ghenry,1,0.00023,70456,16.26378,433208
9556,ghfalcon7,1,0.00023,70457,16.26401,433208
9557,ghostcodersmn,1,0.00023,70458,16.26424,433208
9558,GhostInThePotato,1,0.00023,70459,16.26447,433208
9559,gi8lino,1,0.00023,70460,16.26470,433208
9560,Giaco9,1,0.00023,70461,16.26494,433208
9561,giafar,1,0.00023,70462,16.26517,433208
9562,GideonStowell,1,0.00023,70463,16.26540,433208
9563,giftDad,1,0.00023,70464,16.26563,433208
9564,gigglegrig,1,0.00023,70465,16.26586,433208
9565,Gii16,1,0.00023,70466,16.26609,433208
9566,giiita,1,0.00023,70467,16.26632,433208
9567,gillbee,1,0.00023,70468,16.26655,433208
9568,gilrodar,1,0.00023,70469,16.26678,433208
9569,GingerMoon,1,0.00023,70470,16.26701,433208
9570,GinYM,1,0.00023,70471,16.26724,433208
9571,Giohn,1,0.00023,70472,16.26747,433208
9572,gionapaolini,1,0.00023,70473,16.26771,433208
9573,gioragutt,1,0.00023,70474,16.26794,433208
9574,giotab,1,0.00023,70475,16.26817,433208
9575,git823,1,0.00023,70476,16.26840,433208
9576,gitege,1,0.00023,70477,16.26863,433208
9577,githomin,1,0.00023,70478,16.26886,433208
9578,githubajaydhage,1,0.00023,70479,16.26909,433208
9579,gitlijian,1,0.00023,70480,16.26932,433208
9580,gitnote-images,1,0.00023,70481,16.26955,433208
9581,gitshawn,1,0.00023,70482,16.26978,433208
9582,GitSnafu,1,0.00023,70483,16.27001,433208
9583,gitumarkk,1,0.00023,70484,16.27024,433208
9584,gitwangdi,1,0.00023,70485,16.27048,433208
9585,GitWrld,1,0.00023,70486,16.27071,433208
9586,gi-wg2,1,0.00023,70487,16.27094,433208
9587,gjermystreeva,1,0.00023,70488,16.27117,433208
9588,gjmscc,1,0.00023,70489,16.27140,433208
9589,gkaemmer,1,0.00023,70490,16.27163,433208
9590,glcx,1,0.00023,70491,16.27186,433208
9591,GlebIgnatevEmlid,1,0.00023,70492,16.27209,433208
9592,glenjamin,1,0.00023,70493,16.27232,433208
9593,glennpratt,1,0.00023,70494,16.27255,433208
9594,glenraynor,1,0.00023,70495,16.27278,433208
9595,GlorifiedTypist,1,0.00023,70496,16.27301,433208
9596,gluk-w,1,0.00023,70497,16.27325,433208
9597,gmcruz,1,0.00023,70498,16.27348,433208
9598,gmd20,1,0.00023,70499,16.27371,433208
9599,gmelillo,1,0.00023,70500,16.27394,433208
9600,gmoshiko,1,0.00023,70501,16.27417,433208
9601,gmrodgers,1,0.00023,70502,16.27440,433208
9602,gmsnzhang,1,0.00023,70503,16.27463,433208
9603,gnu300,1,0.00023,70504,16.27486,433208
9604,goal86sg,1,0.00023,70505,16.27509,433208
9605,godocean,1,0.00023,70506,16.27532,433208
9606,goith,1,0.00023,70507,16.27555,433208
9607,gojud,1,0.00023,70508,16.27578,433208
9608,gokcesurenkok,1,0.00023,70509,16.27602,433208
9609,gokulkrishnank,1,0.00023,70510,16.27625,433208
9610,go-lumberjack,1,0.00023,70511,16.27648,433208
9611,golyalpha,1,0.00023,70512,16.27671,433208
9612,goock,1,0.00023,70513,16.27694,433208
9613,goods4455,1,0.00023,70514,16.27717,433208
9614,gopalakrishnaR,1,0.00023,70515,16.27740,433208
9615,gopalvibm,1,0.00023,70516,16.27763,433208
9616,gophobic,1,0.00023,70517,16.27786,433208
9617,Gopichandar,1,0.00023,70518,16.27809,433208
9618,goran-rumin,1,0.00023,70519,16.27832,433208
9619,gordalina,1,0.00023,70520,16.27855,433208
9620,gordon-rennie,1,0.00023,70521,16.27879,433208
9621,gorishagh,1,0.00023,70522,16.27902,433208
9622,GOrtiz07,1,0.00023,70523,16.27925,433208
9623,gossion,1,0.00023,70524,16.27948,433208
9624,gotiniens,1,0.00023,70525,16.27971,433208
9625,gotoing,1,0.00023,70526,16.27994,433208
9626,gouterelo,1,0.00023,70527,16.28017,433208
9627,govale,1,0.00023,70528,16.28040,433208
9628,govinda-attal,1,0.00023,70529,16.28063,433208
9629,govindkailas,1,0.00023,70530,16.28086,433208
9630,gowei710,1,0.00023,70531,16.28109,433208
9631,gpkc,1,0.00023,70532,16.28132,433208
9632,gpolicante,1,0.00023,70533,16.28156,433208
9633,gpoothia,1,0.00023,70534,16.28179,433208
9634,GRACEMARYMATHEW,1,0.00023,70535,16.28202,433208
9635,grader75,1,0.00023,70536,16.28225,433208
9636,Gradlon,1,0.00023,70537,16.28248,433208
9637,Graham-M,1,0.00023,70538,16.28271,433208
9638,grahamsutton,1,0.00023,70539,16.28294,433208
9639,gramozkaragjyzi,1,0.00023,70540,16.28317,433208
9640,grantbeattie,1,0.00023,70541,16.28340,433208
9641,graphex-sumo,1,0.00023,70542,16.28363,433208
9642,gravitionium,1,0.00023,70543,16.28386,433208
9643,graywolf-at-work,1,0.00023,70544,16.28409,433208
9644,GreatThan365,1,0.00023,70545,16.28433,433208
9645,greatvovan,1,0.00023,70546,16.28456,433208
9646,greed42,1,0.00023,70547,16.28479,433208
9647,greenkiwi,1,0.00023,70548,16.28502,433208
9648,greenren,1,0.00023,70549,16.28525,433208
9649,greenu,1,0.00023,70550,16.28548,433208
9650,gregfajen,1,0.00023,70551,16.28571,433208
9651,gregleb,1,0.00023,70552,16.28594,433208
9652,GregMefford,1,0.00023,70553,16.28617,433208
9653,gregnebu,1,0.00023,70554,16.28640,433208
9654,gregroe,1,0.00023,70555,16.28663,433208
9655,GregSharpe1,1,0.00023,70556,16.28686,433208
9656,Gremash,1,0.00023,70557,16.28710,433208
9657,grepthat,1,0.00023,70558,16.28733,433208
9658,greywolve,1,0.00023,70559,16.28756,433208
9659,grieshaber,1,0.00023,70560,16.28779,433208
9660,griffincollege,1,0.00023,70561,16.28802,433208
9661,griffint61,1,0.00023,70562,16.28825,433208
9662,grmhay,1,0.00023,70563,16.28848,433208
9663,Grompot77,1,0.00023,70564,16.28871,433208
9664,GrooveCS,1,0.00023,70565,16.28894,433208
9665,grubbins,1,0.00023,70566,16.28917,433208
9666,gruppferi,1,0.00023,70567,16.28940,433208
9667,gseidel,1,0.00023,70568,16.28963,433208
9668,gudipudipradeep,1,0.00023,70569,16.28987,433208
9669,Guerric-P,1,0.00023,70570,16.29010,433208
9670,guillaume-chervet,1,0.00023,70571,16.29033,433208
9671,Guldanx,1,0.00023,70572,16.29056,433208
9672,guptthha,1,0.00023,70573,16.29079,433208
9673,guxlightyear,1,0.00023,70574,16.29102,433208
9674,guykanyvision,1,0.00023,70575,16.29125,433208
9675,GuyPaddock,1,0.00023,70576,16.29148,433208
9676,gvtaras,1,0.00023,70577,16.29171,433208
9677,gwohletz,1,0.00023,70578,16.29194,433208
9678,gws,1,0.00023,70579,16.29217,433208
9679,gyalowitzdtlr,1,0.00023,70580,16.29240,433208
9680,gymlt,1,0.00023,70581,16.29264,433208
9681,h1z3y3,1,0.00023,70582,16.29287,433208
9682,H3rman8,1,0.00023,70583,16.29310,433208
9683,habmic,1,0.00023,70584,16.29333,433208
9684,hackaholic,1,0.00023,70585,16.29356,433208
9685,hacktmz,1,0.00023,70586,16.29379,433208
9686,HackToHell,1,0.00023,70587,16.29402,433208
9687,hacktron95,1,0.00023,70588,16.29425,433208
9688,HaddadJoe,1,0.00023,70589,16.29448,433208
9689,hadifarnoud,1,0.00023,70590,16.29471,433208
9690,haexhub,1,0.00023,70591,16.29494,433208
9691,hafsaasaleem,1,0.00023,70592,16.29517,433208
9692,hakeemfsz,1,0.00023,70593,16.29541,433208
9693,Hakob,1,0.00023,70594,16.29564,433208
9694,hallgeirl,1,0.00023,70595,16.29587,433208
9695,halversonea,1,0.00023,70596,16.29610,433208
9696,hamishforbes,1,0.00023,70597,16.29633,433208
9697,Hamza-Q,1,0.00023,70598,16.29656,433208
9698,haneychad,1,0.00023,70599,16.29679,433208
9699,HanHoRang,1,0.00023,70600,16.29702,433208
9700,hannesvoss,1,0.00023,70601,16.29725,433208
9701,hans72118,1,0.00023,70602,16.29748,433208
9702,hantsy,1,0.00023,70603,16.29771,433208
9703,hanyu100,1,0.00023,70604,16.29794,433208
9704,hanzhc,1,0.00023,70605,16.29818,433208
9705,HaojingLu97,1,0.00023,70606,16.29841,433208
9706,haresh93,1,0.00023,70607,16.29864,433208
9707,harikrishnajiju,1,0.00023,70608,16.29887,433208
9708,HarikrishnanBalagopal,1,0.00023,70609,16.29910,433208
9709,hariomshandilya,1,0.00023,70610,16.29933,433208
9710,harirajanv,1,0.00023,70611,16.29956,433208
9711,harish2704,1,0.00023,70612,16.29979,433208
9712,harishachappa,1,0.00023,70613,16.30002,433208
9713,harishp8889,1,0.00023,70614,16.30025,433208
9714,harrypintous,1,0.00023,70615,16.30048,433208
9715,harsh2699,1,0.00023,70616,16.30071,433208
9716,HarshalGoyal,1,0.00023,70617,16.30095,433208
9717,Harshit-techno,1,0.00023,70618,16.30118,433208
9718,harshmanvar,1,0.00023,70619,16.30141,433208
9719,harshp1732,1,0.00023,70620,16.30164,433208
9720,harveyxia,1,0.00023,70621,16.30187,433208
9721,hash1024,1,0.00023,70622,16.30210,433208
9722,hasimyerlikaya,1,0.00023,70623,16.30233,433208
9723,hasmizal,1,0.00023,70624,16.30256,433208
9724,hassanzia32,1,0.00023,70625,16.30279,433208
9725,hasssammalik,1,0.00023,70626,16.30302,433208
9726,hawking-lab,1,0.00023,70627,16.30325,433208
9727,hbhanawat,1,0.00023,70628,16.30348,433208
9728,hcsaustrup,1,0.00023,70629,16.30372,433208
9729,hdonnay,1,0.00023,70630,16.30395,433208
9730,h-dub,1,0.00023,70631,16.30418,433208
9731,headwhacker,1,0.00023,70632,16.30441,433208
9732,HebeHH,1,0.00023,70633,16.30464,433208
9733,hehe717,1,0.00023,70634,16.30487,433208
9734,HeikoScholtes,1,0.00023,70635,16.30510,433208
9735,heinemml,1,0.00023,70636,16.30533,433208
9736,helenabutowatcisco,1,0.00023,70637,16.30556,433208
9737,helicase-bzh,1,0.00023,70638,16.30579,433208
9738,hellstrikes13,1,0.00023,70639,16.30602,433208
9739,hemuke,1,0.00023,70640,16.30625,433208
9740,Hendrik-H,1,0.00023,70641,16.30649,433208
9741,HenriBeck,1,0.00023,70642,16.30672,433208
9742,henrytran026,1,0.00023,70643,16.30695,433208
9743,hensur,1,0.00023,70644,16.30718,433208
9744,her,1,0.00023,70645,16.30741,433208
9745,herico516,1,0.00023,70646,16.30764,433208
9746,hesamwls,1,0.00023,70647,16.30787,433208
9747,hetpats,1,0.00023,70648,16.30810,433208
9748,hev,1,0.00023,70649,16.30833,433208
9749,heyitsmdr,1,0.00023,70650,16.30856,433208
9750,HFeilx,1,0.00023,70651,16.30879,433208
9751,hfutcbl,1,0.00023,70652,16.30902,433208
9752,hguerrero,1,0.00023,70653,16.30926,433208
9753,hhsel,1,0.00023,70654,16.30949,433208
9754,hhsnow,1,0.00023,70655,16.30972,433208
9755,Hichem-BenJeddi,1,0.00023,70656,16.30995,433208
9756,HichuYamichu,1,0.00023,70657,16.31018,433208
9757,hielfx,1,0.00023,70658,16.31041,433208
9758,Hiieu,1,0.00023,70659,16.31064,433208
9759,hijak,1,0.00023,70660,16.31087,433208
9760,hikkyu,1,0.00023,70661,16.31110,433208
9761,hikoz,1,0.00023,70662,16.31133,433208
9762,HimanshuGupta11110000,1,0.00023,70663,16.31156,433208
9763,Himanshu-Sharma-java,1,0.00023,70664,16.31179,433208
9764,hindog,1,0.00023,70665,16.31203,433208
9765,hingstarne,1,0.00023,70666,16.31226,433208
9766,HisokaHous,1,0.00023,70667,16.31249,433208
9767,Hixon10,1,0.00023,70668,16.31272,433208
9768,hkiang01,1,0.00023,70669,16.31295,433208
9769,hleung1,1,0.00023,70670,16.31318,433208
9770,hma23,1,0.00023,70671,16.31341,433208
9771,hnutank163,1,0.00023,70672,16.31364,433208
9772,hoantran3108,1,0.00023,70673,16.31387,433208
9773,hoantv,1,0.00023,70674,16.31410,433208
9774,hodgesds,1,0.00023,70675,16.31433,433208
9775,hoffa,1,0.00023,70676,16.31456,433208
9776,HokhyTann,1,0.00023,70677,16.31480,433208
9777,holdenk,1,0.00023,70678,16.31503,433208
9778,holycheater,1,0.00023,70679,16.31526,433208
9779,holzeis,1,0.00023,70680,16.31549,433208
9780,holzkeil,1,0.00023,70681,16.31572,433208
9781,HongChenTW,1,0.00023,70682,16.31595,433208
9782,HongjiangHuang,1,0.00023,70683,16.31618,433208
9783,hongkongkiwi,1,0.00023,70684,16.31641,433208
9784,hongweijia,1,0.00023,70685,16.31664,433208
9785,hoonahn,1,0.00023,70686,16.31687,433208
9786,hoozecn,1,0.00023,70687,16.31710,433208
9787,hopkiw,1,0.00023,70688,16.31733,433208
9788,horjulf,1,0.00023,70689,16.31757,433208
9789,hotchkj,1,0.00023,70690,16.31780,433208
9790,hottomato4,1,0.00023,70691,16.31803,433208
9791,houfangdong,1,0.00023,70692,16.31826,433208
9792,houston88,1,0.00023,70693,16.31849,433208
9793,houyuqian5,1,0.00023,70694,16.31872,433208
9794,Howie59,1,0.00023,70695,16.31895,433208
9795,HowJMay,1,0.00023,70696,16.31918,433208
9796,hrivera-ntap,1,0.00023,70697,16.31941,433208
9797,hrodrig,1,0.00023,70698,16.31964,433208
9798,hroyg,1,0.00023,70699,16.31987,433208
9799,hrshshh9,1,0.00023,70700,16.32010,433208
9800,hsezhiyan,1,0.00023,70701,16.32034,433208
9801,hsjalilian,1,0.00023,70702,16.32057,433208
9802,Hsn723,1,0.00023,70703,16.32080,433208
9803,huachangYu,1,0.00023,70704,16.32103,433208
9804,huangchengwu,1,0.00023,70705,16.32126,433208
9805,huangleilz,1,0.00023,70706,16.32149,433208
9806,huangsz1599,1,0.00023,70707,16.32172,433208
9807,huangyisan,1,0.00023,70708,16.32195,433208
9808,HuaxuanGAO,1,0.00023,70709,16.32218,433208
9809,hughperkins,1,0.00023,70710,16.32241,433208
9810,hugo2017,1,0.00023,70711,16.32264,433208
9811,huimxu,1,0.00023,70712,16.32287,433208
9812,huiwq1990,1,0.00023,70713,16.32311,433208
9813,huizengaJoe,1,0.00023,70714,16.32334,433208
9814,hukaixuan,1,0.00023,70715,16.32357,433208
9815,HumairAK,1,0.00023,70716,16.32380,433208
9816,humantargetjoe,1,0.00023,70717,16.32403,433208
9817,humbleengineer,1,0.00023,70718,16.32426,433208
9818,hunzaboy,1,0.00023,70719,16.32449,433208
9819,huornlmj,1,0.00023,70720,16.32472,433208
9820,husak1984,1,0.00023,70721,16.32495,433208
9821,huychau,1,0.00023,70722,16.32518,433208
9822,hxquangnhat,1,0.00023,70723,16.32541,433208
9823,hxzhao527,1,0.00023,70724,16.32564,433208
9824,hyamy,1,0.00023,70725,16.32588,433208
9825,hyprnick,1,0.00023,70726,16.32611,433208
9826,HyungJune,1,0.00023,70727,16.32634,433208
9827,hyunrealshadow,1,0.00023,70728,16.32657,433208
9828,hzy46,1,0.00023,70729,16.32680,433208
9829,iagomelanias,1,0.00023,70730,16.32703,433208
9830,IainAdamsLabs,1,0.00023,70731,16.32726,433208
9831,iamalexmang,1,0.00023,70732,16.32749,433208
9832,iamanishagarwal,1,0.00023,70733,16.32772,433208
9833,iambumblehead,1,0.00023,70734,16.32795,433208
9834,iamniting,1,0.00023,70735,16.32818,433208
9835,IamonFireee,1,0.00023,70736,16.32841,433208
9836,iampastor,1,0.00023,70737,16.32865,433208
9837,iamperson347,1,0.00023,70738,16.32888,433208
9838,iamrahul-9,1,0.00023,70739,16.32911,433208
9839,IamRajatBadjatya,1,0.00023,70740,16.32934,433208
9840,iamsouravin,1,0.00023,70741,16.32957,433208
9841,iamsudip,1,0.00023,70742,16.32980,433208
9842,iamtakingiteasy,1,0.00023,70743,16.33003,433208
9843,iamzhangyong,1,0.00023,70744,16.33026,433208
9844,ianfergu,1,0.00023,70745,16.33049,433208
9845,ianks,1,0.00023,70746,16.33072,433208
9846,IANTHEREAL,1,0.00023,70747,16.33095,433208
9847,iapicca,1,0.00023,70748,16.33119,433208
9848,iavael,1,0.00023,70749,16.33142,433208
9849,iben12,1,0.00023,70750,16.33165,433208
9850,icco,1,0.00023,70751,16.33188,433208
9851,icebrian,1,0.00023,70752,16.33211,433208
9852,IcyEagle,1,0.00023,70753,16.33234,433208
9853,ideepika,1,0.00023,70754,16.33257,433208
9854,idursun,1,0.00023,70755,16.33280,433208
9855,ifalex,1,0.00023,70756,16.33303,433208
9856,ifaridi79,1,0.00023,70757,16.33326,433208
9857,igor9silva,1,0.00023,70758,16.33349,433208
9858,igordptx,1,0.00023,70759,16.33372,433208
9859,igordrnobrega,1,0.00023,70760,16.33396,433208
9860,igor-nikiforov,1,0.00023,70761,16.33419,433208
9861,IgorOhrimenko,1,0.00023,70762,16.33442,433208
9862,igraecao,1,0.00023,70763,16.33465,433208
9863,iilyak,1,0.00023,70764,16.33488,433208
9864,iiwoai,1,0.00023,70765,16.33511,433208
9865,iizxkii,1,0.00023,70766,16.33534,433208
9866,ikaccc,1,0.00023,70767,16.33557,433208
9867,illegalnumbers,1,0.00023,70768,16.33580,433208
9868,Ilyes512,1,0.00023,70769,16.33603,433208
9869,imabhinav,1,0.00023,70770,16.33626,433208
9870,imbhuvnesh,1,0.00023,70771,16.33649,433208
9871,iminto,1,0.00023,70772,16.33673,433208
9872,imitbn,1,0.00023,70773,16.33696,433208
9873,immanetize,1,0.00023,70774,16.33719,433208
9874,immortalize,1,0.00023,70775,16.33742,433208
9875,impradeepgupta,1,0.00023,70776,16.33765,433208
9876,imranansari,1,0.00023,70777,16.33788,433208
9877,imranhadi01,1,0.00023,70778,16.33811,433208
9878,imranrazakhan,1,0.00023,70779,16.33834,433208
9879,imsunhao,1,0.00023,70780,16.33857,433208
9880,Imunhatep,1,0.00023,70781,16.33880,433208
9881,imvijaysingh,1,0.00023,70782,16.33903,433208
9882,InbarRose,1,0.00023,70783,16.33926,433208
9883,incedo,1,0.00023,70784,16.33950,433208
9884,inceptio-jingzhao,1,0.00023,70785,16.33973,433208
9885,includerandom,1,0.00023,70786,16.33996,433208
9886,indavarapuaneesh,1,0.00023,70787,16.34019,433208
9887,IndicatorFluid,1,0.00023,70788,16.34042,433208
9888,indrif,1,0.00023,70789,16.34065,433208
9889,indykish,1,0.00023,70790,16.34088,433208
9890,iNecas,1,0.00023,70791,16.34111,433208
9891,infa-ddeore,1,0.00023,70792,16.34134,433208
9892,infa-svijayak,1,0.00023,70793,16.34157,433208
9893,infoguru19,1,0.00023,70794,16.34180,433208
9894,inggrecmarc,1,0.00023,70795,16.34203,433208
9895,ingluife,1,0.00023,70796,16.34227,433208
9896,initd,1,0.00023,70797,16.34250,433208
9897,in-park,1,0.00023,70798,16.34273,433208
9898,insanemal,1,0.00023,70799,16.34296,433208
9899,insta-code1,1,0.00023,70800,16.34319,433208
9900,Internauta1972,1,0.00023,70801,16.34342,433208
9901,intrand,1,0.00023,70802,16.34365,433208
9902,invertigo,1,0.00023,70803,16.34388,433208
9903,ioagel,1,0.00023,70804,16.34411,433208
9904,IonicaBizau,1,0.00023,70805,16.34434,433208
9905,ip6li,1,0.00023,70806,16.34457,433208
9906,i-Pix,1,0.00023,70807,16.34480,433208
9907,ipnextgen,1,0.00023,70808,16.34504,433208
9908,ipolonsk,1,0.00023,70809,16.34527,433208
9909,ipsita2192,1,0.00023,70810,16.34550,433208
9910,iptizer,1,0.00023,70811,16.34573,433208
9911,iqbalhusen,1,0.00023,70812,16.34596,433208
9912,Iridias,1,0.00023,70813,16.34619,433208
9913,irinagordei,1,0.00023,70814,16.34642,433208
9914,Isakgicu,1,0.00023,70815,16.34665,433208
9915,Isan-Rivkin,1,0.00023,70816,16.34688,433208
9916,Isa-rentacs,1,0.00023,70817,16.34711,433208
9917,ishaannarang,1,0.00023,70818,16.34734,433208
9918,Ishiihara,1,0.00023,70819,16.34757,433208
9919,ishswar,1,0.00023,70820,16.34781,433208
9920,ish-xyz,1,0.00023,70821,16.34804,433208
9921,isi-lincoln,1,0.00023,70822,16.34827,433208
9922,isliqian,1,0.00023,70823,16.34850,433208
9923,Ismail-Ham,1,0.00023,70824,16.34873,433208
9924,Isolus,1,0.00023,70825,16.34896,433208
9925,iss1995,1,0.00023,70826,16.34919,433208
9926,Issaaaaaaaaam,1,0.00023,70827,16.34942,433208
9927,isuchathuranga,1,0.00023,70828,16.34965,433208
9928,iszhyang,1,0.00023,70829,16.34988,433208
9929,itamarbitton,1,0.00023,70830,16.35011,433208
9930,itamarkam,1,0.00023,70831,16.35034,433208
9931,ITBOX-ITBOY,1,0.00023,70832,16.35058,433208
9932,itga,1,0.00023,70833,16.35081,433208
9933,itkq,1,0.00023,70834,16.35104,433208
9934,its-crypted,1,0.00023,70835,16.35127,433208
9935,itsLucario,1,0.00023,70836,16.35150,433208
9936,itsmjeu,1,0.00023,70837,16.35173,433208
9937,ivadoncheva,1,0.00023,70838,16.35196,433208
9938,ivanamat,1,0.00023,70839,16.35219,433208
9939,ivan-caspeta-by,1,0.00023,70840,16.35242,433208
9940,ivanfarkas2,1,0.00023,70841,16.35265,433208
9941,ivanivanovicdimov,1,0.00023,70842,16.35288,433208
9942,ivanlemeshev,1,0.00023,70843,16.35311,433208
9943,ivanr,1,0.00023,70844,16.35335,433208
9944,ivcosla,1,0.00023,70845,16.35358,433208
9945,iven,1,0.00023,70846,16.35381,433208
9946,ivoglent,1,0.00023,70847,16.35404,433208
9947,ivomagi,1,0.00023,70848,16.35427,433208
9948,ivoribeiro,1,0.00023,70849,16.35450,433208
9949,iyankovsky,1,0.00023,70850,16.35473,433208
9950,iyesin,1,0.00023,70851,16.35496,433208
9951,iyuvalk,1,0.00023,70852,16.35519,433208
9952,izmailoff,1,0.00023,70853,16.35542,433208
9953,j0holo,1,0.00023,70854,16.35565,433208
9954,j0sh3rs,1,0.00023,70855,16.35588,433208
9955,JaapHaitsma,1,0.00023,70856,16.35612,433208
9956,jaawasth,1,0.00023,70857,16.35635,433208
9957,jack85811,1,0.00023,70858,16.35658,433208
9958,jackfarzan,1,0.00023,70859,16.35681,433208
9959,JackGzj,1,0.00023,70860,16.35704,433208
9960,jackieluc,1,0.00023,70861,16.35727,433208
9961,jackmuskopf,1,0.00023,70862,16.35750,433208
9962,jacknagel,1,0.00023,70863,16.35773,433208
9963,jackopoz,1,0.00023,70864,16.35796,433208
9964,Jacksonary,1,0.00023,70865,16.35819,433208
9965,jackychow,1,0.00023,70866,16.35842,433208
9966,jacobsmith928,1,0.00023,70867,16.35865,433208
9967,JacopoKenzo,1,0.00023,70868,16.35889,433208
9968,jacques414,1,0.00023,70869,16.35912,433208
9969,JaehunYoon,1,0.00023,70870,16.35935,433208
9970,jafferaws,1,0.00023,70871,16.35958,433208
9971,Jagadeeshmopuri,1,0.00023,70872,16.35981,433208
9972,jaganrajagopalme,1,0.00023,70873,16.36004,433208
9973,jahpola-futurice,1,0.00023,70874,16.36027,433208
9974,jaiksolanki,1,0.00023,70875,16.36050,433208
9975,jainshikha,1,0.00023,70876,16.36073,433208
9976,jairofloress,1,0.00023,70877,16.36096,433208
9977,jaishirole,1,0.00023,70878,16.36119,433208
9978,Jajitha94,1,0.00023,70879,16.36142,433208
9979,Jakeler,1,0.00023,70880,16.36166,433208
9980,jakepaw,1,0.00023,70881,16.36189,433208
9981,jakerbeck,1,0.00023,70882,16.36212,433208
9982,jakubrauch,1,0.00023,70883,16.36235,433208
9983,JakubWes,1,0.00023,70884,16.36258,433208
9984,jalavosus,1,0.00023,70885,16.36281,433208
9985,james4388,1,0.00023,70886,16.36304,433208
9986,James4Deutschland,1,0.00023,70887,16.36327,433208
9987,jamesglennan,1,0.00023,70888,16.36350,433208
9988,jamesgustard,1,0.00023,70889,16.36373,433208
9989,jamesinc,1,0.00023,70890,16.36396,433208
9990,james-m-tubbs,1,0.00023,70891,16.36419,433208
9991,james-nesbitt,1,0.00023,70892,16.36443,433208
9992,jamesongithub,1,0.00023,70893,16.36466,433208
9993,jamesread,1,0.00023,70894,16.36489,433208
9994,james-thomson,1,0.00023,70895,16.36512,433208
9995,jameswynn,1,0.00023,70896,16.36535,433208
9996,jamiechapmanbrn,1,0.00023,70897,16.36558,433208
9997,jamiecyber,1,0.00023,70898,16.36581,433208
9998,jamiewri,1,0.00023,70899,16.36604,433208
9999,janavenkat,1,0.00023,70900,16.36627,433208
10000,jandubois,1,0.00023,70901,16.36650,433208
10001,janegilring,1,0.00023,70902,16.36673,433208
10002,janekwonner,1,0.00023,70903,16.36696,433208
10003,JanFeld,1,0.00023,70904,16.36720,433208
10004,jan-from-meiro,1,0.00023,70905,16.36743,433208
10005,janilsongomesmendes,1,0.00023,70906,16.36766,433208
10006,janiskemper,1,0.00023,70907,16.36789,433208
10007,janlau1111,1,0.00023,70908,16.36812,433208
10008,janlud,1,0.00023,70909,16.36835,433208
10009,Jan-M,1,0.00023,70910,16.36858,433208
10010,JanRK,1,0.00023,70911,16.36881,433208
10011,janschauta,1,0.00023,70912,16.36904,433208
10012,jansony1,1,0.00023,70913,16.36927,433208
10013,janysp,1,0.00023,70914,16.36950,433208
10014,japita-se,1,0.00023,70915,16.36973,433208
10015,jaredallmond,1,0.00023,70916,16.36997,433208
10016,jaredhancock31,1,0.00023,70917,16.37020,433208
10017,jaredstehler,1,0.00023,70918,16.37043,433208
10018,JarenZhan,1,0.00023,70919,16.37066,433208
10019,jarfil,1,0.00023,70920,16.37089,433208
10020,jarivk,1,0.00023,70921,16.37112,433208
10021,jarnonestor,1,0.00023,70922,16.37135,433208
10022,jarrodcal,1,0.00023,70923,16.37158,433208
10023,JasLin,1,0.00023,70924,16.37181,433208
10024,jasonhubs,1,0.00023,70925,16.37204,433208
10025,jasonliu747,1,0.00023,70926,16.37227,433208
10026,jasonodonnell,1,0.00023,70927,16.37250,433208
10027,JasonRD,1,0.00023,70928,16.37274,433208
10028,jaswQ,1,0.00023,70929,16.37297,433208
10029,jaubin,1,0.00023,70930,16.37320,433208
10030,javierdompablo,1,0.00023,70931,16.37343,433208
10031,jawabuu,1,0.00023,70932,16.37366,433208
10032,jawhites,1,0.00023,70933,16.37389,433208
10033,JayakumarB,1,0.00023,70934,16.37412,433208
10034,jayanthvn,1,0.00023,70935,16.37435,433208
10035,JayBenato,1,0.00023,70936,16.37458,433208
10036,jayeshmann,1,0.00023,70937,16.37481,433208
10037,jaym,1,0.00023,70938,16.37504,433208
10038,jayrmehta,1,0.00023,70939,16.37527,433208
10039,jaysiee,1,0.00023,70940,16.37551,433208
10040,jayvie,1,0.00023,70941,16.37574,433208
10041,jazzsaxmafia,1,0.00023,70942,16.37597,433208
10042,jbampton,1,0.00023,70943,16.37620,433208
10043,jbaranguan,1,0.00023,70944,16.37643,433208
10044,jbarciauskas,1,0.00023,70945,16.37666,433208
10045,jbdoumenjou,1,0.00023,70946,16.37689,433208
10046,jbhennin,1,0.00023,70947,16.37712,433208
10047,jbradleynh,1,0.00023,70948,16.37735,433208
10048,jbrokamp,1,0.00023,70949,16.37758,433208
10049,jbrouwers,1,0.00023,70950,16.37781,433208
10050,jcarreira,1,0.00023,70951,16.37804,433208
10051,jcdauchy,1,0.00023,70952,16.37828,433208
10052,jcelliott,1,0.00023,70953,16.37851,433208
10053,jc-lab,1,0.00023,70954,16.37874,433208
10054,jcleira,1,0.00023,70955,16.37897,433208
10055,jclusso,1,0.00023,70956,16.37920,433208
10056,jcoconnor,1,0.00023,70957,16.37943,433208
10057,jconway,1,0.00023,70958,16.37966,433208
10058,jcstanaway,1,0.00023,70959,16.37989,433208
10059,jcttrll,1,0.00023,70960,16.38012,433208
10060,jcx-vmw,1,0.00023,70961,16.38035,433208
10061,jdamour98,1,0.00023,70962,16.38058,433208
10062,jdavidpeter,1,0.00023,70963,16.38081,433208
10063,jdbohrman,1,0.00023,70964,16.38105,433208
10064,j-denner,1,0.00023,70965,16.38128,433208
10065,jdkhong,1,0.00023,70966,16.38151,433208
10066,jdorel,1,0.00023,70967,16.38174,433208
10067,jdtw,1,0.00023,70968,16.38197,433208
10068,jdunhamvrtx,1,0.00023,70969,16.38220,433208
10069,jDzames,1,0.00023,70970,16.38243,433208
10070,JeanBaptisteWATENBERG,1,0.00023,70971,16.38266,433208
10071,jedcunningham,1,0.00023,70972,16.38289,433208
10072,Jeeppler,1,0.00023,70973,16.38312,433208
10073,jeffherald,1,0.00023,70974,16.38335,433208
10074,jeff-mccoy,1,0.00023,70975,16.38358,433208
10075,jeffreyacegong,1,0.00023,70976,16.38382,433208
10076,jeffreywang1,1,0.00023,70977,16.38405,433208
10077,jeffwalsh,1,0.00023,70978,16.38428,433208
10078,jekader,1,0.00023,70979,16.38451,433208
10079,jekakm,1,0.00023,70980,16.38474,433208
10080,jellis,1,0.00023,70981,16.38497,433208
10081,jeloba,1,0.00023,70982,16.38520,433208
10082,Jenishk56,1,0.00023,70983,16.38543,433208
10083,jennydove,1,0.00023,70984,16.38566,433208
10084,jepperson2,1,0.00023,70985,16.38589,433208
10085,jeroenhartgers,1,0.00023,70986,16.38612,433208
10086,jeroenjacobs79,1,0.00023,70987,16.38635,433208
10087,jeroenlandheer,1,0.00023,70988,16.38659,433208
10088,Jerry061-eng,1,0.00023,70989,16.38682,433208
10089,jerry-sc,1,0.00023,70990,16.38705,433208
10090,Jerryzhao-z,1,0.00023,70991,16.38728,433208
10091,Jeson515,1,0.00023,70992,16.38751,433208
10092,JessedeJonge,1,0.00023,70993,16.38774,433208
10093,jesussancheztellomm,1,0.00023,70994,16.38797,433208
10094,jeus,1,0.00023,70995,16.38820,433208
10095,jewar,1,0.00023,70996,16.38843,433208
10096,jfbrennan,1,0.00023,70997,16.38866,433208
10097,jferr,1,0.00023,70998,16.38889,433208
10098,jfrederickson,1,0.00023,70999,16.38912,433208
10099,jfruge,1,0.00023,71000,16.38936,433208
10100,JGoldman110,1,0.00023,71001,16.38959,433208
10101,jgowdy,1,0.00023,71002,16.38982,433208
10102,jgquach3,1,0.00023,71003,16.39005,433208
10103,jhawthorn22,1,0.00023,71004,16.39028,433208
10104,Jhovanni,1,0.00023,71005,16.39051,433208
10105,jianchengfeng,1,0.00023,71006,16.39074,433208
10106,jiangxiaoqiang,1,0.00023,71007,16.39097,433208
10107,jiaozg22,1,0.00023,71008,16.39120,433208
10108,jiapeish,1,0.00023,71009,16.39143,433208
10109,Jiasm,1,0.00023,71010,16.39166,433208
10110,Jiaweizdev,1,0.00023,71011,16.39189,433208
10111,JibinNajeeb,1,0.00023,71012,16.39213,433208
10112,JihadMotii-REISys,1,0.00023,71013,16.39236,433208
10113,jijotj,1,0.00023,71014,16.39259,433208
10114,jimbali,1,0.00023,71015,16.39282,433208
10115,jim-barber-he,1,0.00023,71016,16.39305,433208
10116,jimbocoder,1,0.00023,71017,16.39328,433208
10117,jimdickinson,1,0.00023,71018,16.39351,433208
10118,jimmy17x,1,0.00023,71019,16.39374,433208
10119,jineshmathewt,1,0.00023,71020,16.39397,433208
10120,jing2uo,1,0.00023,71021,16.39420,433208
10121,JINGJIEworld,1,0.00023,71022,16.39443,433208
10122,JinjunXiong,1,0.00023,71023,16.39466,433208
10123,jinlinux,1,0.00023,71024,16.39490,433208
10124,jinlxz,1,0.00023,71025,16.39513,433208
10125,jinzishuai,1,0.00023,71026,16.39536,433208
10126,jiraguha,1,0.00023,71027,16.39559,433208
10127,jiridanek,1,0.00023,71028,16.39582,433208
10128,jj0b,1,0.00023,71029,16.39605,433208
10129,jjayeshgohil,1,0.00023,71030,16.39628,433208
10130,jjhuang-github,1,0.00023,71031,16.39651,433208
10131,jjimenezmont,1,0.00023,71032,16.39674,433208
10132,jjulien,1,0.00023,71033,16.39697,433208
10133,jkachika,1,0.00023,71034,16.39720,433208
10134,jkanywhere,1,0.00023,71035,16.39743,433208
10135,jkim-codecademy,1,0.00023,71036,16.39767,433208
10136,jkopacze,1,0.00023,71037,16.39790,433208
10137,jkubarek,1,0.00023,71038,16.39813,433208
10138,jlaffaye,1,0.00023,71039,16.39836,433208
10139,jleskovar-tyro,1,0.00023,71040,16.39859,433208
10140,jlfowle,1,0.00023,71041,16.39882,433208
10141,jlstephens89,1,0.00023,71042,16.39905,433208
10142,jmbeach,1,0.00023,71043,16.39928,433208
10143,jmboby,1,0.00023,71044,16.39951,433208
10144,jmcdaniel-bc,1,0.00023,71045,16.39974,433208
10145,jmcdonagh,1,0.00023,71046,16.39997,433208
10146,jmencak,1,0.00023,71047,16.40020,433208
10147,jmichelgarcia,1,0.00023,71048,16.40044,433208
10148,jmorcar,1,0.00023,71049,16.40067,433208
10149,jmpavlec,1,0.00023,71050,16.40090,433208
10150,jmreid,1,0.00023,71051,16.40113,433208
10151,jmriebold,1,0.00023,71052,16.40136,433208
10152,jmurphyau,1,0.00023,71053,16.40159,433208
10153,jnamdar,1,0.00023,71054,16.40182,433208
10154,jnisperuza,1,0.00023,71055,16.40205,433208
10155,jnm,1,0.00023,71056,16.40228,433208
10156,jnovy,1,0.00023,71057,16.40251,433208
10157,joaobrittoneto,1,0.00023,71058,16.40274,433208
10158,JoaoPinheiro,1,0.00023,71059,16.40298,433208
10159,joaovitor,1,0.00023,71060,16.40321,433208
10160,joberdick,1,0.00023,71061,16.40344,433208
10161,jodavis-suse,1,0.00023,71062,16.40367,433208
10162,joehoeller,1,0.00023,71063,16.40390,433208
10163,JoelJJoseph,1,0.00023,71064,16.40413,433208
10164,JoeryH,1,0.00023,71065,16.40436,433208
10165,joeschram,1,0.00023,71066,16.40459,433208
10166,Joeskyyy,1,0.00023,71067,16.40482,433208
10167,JoeStill,1,0.00023,71068,16.40505,433208
10168,john01dav,1,0.00023,71069,16.40528,433208
10169,john-auld,1,0.00023,71070,16.40551,433208
10170,johnc219,1,0.00023,71071,16.40575,433208
10171,JohnCarmichael3000,1,0.00023,71072,16.40598,433208
10172,johndiego,1,0.00023,71073,16.40621,433208
10173,JohnFrampton,1,0.00023,71074,16.40644,433208
10174,JohnGarbutt,1,0.00023,71075,16.40667,433208
10175,johnjbateman,1,0.00023,71076,16.40690,433208
10176,johnlindholm,1,0.00023,71077,16.40713,433208
10177,johnnian,1,0.00023,71078,16.40736,433208
10178,johnnyhuy,1,0.00023,71079,16.40759,433208
10179,Johnny-Three,1,0.00023,71080,16.40782,433208
10180,John-Oula,1,0.00023,71081,16.40805,433208
10181,JohnPaton,1,0.00023,71082,16.40828,433208
10182,johnpoth,1,0.00023,71083,16.40852,433208
10183,johnreutersward,1,0.00023,71084,16.40875,433208
10184,johnrkriter,1,0.00023,71085,16.40898,433208
10185,jolmg,1,0.00023,71086,16.40921,433208
10186,jonasdebeukelaer,1,0.00023,71087,16.40944,433208
10187,JonasDoe,1,0.00023,71088,16.40967,433208
10188,JonasJW,1,0.00023,71089,16.40990,433208
10189,JonathanMace,1,0.00023,71090,16.41013,433208
10190,jonathonbattista,1,0.00023,71091,16.41036,433208
10191,jondequinor,1,0.00023,71092,16.41059,433208
10192,joneshf-cn,1,0.00023,71093,16.41082,433208
10193,joni7777,1,0.00023,71094,16.41105,433208
10194,jonnalagadda35153,1,0.00023,71095,16.41129,433208
10195,jonpeterson,1,0.00023,71096,16.41152,433208
10196,jontkong,1,0.00023,71097,16.41175,433208
10197,jontutcher,1,0.00023,71098,16.41198,433208
10198,JonZeolla,1,0.00023,71099,16.41221,433208
10199,joostschriek,1,0.00023,71100,16.41244,433208
10200,JordiCano,1,0.00023,71101,16.41267,433208
10201,jordi-crespo,1,0.00023,71102,16.41290,433208
10202,jordiprats,1,0.00023,71103,16.41313,433208
10203,jordips,1,0.00023,71104,16.41336,433208
10204,jorik,1,0.00023,71105,16.41359,433208
10205,jorrit-wehelp,1,0.00023,71106,16.41382,433208
10206,josealmeida-vf,1,0.00023,71107,16.41406,433208
10207,josefoSe,1,0.00023,71108,16.41429,433208
10208,josemigallas,1,0.00023,71109,16.41452,433208
10209,josemiteba,1,0.00023,71110,16.41475,433208
10210,josephdubeau,1,0.00023,71111,16.41498,433208
10211,josephharrington,1,0.00023,71112,16.41521,433208
10212,josephmcgovern-wf,1,0.00023,71113,16.41544,433208
10213,josephreynolds,1,0.00023,71114,16.41567,433208
10214,JoseRIvera07,1,0.00023,71115,16.41590,433208
10215,Josh-a-e,1,0.00023,71116,16.41613,433208
10216,JoshHull-Wellsky,1,0.00023,71117,16.41636,433208
10217,joshi55,1,0.00023,71118,16.41659,433208
10218,joshiomkarj,1,0.00023,71119,16.41683,433208
10219,joshiste,1,0.00023,71120,16.41706,433208
10220,joshuafc,1,0.00023,71121,16.41729,433208
10221,joshuahlang,1,0.00023,71122,16.41752,433208
10222,joshwlewis,1,0.00023,71123,16.41775,433208
10223,josiahsams,1,0.00023,71124,16.41798,433208
10224,Josua-SR,1,0.00023,71125,16.41821,433208
10225,jozseffarago,1,0.00023,71126,16.41844,433208
10226,jpbochi,1,0.00023,71127,16.41867,433208
10227,jpc204,1,0.00023,71128,16.41890,433208
10228,jpdoria,1,0.00023,71129,16.41913,433208
10229,jpepin,1,0.00023,71130,16.41936,433208
10230,jphgardner,1,0.00023,71131,16.41960,433208
10231,jpmcb,1,0.00023,71132,16.41983,433208
10232,jrake-revelant,1,0.00023,71133,16.42006,433208
10233,jrdi,1,0.00023,71134,16.42029,433208
10234,jrefior,1,0.00023,71135,16.42052,433208
10235,jrhee17,1,0.00023,71136,16.42075,433208
10236,jrkt,1,0.00023,71137,16.42098,433208
10237,Jrobles-Oniad,1,0.00023,71138,16.42121,433208
10238,jrowlison-dart,1,0.00023,71139,16.42144,433208
10239,jrozentur,1,0.00023,71140,16.42167,433208
10240,jrweldon,1,0.00023,71141,16.42190,433208
10241,JrZemdegs712,1,0.00023,71142,16.42213,433208
10242,jsaguiar,1,0.00023,71143,16.42237,433208
10243,jsane-vp,1,0.00023,71144,16.42260,433208
10244,jsantanders,1,0.00023,71145,16.42283,433208
10245,jscarl,1,0.00023,71146,16.42306,433208
10246,jsedy7,1,0.00023,71147,16.42329,433208
10247,jseiser,1,0.00023,71148,16.42352,433208
10248,jsen-,1,0.00023,71149,16.42375,433208
10249,jsj,1,0.00023,71150,16.42398,433208
10250,jsmouret,1,0.00023,71151,16.42421,433208
10251,jspc,1,0.00023,71152,16.42444,433208
10252,jspiro,1,0.00023,71153,16.42467,433208
10253,jstafford5380,1,0.00023,71154,16.42490,433208
10254,jt4000,1,0.00023,71155,16.42514,433208
10255,JTambunt,1,0.00023,71156,16.42537,433208
10256,JThakrar,1,0.00023,71157,16.42560,433208
10257,jtigger,1,0.00023,71158,16.42583,433208
10258,jtlz2,1,0.00023,71159,16.42606,433208
10259,jtmal-signalfx,1,0.00023,71160,16.42629,433208
10260,jtudelag,1,0.00023,71161,16.42652,433208
10261,jtweaver,1,0.00023,71162,16.42675,433208
10262,juanandresgs,1,0.00023,71163,16.42698,433208
10263,juanbrny,1,0.00023,71164,16.42721,433208
10264,juanjoDiaz,1,0.00023,71165,16.42744,433208
10265,juanluisrp,1,0.00023,71166,16.42767,433208
10266,judeki,1,0.00023,71167,16.42791,433208
10267,jueeee,1,0.00023,71168,16.42814,433208
10268,juergen-walter,1,0.00023,71169,16.42837,433208
10269,juiceblender,1,0.00023,71170,16.42860,433208
10270,jujis008,1,0.00023,71171,16.42883,433208
10271,jujoramos,1,0.00023,71172,16.42906,433208
10272,jukvalim,1,0.00023,71173,16.42929,433208
10273,juliababkina,1,0.00023,71174,16.42952,433208
10274,julia-lawgeex,1,0.00023,71175,16.42975,433208
10275,juliantaylor,1,0.00023,71176,16.42998,433208
10276,JulieMei325,1,0.00023,71177,16.43021,433208
10277,juliencoopengo,1,0.00023,71178,16.43044,433208
10278,julien-lebot,1,0.00023,71179,16.43068,433208
10279,JulienPotvin,1,0.00023,71180,16.43091,433208
10280,juliensap1,1,0.00023,71181,16.43114,433208
10281,jullianoacqio,1,0.00023,71182,16.43137,433208
10282,julyclyde,1,0.00023,71183,16.43160,433208
10283,JulyIghor,1,0.00023,71184,16.43183,433208
10284,jumping,1,0.00023,71185,16.43206,433208
10285,Jumziey,1,0.00023,71186,16.43229,433208
10286,junhong-leanix,1,0.00023,71187,16.43252,433208
10287,junhuangli,1,0.00023,71188,16.43275,433208
10288,jurim76,1,0.00023,71189,16.43298,433208
10289,just1689,1,0.00023,71190,16.43321,433208
10290,just1900,1,0.00023,71191,16.43345,433208
10291,JustasStankunas,1,0.00023,71192,16.43368,433208
10292,justin0mcateer,1,0.00023,71193,16.43391,433208
10293,justinkillen,1,0.00023,71194,16.43414,433208
10294,justinshinmaplarge,1,0.00023,71195,16.43437,433208
10295,justmara,1,0.00023,71196,16.43460,433208
10296,jvanmalder,1,0.00023,71197,16.43483,433208
10297,jvanzyl,1,0.00023,71198,16.43506,433208
10298,jvergara-runbuggy,1,0.00023,71199,16.43529,433208
10299,J-Vin,1,0.00023,71200,16.43552,433208
10300,jwanga,1,0.00023,71201,16.43575,433208
10301,jwausle,1,0.00023,71202,16.43598,433208
10302,jweyrich,1,0.00023,71203,16.43622,433208
10303,jwhb,1,0.00023,71204,16.43645,433208
10304,jwuman,1,0.00023,71205,16.43668,433208
10305,jxy859,1,0.00023,71206,16.43691,433208
10306,jxyy,1,0.00023,71207,16.43714,433208
10307,jyozq,1,0.00023,71208,16.43737,433208
10308,jyyeom,1,0.00023,71209,16.43760,433208
10309,jzhang046,1,0.00023,71210,16.43783,433208
10310,j-zimnowoda,1,0.00023,71211,16.43806,433208
10311,k0tl,1,0.00023,71212,16.43829,433208
10312,k3a,1,0.00023,71213,16.43852,433208
10313,k3daevin,1,0.00023,71214,16.43875,433208
10314,k3nny0ne,1,0.00023,71215,16.43899,433208
10315,kable-wilmoth,1,0.00023,71216,16.43922,433208
10316,kabooboo,1,0.00023,71217,16.43945,433208
10317,kachar,1,0.00023,71218,16.43968,433208
10318,KaelBaldwin,1,0.00023,71219,16.43991,433208
10319,KairaMiu,1,0.00023,71220,16.44014,433208
10320,kakaroto,1,0.00023,71221,16.44037,433208
10321,kaleocheng,1,0.00023,71222,16.44060,433208
10322,kalid117658,1,0.00023,71223,16.44083,433208
10323,kalman5,1,0.00023,71224,16.44106,433208
10324,kamal9399,1,0.00023,71225,16.44129,433208
10325,kamal94,1,0.00023,71226,16.44152,433208
10326,kamelotnsk,1,0.00023,71227,16.44176,433208
10327,kamilswiec,1,0.00023,71228,16.44199,433208
10328,kamit78,1,0.00023,71229,16.44222,433208
10329,kammous,1,0.00023,71230,16.44245,433208
10330,kandaaaaa,1,0.00023,71231,16.44268,433208
10331,kangaechu,1,0.00023,71232,16.44291,433208
10332,kannanvr,1,0.00023,71233,16.44314,433208
10333,kanubhav906,1,0.00023,71234,16.44337,433208
10334,kanwar-saad,1,0.00023,71235,16.44360,433208
10335,kapil-raj,1,0.00023,71236,16.44383,433208
10336,kapitaldata,1,0.00023,71237,16.44406,433208
10337,karan97144,1,0.00023,71238,16.44429,433208
10338,KarenEfereyan,1,0.00023,71239,16.44453,433208
10339,karibertils,1,0.00023,71240,16.44476,433208
10340,karimhm,1,0.00023,71241,16.44499,433208
10341,karlmuscat,1,0.00023,71242,16.44522,433208
10342,karolinepauls,1,0.00023,71243,16.44545,433208
10343,kartheek7895,1,0.00023,71244,16.44568,433208
10344,karthick-kk,1,0.00023,71245,16.44591,433208
10345,karthikm83,1,0.00023,71246,16.44614,433208
10346,karthirm,1,0.00023,71247,16.44637,433208
10347,karthm12,1,0.00023,71248,16.44660,433208
10348,KartikJangir,1,0.00023,71249,16.44683,433208
10349,Kashyap85,1,0.00023,71250,16.44706,433208
10350,kasriniv,1,0.00023,71251,16.44730,433208
10351,katlimruiz,1,0.00023,71252,16.44753,433208
10352,katmai,1,0.00023,71253,16.44776,433208
10353,katrinleinweber,1,0.00023,71254,16.44799,433208
10354,kaushalyap,1,0.00023,71255,16.44822,433208
10355,kaustubhd93,1,0.00023,71256,16.44845,433208
10356,kaviarasan-ex2,1,0.00023,71257,16.44868,433208
10357,kavicse87,1,0.00023,71258,16.44891,433208
10358,kavitsheth,1,0.00023,71259,16.44914,433208
10359,kaychu2013,1,0.00023,71260,16.44937,433208
10360,kayousterhout,1,0.00023,71261,16.44960,433208
10361,kazysgurskas,1,0.00023,71262,16.44983,433208
10362,kbbqiu,1,0.00023,71263,16.45007,433208
10363,kbirger,1,0.00023,71264,16.45030,433208
10364,kbrowder,1,0.00023,71265,16.45053,433208
10365,kd7lxl,1,0.00023,71266,16.45076,433208
10366,keerthisagar40,1,0.00023,71267,16.45099,433208
10367,keifgwinn,1,0.00023,71268,16.45122,433208
10368,kellengreen,1,0.00023,71269,16.45145,433208
10369,kelly-brown,1,0.00023,71270,16.45168,433208
10370,kenans,1,0.00023,71271,16.45191,433208
10371,kenjapkowalczyk,1,0.00023,71272,16.45214,433208
10372,kenke7,1,0.00023,71273,16.45237,433208
10373,kennyish1173,1,0.00023,71274,16.45260,433208
10374,kennyk65,1,0.00023,71275,16.45284,433208
10375,kenshaw,1,0.00023,71276,16.45307,433208
10376,Kenzi007220,1,0.00023,71277,16.45330,433208
10377,kenzieschmoll,1,0.00023,71278,16.45353,433208
10378,Keralin,1,0.00023,71279,16.45376,433208
10379,keremgocen,1,0.00023,71280,16.45399,433208
10380,keriksson-rosenqvist,1,0.00023,71281,16.45422,433208
10381,kernelgonnapanic,1,0.00023,71282,16.45445,433208
10382,kevin90n,1,0.00023,71283,16.45468,433208
10383,kevindavee,1,0.00023,71284,16.45491,433208
10384,KevinDitschke,1,0.00023,71285,16.45514,433208
10385,KevinGG,1,0.00023,71286,16.45537,433208
10386,kevin-hanselman,1,0.00023,71287,16.45561,433208
10387,kevinkarwaski,1,0.00023,71288,16.45584,433208
10388,kevin-king,1,0.00023,71289,16.45607,433208
10389,kevin-lindsay-1,1,0.00023,71290,16.45630,433208
10390,kevinmichaelchen,1,0.00023,71291,16.45653,433208
10391,kevinpollet,1,0.00023,71292,16.45676,433208
10392,kgcarr,1,0.00023,71293,16.45699,433208
10393,KGODS,1,0.00023,71294,16.45722,433208
10394,kgtw,1,0.00023,71295,16.45745,433208
10395,kgunjikar,1,0.00023,71296,16.45768,433208
10396,khadka-prakash,1,0.00023,71297,16.45791,433208
10397,khanchi97,1,0.00023,71298,16.45814,433208
10398,khangfsf,1,0.00023,71299,16.45838,433208
10399,khanhtc1202,1,0.00023,71300,16.45861,433208
10400,Khawandjean,1,0.00023,71301,16.45884,433208
10401,khewling,1,0.00023,71302,16.45907,433208
10402,khsabhishek,1,0.00023,71303,16.45930,433208
10403,khteh,1,0.00023,71304,16.45953,433208
10404,khushijindal,1,0.00023,71305,16.45976,433208
10405,kianjones4,1,0.00023,71306,16.45999,433208
10406,kidproquo,1,0.00023,71307,16.46022,433208
10407,kidrocknroll,1,0.00023,71308,16.46045,433208
10408,kiefersmith,1,0.00023,71309,16.46068,433208
10409,kiemlicz,1,0.00023,71310,16.46091,433208
10410,kierankelleher,1,0.00023,71311,16.46115,433208
10411,kieronlangdon,1,0.00023,71312,16.46138,433208
10412,ki-ichino,1,0.00023,71313,16.46161,433208
10413,KimJiAh,1,0.00023,71314,16.46184,433208
10414,kingcody,1,0.00023,71315,16.46207,433208
10415,KingDacker,1,0.00023,71316,16.46230,433208
10416,kingdevnl,1,0.00023,71317,16.46253,433208
10417,kingGang,1,0.00023,71318,16.46276,433208
10418,king-jam,1,0.00023,71319,16.46299,433208
10419,kingkazzy28,1,0.00023,71320,16.46322,433208
10420,kingprimex,1,0.00023,71321,16.46345,433208
10421,kiran009,1,0.00023,71322,16.46368,433208
10422,KiranCS-17,1,0.00023,71323,16.46392,433208
10423,kirankumar77,1,0.00023,71324,16.46415,433208
10424,kiranmeduri,1,0.00023,71325,16.46438,433208
10425,kiransmartclean,1,0.00023,71326,16.46461,433208
10426,Kirill-Garbar,1,0.00023,71327,16.46484,433208
10427,kirkdave,1,0.00023,71328,16.46507,433208
10428,kirk-patton,1,0.00023,71329,16.46530,433208
10429,kirnberger1980,1,0.00023,71330,16.46553,433208
10430,kirooshu,1,0.00023,71331,16.46576,433208
10431,kirualex,1,0.00023,71332,16.46599,433208
10432,kishore25kumar,1,0.00023,71333,16.46622,433208
10433,kishoregv,1,0.00023,71334,16.46645,433208
10434,kishorevaishnav,1,0.00023,71335,16.46669,433208
10435,kisszhangxiansen,1,0.00023,71336,16.46692,433208
10436,kitenco,1,0.00023,71337,16.46715,433208
10437,kiyonlin,1,0.00023,71338,16.46738,433208
10438,kiyor-cai-exa,1,0.00023,71339,16.46761,433208
10439,kiyutink,1,0.00023,71340,16.46784,433208
10440,kjellaso,1,0.00023,71341,16.46807,433208
10441,kjpianeta,1,0.00023,71342,16.46830,433208
10442,kkishoreyadav,1,0.00023,71343,16.46853,433208
10443,kkkarthik,1,0.00023,71344,16.46876,433208
10444,kkweon,1,0.00023,71345,16.46899,433208
10445,kkzz8888,1,0.00023,71346,16.46922,433208
10446,klauskades,1,0.00023,71347,16.46946,433208
10447,kleysonr,1,0.00023,71348,16.46969,433208
10448,klimov-gett,1,0.00023,71349,16.46992,433208
10449,kloudd,1,0.00023,71350,16.47015,433208
10450,klst9498,1,0.00023,71351,16.47038,433208
10451,kmajic,1,0.00023,71352,16.47061,433208
10452,kmangla9,1,0.00023,71353,16.47084,433208
10453,kmcminn,1,0.00023,71354,16.47107,433208
10454,kminder,1,0.00023,71355,16.47130,433208
10455,kmorning,1,0.00023,71356,16.47153,433208
10456,Kn0wl3dge,1,0.00023,71357,16.47176,433208
10457,kngoyal,1,0.00023,71358,16.47199,433208
10458,knightley,1,0.00023,71359,16.47223,433208
10459,knowlengr,1,0.00023,71360,16.47246,433208
10460,ko5tas,1,0.00023,71361,16.47269,433208
10461,kobenauf,1,0.00023,71362,16.47292,433208
10462,kody-abe,1,0.00023,71363,16.47315,433208
10463,koflTS,1,0.00023,71364,16.47338,433208
10464,kogent,1,0.00023,71365,16.47361,433208
10465,kojikobayashi0220,1,0.00023,71366,16.47384,433208
10466,koksario,1,0.00023,71367,16.47407,433208
10467,kolesnikovIV,1,0.00023,71368,16.47430,433208
10468,kollender,1,0.00023,71369,16.47453,433208
10469,Konata9,1,0.00023,71370,16.47477,433208
10470,kong62,1,0.00023,71371,16.47500,433208
10471,konghui,1,0.00023,71372,16.47523,433208
10472,kongkongk,1,0.00023,71373,16.47546,433208
10473,KongSteve,1,0.00023,71374,16.47569,433208
10474,Konmoron,1,0.00023,71375,16.47592,433208
10475,korobass,1,0.00023,71376,16.47615,433208
10476,Korsani,1,0.00023,71377,16.47638,433208
10477,kostyay,1,0.00023,71378,16.47661,433208
10478,kosukeoya,1,0.00023,71379,16.47684,433208
10479,kowshikn,1,0.00023,71380,16.47707,433208
10480,kpbasu,1,0.00023,71381,16.47730,433208
10481,kpr12,1,0.00023,71382,16.47754,433208
10482,krakazyabra,1,0.00023,71383,16.47777,433208
10483,kravivar,1,0.00023,71384,16.47800,433208
10484,krdineshbny,1,0.00023,71385,16.47823,433208
10485,krishnavenisuresh,1,0.00023,71386,16.47846,433208
10486,krishofmans,1,0.00023,71387,16.47869,433208
10487,Kristian-ZH,1,0.00023,71388,16.47892,433208
10488,krotovic,1,0.00023,71389,16.47915,433208
10489,krvarma,1,0.00023,71390,16.47938,433208
10490,kryzthov-stripe,1,0.00023,71391,16.47961,433208
10491,KrzesloSzatan,1,0.00023,71392,16.47984,433208
10492,krzysztofsroga,1,0.00023,71393,16.48007,433208
10493,KS1000,1,0.00023,71394,16.48031,433208
10494,ks4225,1,0.00023,71395,16.48054,433208
10495,ks864148379,1,0.00023,71396,16.48077,433208
10496,ksanchez15,1,0.00023,71397,16.48100,433208
10497,ksaritek,1,0.00023,71398,16.48123,433208
10498,kshcherban,1,0.00023,71399,16.48146,433208
10499,kshke,1,0.00023,71400,16.48169,433208
10500,ksimka,1,0.00023,71401,16.48192,433208
10501,KSVarun,1,0.00023,71402,16.48215,433208
10502,kubadawczynski,1,0.00023,71403,16.48238,433208
10503,kubemq,1,0.00023,71404,16.48261,433208
10504,Kuhlemann,1,0.00023,71405,16.48284,433208
10505,kuja53,1,0.00023,71406,16.48308,433208
10506,kumaranshu72,1,0.00023,71407,16.48331,433208
10507,kumar-mayadata,1,0.00023,71408,16.48354,433208
10508,kumarsiyer,1,0.00023,71409,16.48377,433208
10509,kunalpuriii,1,0.00023,71410,16.48400,433208
10510,kunalshinde213,1,0.00023,71411,16.48423,433208
10511,kundansingh86,1,0.00023,71412,16.48446,433208
10512,kungfutse,1,0.00023,71413,16.48469,433208
10513,kureuil,1,0.00023,71414,16.48492,433208
10514,kursluzz,1,0.00023,71415,16.48515,433208
10515,kuwabarahiroshi,1,0.00023,71416,16.48538,433208
10516,kw7oe,1,0.00023,71417,16.48561,433208
10517,kxesd,1,0.00023,71418,16.48585,433208
10518,Kydybets,1,0.00023,71419,16.48608,433208
10519,Kyle-Cooley,1,0.00023,71420,16.48631,433208
10520,kylerisse,1,0.00023,71421,16.48654,433208
10521,kyriefly,1,0.00023,71422,16.48677,433208
10522,Kyrluckechuck,1,0.00023,71423,16.48700,433208
10523,l1b0k,1,0.00023,71424,16.48723,433208
10524,l3omtz,1,0.00023,71425,16.48746,433208
10525,l4z41,1,0.00023,71426,16.48769,433208
10526,laevilgenius,1,0.00023,71427,16.48792,433208
10527,laithalissa,1,0.00023,71428,16.48815,433208
10528,lambdanis,1,0.00023,71429,16.48838,433208
10529,lance6716,1,0.00023,71430,16.48862,433208
10530,landesherr,1,0.00023,71431,16.48885,433208
10531,Lanpice,1,0.00023,71432,16.48908,433208
10532,laoyao-ch,1,0.00023,71433,16.48931,433208
10533,LargeOrange,1,0.00023,71434,16.48954,433208
10534,Larry1314,1,0.00023,71435,16.48977,433208
10535,larrywax,1,0.00023,71436,16.49000,433208
10536,larsonmpdx,1,0.00023,71437,16.49023,433208
10537,lashukla,1,0.00023,71438,16.49046,433208
10538,lastboy1228,1,0.00023,71439,16.49069,433208
10539,lauer,1,0.00023,71440,16.49092,433208
10540,laundry-96,1,0.00023,71441,16.49115,433208
10541,laurybueno,1,0.00023,71442,16.49139,433208
10542,lavasana,1,0.00023,71443,16.49162,433208
10543,lavieth,1,0.00023,71444,16.49185,433208
10544,Lavish-Garg,1,0.00023,71445,16.49208,433208
10545,lavkesh,1,0.00023,71446,16.49231,433208
10546,laxmanlax,1,0.00023,71447,16.49254,433208
10547,LaysDragon,1,0.00023,71448,16.49277,433208
10548,lazyfrosch,1,0.00023,71449,16.49300,433208
10549,lbs-rodrigo,1,0.00023,71450,16.49323,433208
10550,lcami,1,0.00023,71451,16.49346,433208
10551,lceni,1,0.00023,71452,16.49369,433208
10552,lcontini,1,0.00023,71453,16.49392,433208
10553,lcostamanha,1,0.00023,71454,16.49416,433208
10554,lcwus2,1,0.00023,71455,16.49439,433208
10555,l-dalessandro,1,0.00023,71456,16.49462,433208
10556,lddlww,1,0.00023,71457,16.49485,433208
10557,ldeng-ustc,1,0.00023,71458,16.49508,433208
10558,ldepandis,1,0.00023,71459,16.49531,433208
10559,ldipaolaIT,1,0.00023,71460,16.49554,433208
10560,ldue,1,0.00023,71461,16.49577,433208
10561,leandrosolagna,1,0.00023,71462,16.49600,433208
10562,Learloj,1,0.00023,71463,16.49623,433208
10563,Learnfr,1,0.00023,71464,16.49646,433208
10564,learoyklinginsmith,1,0.00023,71465,16.49669,433208
10565,lebadapetru,1,0.00023,71466,16.49693,433208
10566,lebaptiste,1,0.00023,71467,16.49716,433208
10567,lecaros,1,0.00023,71468,16.49739,433208
10568,ledmonster,1,0.00023,71469,16.49762,433208
10569,leeadh,1,0.00023,71470,16.49785,433208
10570,leemingeer,1,0.00023,71471,16.49808,433208
10571,leflambeur,1,0.00023,71472,16.49831,433208
10572,Lefthander,1,0.00023,71473,16.49854,433208
10573,le-garden-fox,1,0.00023,71474,16.49877,433208
10574,legoktm,1,0.00023,71475,16.49900,433208
10575,leisheyoufu,1,0.00023,71476,16.49923,433208
10576,leiw324,1,0.00023,71477,16.49946,433208
10577,leiysky,1,0.00023,71478,16.49970,433208
10578,lel-war,1,0.00023,71479,16.49993,433208
10579,lemonit-eric-mao,1,0.00023,71480,16.50016,433208
10580,LemonSpike,1,0.00023,71481,16.50039,433208
10581,lenhattan86,1,0.00023,71482,16.50062,433208
10582,LennertMertens,1,0.00023,71483,16.50085,433208
10583,LenzGr,1,0.00023,71484,16.50108,433208
10584,Leo7654,1,0.00023,71485,16.50131,433208
10585,leokassio,1,0.00023,71486,16.50154,433208
10586,leolzbing521,1,0.00023,71487,16.50177,433208
10587,leon0204,1,0.00023,71488,16.50200,433208
10588,LeonAlvarez,1,0.00023,71489,16.50223,433208
10589,LeoQuote,1,0.00023,71490,16.50247,433208
10590,LeoSkyeer,1,0.00023,71491,16.50270,433208
10591,lethe2211,1,0.00023,71492,16.50293,433208
10592,levonet,1,0.00023,71493,16.50316,433208
10593,levous,1,0.00023,71494,16.50339,433208
10594,lewislbr,1,0.00023,71495,16.50362,433208
10595,lexore,1,0.00023,71496,16.50385,433208
10596,lgelfan,1,0.00023,71497,16.50408,433208
10597,lguinn,1,0.00023,71498,16.50431,433208
10598,lgypro,1,0.00023,71499,16.50454,433208
10599,LHCGreg,1,0.00023,71500,16.50477,433208
10600,liafizan,1,0.00023,71501,16.50500,433208
10601,liakouras,1,0.00023,71502,16.50524,433208
10602,liamwhan,1,0.00023,71503,16.50547,433208
10603,lianfulei,1,0.00023,71504,16.50570,433208
10604,liangfangyin,1,0.00023,71505,16.50593,433208
10605,liangguohun,1,0.00023,71506,16.50616,433208
10606,LIANGQI0811,1,0.00023,71507,16.50639,433208
10607,liangran10000,1,0.00023,71508,16.50662,433208
10608,liaozb,1,0.00023,71509,16.50685,433208
10609,liatgold,1,0.00023,71510,16.50708,433208
10610,liavyona,1,0.00023,71511,16.50731,433208
10611,liboyue23,1,0.00023,71512,16.50754,433208
10612,lichaojacobs,1,0.00023,71513,16.50777,433208
10613,lictw,1,0.00023,71514,16.50801,433208
10614,lidajia,1,0.00023,71515,16.50824,433208
10615,lidorg-dev,1,0.00023,71516,16.50847,433208
10616,lienerieksta,1,0.00023,71517,16.50870,433208
10617,life0215,1,0.00023,71518,16.50893,433208
10618,lifesboy,1,0.00023,71519,16.50916,433208
10619,lighteness,1,0.00023,71520,16.50939,433208
10620,lights0123,1,0.00023,71521,16.50962,433208
10621,Limdi,1,0.00023,71522,16.50985,433208
10622,limouren,1,0.00023,71523,16.51008,433208
10623,Lincon-Freitas,1,0.00023,71524,16.51031,433208
10624,LinQing2017,1,0.00023,71525,16.51054,433208
10625,linuxpham,1,0.00023,71526,16.51078,433208
10626,linyinli,1,0.00023,71527,16.51101,433208
10627,lionelyoung,1,0.00023,71528,16.51124,433208
10628,lionzdz,1,0.00023,71529,16.51147,433208
10629,liorkesos,1,0.00023,71530,16.51170,433208
10630,LipingSun,1,0.00023,71531,16.51193,433208
10631,lipingtababa,1,0.00023,71532,16.51216,433208
10632,LiranBri,1,0.00023,71533,16.51239,433208
10633,Lirt,1,0.00023,71534,16.51262,433208
10634,LisaFournet8,1,0.00023,71535,16.51285,433208
10635,lishinho,1,0.00023,71536,16.51308,433208
10636,lisongmin,1,0.00023,71537,16.51331,433208
10637,litao20102546,1,0.00023,71538,16.51355,433208
10638,LittleFall,1,0.00023,71539,16.51378,433208
10639,littleforce163,1,0.00023,71540,16.51401,433208
10640,liubo0127,1,0.00023,71541,16.51424,433208
10641,liuerfire,1,0.00023,71542,16.51447,433208
10642,liuht777,1,0.00023,71543,16.51470,433208
10643,liuhuanHappyStudy,1,0.00023,71544,16.51493,433208
10644,liusi123,1,0.00023,71545,16.51516,433208
10645,liwade110,1,0.00023,71546,16.51539,433208
10646,lixiaopengxiya,1,0.00023,71547,16.51562,433208
10647,liy516,1,0.00023,71548,16.51585,433208
10648,liyinxin,1,0.00023,71549,16.51608,433208
10649,liyk1024,1,0.00023,71550,16.51632,433208
10650,lizhichao,1,0.00023,71551,16.51655,433208
10651,lkoniecz,1,0.00023,71552,16.51678,433208
10652,lkr2des,1,0.00023,71553,16.51701,433208
10653,lkxsoul,1,0.00023,71554,16.51724,433208
10654,llazzaro,1,0.00023,71555,16.51747,433208
10655,llech,1,0.00023,71556,16.51770,433208
10656,llienard,1,0.00023,71557,16.51793,433208
10657,lllamnyp,1,0.00023,71558,16.51816,433208
10658,lmmmml,1,0.00023,71559,16.51839,433208
10659,lnguyen2341,1,0.00023,71560,16.51862,433208
10660,lnparker,1,0.00023,71561,16.51885,433208
10661,lnto3408,1,0.00023,71562,16.51909,433208
10662,LockLi,1,0.00023,71563,16.51932,433208
10663,loganmzz,1,0.00023,71564,16.51955,433208
10664,logicatmidod,1,0.00023,71565,16.51978,433208
10665,logicethos,1,0.00023,71566,16.52001,433208
10666,lokoArt,1,0.00023,71567,16.52024,433208
10667,Lonor,1,0.00023,71568,16.52047,433208
10668,LookImHigh,1,0.00023,71569,16.52070,433208
10669,LordNoteworthy,1,0.00023,71570,16.52093,433208
10670,lordnynex,1,0.00023,71571,16.52116,433208
10671,lorenzozimolo,1,0.00023,71572,16.52139,433208
10672,lorf,1,0.00023,71573,16.52162,433208
10673,lostmimic,1,0.00023,71574,16.52186,433208
10674,lostpoint-ru,1,0.00023,71575,16.52209,433208
10675,lotress,1,0.00023,71576,16.52232,433208
10676,lovasoa,1,0.00023,71577,16.52255,433208
10677,lovew,1,0.00023,71578,16.52278,433208
10678,lpar,1,0.00023,71579,16.52301,433208
10679,lrascao,1,0.00023,71580,16.52324,433208
10680,lretrain91,1,0.00023,71581,16.52347,433208
10681,ls42,1,0.00023,71582,16.52370,433208
10682,lsamayoa,1,0.00023,71583,16.52393,433208
10683,lsambolino,1,0.00023,71584,16.52416,433208
10684,ls-brentsmith,1,0.00023,71585,16.52439,433208
10685,lsc21,1,0.00023,71586,16.52463,433208
10686,lsj9383,1,0.00023,71587,16.52486,433208
10687,lslebodn,1,0.00023,71588,16.52509,433208
10688,ltutar,1,0.00023,71589,16.52532,433208
10689,lu1as,1,0.00023,71590,16.52555,433208
10690,lucasgvarela,1,0.00023,71591,16.52578,433208
10691,lucaskjaero,1,0.00023,71592,16.52601,433208
10692,lucassha,1,0.00023,71593,16.52624,433208
10693,lucatk,1,0.00023,71594,16.52647,433208
10694,ludichrislyts,1,0.00023,71595,16.52670,433208
10695,ludusrusso,1,0.00023,71596,16.52693,433208
10696,LuffyBySunny,1,0.00023,71597,16.52716,433208
10697,luissio,1,0.00023,71598,16.52740,433208
10698,luisusr,1,0.00023,71599,16.52763,433208
10699,lujiajing1126,1,0.00023,71600,16.52786,433208
10700,lujia-zhang,1,0.00023,71601,16.52809,433208
10701,lujuanzhai,1,0.00023,71602,16.52832,433208
10702,lukas1994,1,0.00023,71603,16.52855,433208
10703,lukasfrank,1,0.00023,71604,16.52878,433208
10704,lukaslentner,1,0.00023,71605,16.52901,433208
10705,lukatera,1,0.00023,71606,16.52924,433208
10706,LukeBalizetPatriot,1,0.00023,71607,16.52947,433208
10707,lukegb,1,0.00023,71608,16.52970,433208
10708,LukeWood,1,0.00023,71609,16.52993,433208
10709,lukeyeager,1,0.00023,71610,16.53017,433208
10710,lukos,1,0.00023,71611,16.53040,433208
10711,LukvonStrom,1,0.00023,71612,16.53063,433208
10712,lumenCodes,1,0.00023,71613,16.53086,433208
10713,lunighty,1,0.00023,71614,16.53109,433208
10714,luryus,1,0.00023,71615,16.53132,433208
10715,luxmeter,1,0.00023,71616,16.53155,433208
10716,lvargas0584,1,0.00023,71617,16.53178,433208
10717,lvcaiping,1,0.00023,71618,16.53201,433208
10718,lvs071103,1,0.00023,71619,16.53224,433208
10719,lvyishan,1,0.00023,71620,16.53247,433208
10720,lw-kaijparo,1,0.00023,71621,16.53270,433208
10721,LXBdev,1,0.00023,71622,16.53294,433208
10722,LYHFUU,1,0.00023,71623,16.53317,433208
10723,LyingChild,1,0.00023,71624,16.53340,433208
10724,lynch0227,1,0.00023,71625,16.53363,433208
10725,Lynskylate,1,0.00023,71626,16.53386,433208
10726,lyschoening,1,0.00023,71627,16.53409,433208
10727,lyuma,1,0.00023,71628,16.53432,433208
10728,lyz-code,1,0.00023,71629,16.53455,433208
10729,lz1998,1,0.00023,71630,16.53478,433208
10730,lzhecheng,1,0.00023,71631,16.53501,433208
10731,lzp0412,1,0.00023,71632,16.53524,433208
10732,M0rdecay,1,0.00023,71633,16.53547,433208
10733,m33m33k,1,0.00023,71634,16.53571,433208
10734,M3t0r,1,0.00023,71635,16.53594,433208
10735,m4ldonado,1,0.00023,71636,16.53617,433208
10736,MA357151,1,0.00023,71637,16.53640,433208
10737,mach-kernel,1,0.00023,71638,16.53663,433208
10738,Mackiovello,1,0.00023,71639,16.53686,433208
10739,maclockard,1,0.00023,71640,16.53709,433208
10740,macolso,1,0.00023,71641,16.53732,433208
10741,Madamas,1,0.00023,71642,16.53755,433208
10742,madchap,1,0.00023,71643,16.53778,433208
10743,maddilli16,1,0.00023,71644,16.53801,433208
10744,MaddSauer,1,0.00023,71645,16.53824,433208
10745,madeleine666,1,0.00023,71646,16.53848,433208
10746,MadEngineX,1,0.00023,71647,16.53871,433208
10747,Madhu-cherukuri,1,0.00023,71648,16.53894,433208
10748,madhuresh04,1,0.00023,71649,16.53917,433208
10749,madianas,1,0.00023,71650,16.53940,433208
10750,madjidGH,1,0.00023,71651,16.53963,433208
10751,madorodam,1,0.00023,71652,16.53986,433208
10752,madushan1000,1,0.00023,71653,16.54009,433208
10753,Madvinking,1,0.00023,71654,16.54032,433208
10754,maeb,1,0.00023,71655,16.54055,433208
10755,maennchen,1,0.00023,71656,16.54078,433208
10756,MaerF0x0,1,0.00023,71657,16.54101,433208
10757,maganaluis,1,0.00023,71658,16.54125,433208
10758,MaGaoju,1,0.00023,71659,16.54148,433208
10759,maged,1,0.00023,71660,16.54171,433208
10760,magederek,1,0.00023,71661,16.54194,433208
10761,maggieliu,1,0.00023,71662,16.54217,433208
10762,magikid,1,0.00023,71663,16.54240,433208
10763,maglun2,1,0.00023,71664,16.54263,433208
10764,magnate3,1,0.00023,71665,16.54286,433208
10765,Magnitus-,1,0.00023,71666,16.54309,433208
10766,magnusp,1,0.00023,71667,16.54332,433208
10767,mahendran8655,1,0.00023,71668,16.54355,433208
10768,maheswarasunil,1,0.00023,71669,16.54378,433208
10769,Mahmoud-Karam,1,0.00023,71670,16.54402,433208
10770,mahmoud-mahdi,1,0.00023,71671,16.54425,433208
10771,mahmoudshirivaramini,1,0.00023,71672,16.54448,433208
10772,maikelvl,1,0.00023,71673,16.54471,433208
10773,maikknebel,1,0.00023,71674,16.54494,433208
10774,maitrungduc1410,1,0.00023,71675,16.54517,433208
10775,majian159,1,0.00023,71676,16.54540,433208
10776,majidma-ag,1,0.00023,71677,16.54563,433208
10777,majormoses,1,0.00023,71678,16.54586,433208
10778,makdmi,1,0.00023,71679,16.54609,433208
10779,makkarpov,1,0.00023,71680,16.54632,433208
10780,maksatmeredovcusat,1,0.00023,71681,16.54656,433208
10781,mal-berbatovci,1,0.00023,71682,16.54679,433208
10782,malli31,1,0.00023,71683,16.54702,433208
10783,malmor,1,0.00023,71684,16.54725,433208
10784,man4red,1,0.00023,71685,16.54748,433208
10785,manan00,1,0.00023,71686,16.54771,433208
10786,manfontan,1,0.00023,71687,16.54794,433208
10787,mangoleaf,1,0.00023,71688,16.54817,433208
10788,manikanta-talanki,1,0.00023,71689,16.54840,433208
10789,ManishGuptaKuumar,1,0.00023,71690,16.54863,433208
10790,manjuvee,1,0.00023,71691,16.54886,433208
10791,manoadamro,1,0.00023,71692,16.54909,433208
10792,manodupont,1,0.00023,71693,16.54933,433208
10793,Manoj-KumarYadav,1,0.00023,71694,16.54956,433208
10794,ManojPathakc1,1,0.00023,71695,16.54979,433208
10795,manojvs157,1,0.00023,71696,16.55002,433208
10796,mans0954,1,0.00023,71697,16.55025,433208
10797,mantasmatelis,1,0.00023,71698,16.55048,433208
10798,manuelnp,1,0.00023,71699,16.55071,433208
10799,manzsolutions-lpreis,1,0.00023,71700,16.55094,433208
10800,maoling,1,0.00023,71701,16.55117,433208
10801,maonoam,1,0.00023,71702,16.55140,433208
10802,maracle6,1,0.00023,71703,16.55163,433208
10803,marcelobrake,1,0.00023,71704,16.55186,433208
10804,marcelo-devsres,1,0.00023,71705,16.55210,433208
10805,marcelomanchester,1,0.00023,71706,16.55233,433208
10806,marcelser,1,0.00023,71707,16.55256,433208
10807,marcgascon,1,0.00023,71708,16.55279,433208
10808,marcheil,1,0.00023,71709,16.55302,433208
10809,marcinbojko,1,0.00023,71710,16.55325,433208
10810,marcinkoperski,1,0.00023,71711,16.55348,433208
10811,marcinma,1,0.00023,71712,16.55371,433208
10812,marcomicera,1,0.00023,71713,16.55394,433208
10813,marcominetti,1,0.00023,71714,16.55417,433208
10814,MarcoR83,1,0.00023,71715,16.55440,433208
10815,marcosinger,1,0.00023,71716,16.55463,433208
10816,marcpar,1,0.00023,71717,16.55487,433208
10817,marcphilipp,1,0.00023,71718,16.55510,433208
10818,marcvs,1,0.00023,71719,16.55533,433208
10819,mareklubinski,1,0.00023,71720,16.55556,433208
10820,mareksapota,1,0.00023,71721,16.55579,433208
10821,mariana-mendes,1,0.00023,71722,16.55602,433208
10822,marianoao,1,0.00023,71723,16.55625,433208
10823,marianoarga,1,0.00023,71724,16.55648,433208
10824,marinetteman2,1,0.00023,71725,16.55671,433208
10825,MarioAllegro,1,0.00023,71726,16.55694,433208
10826,mariojacobo,1,0.00023,71727,16.55717,433208
10827,mario-purestake,1,0.00023,71728,16.55740,433208
10828,mariorojas,1,0.00023,71729,16.55764,433208
10829,Mariyo,1,0.00023,71730,16.55787,433208
10830,MarkDeckert,1,0.00023,71731,16.55810,433208
10831,marklinders-planon,1,0.00023,71732,16.55833,433208
10832,markmsmith,1,0.00023,71733,16.55856,433208
10833,markphelps,1,0.00023,71734,16.55879,433208
10834,markrity,1,0.00023,71735,16.55902,433208
10835,markstos,1,0.00023,71736,16.55925,433208
10836,markus7811,1,0.00023,71737,16.55948,433208
10837,Markus-ipse,1,0.00023,71738,16.55971,433208
10838,MarkZither,1,0.00023,71739,16.55994,433208
10839,marrem,1,0.00023,71740,16.56017,433208
10840,MarsWarrior,1,0.00023,71741,16.56041,433208
10841,Martin3498,1,0.00023,71742,16.56064,433208
10842,martinbeentjes,1,0.00023,71743,16.56087,433208
10843,martinfar,1,0.00023,71744,16.56110,433208
10844,Martin-Luther,1,0.00023,71745,16.56133,433208
10845,MartinSGill,1,0.00023,71746,16.56156,433208
10846,martint17r,1,0.00023,71747,16.56179,433208
10847,martonsz,1,0.00023,71748,16.56202,433208
10848,marvelous-melanie,1,0.00023,71749,16.56225,433208
10849,marvinkite,1,0.00023,71750,16.56248,433208
10850,marzianor9,1,0.00023,71751,16.56271,433208
10851,masariello,1,0.00023,71752,16.56294,433208
10852,masontin,1,0.00023,71753,16.56318,433208
10853,mastar3104,1,0.00023,71754,16.56341,433208
10854,mastergberry,1,0.00023,71755,16.56364,433208
10855,mastermind3800,1,0.00023,71756,16.56387,433208
10856,masters3d,1,0.00023,71757,16.56410,433208
10857,mastertheknife,1,0.00023,71758,16.56433,433208
10858,Mataresa,1,0.00023,71759,16.56456,433208
10859,MatasMark,1,0.00023,71760,16.56479,433208
10860,MatejLach,1,0.00023,71761,16.56502,433208
10861,mathewprokos,1,0.00023,71762,16.56525,433208
10862,mathieux51,1,0.00023,71763,16.56548,433208
10863,math-nao,1,0.00023,71764,16.56571,433208
10864,matias-devoto,1,0.00023,71765,16.56595,433208
10865,mativillagra,1,0.00023,71766,16.56618,433208
10866,matlegit,1,0.00023,71767,16.56641,433208
10867,mattb290,1,0.00023,71768,16.56664,433208
10868,mattgugu,1,0.00023,71769,16.56687,433208
10869,matthewdaltonamount,1,0.00023,71770,16.56710,433208
10870,matthiasa4,1,0.00023,71771,16.56733,433208
10871,matthiasdeblock,1,0.00023,71772,16.56756,433208
10872,matthiasfeurer,1,0.00023,71773,16.56779,433208
10873,MatthiasLohr,1,0.00023,71774,16.56802,433208
10874,matthiaswenz,1,0.00023,71775,16.56825,433208
10875,mattmceuen,1,0.00023,71776,16.56848,433208
10876,mattmodene,1,0.00023,71777,16.56872,433208
10877,mattnathan,1,0.00023,71778,16.56895,433208
10878,MattPOlson,1,0.00023,71779,16.56918,433208
10879,mattrua,1,0.00023,71780,16.56941,433208
10880,mattus,1,0.00023,71781,16.56964,433208
10881,mattwillsher,1,0.00023,71782,16.56987,433208
10882,matty1979,1,0.00023,71783,16.57010,433208
10883,mattyev87,1,0.00023,71784,16.57033,433208
10884,matzegebbe,1,0.00023,71785,16.57056,433208
10885,maxbraun,1,0.00023,71786,16.57079,433208
10886,MaxBrinegar,1,0.00023,71787,16.57102,433208
10887,maximaub,1,0.00023,71788,16.57125,433208
10888,MaximF,1,0.00023,71789,16.57149,433208
10889,MaximumQuiet,1,0.00023,71790,16.57172,433208
10890,maxisme,1,0.00023,71791,16.57195,433208
10891,maxpaj,1,0.00023,71792,16.57218,433208
10892,maxpoirier,1,0.00023,71793,16.57241,433208
10893,maxucheng0,1,0.00023,71794,16.57264,433208
10894,Mayank4git,1,0.00023,71795,16.57287,433208
10895,mayankaryaman10,1,0.00023,71796,16.57310,433208
10896,mayankcpdixit,1,0.00023,71797,16.57333,433208
10897,mayur-rammer,1,0.00023,71798,16.57356,433208
10898,mbanck,1,0.00023,71799,16.57379,433208
10899,mbig,1,0.00023,71800,16.57402,433208
10900,mbornoz,1,0.00023,71801,16.57426,433208
10901,mbrijun,1,0.00023,71802,16.57449,433208
10902,mbuffa,1,0.00023,71803,16.57472,433208
10903,mbukatov,1,0.00023,71804,16.57495,433208
10904,mchan-b,1,0.00023,71805,16.57518,433208
10905,mchomin,1,0.00023,71806,16.57541,433208
10906,mckingho,1,0.00023,71807,16.57564,433208
10907,mdanielolsson,1,0.00023,71808,16.57587,433208
10908,mdevasar,1,0.00023,71809,16.57610,433208
10909,mdinc-ishangupta,1,0.00023,71810,16.57633,433208
10910,mdraijer,1,0.00023,71811,16.57656,433208
10911,md-waldron,1,0.00023,71812,16.57679,433208
10912,mdykes-gw,1,0.00023,71813,16.57703,433208
10913,meadlai,1,0.00023,71814,16.57726,433208
10914,meanwhy,1,0.00023,71815,16.57749,433208
10915,mediocrematt,1,0.00023,71816,16.57772,433208
10916,medoror,1,0.00023,71817,16.57795,433208
10917,Meemaw,1,0.00023,71818,16.57818,433208
10918,meerkampdvv,1,0.00023,71819,16.57841,433208
10919,meetpatel125,1,0.00023,71820,16.57864,433208
10920,MeetVaishnav,1,0.00023,71821,16.57887,433208
10921,meezaan,1,0.00023,71822,16.57910,433208
10922,Meg4Bit,1,0.00023,71823,16.57933,433208
10923,megastallman,1,0.00023,71824,16.57956,433208
10924,MehranJanfeshan,1,0.00023,71825,16.57980,433208
10925,mehrdadn,1,0.00023,71826,16.58003,433208
10926,mei-ling,1,0.00023,71827,16.58026,433208
10927,MeirSolvo,1,0.00023,71828,16.58049,433208
10928,melifaro,1,0.00023,71829,16.58072,433208
10929,melotusme,1,0.00023,71830,16.58095,433208
10930,meltsufin,1,0.00023,71831,16.58118,433208
10931,memboc,1,0.00023,71832,16.58141,433208
10932,memonfaheem,1,0.00023,71833,16.58164,433208
10933,menghao11,1,0.00023,71834,16.58187,433208
10934,menishmueli,1,0.00023,71835,16.58210,433208
10935,Mentat420,1,0.00023,71836,16.58233,433208
10936,Mert84,1,0.00023,71837,16.58257,433208
10937,metalheadaakash,1,0.00023,71838,16.58280,433208
10938,metametadata,1,0.00023,71839,16.58303,433208
10939,metasim,1,0.00023,71840,16.58326,433208
10940,mewa,1,0.00023,71841,16.58349,433208
10941,meztez,1,0.00023,71842,16.58372,433208
10942,mFarghaly,1,0.00023,71843,16.58395,433208
10943,mfcrocker,1,0.00023,71844,16.58418,433208
10944,mfoo,1,0.00023,71845,16.58441,433208
10945,mf-svc-github,1,0.00023,71846,16.58464,433208
10946,mfussenegger,1,0.00023,71847,16.58487,433208
10947,mgcrea,1,0.00023,71848,16.58510,433208
10948,mgerhardy,1,0.00023,71849,16.58534,433208
10949,mgr2178,1,0.00023,71850,16.58557,433208
10950,mgrecar,1,0.00023,71851,16.58580,433208
10951,mgsnuno,1,0.00023,71852,16.58603,433208
10952,mguthmuller,1,0.00023,71853,16.58626,433208
10953,mgyong,1,0.00023,71854,16.58649,433208
10954,mhaideibm,1,0.00023,71855,16.58672,433208
10955,mhamann,1,0.00023,71856,16.58695,433208
10956,mhd999,1,0.00023,71857,16.58718,433208
10957,MhdAna,1,0.00023,71858,16.58741,433208
10958,mhite,1,0.00023,71859,16.58764,433208
10959,mhurtrel,1,0.00023,71860,16.58787,433208
10960,mia01,1,0.00023,71861,16.58811,433208
10961,MicahRam,1,0.00023,71862,16.58834,433208
10962,michael132,1,0.00023,71863,16.58857,433208
10963,Michaelborsellino,1,0.00023,71864,16.58880,433208
10964,michael-bowen-sc,1,0.00023,71865,16.58903,433208
10965,MichaelCade,1,0.00023,71866,16.58926,433208
10966,michaelfward,1,0.00023,71867,16.58949,433208
10967,michaelhaycroft,1,0.00023,71868,16.58972,433208
10968,michael-tracey,1,0.00023,71869,16.58995,433208
10969,michaelurban,1,0.00023,71870,16.59018,433208
10970,MichalGuzieniuk,1,0.00023,71871,16.59041,433208
10971,michal-kaliszewski-sollers-eu,1,0.00023,71872,16.59064,433208
10972,michalmisiewicz,1,0.00023,71873,16.59088,433208
10973,MichalMonko,1,0.00023,71874,16.59111,433208
10974,michalrabinowitch,1,0.00023,71875,16.59134,433208
10975,micheas,1,0.00023,71876,16.59157,433208
10976,michielswaanen,1,0.00023,71877,16.59180,433208
10977,mick62,1,0.00023,71878,16.59203,433208
10978,mickymiek,1,0.00023,71879,16.59226,433208
10979,micos76,1,0.00023,71880,16.59249,433208
10980,miecio45,1,0.00023,71881,16.59272,433208
10981,Mierpo,1,0.00023,71882,16.59295,433208
10982,mig4,1,0.00023,71883,16.59318,433208
10983,migueloller,1,0.00023,71884,16.59341,433208
10984,mihaialexandrescu,1,0.00023,71885,16.59365,433208
10985,miheer,1,0.00023,71886,16.59388,433208
10986,mihir1472,1,0.00023,71887,16.59411,433208
10987,MIhirMishra,1,0.00023,71888,16.59434,433208
10988,miixell,1,0.00023,71889,16.59457,433208
10989,mikabytes,1,0.00023,71890,16.59480,433208
10990,mikaelmorvan,1,0.00023,71891,16.59503,433208
10991,mikeccuk2005,1,0.00023,71892,16.59526,433208
10992,mikechiang2003,1,0.00023,71893,16.59549,433208
10993,mikefomichev,1,0.00023,71894,16.59572,433208
10994,mikegerber,1,0.00023,71895,16.59595,433208
10995,mikeharrisonlt,1,0.00023,71896,16.59618,433208
10996,mikesigs,1,0.00023,71897,16.59642,433208
10997,mikevel,1,0.00023,71898,16.59665,433208
10998,MikeZappa87,1,0.00023,71899,16.59688,433208
10999,Mikhail2577,1,0.00023,71900,16.59711,433208
11000,Mikhail-msft,1,0.00023,71901,16.59734,433208
11001,mikhail-putilov,1,0.00023,71902,16.59757,433208
11002,MikkCZ,1,0.00023,71903,16.59780,433208
11003,mikosa,1,0.00023,71904,16.59803,433208
11004,MikuGhoul,1,0.00023,71905,16.59826,433208
11005,mikys-next-insurance,1,0.00023,71906,16.59849,433208
11006,milanchavda,1,0.00023,71907,16.59872,433208
11007,milasuperstar,1,0.00023,71908,16.59895,433208
11008,milieu,1,0.00023,71909,16.59919,433208
11009,milunko,1,0.00023,71910,16.59942,433208
11010,ming535,1,0.00023,71911,16.59965,433208
11011,MingjieAmadeus,1,0.00023,71912,16.59988,433208
11012,mingliangguo,1,0.00023,71913,16.60011,433208
11013,ming-relax,1,0.00023,71914,16.60034,433208
11014,mingwei-li,1,0.00023,71915,16.60057,433208
11015,minhhieugma,1,0.00023,71916,16.60080,433208
11016,minhnguyenvan95,1,0.00023,71917,16.60103,433208
11017,minhvo3,1,0.00023,71918,16.60126,433208
11018,minioin,1,0.00023,71919,16.60149,433208
11019,minSW,1,0.00023,71920,16.60172,433208
11020,minwoox,1,0.00023,71921,16.60196,433208
11021,minyblossom,1,0.00023,71922,16.60219,433208
11022,MiracleJy,1,0.00023,71923,16.60242,433208
11023,mirage111,1,0.00023,71924,16.60265,433208
11024,mirceaaaa,1,0.00023,71925,16.60288,433208
11025,mirogta,1,0.00023,71926,16.60311,433208
11026,misakwa,1,0.00023,71927,16.60334,433208
11027,mischapedia,1,0.00023,71928,16.60357,433208
11028,MischaWeerwag,1,0.00023,71929,16.60380,433208
11029,mischenkovn,1,0.00023,71930,16.60403,433208
11030,misha-fm,1,0.00023,71931,16.60426,433208
11031,mishindm,1,0.00023,71932,16.60449,433208
11032,mishraomp,1,0.00023,71933,16.60473,433208
11033,misi,1,0.00023,71934,16.60496,433208
11034,Mistic92,1,0.00023,71935,16.60519,433208
11035,MitaiGit,1,0.00023,71936,16.60542,433208
11036,Mitdd9707,1,0.00023,71937,16.60565,433208
11037,Mitrofanov,1,0.00023,71938,16.60588,433208
11038,mitsumaui,1,0.00023,71939,16.60611,433208
11039,mizunos,1,0.00023,71940,16.60634,433208
11040,mjacobs,1,0.00023,71941,16.60657,433208
11041,mjduijn,1,0.00023,71942,16.60680,433208
11042,mjgallag,1,0.00023,71943,16.60703,433208
11043,mjkowalski,1,0.00023,71944,16.60726,433208
11044,mjrepo2,1,0.00023,71945,16.60750,433208
11045,mjsabby,1,0.00023,71946,16.60773,433208
11046,mkeerthy,1,0.00023,71947,16.60796,433208
11047,mkenguva,1,0.00023,71948,16.60819,433208
11048,mkjmkumar,1,0.00023,71949,16.60842,433208
11049,mkostersitz,1,0.00023,71950,16.60865,433208
11050,mltsy,1,0.00023,71951,16.60888,433208
11051,mm304321141,1,0.00023,71952,16.60911,433208
11052,mmazek,1,0.00023,71953,16.60934,433208
11053,mmcaya,1,0.00023,71954,16.60957,433208
11054,mmccord-mdbuyline,1,0.00023,71955,16.60980,433208
11055,mmerickel,1,0.00023,71956,16.61003,433208
11056,mm-fee,1,0.00023,71957,16.61027,433208
11057,mmgari,1,0.00023,71958,16.61050,433208
11058,mmiller1,1,0.00023,71959,16.61073,433208
11059,mmontes11,1,0.00023,71960,16.61096,433208
11060,MMWPF,1,0.00023,71961,16.61119,433208
11061,mnasruul,1,0.00023,71962,16.61142,433208
11062,mnencia,1,0.00023,71963,16.61165,433208
11063,mnshrr,1,0.00023,71964,16.61188,433208
11064,Moadfinn,1,0.00023,71965,16.61211,433208
11065,MoBlockbuster,1,0.00023,71966,16.61234,433208
11066,Modnxs,1,0.00023,71967,16.61257,433208
11067,moewill,1,0.00023,71968,16.61280,433208
11068,mohamedelhabib,1,0.00023,71969,16.61304,433208
11069,MohammadrezaMasoumi,1,0.00023,71970,16.61327,433208
11070,mohsenmottaghi,1,0.00023,71971,16.61350,433208
11071,mohsenpashna,1,0.00023,71972,16.61373,433208
11072,moises-perez-tfs,1,0.00023,71973,16.61396,433208
11073,Mokon,1,0.00023,71974,16.61419,433208
11074,momalik11,1,0.00023,71975,16.61442,433208
11075,momkeller,1,0.00023,71976,16.61465,433208
11076,momonala,1,0.00023,71977,16.61488,433208
11077,Monkman08,1,0.00023,71978,16.61511,433208
11078,Monstrofil,1,0.00023,71979,16.61534,433208
11079,montanaflynn,1,0.00023,71980,16.61557,433208
11080,montenegrodr,1,0.00023,71981,16.61581,433208
11081,mor300,1,0.00023,71982,16.61604,433208
11082,moret,1,0.00023,71983,16.61627,433208
11083,morfj,1,0.00023,71984,16.61650,433208
11084,morganwalker,1,0.00023,71985,16.61673,433208
11085,Morride,1,0.00023,71986,16.61696,433208
11086,mortensorensen,1,0.00023,71987,16.61719,433208
11087,mosee9,1,0.00023,71988,16.61742,433208
11088,mosfet1kg,1,0.00023,71989,16.61765,433208
11089,moskit,1,0.00023,71990,16.61788,433208
11090,MostafaAmer-2,1,0.00023,71991,16.61811,433208
11091,mostlyAtNight,1,0.00023,71992,16.61834,433208
11092,mot256,1,0.00023,71993,16.61858,433208
11093,motionsuggests,1,0.00023,71994,16.61881,433208
11094,motmot80,1,0.00023,71995,16.61904,433208
11095,mouliveera,1,0.00023,71996,16.61927,433208
11096,Moumouls,1,0.00023,71997,16.61950,433208
11097,MountainAndSea,1,0.00023,71998,16.61973,433208
11098,mouradmourafiq,1,0.00023,71999,16.61996,433208
11099,MouseRider,1,0.00023,72000,16.62019,433208
11100,mouyang,1,0.00023,72001,16.62042,433208
11101,movergan,1,0.00023,72002,16.62065,433208
11102,mozts2005,1,0.00023,72003,16.62088,433208
11103,mpbarrett,1,0.00023,72004,16.62112,433208
11104,mpechner,1,0.00023,72005,16.62135,433208
11105,mpepping,1,0.00023,72006,16.62158,433208
11106,MPickfield,1,0.00023,72007,16.62181,433208
11107,mpmprock3,1,0.00023,72008,16.62204,433208
11108,mprigge,1,0.00023,72009,16.62227,433208
11109,mpx,1,0.00023,72010,16.62250,433208
11110,mradmila,1,0.00023,72011,16.62273,433208
11111,mrafieee,1,0.00023,72012,16.62296,433208
11112,mraliagha,1,0.00023,72013,16.62319,433208
11113,MrDienns,1,0.00023,72014,16.62342,433208
11114,mreferre,1,0.00023,72015,16.62365,433208
11115,mreider,1,0.00023,72016,16.62389,433208
11116,mrghasemi1992,1,0.00023,72017,16.62412,433208
11117,mrgoonie,1,0.00023,72018,16.62435,433208
11118,mrlioncub,1,0.00023,72019,16.62458,433208
11119,mrmeku,1,0.00023,72020,16.62481,433208
11120,mrmrcoleman,1,0.00023,72021,16.62504,433208
11121,mrobinson513,1,0.00023,72022,16.62527,433208
11122,mrsimo,1,0.00023,72023,16.62550,433208
11123,MrYuanZhen,1,0.00023,72024,16.62573,433208
11124,msaavedra91,1,0.00023,72025,16.62596,433208
11125,msaurabhee,1,0.00023,72026,16.62619,433208
11126,mschweiker,1,0.00023,72027,16.62642,433208
11127,msgongora,1,0.00023,72028,16.62666,433208
11128,M-Sherif,1,0.00023,72029,16.62689,433208
11129,mslady021,1,0.00023,72030,16.62712,433208
11130,msldn,1,0.00023,72031,16.62735,433208
11131,msmagnanijr,1,0.00023,72032,16.62758,433208
11132,msm-code,1,0.00023,72033,16.62781,433208
11133,msoisalo,1,0.00023,72034,16.62804,433208
11134,msonnabaum,1,0.00023,72035,16.62827,433208
11135,mssachan,1,0.00023,72036,16.62850,433208
11136,mstachniuk,1,0.00023,72037,16.62873,433208
11137,mstumpfx,1,0.00023,72038,16.62896,433208
11138,mszygenda,1,0.00023,72039,16.62919,433208
11139,mtalalkhan,1,0.00023,72040,16.62943,433208
11140,mtardy,1,0.00023,72041,16.62966,433208
11141,mteodori,1,0.00023,72042,16.62989,433208
11142,mthird,1,0.00023,72043,16.63012,433208
11143,mtitolo,1,0.00023,72044,16.63035,433208
11144,muansari7275,1,0.00023,72045,16.63058,433208
11145,muhanadali100,1,0.00023,72046,16.63081,433208
11146,mukul-c2fo,1,0.00023,72047,16.63104,433208
11147,mullgundmath,1,0.00023,72048,16.63127,433208
11148,Multiply,1,0.00023,72049,16.63150,433208
11149,mumrau,1,0.00023,72050,16.63173,433208
11150,mumutu66,1,0.00023,72051,16.63196,433208
11151,muralikri32,1,0.00023,72052,16.63220,433208
11152,murrays,1,0.00023,72053,16.63243,433208
11153,muvster,1,0.00023,72054,16.63266,433208
11154,muxuelan,1,0.00023,72055,16.63289,433208
11155,muzcategui1106-gs,1,0.00023,72056,16.63312,433208
11156,mvailati84,1,0.00023,72057,16.63335,433208
11157,mvalliath,1,0.00023,72058,16.63358,433208
11158,mvandewouw,1,0.00023,72059,16.63381,433208
11159,mvineza,1,0.00023,72060,16.63404,433208
11160,mwasowski,1,0.00023,72061,16.63427,433208
11161,mwebber,1,0.00023,72062,16.63450,433208
11162,MXClyde,1,0.00023,72063,16.63473,433208
11163,mxkmp,1,0.00023,72064,16.63497,433208
11164,mxmorin,1,0.00023,72065,16.63520,433208
11165,mxs162630,1,0.00023,72066,16.63543,433208
11166,mydockergit,1,0.00023,72067,16.63566,433208
11167,MyIgel,1,0.00023,72068,16.63589,433208
11168,mykhailoguk,1,0.00023,72069,16.63612,433208
11169,mymtak,1,0.00023,72070,16.63635,433208
11170,mynameisneo7,1,0.00023,72071,16.63658,433208
11171,Myrecord,1,0.00023,72072,16.63681,433208
11172,Mythyo1,1,0.00023,72073,16.63704,433208
11173,mytu,1,0.00023,72074,16.63727,433208
11174,mywkaa,1,0.00023,72075,16.63750,433208
11175,myxland,1,0.00023,72076,16.63774,433208
11176,n0izn0iz,1,0.00023,72077,16.63797,433208
11177,n2aws,1,0.00023,72078,16.63820,433208
11178,n3m8tz,1,0.00023,72079,16.63843,433208
11179,nadar,1,0.00023,72080,16.63866,433208
11180,nadilas,1,0.00023,72081,16.63889,433208
11181,nadworny,1,0.00023,72082,16.63912,433208
11182,naemono,1,0.00023,72083,16.63935,433208
11183,nagaraj200788,1,0.00023,72084,16.63958,433208
11184,naikajah,1,0.00023,72085,16.63981,433208
11185,nakkurt,1,0.00023,72086,16.64004,433208
11186,namaiiee2222,1,0.00023,72087,16.64027,433208
11187,namm2,1,0.00023,72088,16.64051,433208
11188,namneesh16k,1,0.00023,72089,16.64074,433208
11189,nan008,1,0.00023,72090,16.64097,433208
11190,nan-avan-alla,1,0.00023,72091,16.64120,433208
11191,nandhukishor,1,0.00023,72092,16.64143,433208
11192,NanduNiran,1,0.00023,72093,16.64166,433208
11193,nanil4568,1,0.00023,72094,16.64189,433208
11194,nanorobocop,1,0.00023,72095,16.64212,433208
11195,narayanan,1,0.00023,72096,16.64235,433208
11196,nareshadoni1,1,0.00023,72097,16.64258,433208
11197,narmadha956,1,0.00023,72098,16.64281,433208
11198,narthollis,1,0.00023,72099,16.64304,433208
11199,naruepanart,1,0.00023,72100,16.64328,433208
11200,nashant,1,0.00023,72101,16.64351,433208
11201,nasirkamal,1,0.00023,72102,16.64374,433208
11202,nassercarlos19,1,0.00023,72103,16.64397,433208
11203,naszley93,1,0.00023,72104,16.64420,433208
11204,Natanande,1,0.00023,72105,16.64443,433208
11205,NatarajanR,1,0.00023,72106,16.64466,433208
11206,nathan-c,1,0.00023,72107,16.64489,433208
11207,naveenb30,1,0.00023,72108,16.64512,433208
11208,naviat,1,0.00023,72109,16.64535,433208
11209,navndn,1,0.00023,72110,16.64558,433208
11210,nayan-kalita,1,0.00023,72111,16.64581,433208
11211,nayrnet,1,0.00023,72112,16.64605,433208
11212,nbigaouette,1,0.00023,72113,16.64628,433208
11213,nblumhardt,1,0.00023,72114,16.64651,433208
11214,nbublikov,1,0.00023,72115,16.64674,433208
11215,ncarenton,1,0.00023,72116,16.64697,433208
11216,ncoonrod,1,0.00023,72117,16.64720,433208
11217,nd4pa,1,0.00023,72118,16.64743,433208
11218,nealrichardson,1,0.00023,72119,16.64766,433208
11219,ned1313,1,0.00023,72120,16.64789,433208
11220,nedhanks,1,0.00023,72121,16.64812,433208
11221,neerajgrg,1,0.00023,72122,16.64835,433208
11222,neha1196,1,0.00023,72123,16.64858,433208
11223,nehaev,1,0.00023,72124,16.64882,433208
11224,NehaSachan,1,0.00023,72125,16.64905,433208
11225,neighbour-oldhuang,1,0.00023,72126,16.64928,433208
11226,neild,1,0.00023,72127,16.64951,433208
11227,NeilFataway,1,0.00023,72128,16.64974,433208
11228,neilharris123,1,0.00023,72129,16.64997,433208
11229,neilwashere,1,0.00023,72130,16.65020,433208
11230,nela,1,0.00023,72131,16.65043,433208
11231,nemanja28,1,0.00023,72132,16.65066,433208
11232,neo42man,1,0.00023,72133,16.65089,433208
11233,neomadara,1,0.00023,72134,16.65112,433208
11234,Neonox31,1,0.00023,72135,16.65135,433208
11235,neoseele,1,0.00023,72136,16.65159,433208
11236,netflash,1,0.00023,72137,16.65182,433208
11237,NetGH,1,0.00023,72138,16.65205,433208
11238,Nethminiromina,1,0.00023,72139,16.65228,433208
11239,netkiller,1,0.00023,72140,16.65251,433208
11240,netsnipe,1,0.00023,72141,16.65274,433208
11241,neuliuyin-new,1,0.00023,72142,16.65297,433208
11242,neuqlz,1,0.00023,72143,16.65320,433208
11243,Neurozone,1,0.00023,72144,16.65343,433208
11244,neverexists,1,0.00023,72145,16.65366,433208
11245,nevonb,1,0.00023,72146,16.65389,433208
11246,newbieDatascientist,1,0.00023,72147,16.65412,433208
11247,newctech,1,0.00023,72148,16.65436,433208
11248,newtoncorp,1,0.00023,72149,16.65459,433208
11249,nexter2606,1,0.00023,72150,16.65482,433208
11250,nextsux,1,0.00023,72151,16.65505,433208
11251,Neylion,1,0.00023,72152,16.65528,433208
11252,nezha2017,1,0.00023,72153,16.65551,433208
11253,nfillot,1,0.00023,72154,16.65574,433208
11254,ng29,1,0.00023,72155,16.65597,433208
11255,ngadre-juniper,1,0.00023,72156,16.65620,433208
11256,ngmariusz,1,0.00023,72157,16.65643,433208
11257,ngv-nexo,1,0.00023,72158,16.65666,433208
11258,nic-hima,1,0.00023,72159,16.65689,433208
11259,nickamuchwatt,1,0.00023,72160,16.65713,433208
11260,NickEAVE,1,0.00023,72161,16.65736,433208
11261,nick-ivanov-ibm,1,0.00023,72162,16.65759,433208
11262,nicklan,1,0.00023,72163,16.65782,433208
11263,NickMetz,1,0.00023,72164,16.65805,433208
11264,NicksonYap,1,0.00023,72165,16.65828,433208
11265,nico0olas,1,0.00023,72166,16.65851,433208
11266,nicoschuck,1,0.00023,72167,16.65874,433208
11267,nieldw,1,0.00023,72168,16.65897,433208
11268,nielstenboom,1,0.00023,72169,16.65920,433208
11269,nightmareze1,1,0.00023,72170,16.65943,433208
11270,nightvisi0n,1,0.00023,72171,16.65966,433208
11271,nik13,1,0.00023,72172,16.65990,433208
11272,nikhilagrawal577,1,0.00023,72173,16.66013,433208
11273,nikhilkr1402,1,0.00023,72174,16.66036,433208
11274,nikita812,1,0.00023,72175,16.66059,433208
11275,nikitaarora2995,1,0.00023,72176,16.66082,433208
11276,nikkelma,1,0.00023,72177,16.66105,433208
11277,nikkirs,1,0.00023,72178,16.66128,433208
11278,niklasR,1,0.00023,72179,16.66151,433208
11279,niklev,1,0.00023,72180,16.66174,433208
11280,nikmd23,1,0.00023,72181,16.66197,433208
11281,nikolay-te,1,0.00023,72182,16.66220,433208
11282,Nikosmonaut,1,0.00023,72183,16.66243,433208
11283,NILESH2323,1,0.00023,72184,16.66267,433208
11284,nileshbhadana,1,0.00023,72185,16.66290,433208
11285,nilic,1,0.00023,72186,16.66313,433208
11286,nilsonsfj,1,0.00023,72187,16.66336,433208
11287,nimmichele,1,0.00023,72188,16.66359,433208
11288,nimrodf1,1,0.00023,72189,16.66382,433208
11289,Nirali0029,1,0.00023,72190,16.66405,433208
11290,niranjanreddy48,1,0.00023,72191,16.66428,433208
11291,NIRLESH,1,0.00023,72192,16.66451,433208
11292,nirmannarang,1,0.00023,72193,16.66474,433208
11293,nirrozenbaum,1,0.00023,72194,16.66497,433208
11294,Nischal2020,1,0.00023,72195,16.66520,433208
11295,nisp94,1,0.00023,72196,16.66544,433208
11296,nistiwar,1,0.00023,72197,16.66567,433208
11297,NitHas89,1,0.00023,72198,16.66590,433208
11298,nithinkd-geon,1,0.00023,72199,16.66613,433208
11299,nithinmohan114,1,0.00023,72200,16.66636,433208
11300,Nithisha-BR,1,0.00023,72201,16.66659,433208
11301,Nitive,1,0.00023,72202,16.66682,433208
11302,nitpum,1,0.00023,72203,16.66705,433208
11303,nitram509,1,0.00023,72204,16.66728,433208
11304,NitroAMD,1,0.00023,72205,16.66751,433208
11305,niuqg,1,0.00023,72206,16.66774,433208
11306,Nivedita967,1,0.00023,72207,16.66797,433208
11307,NiveditaKumari14,1,0.00023,72208,16.66821,433208
11308,njam,1,0.00023,72209,16.66844,433208
11309,nkguoym,1,0.00023,72210,16.66867,433208
11310,NKGupta07,1,0.00023,72211,16.66890,433208
11311,nmarus,1,0.00023,72212,16.66913,433208
11312,nmiodice,1,0.00023,72213,16.66936,433208
11313,Nnadozie,1,0.00023,72214,16.66959,433208
11314,nnao45,1,0.00023,72215,16.66982,433208
11315,nnthuanegany,1,0.00023,72216,16.67005,433208
11316,noahi,1,0.00023,72217,16.67028,433208
11317,noamichael,1,0.00023,72218,16.67051,433208
11318,nobu,1,0.00023,72219,16.67074,433208
11319,noelo,1,0.00023,72220,16.67098,433208
11320,nohitme,1,0.00023,72221,16.67121,433208
11321,nomadcz,1,0.00023,72222,16.67144,433208
11322,nonbob,1,0.00023,72223,16.67167,433208
11323,notanton,1,0.00023,72224,16.67190,433208
11324,notevery,1,0.00023,72225,16.67213,433208
11325,nothingofuse,1,0.00023,72226,16.67236,433208
11326,notras,1,0.00023,72227,16.67259,433208
11327,nous23,1,0.00023,72228,16.67282,433208
11328,NovaHe,1,0.00023,72229,16.67305,433208
11329,Noveen,1,0.00023,72230,16.67328,433208
11330,novegit,1,0.00023,72231,16.67351,433208
11331,Novex,1,0.00023,72232,16.67375,433208
11332,novocodev,1,0.00023,72233,16.67398,433208
11333,novonilc,1,0.00023,72234,16.67421,433208
11334,noygal,1,0.00023,72235,16.67444,433208
11335,NoyMiranFyber,1,0.00023,72236,16.67467,433208
11336,npajkovsky,1,0.00023,72237,16.67490,433208
11337,nprabhu2195,1,0.00023,72238,16.67513,433208
11338,nronas,1,0.00023,72239,16.67536,433208
11339,nsainaney,1,0.00023,72240,16.67559,433208
11340,ntavares,1,0.00023,72241,16.67582,433208
11341,ntdef,1,0.00023,72242,16.67605,433208
11342,ntippabhatla,1,0.00023,72243,16.67628,433208
11343,ntx-ben,1,0.00023,72244,16.67652,433208
11344,nullcore1024,1,0.00023,72245,16.67675,433208
11345,NULLx76,1,0.00023,72246,16.67698,433208
11346,Num2,1,0.00023,72247,16.67721,433208
11347,Numblesix,1,0.00023,72248,16.67744,433208
11348,nupplaphil,1,0.00023,72249,16.67767,433208
11349,nurhun,1,0.00023,72250,16.67790,433208
11350,nuved,1,0.00023,72251,16.67813,433208
11351,nvx,1,0.00023,72252,16.67836,433208
11352,nxtof,1,0.00023,72253,16.67859,433208
11353,n-zeed,1,0.00023,72254,16.67882,433208
11354,nzjustin,1,0.00023,72255,16.67905,433208
11355,nzncngz,1,0.00023,72256,16.67929,433208
11356,nzupan,1,0.00023,72257,16.67952,433208
11357,oabunk,1,0.00023,72258,16.67975,433208
11358,oaicstef,1,0.00023,72259,16.67998,433208
11359,oasisvali,1,0.00023,72260,16.68021,433208
11360,ob,1,0.00023,72261,16.68044,433208
11361,obaranov,1,0.00023,72262,16.68067,433208
11362,obedtandadjaja,1,0.00023,72263,16.68090,433208
11363,Obi-Dann,1,0.00023,72264,16.68113,433208
11364,ObidiIsaac,1,0.00023,72265,16.68136,433208
11365,oblogic7,1,0.00023,72266,16.68159,433208
11366,obrienrobert,1,0.00023,72267,16.68182,433208
11367,occupytheweb,1,0.00023,72268,16.68206,433208
11368,oceandengabc,1,0.00023,72269,16.68229,433208
11369,oceanmist-github,1,0.00023,72270,16.68252,433208
11370,ocervinka,1,0.00023,72271,16.68275,433208
11371,Octogonapus,1,0.00023,72272,16.68298,433208
11372,octplane,1,0.00023,72273,16.68321,433208
11373,odeng888,1,0.00023,72274,16.68344,433208
11374,odin-delrio,1,0.00023,72275,16.68367,433208
11375,odinsy,1,0.00023,72276,16.68390,433208
11376,oester,1,0.00023,72277,16.68413,433208
11377,ofen,1,0.00023,72278,16.68436,433208
11378,ofw,1,0.00023,72279,16.68459,433208
11379,oganga,1,0.00023,72280,16.68483,433208
11380,ogerasymenko,1,0.00023,72281,16.68506,433208
11381,ognots,1,0.00023,72282,16.68529,433208
11382,ogolberg,1,0.00023,72283,16.68552,433208
11383,oguzhanaygn,1,0.00023,72284,16.68575,433208
11384,ohmanandam,1,0.00023,72285,16.68598,433208
11385,OkBeacon,1,0.00023,72286,16.68621,433208
11386,okdas,1,0.00023,72287,16.68644,433208
11387,okravets,1,0.00023,72288,16.68667,433208
11388,olearycrew,1,0.00023,72289,16.68690,433208
11389,olegburov,1,0.00023,72290,16.68713,433208
11390,oleg-filiutsich,1,0.00023,72291,16.68736,433208
11391,oleggalimov,1,0.00023,72292,16.68760,433208
11392,olegsa,1,0.00023,72293,16.68783,433208
11393,OleksandrMykytenko,1,0.00023,72294,16.68806,433208
11394,olfway,1,0.00023,72295,16.68829,433208
11395,olib963,1,0.00023,72296,16.68852,433208
11396,oliveratutexas,1,0.00023,72297,16.68875,433208
11397,olivercodes,1,0.00023,72298,16.68898,433208
11398,OlleLarsson,1,0.00023,72299,16.68921,433208
11399,olomakovskyi-blackbird,1,0.00023,72300,16.68944,433208
11400,Omar-V2,1,0.00023,72301,16.68967,433208
11401,ommehaz,1,0.00023,72302,16.68990,433208
11402,omninonsense,1,0.00023,72303,16.69013,433208
11403,omron93,1,0.00023,72304,16.69037,433208
11404,ondravondra,1,0.00023,72305,16.69060,433208
11405,one1zero1one,1,0.00023,72306,16.69083,433208
11406,OneCodeMonkey,1,0.00023,72307,16.69106,433208
11407,One-ders,1,0.00023,72308,16.69129,433208
11408,onichandame,1,0.00023,72309,16.69152,433208
11409,onrylmz,1,0.00023,72310,16.69175,433208
11410,oocx,1,0.00023,72311,16.69198,433208
11411,oofnikj,1,0.00023,72312,16.69221,433208
11412,ooichman,1,0.00023,72313,16.69244,433208
11413,ooneko,1,0.00023,72314,16.69267,433208
11414,open-richard,1,0.00023,72315,16.69291,433208
11415,opswfit,1,0.00023,72316,16.69314,433208
11416,orecht,1,0.00023,72317,16.69337,433208
11417,Orion7r,1,0.00023,72318,16.69360,433208
11418,oronboni,1,0.00023,72319,16.69383,433208
11419,orondon,1,0.00023,72320,16.69406,433208
11420,oronge,1,0.00023,72321,16.69429,433208
11421,orsher,1,0.00023,72322,16.69452,433208
11422,OryanOmer,1,0.00023,72323,16.69475,433208
11423,ossdev07,1,0.00023,72324,16.69498,433208
11424,ostackbrian,1,0.00023,72325,16.69521,433208
11425,ostera,1,0.00023,72326,16.69544,433208
11426,os-virtualretail,1,0.00023,72327,16.69568,433208
11427,othillo,1,0.00023,72328,16.69591,433208
11428,ottomata,1,0.00023,72329,16.69614,433208
11429,ouaouat,1,0.00023,72330,16.69637,433208
11430,ouchengle,1,0.00023,72331,16.69660,433208
11431,ovk,1,0.00023,72332,16.69683,433208
11432,oweise,1,0.00023,72333,16.69706,433208
11433,owenchak,1,0.00023,72334,16.69729,433208
11434,OxFFFFFFFF,1,0.00023,72335,16.69752,433208
11435,oxr463,1,0.00023,72336,16.69775,433208
11436,oyakhilomee,1,0.00023,72337,16.69798,433208
11437,oyevtushok,1,0.00023,72338,16.69821,433208
11438,ozhankaraman,1,0.00023,72339,16.69845,433208
11439,ozloozlo,1,0.00023,72340,16.69868,433208
11440,Oznup,1,0.00023,72341,16.69891,433208
11441,paavan98pm,1,0.00023,72342,16.69914,433208
11442,paawan01,1,0.00023,72343,16.69937,433208
11443,PacoDu,1,0.00023,72344,16.69960,433208
11444,pacu,1,0.00023,72345,16.69983,433208
11445,paddy-hack,1,0.00023,72346,16.70006,433208
11446,PA-Devol,1,0.00023,72347,16.70029,433208
11447,padmakumar05,1,0.00023,72348,16.70052,433208
11448,pahjbo,1,0.00023,72349,16.70075,433208
11449,pai911,1,0.00023,72350,16.70098,433208
11450,painhardcore,1,0.00023,72351,16.70122,433208
11451,pajowu,1,0.00023,72352,16.70145,433208
11452,pak11273,1,0.00023,72353,16.70168,433208
11453,palash9561,1,0.00023,72354,16.70191,433208
11454,pal-dinesh23,1,0.00023,72355,16.70214,433208
11455,p-alexisv,1,0.00023,72356,16.70237,433208
11456,palma21,1,0.00023,72357,16.70260,433208
11457,pamido,1,0.00023,72358,16.70283,433208
11458,pandeysujan-44,1,0.00023,72359,16.70306,433208
11459,pando85,1,0.00023,72360,16.70329,433208
11460,panfiva,1,0.00023,72361,16.70352,433208
11461,panhaitao,1,0.00023,72362,16.70375,433208
11462,panicbit,1,0.00023,72363,16.70399,433208
11463,pankaj1278,1,0.00023,72364,16.70422,433208
11464,Panoptik,1,0.00023,72365,16.70445,433208
11465,panva,1,0.00023,72366,16.70468,433208
11466,panzhc,1,0.00023,72367,16.70491,433208
11467,paolofacchinetti,1,0.00023,72368,16.70514,433208
11468,papi83dm,1,0.00023,72369,16.70537,433208
11469,papioyue,1,0.00023,72370,16.70560,433208
11470,pappasam,1,0.00023,72371,16.70583,433208
11471,Parad0X,1,0.00023,72372,16.70606,433208
11472,parekhha,1,0.00023,72373,16.70629,433208
11473,parente,1,0.00023,72374,16.70652,433208
11474,Parikshit-Hooda,1,0.00023,72375,16.70676,433208
11475,parkaralice,1,0.00023,72376,16.70699,433208
11476,parkerjm,1,0.00023,72377,16.70722,433208
11477,parsley42,1,0.00023,72378,16.70745,433208
11478,parthibd,1,0.00023,72379,16.70768,433208
11479,ParthSareen,1,0.00023,72380,16.70791,433208
11480,pascal-hofmann,1,0.00023,72381,16.70814,433208
11481,pashagolub,1,0.00023,72382,16.70837,433208
11482,pasimoes,1,0.00023,72383,16.70860,433208
11483,pat70,1,0.00023,72384,16.70883,433208
11484,PatelRudra,1,0.00023,72385,16.70906,433208
11485,pathania29,1,0.00023,72386,16.70929,433208
11486,patrick91,1,0.00023,72387,16.70953,433208
11487,PatrickGG,1,0.00023,72388,16.70976,433208
11488,Patrick-Remy,1,0.00023,72389,16.70999,433208
11489,patrijua,1,0.00023,72390,16.71022,433208
11490,PatrikSteuer,1,0.00023,72391,16.71045,433208
11491,patrungel,1,0.00023,72392,16.71068,433208
11492,paulcosma,1,0.00023,72393,16.71091,433208
11493,paulden,1,0.00023,72394,16.71114,433208
11494,paulfermoreyes,1,0.00023,72395,16.71137,433208
11495,paulmiller3000,1,0.00023,72396,16.71160,433208
11496,paulmwatson,1,0.00023,72397,16.71183,433208
11497,PauloFavero,1,0.00023,72398,16.71206,433208
11498,paulraines68,1,0.00023,72399,16.71230,433208
11499,paulrostorp,1,0.00023,72400,16.71253,433208
11500,paulrouget,1,0.00023,72401,16.71276,433208
11501,paulwfield,1,0.00023,72402,16.71299,433208
11502,pavelgordon,1,0.00023,72403,16.71322,433208
11503,pavel-z1,1,0.00023,72404,16.71345,433208
11504,PavloZabudskyi,1,0.00023,72405,16.71368,433208
11505,pawelan,1,0.00023,72406,16.71391,433208
11506,paxosX,1,0.00023,72407,16.71414,433208
11507,pbebbo,1,0.00023,72408,16.71437,433208
11508,pbetkier,1,0.00023,72409,16.71460,433208
11509,pbhatnagar3248,1,0.00023,72410,16.71483,433208
11510,pceuropa,1,0.00023,72411,16.71507,433208
11511,pchico83,1,0.00023,72412,16.71530,433208
11512,pc-kdholakia,1,0.00023,72413,16.71553,433208
11513,pc-rshetty,1,0.00023,72414,16.71576,433208
11514,pdecks,1,0.00023,72415,16.71599,433208
11515,pdhung,1,0.00023,72416,16.71622,433208
11516,PeakDing,1,0.00023,72417,16.71645,433208
11517,peddicnu,1,0.00023,72418,16.71668,433208
11518,pedrodotmc,1,0.00023,72419,16.71691,433208
11519,pedrohmuniz,1,0.00023,72420,16.71714,433208
11520,PeiyuanQi,1,0.00023,72421,16.71737,433208
11521,penglongli,1,0.00023,72422,16.71760,433208
11522,pengpj,1,0.00023,72423,16.71784,433208
11523,pentolone,1,0.00023,72424,16.71807,433208
11524,perbie,1,0.00023,72425,16.71830,433208
11525,perfectworks,1,0.00023,72426,16.71853,433208
11526,perk-sumo,1,0.00023,72427,16.71876,433208
11527,perlinger,1,0.00023,72428,16.71899,433208
11528,persunde,1,0.00023,72429,16.71922,433208
11529,pertoft,1,0.00023,72430,16.71945,433208
11530,peterfeifanchen,1,0.00023,72431,16.71968,433208
11531,peterfication,1,0.00023,72432,16.71991,433208
11532,PeterGerrard,1,0.00023,72433,16.72014,433208
11533,PeterIttner,1,0.00023,72434,16.72037,433208
11534,peterldowns,1,0.00023,72435,16.72061,433208
11535,peter-maday,1,0.00023,72436,16.72084,433208
11536,peterpar1984,1,0.00023,72437,16.72107,433208
11537,peter-poki,1,0.00023,72438,16.72130,433208
11538,Peterwangyyy,1,0.00023,72439,16.72153,433208
11539,peteychuk,1,0.00023,72440,16.72176,433208
11540,PetroGromovo,1,0.00023,72441,16.72199,433208
11541,PetruGarstea,1,0.00023,72442,16.72222,433208
11542,petrukngantuk,1,0.00023,72443,16.72245,433208
11543,PF2000,1,0.00023,72444,16.72268,433208
11544,PGDream,1,0.00023,72445,16.72291,433208
11545,pgiles,1,0.00023,72446,16.72314,433208
11546,pgkulk,1,0.00023,72447,16.72338,433208
11547,pguduru,1,0.00023,72448,16.72361,433208
11548,pguinardco,1,0.00023,72449,16.72384,433208
11549,Ph0rse,1,0.00023,72450,16.72407,433208
11550,Phaham,1,0.00023,72451,16.72430,433208
11551,phaus,1,0.00023,72452,16.72453,433208
11552,phchoi,1,0.00023,72453,16.72476,433208
11553,phdesign,1,0.00023,72454,16.72499,433208
11554,phelanma,1,0.00023,72455,16.72522,433208
11555,phidahl,1,0.00023,72456,16.72545,433208
11556,philios33,1,0.00023,72457,16.72568,433208
11557,philippevidal80,1,0.00023,72458,16.72591,433208
11558,philippgille,1,0.00023,72459,16.72615,433208
11559,philipstarkey,1,0.00023,72460,16.72638,433208
11560,phinphing,1,0.00023,72461,16.72661,433208
11561,phmx,1,0.00023,72462,16.72684,433208
11562,phoenixNull,1,0.00023,72463,16.72707,433208
11563,phomein,1,0.00023,72464,16.72730,433208
11564,piano-man,1,0.00023,72465,16.72753,433208
11565,piaoairy219,1,0.00023,72466,16.72776,433208
11566,piaverous,1,0.00023,72467,16.72799,433208
11567,pickfire,1,0.00023,72468,16.72822,433208
11568,Pictor13,1,0.00023,72469,16.72845,433208
11569,piepmatz,1,0.00023,72470,16.72868,433208
11570,pierredadt,1,0.00023,72471,16.72892,433208
11571,pierre-elie,1,0.00023,72472,16.72915,433208
11572,PierrickVoulet,1,0.00023,72473,16.72938,433208
11573,pilou-,1,0.00023,72474,16.72961,433208
11574,pimenvibritania,1,0.00023,72475,16.72984,433208
11575,pinglamb,1,0.00023,72476,16.73007,433208
11576,pingnamo,1,0.00023,72477,16.73030,433208
11577,pingping95,1,0.00023,72478,16.73053,433208
11578,pinkertonpg,1,0.00023,72479,16.73076,433208
11579,pio2pio,1,0.00023,72480,16.73099,433208
11580,piotrmsc,1,0.00023,72481,16.73122,433208
11581,pirDOL,1,0.00023,72482,16.73145,433208
11582,pirteac,1,0.00023,72483,16.73169,433208
11583,piscisaureus,1,0.00023,72484,16.73192,433208
11584,pittar,1,0.00023,72485,16.73215,433208
11585,Piyush27co,1,0.00023,72486,16.73238,433208
11586,PIYUSH6791,1,0.00023,72487,16.73261,433208
11587,pjo256,1,0.00023,72488,16.73284,433208
11588,pjshort22,1,0.00023,72489,16.73307,433208
11589,pjz,1,0.00023,72490,16.73330,433208
11590,PKalhara,1,0.00023,72491,16.73353,433208
11591,pkarrot,1,0.00023,72492,16.73376,433208
11592,pkwarren,1,0.00023,72493,16.73399,433208
11593,Placidina,1,0.00023,72494,16.73422,433208
11594,planetmarshall,1,0.00023,72495,16.73446,433208
11595,plantegg,1,0.00023,72496,16.73469,433208
11596,plantusd,1,0.00023,72497,16.73492,433208
11597,player0130,1,0.00023,72498,16.73515,433208
11598,playniuniu,1,0.00023,72499,16.73538,433208
11599,pliutak-nih,1,0.00023,72500,16.73561,433208
11600,plnordquist,1,0.00023,72501,16.73584,433208
11601,plpan,1,0.00023,72502,16.73607,433208
11602,pmarreck,1,0.00023,72503,16.73630,433208
11603,pmhahn,1,0.00023,72504,16.73653,433208
11604,pnuaxen,1,0.00023,72505,16.73676,433208
11605,poikilotherm,1,0.00023,72506,16.73699,433208
11606,poindexter-1,1,0.00023,72507,16.73723,433208
11607,Pokom,1,0.00023,72508,16.73746,433208
11608,poliander,1,0.00023,72509,16.73769,433208
11609,polinchw,1,0.00023,72510,16.73792,433208
11610,polyaxon-team,1,0.00023,72511,16.73815,433208
11611,pommelinho,1,0.00023,72512,16.73838,433208
11612,PontusTideman,1,0.00023,72513,16.73861,433208
11613,poojabolla,1,0.00023,72514,16.73884,433208
11614,poornachandratejasvi,1,0.00023,72515,16.73907,433208
11615,popomore,1,0.00023,72516,16.73930,433208
11616,pordaniel01,1,0.00023,72517,16.73953,433208
11617,Porges,1,0.00023,72518,16.73976,433208
11618,PorkCharsui79,1,0.00023,72519,16.74000,433208
11619,PovarovDenis,1,0.00023,72520,16.74023,433208
11620,pow-devops2020,1,0.00023,72521,16.74046,433208
11621,ppadevski,1,0.00023,72522,16.74069,433208
11622,ppageo,1,0.00023,72523,16.74092,433208
11623,ppapasani1,1,0.00023,72524,16.74115,433208
11624,ppulse,1,0.00023,72525,16.74138,433208
11625,prabhakhar,1,0.00023,72526,16.74161,433208
11626,Prabhav-Thali,1,0.00023,72527,16.74184,433208
11627,PrabhuJoseph,1,0.00023,72528,16.74207,433208
11628,prabirkumardhar,1,0.00023,72529,16.74230,433208
11629,prabsdubey,1,0.00023,72530,16.74253,433208
11630,PrabuddhaRaj,1,0.00023,72531,16.74277,433208
11631,PrachYothaprasert,1,0.00023,72532,16.74300,433208
11632,pradn,1,0.00023,72533,16.74323,433208
11633,pradvenkat,1,0.00023,72534,16.74346,433208
11634,prajaktachaudhari,1,0.00023,72535,16.74369,433208
11635,PrakashArumugamVmware,1,0.00023,72536,16.74392,433208
11636,prakashkl88,1,0.00023,72537,16.74415,433208
11637,pramodkoshti,1,0.00023,72538,16.74438,433208
11638,pramodsharma62,1,0.00023,72539,16.74461,433208
11639,pranas,1,0.00023,72540,16.74484,433208
11640,praneshshzl,1,0.00023,72541,16.74507,433208
11641,pranshuag1818,1,0.00023,72542,16.74530,433208
11642,prasadambasaveswar,1,0.00023,72543,16.74554,433208
11643,prasant123,1,0.00023,72544,16.74577,433208
11644,prashantcsutar,1,0.00023,72545,16.74600,433208
11645,prashanthc,1,0.00023,72546,16.74623,433208
11646,prashantmait,1,0.00023,72547,16.74646,433208
11647,prashantnitt07,1,0.00023,72548,16.74669,433208
11648,pratibhamoogi,1,0.00023,72549,16.74692,433208
11649,pratikbalar,1,0.00023,72550,16.74715,433208
11650,pratik-sinha,1,0.00023,72551,16.74738,433208
11651,pravb,1,0.00023,72552,16.74761,433208
11652,praveen-mummasani,1,0.00023,72553,16.74784,433208
11653,PravinRanjan10,1,0.00023,72554,16.74807,433208
11654,pravin-singhal,1,0.00023,72555,16.74831,433208
11655,praxist,1,0.00023,72556,16.74854,433208
11656,prbsparx,1,0.00023,72557,16.74877,433208
11657,preetamsahu,1,0.00023,72558,16.74900,433208
11658,PreetSangha,1,0.00023,72559,16.74923,433208
11659,Preisschild,1,0.00023,72560,16.74946,433208
11660,premkritin,1,0.00023,72561,16.74969,433208
11661,preraktiwari,1,0.00023,72562,16.74992,433208
11662,preved911,1,0.00023,72563,16.75015,433208
11663,princeyo123,1,0.00023,72564,16.75038,433208
11664,prios-peter-olivo,1,0.00023,72565,16.75061,433208
11665,Prithvipal,1,0.00023,72566,16.75084,433208
11666,priyanka19-98,1,0.00023,72567,16.75108,433208
11667,priyanshu5474,1,0.00023,72568,16.75131,433208
11668,problame,1,0.00023,72569,16.75154,433208
11669,ProgramSalamander,1,0.00023,72570,16.75177,433208
11670,prolificeric,1,0.00023,72571,16.75200,433208
11671,promasu,1,0.00023,72572,16.75223,433208
11672,pronny,1,0.00023,72573,16.75246,433208
11673,prosunh,1,0.00023,72574,16.75269,433208
11674,ProteanCode,1,0.00023,72575,16.75292,433208
11675,PrzemyslawSwiderski,1,0.00023,72576,16.75315,433208
11676,PSANGAN,1,0.00023,72577,16.75338,433208
11677,psav,1,0.00023,72578,16.75361,433208
11678,pshanoop,1,0.00023,72579,16.75385,433208
11679,pskaarup,1,0.00023,72580,16.75408,433208
11680,pstackle,1,0.00023,72581,16.75431,433208
11681,psy-q,1,0.00023,72582,16.75454,433208
11682,pthalasta,1,0.00023,72583,16.75477,433208
11683,ptlanu22,1,0.00023,72584,16.75500,433208
11684,ptramsey,1,0.00023,72585,16.75523,433208
11685,ptravers,1,0.00023,72586,16.75546,433208
11686,publiclou,1,0.00023,72587,16.75569,433208
11687,pulish,1,0.00023,72588,16.75592,433208
11688,PuneeshMotwani,1,0.00023,72589,16.75615,433208
11689,puneetkatyal,1,0.00023,72590,16.75638,433208
11690,PuneetPunamiya,1,0.00023,72591,16.75662,433208
11691,PushkarJ,1,0.00023,72592,16.75685,433208
11692,pushkarv,1,0.00023,72593,16.75708,433208
11693,pushparavi123,1,0.00023,72594,16.75731,433208
11694,pvsousalima,1,0.00023,72595,16.75754,433208
11695,pyr0hu,1,0.00023,72596,16.75777,433208
11696,pyramation,1,0.00023,72597,16.75800,433208
11697,pythonebasta,1,0.00023,72598,16.75823,433208
11698,pythonzm,1,0.00023,72599,16.75846,433208
11699,pzbiegiel,1,0.00023,72600,16.75869,433208
11700,pzinovkin,1,0.00023,72601,16.75892,433208
11701,pzocchi,1,0.00023,72602,16.75915,433208
11702,pzou1974,1,0.00023,72603,16.75939,433208
11703,pzqu,1,0.00023,72604,16.75962,433208
11704,qadet123,1,0.00023,72605,16.75985,433208
11705,QaiserAli,1,0.00023,72606,16.76008,433208
11706,Qard,1,0.00023,72607,16.76031,433208
11707,qbaze,1,0.00023,72608,16.76054,433208
11708,qcloop,1,0.00023,72609,16.76077,433208
11709,qfny88,1,0.00023,72610,16.76100,433208
11710,qiang93,1,0.00023,72611,16.76123,433208
11711,qinmaye,1,0.00023,72612,16.76146,433208
11712,qins,1,0.00023,72613,16.76169,433208
11713,qiq,1,0.00023,72614,16.76192,433208
11714,qiuhongshuai,1,0.00023,72615,16.76216,433208
11715,qiyongxiao,1,0.00023,72616,16.76239,433208
11716,QizhouYang,1,0.00023,72617,16.76262,433208
11717,qkss,1,0.00023,72618,16.76285,433208
11718,qq282485068,1,0.00023,72619,16.76308,433208
11719,qqbuby,1,0.00023,72620,16.76331,433208
11720,qtvspa,1,0.00023,72621,16.76354,433208
11721,Quanalogy,1,0.00023,72622,16.76377,433208
11722,quangkieu,1,0.00023,72623,16.76400,433208
11723,quangnb2,1,0.00023,72624,16.76423,433208
11724,Quantas,1,0.00023,72625,16.76446,433208
11725,quckly,1,0.00023,72626,16.76470,433208
11726,quentinplessis,1,0.00023,72627,16.76493,433208
11727,QuintinBecker,1,0.00023,72628,16.76516,433208
11728,quoccuongmmt,1,0.00023,72629,16.76539,433208
11729,QUSHLEE,1,0.00023,72630,16.76562,433208
11730,qwerty10110,1,0.00023,72631,16.76585,433208
11731,qwzhou89,1,0.00023,72632,16.76608,433208
11732,qzwlinux,1,0.00023,72633,16.76631,433208
11733,r0kas,1,0.00023,72634,16.76654,433208
11734,r3d00,1,0.00023,72635,16.76677,433208
11735,r3d3mpt10n,1,0.00023,72636,16.76700,433208
11736,r3dback,1,0.00023,72637,16.76723,433208
11737,r3econ,1,0.00023,72638,16.76747,433208
11738,raafvargas,1,0.00023,72639,16.76770,433208
11739,rabidscorpio,1,0.00023,72640,16.76793,433208
11740,rabin-io,1,0.00023,72641,16.76816,433208
11741,Raboo,1,0.00023,72642,16.76839,433208
11742,racerxdl,1,0.00023,72643,16.76862,433208
11743,RadekC85,1,0.00023,72644,16.76885,433208
11744,radoha,1,0.00023,72645,16.76908,433208
11745,radoye,1,0.00023,72646,16.76931,433208
11746,rafaeldasilva,1,0.00023,72647,16.76954,433208
11747,rafaelpereyra,1,0.00023,72648,16.76977,433208
11748,rafaelrenanpacheco,1,0.00023,72649,16.77000,433208
11749,rafalAtAdscale,1,0.00023,72650,16.77024,433208
11750,rafaleon15,1,0.00023,72651,16.77047,433208
11751,rafalfaro18,1,0.00023,72652,16.77070,433208
11752,rafal-prasal,1,0.00023,72653,16.77093,433208
11753,rafi,1,0.00023,72654,16.77116,433208
11754,rafis,1,0.00023,72655,16.77139,433208
11755,raghuP9,1,0.00023,72656,16.77162,433208
11756,Raghuvorkady,1,0.00023,72657,16.77185,433208
11757,ragingpastry,1,0.00023,72658,16.77208,433208
11758,ragrawal-humana,1,0.00023,72659,16.77231,433208
11759,ragunathan23,1,0.00023,72660,16.77254,433208
11760,rahul799,1,0.00023,72661,16.77277,433208
11761,rahuledjx,1,0.00023,72662,16.77301,433208
11762,rahulram756,1,0.00023,72663,16.77324,433208
11763,rahulsadanandan,1,0.00023,72664,16.77347,433208
11764,rahulsharma2020,1,0.00023,72665,16.77370,433208
11765,rahulwagh,1,0.00023,72666,16.77393,433208
11766,raihan71,1,0.00023,72667,16.77416,433208
11767,railgadi,1,0.00023,72668,16.77439,433208
11768,raimundogomes,1,0.00023,72669,16.77462,433208
11769,RainingNight,1,0.00023,72670,16.77485,433208
11770,Raiondesu,1,0.00023,72671,16.77508,433208
11771,Rajani12345678910,1,0.00023,72672,16.77531,433208
11772,rajashit14,1,0.00023,72673,16.77554,433208
11773,rajeshchandupatla,1,0.00023,72674,16.77578,433208
11774,rajeshdannina,1,0.00023,72675,16.77601,433208
11775,rajeshkumaratappviewx,1,0.00023,72676,16.77624,433208
11776,rajmondx,1,0.00023,72677,16.77647,433208
11777,rajneeshbajaj,1,0.00023,72678,16.77670,433208
11778,rajreet,1,0.00023,72679,16.77693,433208
11779,rakeshr99,1,0.00023,72680,16.77716,433208
11780,ralphbuk,1,0.00023,72681,16.77739,433208
11781,RamanaChowdam,1,0.00023,72682,16.77762,433208
11782,rameshgkwd05,1,0.00023,72683,16.77785,433208
11783,rameshkalluri,1,0.00023,72684,16.77808,433208
11784,rameshneela,1,0.00023,72685,16.77831,433208
11785,ramoncabrera,1,0.00023,72686,16.77855,433208
11786,ramrengaswamy,1,0.00023,72687,16.77878,433208
11787,ramsesrm,1,0.00023,72688,16.77901,433208
11788,ranchothu,1,0.00023,72689,16.77924,433208
11789,randallt,1,0.00023,72690,16.77947,433208
11790,Randhir123,1,0.00023,72691,16.77970,433208
11791,randomanderson,1,0.00023,72692,16.77993,433208
11792,randrewy,1,0.00023,72693,16.78016,433208
11793,randrusiak,1,0.00023,72694,16.78039,433208
11794,ranjitvaradi,1,0.00023,72695,16.78062,433208
11795,raogayathri,1,0.00023,72696,16.78085,433208
11796,raphaelauv,1,0.00023,72697,16.78108,433208
11797,raphael-bos,1,0.00023,72698,16.78132,433208
11798,raphink,1,0.00023,72699,16.78155,433208
11799,rarick,1,0.00023,72700,16.78178,433208
11800,ras0219,1,0.00023,72701,16.78201,433208
11801,rashmi-ibm,1,0.00023,72702,16.78224,433208
11802,rashmilengade,1,0.00023,72703,16.78247,433208
11803,rashmip22,1,0.00023,72704,16.78270,433208
11804,rasisuku,1,0.00023,72705,16.78293,433208
11805,rassadi,1,0.00023,72706,16.78316,433208
11806,RationalityFrontline,1,0.00023,72707,16.78339,433208
11807,raukadah,1,0.00023,72708,16.78362,433208
11808,raunyoliveira-hotmart,1,0.00023,72709,16.78385,433208
11809,ravichiripurapu,1,0.00023,72710,16.78409,433208
11810,ravikanth39,1,0.00023,72711,16.78432,433208
11811,raviranjithkumar,1,0.00023,72712,16.78455,433208
11812,raviroshan224,1,0.00023,72713,16.78478,433208
11813,ravvy00,1,0.00023,72714,16.78501,433208
11814,rawon,1,0.00023,72715,16.78524,433208
11815,rayisbadat,1,0.00023,72716,16.78547,433208
11816,rayjcwu,1,0.00023,72717,16.78570,433208
11817,rayjlinden,1,0.00023,72718,16.78593,433208
11818,RaymondKYLiu,1,0.00023,72719,16.78616,433208
11819,RaymondWaterlooLi,1,0.00023,72720,16.78639,433208
11820,rayway30419,1,0.00023,72721,16.78662,433208
11821,RazaHasan84,1,0.00023,72722,16.78686,433208
11822,razvan-ig,1,0.00023,72723,16.78709,433208
11823,rb3ckers,1,0.00023,72724,16.78732,433208
11824,rbkumar88,1,0.00023,72725,16.78755,433208
11825,rbq,1,0.00023,72726,16.78778,433208
11826,rbreekveldt,1,0.00023,72727,16.78801,433208
11827,rbuck-som,1,0.00023,72728,16.78824,433208
11828,rcny,1,0.00023,72729,16.78847,433208
11829,rdohms,1,0.00023,72730,16.78870,433208
11830,rdpa,1,0.00023,72731,16.78893,433208
11831,readall,1,0.00023,72732,16.78916,433208
11832,real420og,1,0.00023,72733,16.78939,433208
11833,realknorke,1,0.00023,72734,16.78963,433208
11834,RealRadOne,1,0.00023,72735,16.78986,433208
11835,reasland,1,0.00023,72736,16.79009,433208
11836,recentcoin,1,0.00023,72737,16.79032,433208
11837,Redface28,1,0.00023,72738,16.79055,433208
11838,regorsmitz,1,0.00023,72739,16.79078,433208
11839,Rehan290,1,0.00023,72740,16.79101,433208
11840,ReillyTevera,1,0.00023,72741,16.79124,433208
11841,reivaj84,1,0.00023,72742,16.79147,433208
11842,relaxgo,1,0.00023,72743,16.79170,433208
11843,relnetops,1,0.00023,72744,16.79193,433208
11844,relyt0925,1,0.00023,72745,16.79216,433208
11845,remcohaszing,1,0.00023,72746,16.79240,433208
11846,RemiGaudin,1,0.00023,72747,16.79263,433208
11847,remones,1,0.00023,72748,16.79286,433208
11848,renatozhang,1,0.00023,72749,16.79309,433208
11849,rendler-denis,1,0.00023,72750,16.79332,433208
11850,rene-demonsters,1,0.00023,72751,16.79355,433208
11851,renevanosnabrugge,1,0.00023,72752,16.79378,433208
11852,renyuntao,1,0.00023,72753,16.79401,433208
11853,resec,1,0.00023,72754,16.79424,433208
11854,Ressetkk,1,0.00023,72755,16.79447,433208
11855,restanrm,1,0.00023,72756,16.79470,433208
11856,restfulhead,1,0.00023,72757,16.79493,433208
11857,retrry,1,0.00023,72758,16.79517,433208
11858,reutsharabani,1,0.00023,72759,16.79540,433208
11859,revilwang,1,0.00023,72760,16.79563,433208
11860,rexroof,1,0.00023,72761,16.79586,433208
11861,rezabojnordi,1,0.00023,72762,16.79609,433208
11862,rfarro82,1,0.00023,72763,16.79632,433208
11863,rfezz,1,0.00023,72764,16.79655,433208
11864,rfielding,1,0.00023,72765,16.79678,433208
11865,rforrizwan55,1,0.00023,72766,16.79701,433208
11866,rglyons,1,0.00023,72767,16.79724,433208
11867,rgueldem,1,0.00023,72768,16.79747,433208
11868,rhenwood-arm,1,0.00023,72769,16.79770,433208
11869,rhysemmas,1,0.00023,72770,16.79794,433208
11870,ricardjp-icabbi,1,0.00023,72771,16.79817,433208
11871,ricardoandre97,1,0.00023,72772,16.79840,433208
11872,ricardojdsilva87,1,0.00023,72773,16.79863,433208
11873,ricardopt,1,0.00023,72774,16.79886,433208
11874,richardbadman,1,0.00023,72775,16.79909,433208
11875,richard-cox,1,0.00023,72776,16.79932,433208
11876,RichardHsiung,1,0.00023,72777,16.79955,433208
11877,rick-pri,1,0.00023,72778,16.79978,433208
11878,Rickyf115,1,0.00023,72779,16.80001,433208
11879,Rick-yi,1,0.00023,72780,16.80024,433208
11880,rickysway,1,0.00023,72781,16.80047,433208
11881,rimaddo,1,0.00023,72782,16.80071,433208
11882,Rimobul,1,0.00023,72783,16.80094,433208
11883,ripx80,1,0.00023,72784,16.80117,433208
11884,Rishabh4303,1,0.00023,72785,16.80140,433208
11885,rishibarad,1,0.00023,72786,16.80163,433208
11886,rishi-suresh-keshav,1,0.00023,72787,16.80186,433208
11887,riteshgurung,1,0.00023,72788,16.80209,433208
11888,ritheshgm,1,0.00023,72789,16.80232,433208
11889,ritika-saha,1,0.00023,72790,16.80255,433208
11890,ritikofficial,1,0.00023,72791,16.80278,433208
11891,Rittu21,1,0.00023,72792,16.80301,433208
11892,ritubajaj889,1,0.00023,72793,16.80324,433208
11893,riuvshyn,1,0.00023,72794,16.80348,433208
11894,riyaz-ali,1,0.00023,72795,16.80371,433208
11895,rjackson90,1,0.00023,72796,16.80394,433208
11896,rjtokenring,1,0.00023,72797,16.80417,433208
11897,rjunior069,1,0.00023,72798,16.80440,433208
11898,rkevin-arch,1,0.00023,72799,16.80463,433208
11899,rkluszczynski,1,0.00023,72800,16.80486,433208
11900,rmartinez3,1,0.00023,72801,16.80509,433208
11901,rmasclef,1,0.00023,72802,16.80532,433208
11902,RMcD,1,0.00023,72803,16.80555,433208
11903,Rmond,1,0.00023,72804,16.80578,433208
11904,robbrit,1,0.00023,72805,16.80601,433208
11905,robcecil,1,0.00023,72806,16.80625,433208
11906,robertogyn19,1,0.00023,72807,16.80648,433208
11907,robertrbruno,1,0.00023,72808,16.80671,433208
11908,Robert-turbo,1,0.00023,72809,16.80694,433208
11909,robertwb,1,0.00023,72810,16.80717,433208
11910,robertwol,1,0.00023,72811,16.80740,433208
11911,robinator8,1,0.00023,72812,16.80763,433208
11912,robinmeiss,1,0.00023,72813,16.80786,433208
11913,robin-rpr,1,0.00023,72814,16.80809,433208
11914,robisoh88,1,0.00023,72815,16.80832,433208
11915,roboslone,1,0.00023,72816,16.80855,433208
11916,robross0606,1,0.00023,72817,16.80878,433208
11917,robseidel,1,0.00023,72818,16.80902,433208
11918,rockaut,1,0.00023,72819,16.80925,433208
11919,rockpanda,1,0.00023,72820,16.80948,433208
11920,rockysingh,1,0.00023,72821,16.80971,433208
11921,rocqina,1,0.00023,72822,16.80994,433208
11922,Roderick-Jonsson,1,0.00023,72823,16.81017,433208
11923,roDew,1,0.00023,72824,16.81040,433208
11924,Rodionp13,1,0.00023,72825,16.81063,433208
11925,rodrigoporcionato,1,0.00023,72826,16.81086,433208
11926,rogaha,1,0.00023,72827,16.81109,433208
11927,rogeliodh,1,0.00023,72828,16.81132,433208
11928,rogersd,1,0.00023,72829,16.81155,433208
11929,rogst,1,0.00023,72830,16.81179,433208
11930,rohanme,1,0.00023,72831,16.81202,433208
11931,rohitagg2020,1,0.00023,72832,16.81225,433208
11932,rohitshaw892,1,0.00023,72833,16.81248,433208
11933,rohitwaghmare101,1,0.00023,72834,16.81271,433208
11934,rohrit,1,0.00023,72835,16.81294,433208
11935,Roihn,1,0.00023,72836,16.81317,433208
11936,rokn,1,0.00023,72837,16.81340,433208
11937,rolandabt,1,0.00023,72838,16.81363,433208
11938,romain325,1,0.00023,72839,16.81386,433208
11939,romanjoffee,1,0.00023,72840,16.81409,433208
11940,romanvog,1,0.00023,72841,16.81432,433208
11941,R-omk,1,0.00023,72842,16.81456,433208
11942,romuloctba,1,0.00023,72843,16.81479,433208
11943,ronaldour,1,0.00023,72844,16.81502,433208
11944,Ronald-Saunfe,1,0.00023,72845,16.81525,433208
11945,roncgabriel,1,0.00023,72846,16.81548,433208
11946,ronitshrivastava447,1,0.00023,72847,16.81571,433208
11947,RonVider,1,0.00023,72848,16.81594,433208
11948,ronwxy,1,0.00023,72849,16.81617,433208
11949,roock,1,0.00023,72850,16.81640,433208
11950,rootqu,1,0.00023,72851,16.81663,433208
11951,roppa,1,0.00023,72852,16.81686,433208
11952,RossVertizan,1,0.00023,72853,16.81709,433208
11953,rothsa,1,0.00023,72854,16.81733,433208
11954,rowan-baker,1,0.00023,72855,16.81756,433208
11955,Rowayda-Khayri,1,0.00023,72856,16.81779,433208
11956,roy2220,1,0.00023,72857,16.81802,433208
11957,roygbip,1,0.00023,72858,16.81825,433208
11958,roylee17,1,0.00023,72859,16.81848,433208
11959,royolsen,1,0.00023,72860,16.81871,433208
11960,roysahar-ibm,1,0.00023,72861,16.81894,433208
11961,roystchiang,1,0.00023,72862,16.81917,433208
11962,RoySunnySean007,1,0.00023,72863,16.81940,433208
11963,roy-work,1,0.00023,72864,16.81963,433208
11964,rpagliuca,1,0.00023,72865,16.81986,433208
11965,rpf3,1,0.00023,72866,16.82010,433208
11966,rra,1,0.00023,72867,16.82033,433208
11967,rrajarap,1,0.00023,72868,16.82056,433208
11968,RSaladi,1,0.00023,72869,16.82079,433208
11969,rschwarz-sotec,1,0.00023,72870,16.82102,433208
11970,rsilva-nk,1,0.00023,72871,16.82125,433208
11971,rsleem,1,0.00023,72872,16.82148,433208
11972,r-t-m,1,0.00023,72873,16.82171,433208
11973,rubenpurple,1,0.00023,72874,16.82194,433208
11974,rubenstolk,1,0.00023,72875,16.82217,433208
11975,rubin55,1,0.00023,72876,16.82240,433208
11976,ruckc,1,0.00023,72877,16.82263,433208
11977,rudhrasekar,1,0.00023,72878,16.82287,433208
11978,rudrabisht,1,0.00023,72879,16.82310,433208
11979,rudy2steiner,1,0.00023,72880,16.82333,433208
11980,RudyBone,1,0.00023,72881,16.82356,433208
11981,rufreakde,1,0.00023,72882,16.82379,433208
11982,Ruifeng-Wu,1,0.00023,72883,16.82402,433208
11983,Ruilkyu,1,0.00023,72884,16.82425,433208
11984,Rui-Tang,1,0.00023,72885,16.82448,433208
11985,rukletsov,1,0.00023,72886,16.82471,433208
11986,RuncibleSpoon,1,0.00023,72887,16.82494,433208
11987,RunDevelopment,1,0.00023,72888,16.82517,433208
11988,rushminatorr,1,0.00023,72889,16.82540,433208
11989,russellwhitaker,1,0.00023,72890,16.82564,433208
11990,Russiancold,1,0.00023,72891,16.82587,433208
11991,russurquhart1,1,0.00023,72892,16.82610,433208
11992,ruvany,1,0.00023,72893,16.82633,433208
11993,rvdhiver,1,0.00023,72894,16.82656,433208
11994,rvgud,1,0.00023,72895,16.82679,433208
11995,RVKSaladi,1,0.00023,72896,16.82702,433208
11996,rwenz3l,1,0.00023,72897,16.82725,433208
11997,rwkarg,1,0.00023,72898,16.82748,433208
11998,rxbn,1,0.00023,72899,16.82771,433208
11999,rxwang662001,1,0.00023,72900,16.82794,433208
12000,ryan109,1,0.00023,72901,16.82817,433208
12001,ryan4yin,1,0.00023,72902,16.82841,433208
12002,ryanberger-az,1,0.00023,72903,16.82864,433208
12003,ryan-chase,1,0.00023,72904,16.82887,433208
12004,ryanc-me,1,0.00023,72905,16.82910,433208
12005,ryanelliottsmith,1,0.00023,72906,16.82933,433208
12006,ryanjwh,1,0.00023,72907,16.82956,433208
12007,ryantiger658,1,0.00023,72908,16.82979,433208
12008,RyanW02,1,0.00023,72909,16.83002,433208
12009,RyanW8,1,0.00023,72910,16.83025,433208
12010,ryanwangJC,1,0.00023,72911,16.83048,433208
12011,ryjogo,1,0.00023,72912,16.83071,433208
12012,rymeskar,1,0.00023,72913,16.83094,433208
12013,Ryner51,1,0.00023,72914,16.83118,433208
12014,RytisLT,1,0.00023,72915,16.83141,433208
12015,Ryuzaki42,1,0.00023,72916,16.83164,433208
12016,SaadUllahSheikh,1,0.00023,72917,16.83187,433208
12017,saariniemi,1,0.00023,72918,16.83210,433208
12018,SAbdulRahuman,1,0.00023,72919,16.83233,433208
12019,Saberos,1,0.00023,72920,16.83256,433208
12020,SaberSeddik,1,0.00023,72921,16.83279,433208
12021,sabyabr,1,0.00023,72922,16.83302,433208
12022,sacgoel,1,0.00023,72923,16.83325,433208
12023,sadovnikov,1,0.00023,72924,16.83348,433208
12024,saehan-suh,1,0.00023,72925,16.83371,433208
12025,SafaTinaztepe,1,0.00023,72926,16.83395,433208
12026,sagaraspl,1,0.00023,72927,16.83418,433208
12027,sagarwalke295,1,0.00023,72928,16.83441,433208
12028,SagiMedinaCheckmarx,1,0.00023,72929,16.83464,433208
12029,sahilnegi100,1,0.00023,72930,16.83487,433208
12030,SahilSayani,1,0.00023,72931,16.83510,433208
12031,SaigyoujiYuyuko233,1,0.00023,72932,16.83533,433208
12032,saiharshitachava,1,0.00023,72933,16.83556,433208
12033,saipraveen-a,1,0.00023,72934,16.83579,433208
12034,saiyam1712,1,0.00023,72935,16.83602,433208
12035,saiyidi,1,0.00023,72936,16.83625,433208
12036,saksham-git,1,0.00023,72937,16.83649,433208
12037,sakshirathorebgw,1,0.00023,72938,16.83672,433208
12038,salimjaved18,1,0.00023,72939,16.83695,433208
12039,salman-bhai,1,0.00023,72940,16.83718,433208
12040,saltbo,1,0.00023,72941,16.83741,433208
12041,saltyskip,1,0.00023,72942,16.83764,433208
12042,salva-gglez,1,0.00023,72943,16.83787,433208
12043,salzig,1,0.00023,72944,16.83810,433208
12044,samadhiyaaman93,1,0.00023,72945,16.83833,433208
12045,sam-almighty,1,0.00023,72946,16.83856,433208
12046,samamoateng,1,0.00023,72947,16.83879,433208
12047,samath117,1,0.00023,72948,16.83902,433208
12048,samceena,1,0.00023,72949,16.83926,433208
12049,samddico,1,0.00023,72950,16.83949,433208
12050,sameer8991,1,0.00023,72951,16.83972,433208
12051,sameerbhadouria,1,0.00023,72952,16.83995,433208
12052,sameergn,1,0.00023,72953,16.84018,433208
12053,sameerraj362000,1,0.00023,72954,16.84041,433208
12054,samirshaik,1,0.00023,72955,16.84064,433208
12055,Sami-svmx,1,0.00023,72956,16.84087,433208
12056,sampaddemo,1,0.00023,72957,16.84110,433208
12057,Samshopify,1,0.00023,72958,16.84133,433208
12058,samsplunks,1,0.00023,72959,16.84156,433208
12059,samta,1,0.00023,72960,16.84179,433208
12060,samtoi,1,0.00023,72961,16.84203,433208
12061,SamuelBagattin,1,0.00023,72962,16.84226,433208
12062,samuelthan,1,0.00023,72963,16.84249,433208
12063,samvdkris,1,0.00023,72964,16.84272,433208
12064,samw08,1,0.00023,72965,16.84295,433208
12065,sanagarw,1,0.00023,72966,16.84318,433208
12066,sandeeprapido,1,0.00023,72967,16.84341,433208
12067,SandeepVaman,1,0.00023,72968,16.84364,433208
12068,sandhyashrek,1,0.00023,72969,16.84387,433208
12069,sandinak,1,0.00023,72970,16.84410,433208
12070,sandyharvie,1,0.00023,72971,16.84433,433208
12071,sangeethdba,1,0.00023,72972,16.84456,433208
12072,Sanghamitra-BEAGILE,1,0.00023,72973,16.84480,433208
12073,sangkeon,1,0.00023,72974,16.84503,433208
12074,sanjaytiwari18,1,0.00023,72975,16.84526,433208
12075,SankarMittapally,1,0.00023,72976,16.84549,433208
12076,sannadi99,1,0.00023,72977,16.84572,433208
12077,sanposhiho,1,0.00023,72978,16.84595,433208
12078,sanprasingh,1,0.00023,72979,16.84618,433208
12079,santh5858,1,0.00023,72980,16.84641,433208
12080,santi-asapp,1,0.00023,72981,16.84664,433208
12081,santoo1116,1,0.00023,72982,16.84687,433208
12082,santosh653,1,0.00023,72983,16.84710,433208
12083,saptarsi96,1,0.00023,72984,16.84733,433208
12084,saraAlizadeh,1,0.00023,72985,16.84757,433208
12085,sarcasticadmin,1,0.00023,72986,16.84780,433208
12086,Sarga,1,0.00023,72987,16.84803,433208
12087,sarlaccpit,1,0.00023,72988,16.84826,433208
12088,sarthak-sriw,1,0.00023,72989,16.84849,433208
12089,sarveshtamba,1,0.00023,72990,16.84872,433208
12090,Sasasu,1,0.00023,72991,16.84895,433208
12091,SaschaHeyer,1,0.00023,72992,16.84918,433208
12092,SAshish19,1,0.00023,72993,16.84941,433208
12093,sa-spag,1,0.00023,72994,16.84964,433208
12094,satish143,1,0.00023,72995,16.84987,433208
12095,SatoruItaya,1,0.00023,72996,16.85010,433208
12096,satvirgrewal,1,0.00023,72997,16.85034,433208
12097,satyamsah,1,0.00023,72998,16.85057,433208
12098,saul-gush,1,0.00023,72999,16.85080,433208
12099,saulmmendoza,1,0.00023,73000,16.85103,433208
12100,Saumiya-Ranjan,1,0.00023,73001,16.85126,433208
12101,saurabhcs,1,0.00023,73002,16.85149,433208
12102,saurabhIU,1,0.00023,73003,16.85172,433208
12103,sauravvijay,1,0.00023,73004,16.85195,433208
12104,sausagee,1,0.00023,73005,16.85218,433208
12105,SawyerLan,1,0.00023,73006,16.85241,433208
12106,sbiermann,1,0.00023,73007,16.85264,433208
12107,sbkg0002,1,0.00023,73008,16.85287,433208
12108,sc0ttbeardsley,1,0.00023,73009,16.85311,433208
12109,scarby,1,0.00023,73010,16.85334,433208
12110,schapiroalexis,1,0.00023,73011,16.85357,433208
12111,schaze,1,0.00023,73012,16.85380,433208
12112,schezfaz,1,0.00023,73013,16.85403,433208
12113,Schildkroete23,1,0.00023,73014,16.85426,433208
12114,schlauerlauer,1,0.00023,73015,16.85449,433208
12115,schneems,1,0.00023,73016,16.85472,433208
12116,scholtalbers,1,0.00023,73017,16.85495,433208
12117,schra,1,0.00023,73018,16.85518,433208
12118,ScienceOfficer,1,0.00023,73019,16.85541,433208
12119,Sckmo,1,0.00023,73020,16.85564,433208
12120,SCLogo,1,0.00023,73021,16.85588,433208
12121,scloudguru,1,0.00023,73022,16.85611,433208
12122,scolbeck,1,0.00023,73023,16.85634,433208
12123,scones,1,0.00023,73024,16.85657,433208
12124,Scoppio,1,0.00023,73025,16.85680,433208
12125,scotato,1,0.00023,73026,16.85703,433208
12126,scott2449,1,0.00023,73027,16.85726,433208
12127,scottdhowell3,1,0.00023,73028,16.85749,433208
12128,scottf,1,0.00023,73029,16.85772,433208
12129,scott-kirk,1,0.00023,73030,16.85795,433208
12130,scouturier,1,0.00023,73031,16.85818,433208
12131,scq355,1,0.00023,73032,16.85841,433208
12132,scriptmaster,1,0.00023,73033,16.85865,433208
12133,scsinke,1,0.00023,73034,16.85888,433208
12134,scyto,1,0.00023,73035,16.85911,433208
12135,sd2302,1,0.00023,73036,16.85934,433208
12136,sdarwin,1,0.00023,73037,16.85957,433208
12137,sdd,1,0.00023,73038,16.85980,433208
12138,sdghchj,1,0.00023,73039,16.86003,433208
12139,sdgmf,1,0.00023,73040,16.86026,433208
12140,sdhoward,1,0.00023,73041,16.86049,433208
12141,sdrush-mw,1,0.00023,73042,16.86072,433208
12142,SeaLife,1,0.00023,73043,16.86095,433208
12143,sean-ersw,1,0.00023,73044,16.86118,433208
12144,seanho00,1,0.00023,73045,16.86142,433208
12145,sebanazarian,1,0.00023,73046,16.86165,433208
12146,SebastianKristof,1,0.00023,73047,16.86188,433208
12147,sebito91,1,0.00023,73048,16.86211,433208
12148,sebsanchez,1,0.00023,73049,16.86234,433208
12149,segabond,1,0.00023,73050,16.86257,433208
12150,sehz,1,0.00023,73051,16.86280,433208
12151,seime,1,0.00023,73052,16.86303,433208
12152,self-tuts,1,0.00023,73053,16.86326,433208
12153,selvamraman,1,0.00023,73054,16.86349,433208
12154,Semax,1,0.00023,73055,16.86372,433208
12155,semoac,1,0.00023,73056,16.86395,433208
12156,Seoka,1,0.00023,73057,16.86419,433208
12157,sep76,1,0.00023,73058,16.86442,433208
12158,sepulworld,1,0.00023,73059,16.86465,433208
12159,sereinity,1,0.00023,73060,16.86488,433208
12160,sergii-koshel-exa,1,0.00023,73061,16.86511,433208
12161,sergiocharpineljr,1,0.00023,73062,16.86534,433208
12162,SergLeontiev,1,0.00023,73063,16.86557,433208
12163,serheevas,1,0.00023,73064,16.86580,433208
12164,serhei,1,0.00023,73065,16.86603,433208
12165,sescotti,1,0.00023,73066,16.86626,433208
12166,setharnold,1,0.00023,73067,16.86649,433208
12167,Setheck,1,0.00023,73068,16.86672,433208
12168,Seven-t7,1,0.00023,73069,16.86696,433208
12169,sfc-gh-jkhan,1,0.00023,73070,16.86719,433208
12170,sfc-gh-thardie,1,0.00023,73071,16.86742,433208
12171,sfgroups-k8s,1,0.00023,73072,16.86765,433208
12172,sfotony,1,0.00023,73073,16.86788,433208
12173,sgatdell,1,0.00023,73074,16.86811,433208
12174,sgermanserrano,1,0.00023,73075,16.86834,433208
12175,sgltkn,1,0.00023,73076,16.86857,433208
12176,sgoodliff,1,0.00023,73077,16.86880,433208
12177,sgops,1,0.00023,73078,16.86903,433208
12178,Sh1ftry,1,0.00023,73079,16.86926,433208
12179,shaahmed115,1,0.00023,73080,16.86949,433208
12180,shaase-ctrl,1,0.00023,73081,16.86973,433208
12181,shachar-ash,1,0.00023,73082,16.86996,433208
12182,shahadarsh,1,0.00023,73083,16.87019,433208
12183,ShahidAttari26,1,0.00023,73084,16.87042,433208
12184,shahmirn,1,0.00023,73085,16.87065,433208
12185,shaikhahad18,1,0.00023,73086,16.87088,433208
12186,Shaked,1,0.00023,73087,16.87111,433208
12187,shakertanim,1,0.00023,73088,16.87134,433208
12188,shakthi-manai,1,0.00023,73089,16.87157,433208
12189,shalin-hudda,1,0.00023,73090,16.87180,433208
12190,shalomcbouncex,1,0.00023,73091,16.87203,433208
12191,shamork,1,0.00023,73092,16.87226,433208
12192,shane-kearns,1,0.00023,73093,16.87250,433208
12193,shane-lawrence,1,0.00023,73094,16.87273,433208
12194,shaneqld,1,0.00023,73095,16.87296,433208
12195,shankarkc,1,0.00023,73096,16.87319,433208
12196,shao0222,1,0.00023,73097,16.87342,433208
12197,shapor,1,0.00023,73098,16.87365,433208
12198,sharma-sudhakar,1,0.00023,73099,16.87388,433208
12199,Shashankft9,1,0.00023,73100,16.87411,433208
12200,shashanklmurthy,1,0.00023,73101,16.87434,433208
12201,shashankv02,1,0.00023,73102,16.87457,433208
12202,shawncrabtree,1,0.00023,73103,16.87480,433208
12203,Shazzberry,1,0.00023,73104,16.87503,433208
12204,shetengteng,1,0.00023,73105,16.87527,433208
12205,shettyjm,1,0.00023,73106,16.87550,433208
12206,shiba24,1,0.00023,73107,16.87573,433208
12207,shichangzhi,1,0.00023,73108,16.87596,433208
12208,shicheng001sg,1,0.00023,73109,16.87619,433208
12209,shijiesun,1,0.00023,73110,16.87642,433208
12210,shijukuchelan1985,1,0.00023,73111,16.87665,433208
12211,shikhar7,1,0.00023,73112,16.87688,433208
12212,shiningbridge,1,0.00023,73113,16.87711,433208
12213,shiransky,1,0.00023,73114,16.87734,433208
12214,shivabommakanti03,1,0.00023,73115,16.87757,433208
12215,shivakumargn,1,0.00023,73116,16.87780,433208
12216,shivammathur,1,0.00023,73117,16.87804,433208
12217,shivamsinghraipur,1,0.00023,73118,16.87827,433208
12218,Shivang0,1,0.00023,73119,16.87850,433208
12219,ShivaniThevar,1,0.00023,73120,16.87873,433208
12220,shivpathak,1,0.00023,73121,16.87896,433208
12221,shiwano,1,0.00023,73122,16.87919,433208
12222,shiyiyue1102,1,0.00023,73123,16.87942,433208
12223,shiyuan-extreme,1,0.00023,73124,16.87965,433208
12224,shizhyy,1,0.00023,73125,16.87988,433208
12225,shlomibendavid,1,0.00023,73126,16.88011,433208
12226,shmoon-kt,1,0.00023,73127,16.88034,433208
12227,shockogit,1,0.00023,73128,16.88057,433208
12228,shouldnotappearcalm,1,0.00023,73129,16.88081,433208
12229,shousper,1,0.00023,73130,16.88104,433208
12230,ShraddhaGeek,1,0.00023,73131,16.88127,433208
12231,shramikawale,1,0.00023,73132,16.88150,433208
12232,shreben,1,0.00023,73133,16.88173,433208
12233,shreyanshjain806,1,0.00023,73134,16.88196,433208
12234,shreyasdn,1,0.00023,73135,16.88219,433208
12235,Shreyas-Gupta-21,1,0.00023,73136,16.88242,433208
12236,shrutip32,1,0.00023,73137,16.88265,433208
12237,shtamura,1,0.00023,73138,16.88288,433208
12238,shubhamdixit863,1,0.00023,73139,16.88311,433208
12239,shukla2112,1,0.00023,73140,16.88334,433208
12240,shurkus,1,0.00023,73141,16.88358,433208
12241,shuvankar0907,1,0.00023,73142,16.88381,433208
12242,sh-vasily,1,0.00023,73143,16.88404,433208
12243,sibelius,1,0.00023,73144,16.88427,433208
12244,si-c613,1,0.00023,73145,16.88450,433208
12245,sid5566,1,0.00023,73146,16.88473,433208
12246,sidarth164,1,0.00023,73147,16.88496,433208
12247,siddhi523,1,0.00023,73148,16.88519,433208
12248,Siddhu1096,1,0.00023,73149,16.88542,433208
12249,sidheshdivekar29,1,0.00023,73150,16.88565,433208
12250,sidikalamini,1,0.00023,73151,16.88588,433208
12251,sid-maf-account,1,0.00023,73152,16.88611,433208
12252,siepkes,1,0.00023,73153,16.88635,433208
12253,Sikiryl,1,0.00023,73154,16.88658,433208
12254,silasdavis,1,0.00023,73155,16.88681,433208
12255,silashansen,1,0.00023,73156,16.88704,433208
12256,silence8013,1,0.00023,73157,16.88727,433208
12257,silencehe09,1,0.00023,73158,16.88750,433208
12258,silvez-dh,1,0.00023,73159,16.88773,433208
12259,simbro,1,0.00023,73160,16.88796,433208
12260,simon0191,1,0.00023,73161,16.88819,433208
12261,simon-anz,1,0.00023,73162,16.88842,433208
12262,simonasr,1,0.00023,73163,16.88865,433208
12263,simonbaren,1,0.00023,73164,16.88888,433208
12264,simone201,1,0.00023,73165,16.88912,433208
12265,simongottschlag,1,0.00023,73166,16.88935,433208
12266,simonpinn,1,0.00023,73167,16.88958,433208
12267,SimonWoolf,1,0.00023,73168,16.88981,433208
12268,SimonyanG,1,0.00023,73169,16.89004,433208
12269,simran3695,1,0.00023,73170,16.89027,433208
12270,simransharmarajni,1,0.00023,73171,16.89050,433208
12271,sindrepm,1,0.00023,73172,16.89073,433208
12272,SinghDivneet,1,0.00023,73173,16.89096,433208
12273,SingularBunny,1,0.00023,73174,16.89119,433208
12274,SinisterMinister,1,0.00023,73175,16.89142,433208
12275,sirianni,1,0.00023,73176,16.89165,433208
12276,sirinibin,1,0.00023,73177,16.89189,433208
12277,SirOibaf,1,0.00023,73178,16.89212,433208
12278,sirtuxalot,1,0.00023,73179,16.89235,433208
12279,sirudog,1,0.00023,73180,16.89258,433208
12280,SivaKesava1,1,0.00023,73181,16.89281,433208
12281,sjkummer,1,0.00023,73182,16.89304,433208
12282,sjs205,1,0.00023,73183,16.89327,433208
12283,skalolazka,1,0.00023,73184,16.89350,433208
12284,skambashi,1,0.00023,73185,16.89373,433208
12285,Skitionek,1,0.00023,73186,16.89396,433208
12286,skob,1,0.00023,73187,16.89419,433208
12287,SkylarScaling,1,0.00023,73188,16.89442,433208
12288,SlavyanaK,1,0.00023,73189,16.89466,433208
12289,sleekweasel,1,0.00023,73190,16.89489,433208
12290,SleeplessByte,1,0.00023,73191,16.89512,433208
12291,sleerssen,1,0.00023,73192,16.89535,433208
12292,sleeyax,1,0.00023,73193,16.89558,433208
12293,sleshchenko,1,0.00023,73194,16.89581,433208
12294,SliceWire,1,0.00023,73195,16.89604,433208
12295,slto,1,0.00023,73196,16.89627,433208
12296,slwon,1,0.00023,73197,16.89650,433208
12297,slzzz,1,0.00023,73198,16.89673,433208
12298,smarkwell,1,0.00023,73199,16.89696,433208
12299,smartbenson1,1,0.00023,73200,16.89719,433208
12300,smartvolshell,1,0.00023,73201,16.89743,433208
12301,smartxff,1,0.00023,73202,16.89766,433208
12302,smehboub,1,0.00023,73203,16.89789,433208
12303,smehboub-dkt,1,0.00023,73204,16.89812,433208
12304,smekkley,1,0.00023,73205,16.89835,433208
12305,smerkerg,1,0.00023,73206,16.89858,433208
12306,smijolovic,1,0.00023,73207,16.89881,433208
12307,smil2k,1,0.00023,73208,16.89904,433208
12308,SmilingNavern,1,0.00023,73209,16.89927,433208
12309,smithago,1,0.00023,73210,16.89950,433208
12310,smithy9901,1,0.00023,73211,16.89973,433208
12311,smitthakkar96,1,0.00023,73212,16.89996,433208
12312,smo921,1,0.00023,73213,16.90020,433208
12313,smuel1414,1,0.00023,73214,16.90043,433208
12314,smuravev,1,0.00023,73215,16.90066,433208
12315,smuve1,1,0.00023,73216,16.90089,433208
12316,smyrman,1,0.00023,73217,16.90112,433208
12317,snehap25,1,0.00023,73218,16.90135,433208
12318,Snehapriya9955,1,0.00023,73219,16.90158,433208
12319,SniperBean,1,0.00023,73220,16.90181,433208
12320,snooyen,1,0.00023,73221,16.90204,433208
12321,snorwin,1,0.00023,73222,16.90227,433208
12322,snowiow,1,0.00023,73223,16.90250,433208
12323,socotra69,1,0.00023,73224,16.90273,433208
12324,soerenwolfers,1,0.00023,73225,16.90297,433208
12325,sofabeat,1,0.00023,73226,16.90320,433208
12326,softshipper,1,0.00023,73227,16.90343,433208
12327,SohamJ,1,0.00023,73228,16.90366,433208
12328,soharaki,1,0.00023,73229,16.90389,433208
12329,soider,1,0.00023,73230,16.90412,433208
12330,solardiz,1,0.00023,73231,16.90435,433208
12331,soloman817,1,0.00023,73232,16.90458,433208
12332,Solomon98,1,0.00023,73233,16.90481,433208
12333,someshbhalsing,1,0.00023,73234,16.90504,433208
12334,som-nitjsr,1,0.00023,73235,16.90527,433208
12335,somombo,1,0.00023,73236,16.90550,433208
12336,sonam2905,1,0.00023,73237,16.90574,433208
12337,SonamChhetri,1,0.00023,73238,16.90597,433208
12338,sonaysevik,1,0.00023,73239,16.90620,433208
12339,songhanpoo,1,0.00023,73240,16.90643,433208
12340,song-jiang,1,0.00023,73241,16.90666,433208
12341,songjiayang,1,0.00023,73242,16.90689,433208
12342,soni-111,1,0.00023,73243,16.90712,433208
12343,SonicGD,1,0.00023,73244,16.90735,433208
12344,sonogithub,1,0.00023,73245,16.90758,433208
12345,sonuchauhan1597,1,0.00023,73246,16.90781,433208
12346,Sophichia,1,0.00023,73247,16.90804,433208
12347,sosogh,1,0.00023,73248,16.90828,433208
12348,SoulSkare,1,0.00023,73249,16.90851,433208
12349,soumyadipdaripa100,1,0.00023,73250,16.90874,433208
12350,sowntharsakthi,1,0.00023,73251,16.90897,433208
12351,soygalla,1,0.00023,73252,16.90920,433208
12352,spacejam101,1,0.00023,73253,16.90943,433208
12353,spadger,1,0.00023,73254,16.90966,433208
12354,spali,1,0.00023,73255,16.90989,433208
12355,Spamsational,1,0.00023,73256,16.91012,433208
12356,spanky-medal,1,0.00023,73257,16.91035,433208
12357,spansari-cxone,1,0.00023,73258,16.91058,433208
12358,speculatrix,1,0.00023,73259,16.91081,433208
12359,SphereBread,1,0.00023,73260,16.91105,433208
12360,spicysomtam,1,0.00023,73261,16.91128,433208
12361,SpikePy,1,0.00023,73262,16.91151,433208
12362,sploiselle,1,0.00023,73263,16.91174,433208
12363,splunkdevabhi,1,0.00023,73264,16.91197,433208
12364,sPOiDar,1,0.00023,73265,16.91220,433208
12365,sponsology,1,0.00023,73266,16.91243,433208
12366,sptmhall,1,0.00023,73267,16.91266,433208
12367,spurum1008,1,0.00023,73268,16.91289,433208
12368,sqs,1,0.00023,73269,16.91312,433208
12369,srajmane,1,0.00023,73270,16.91335,433208
12370,sramkrishna,1,0.00023,73271,16.91358,433208
12371,sravanpatro,1,0.00023,73272,16.91382,433208
12372,sreaswar,1,0.00023,73273,16.91405,433208
12373,sreekanthadari,1,0.00023,73274,16.91428,433208
12374,sreenigaddam77,1,0.00023,73275,16.91451,433208
12375,sridharratnareddy,1,0.00023,73276,16.91474,433208
12376,sriharshakx,1,0.00023,73277,16.91497,433208
12377,srinivasraojangiti,1,0.00023,73278,16.91520,433208
12378,SrishtyC13,1,0.00023,73279,16.91543,433208
12379,sriveros95,1,0.00023,73280,16.91566,433208
12380,srknc,1,0.00023,73281,16.91589,433208
12381,srt32,1,0.00023,73282,16.91612,433208
12382,sruthakeerthikotla,1,0.00023,73283,16.91635,433208
12383,SS30723,1,0.00023,73284,16.91659,433208
12384,ssandanshi,1,0.00023,73285,16.91682,433208
12385,sschmitt,1,0.00023,73286,16.91705,433208
12386,sseetharaman6,1,0.00023,73287,16.91728,433208
12387,sshakeri,1,0.00023,73288,16.91751,433208
12388,sshine,1,0.00023,73289,16.91774,433208
12389,Sshnyari,1,0.00023,73290,16.91797,433208
12390,ssinghaldev,1,0.00023,73291,16.91820,433208
12391,ssnorrizaurous,1,0.00023,73292,16.91843,433208
12392,sstoyanovucsd,1,0.00023,73293,16.91866,433208
12393,sstubbs,1,0.00023,73294,16.91889,433208
12394,sstuntman,1,0.00023,73295,16.91912,433208
12395,ssytnikov18,1,0.00023,73296,16.91936,433208
12396,stan-iakov,1,0.00023,73297,16.91959,433208
12397,stanislavlevin,1,0.00023,73298,16.91982,433208
12398,stanluk,1,0.00023,73299,16.92005,433208
12399,stantonk,1,0.00023,73300,16.92028,433208
12400,StanYago,1,0.00023,73301,16.92051,433208
12401,starbassma,1,0.00023,73302,16.92074,433208
12402,Starblade42,1,0.00023,73303,16.92097,433208
12403,starcraft66,1,0.00023,73304,16.92120,433208
12404,StasPerekrestov,1,0.00023,73305,16.92143,433208
12405,staticdev,1,0.00023,73306,16.92166,433208
12406,stawii,1,0.00023,73307,16.92189,433208
12407,stebet,1,0.00023,73308,16.92213,433208
12408,stefanandres,1,0.00023,73309,16.92236,433208
12409,stefanKnott,1,0.00023,73310,16.92259,433208
12410,stefanlay,1,0.00023,73311,16.92282,433208
12411,stefanloerwald,1,0.00023,73312,16.92305,433208
12412,StefanMadsen,1,0.00023,73313,16.92328,433208
12413,StefanS111,1,0.00023,73314,16.92351,433208
12414,stefanvangastel,1,0.00023,73315,16.92374,433208
12415,steffenb91,1,0.00023,73316,16.92397,433208
12416,steffeneichler,1,0.00023,73317,16.92420,433208
12417,stepan111,1,0.00023,73318,16.92443,433208
12418,Stephan3555,1,0.00023,73319,16.92466,433208
12419,stephaneey,1,0.00023,73320,16.92490,433208
12420,stephanwesten,1,0.00023,73321,16.92513,433208
12421,stephenhong,1,0.00023,73322,16.92536,433208
12422,stephenrwalli,1,0.00023,73323,16.92559,433208
12423,stepusin,1,0.00023,73324,16.92582,433208
12424,sterlingwes,1,0.00023,73325,16.92605,433208
12425,SteveCruise,1,0.00023,73326,16.92628,433208
12426,SteveL1,1,0.00023,73327,16.92651,433208
12427,stevencl1013,1,0.00023,73328,16.92674,433208
12428,stevenklar,1,0.00023,73329,16.92697,433208
12429,StevenLiekens,1,0.00023,73330,16.92720,433208
12430,stevenmcastano,1,0.00023,73331,16.92743,433208
12431,steveQuadros,1,0.00023,73332,16.92767,433208
12432,stfnbstl,1,0.00023,73333,16.92790,433208
12433,sthomen,1,0.00023,73334,16.92813,433208
12434,Sticksword,1,0.00023,73335,16.92836,433208
12435,StiviiK,1,0.00023,73336,16.92859,433208
12436,stone-z,1,0.00023,73337,16.92882,433208
12437,storm1kk,1,0.00023,73338,16.92905,433208
12438,stpierre,1,0.00023,73339,16.92928,433208
12439,stradigi-andres-de-castro,1,0.00023,73340,16.92951,433208
12440,stradigi-eric-hammel,1,0.00023,73341,16.92974,433208
12441,strantalis,1,0.00023,73342,16.92997,433208
12442,strictnerd,1,0.00023,73343,16.93020,433208
12443,StrikerExtreem,1,0.00023,73344,16.93044,433208
12444,strowk,1,0.00023,73345,16.93067,433208
12445,stsang-intuit,1,0.00023,73346,16.93090,433208
12446,studiocredo,1,0.00023,73347,16.93113,433208
12447,stueeey,1,0.00023,73348,16.93136,433208
12448,stupidlamo,1,0.00023,73349,16.93159,433208
12449,stupidly-logical,1,0.00023,73350,16.93182,433208
12450,su7811659,1,0.00023,73351,16.93205,433208
12451,suauk,1,0.00023,73352,16.93228,433208
12452,subanasif,1,0.00023,73353,16.93251,433208
12453,subanithak,1,0.00023,73354,16.93274,433208
12454,subash20,1,0.00023,73355,16.93297,433208
12455,SubatomicHero,1,0.00023,73356,16.93321,433208
12456,subbukoutlook,1,0.00023,73357,16.93344,433208
12457,subhankarc,1,0.00023,73358,16.93367,433208
12458,Subhasis180689,1,0.00023,73359,16.93390,433208
12459,subhrang,1,0.00023,73360,16.93413,433208
12460,successfuljian,1,0.00023,73361,16.93436,433208
12461,Sudheerkumar,1,0.00023,73362,16.93459,433208
12462,sudip-moengage,1,0.00023,73363,16.93482,433208
12463,sudo6si,1,0.00023,73364,16.93505,433208
12464,sudo-bmitch,1,0.00023,73365,16.93528,433208
12465,sudochop,1,0.00023,73366,16.93551,433208
12466,sudswasavi,1,0.00023,73367,16.93574,433208
12467,suezzelur,1,0.00023,73368,16.93598,433208
12468,suh209,1,0.00023,73369,16.93621,433208
12469,suhavan-gupta,1,0.00023,73370,16.93644,433208
12470,suhsil-streammarket,1,0.00023,73371,16.93667,433208
12471,suibh,1,0.00023,73372,16.93690,433208
12472,sujaykulkarn,1,0.00023,73373,16.93713,433208
12473,suket22,1,0.00023,73374,16.93736,433208
12474,sulochan,1,0.00023,73375,16.93759,433208
12475,Sult,1,0.00023,73376,16.93782,433208
12476,sumanp89,1,0.00023,73377,16.93805,433208
12477,sumeetoc,1,0.00023,73378,16.93828,433208
12478,SumitKu91,1,0.00023,73379,16.93851,433208
12479,sumitkute,1,0.00023,73380,16.93875,433208
12480,sunilkrg,1,0.00023,73381,16.93898,433208
12481,Sunit25,1,0.00023,73382,16.93921,433208
12482,SunMinghui19,1,0.00023,73383,16.93944,433208
12483,sunxiang0918,1,0.00023,73384,16.93967,433208
12484,supabibz,1,0.00023,73385,16.93990,433208
12485,Super-LeiJie,1,0.00023,73386,16.94013,433208
12486,SuperTonic09,1,0.00023,73387,16.94036,433208
12487,suprnurd,1,0.00023,73388,16.94059,433208
12488,surajrana93,1,0.00023,73389,16.94082,433208
12489,sureshamk,1,0.00023,73390,16.94105,433208
12490,surj-bains,1,0.00023,73391,16.94128,433208
12491,suryak,1,0.00023,73392,16.94152,433208
12492,Sushant012,1,0.00023,73393,16.94175,433208
12493,sushil-prasad,1,0.00023,73394,16.94198,433208
12494,susinmotion,1,0.00023,73395,16.94221,433208
12495,suveshmathur,1,0.00023,73396,16.94244,433208
12496,Suyog942,1,0.00023,73397,16.94267,433208
12497,svalentino,1,0.00023,73398,16.94290,433208
12498,sventi555,1,0.00023,73399,16.94313,433208
12499,s-vivien,1,0.00023,73400,16.94336,433208
12500,svrc,1,0.00023,73401,16.94359,433208
12501,svrc-pivotal,1,0.00023,73402,16.94382,433208
12502,swagatopain6,1,0.00023,73403,16.94405,433208
12503,swarthofole,1,0.00023,73404,16.94429,433208
12504,swdee,1,0.00023,73405,16.94452,433208
12505,sweetib,1,0.00023,73406,16.94475,433208
12506,swkwon,1,0.00023,73407,16.94498,433208
12507,swqmaven,1,0.00023,73408,16.94521,433208
12508,sydneyvert,1,0.00023,73409,16.94544,433208
12509,syedimam0012,1,0.00023,73410,16.94567,433208
12510,Syed-Saifulla,1,0.00023,73411,16.94590,433208
12511,Sylfrena,1,0.00023,73412,16.94613,433208
12512,symanovich-a,1,0.00023,73413,16.94636,433208
12513,synepolskyi,1,0.00023,73414,16.94659,433208
12514,synsteve,1,0.00023,73415,16.94682,433208
12515,syntheticgio,1,0.00023,73416,16.94706,433208
12516,sysadmiral,1,0.00023,73417,16.94729,433208
12517,SystemicEmotions,1,0.00023,73418,16.94752,433208
12518,syvanen,1,0.00023,73419,16.94775,433208
12519,szab100,1,0.00023,73420,16.94798,433208
12520,szapps,1,0.00023,73421,16.94821,433208
12521,szarnyasg,1,0.00023,73422,16.94844,433208
12522,szediktam,1,0.00023,73423,16.94867,433208
12523,sznrit,1,0.00023,73424,16.94890,433208
12524,szwed,1,0.00023,73425,16.94913,433208
12525,szymek116,1,0.00023,73426,16.94936,433208
12526,szymonpk,1,0.00023,73427,16.94959,433208
12527,szymonrychu,1,0.00023,73428,16.94983,433208
12528,t051506,1,0.00023,73429,16.95006,433208
12529,t0k4rt,1,0.00023,73430,16.95029,433208
12530,t1hom7as,1,0.00023,73431,16.95052,433208
12531,t3mi,1,0.00023,73432,16.95075,433208
12532,tacf,1,0.00023,73433,16.95098,433208
12533,tacospiller,1,0.00023,73434,16.95121,433208
12534,taiidani,1,0.00023,73435,16.95144,433208
12535,taitelman,1,0.00023,73436,16.95167,433208
12536,takeo-hidaka,1,0.00023,73437,16.95190,433208
12537,tal47,1,0.00023,73438,16.95213,433208
12538,talalatpixlee,1,0.00023,73439,16.95236,433208
12539,tallmanbrew,1,0.00023,73440,16.95260,433208
12540,tamilmani1989,1,0.00023,73441,16.95283,433208
12541,tampler,1,0.00023,73442,16.95306,433208
12542,Tamronimus,1,0.00023,73443,16.95329,433208
12543,taneishamitchell,1,0.00023,73444,16.95352,433208
12544,tanenbaum,1,0.00023,73445,16.95375,433208
12545,tangname,1,0.00023,73446,16.95398,433208
12546,TangqiFeng,1,0.00023,73447,16.95421,433208
12547,tangweihua163,1,0.00023,73448,16.95444,433208
12548,tangzhankun,1,0.00023,73449,16.95467,433208
12549,tanishdragonemperor,1,0.00023,73450,16.95490,433208
12550,tanmayi2010,1,0.00023,73451,16.95513,433208
12551,tantonescu,1,0.00023,73452,16.95537,433208
12552,tarun9715m,1,0.00023,73453,16.95560,433208
12553,taryodor,1,0.00023,73454,16.95583,433208
12554,tatellos,1,0.00023,73455,16.95606,433208
12555,tathastu871,1,0.00023,73456,16.95629,433208
12556,taylor-sutton,1,0.00023,73457,16.95652,433208
12557,tchangs,1,0.00023,73458,16.95675,433208
12558,tclidi,1,0.00023,73459,16.95698,433208
12559,TC-robV,1,0.00023,73460,16.95721,433208
12560,tdensmore,1,0.00023,73461,16.95744,433208
12561,tdensmore-novant,1,0.00023,73462,16.95767,433208
12562,tdongsi,1,0.00023,73463,16.95790,433208
12563,tdsan,1,0.00023,73464,16.95814,433208
12564,tdwyer,1,0.00023,73465,16.95837,433208
12565,tdyas,1,0.00023,73466,16.95860,433208
12566,teamktown,1,0.00023,73467,16.95883,433208
12567,techgnosis,1,0.00023,73468,16.95906,433208
12568,TechHoops,1,0.00023,73469,16.95929,433208
12569,techieshark,1,0.00023,73470,16.95952,433208
12570,TechIsCool,1,0.00023,73471,16.95975,433208
12571,tedtramonte,1,0.00023,73472,16.95998,433208
12572,teejaded,1,0.00023,73473,16.96021,433208
12573,teke97,1,0.00023,73474,16.96044,433208
12574,tekian,1,0.00023,73475,16.96067,433208
12575,tekspacedemo,1,0.00023,73476,16.96091,433208
12576,telemmaite,1,0.00023,73477,16.96114,433208
12577,tenondra,1,0.00023,73478,16.96137,433208
12578,tenwolde,1,0.00023,73479,16.96160,433208
12579,te-online,1,0.00023,73480,16.96183,433208
12580,terrafying,1,0.00023,73481,16.96206,433208
12581,terzonstefano,1,0.00023,73482,16.96229,433208
12582,tessykt,1,0.00023,73483,16.96252,433208
12583,test-account-0,1,0.00023,73484,16.96275,433208
12584,testbsstest,1,0.00023,73485,16.96298,433208
12585,tete17,1,0.00023,73486,16.96321,433208
12586,tetsun,1,0.00023,73487,16.96344,433208
12587,texasbobs,1,0.00023,73488,16.96368,433208
12588,tfar,1,0.00023,73489,16.96391,433208
12589,tfedyanin,1,0.00023,73490,16.96414,433208
12590,tgamayush,1,0.00023,73491,16.96437,433208
12591,tgerczei,1,0.00023,73492,16.96460,433208
12592,tgergo1,1,0.00023,73493,16.96483,433208
12593,tgross,1,0.00023,73494,16.96506,433208
12594,tguptaji,1,0.00023,73495,16.96529,433208
12595,Thakurvaibhav,1,0.00023,73496,16.96552,433208
12596,Thalooka,1,0.00023,73497,16.96575,433208
12597,thande,1,0.00023,73498,16.96598,433208
12598,thangavel-projects,1,0.00023,73499,16.96621,433208
12599,thangchung,1,0.00023,73500,16.96645,433208
12600,ThaSami,1,0.00023,73501,16.96668,433208
12601,thatInfrastructureGuy,1,0.00023,73502,16.96691,433208
12602,The4kings,1,0.00023,73503,16.96714,433208
12603,theadityasam,1,0.00023,73504,16.96737,433208
12604,thealamu,1,0.00023,73505,16.96760,433208
12605,TheAli711,1,0.00023,73506,16.96783,433208
12606,TheAvalanche,1,0.00023,73507,16.96806,433208
12607,thebinary,1,0.00023,73508,16.96829,433208
12608,thechristschn,1,0.00023,73509,16.96852,433208
12609,thecooltechguy,1,0.00023,73510,16.96875,433208
12610,thedanielsun,1,0.00023,73511,16.96898,433208
12611,thedevilsvoice,1,0.00023,73512,16.96922,433208
12612,TheDiveO,1,0.00023,73513,16.96945,433208
12613,TheEnbyperor,1,0.00023,73514,16.96968,433208
12614,theggelund,1,0.00023,73515,16.96991,433208
12615,the-maldridge,1,0.00023,73516,16.97014,433208
12616,thenetengineer,1,0.00023,73517,16.97037,433208
12617,thenonsequitur,1,0.00023,73518,16.97060,433208
12618,Theog75,1,0.00023,73519,16.97083,433208
12619,theophilee,1,0.00023,73520,16.97106,433208
12620,ThePaulHarding,1,0.00023,73521,16.97129,433208
12621,thepoppingone,1,0.00023,73522,16.97152,433208
12622,therohanjaiswal,1,0.00023,73523,16.97175,433208
12623,therzv,1,0.00023,73524,16.97199,433208
12624,the-scott-hand,1,0.00023,73525,16.97222,433208
12625,theshatner,1,0.00023,73526,16.97245,433208
12626,thetechnick,1,0.00023,73527,16.97268,433208
12627,TheTripleV,1,0.00023,73528,16.97291,433208
12628,thezackm,1,0.00023,73529,16.97314,433208
12629,thiagoarrais,1,0.00023,73530,16.97337,433208
12630,thiagolinhares,1,0.00023,73531,16.97360,433208
12631,thiagonache,1,0.00023,73532,16.97383,433208
12632,thinpark,1,0.00023,73533,16.97406,433208
12633,ThisGuyCodes,1,0.00023,73534,16.97429,433208
12634,thodquach,1,0.00023,73535,16.97452,433208
12635,thomasheller,1,0.00023,73536,16.97476,433208
12636,thomaspoignant,1,0.00023,73537,16.97499,433208
12637,ThomWright,1,0.00023,73538,16.97522,433208
12638,thoralt,1,0.00023,73539,16.97545,433208
12639,ThoTischner,1,0.00023,73540,16.97568,433208
12640,thousandhu,1,0.00023,73541,16.97591,433208
12641,ThreeFx,1,0.00023,73542,16.97614,433208
12642,Thrimbda,1,0.00023,73543,16.97637,433208
12643,thrixton,1,0.00023,73544,16.97660,433208
12644,thyarles,1,0.00023,73545,16.97683,433208
12645,TiagoJMartins,1,0.00023,73546,16.97706,433208
12646,TiagoTT,1,0.00023,73547,16.97729,433208
12647,tianhe-oi,1,0.00023,73548,16.97753,433208
12648,tibetsam,1,0.00023,73549,16.97776,433208
12649,ticpu,1,0.00023,73550,16.97799,433208
12650,tiegz,1,0.00023,73551,16.97822,433208
12651,TiemenSch,1,0.00023,73552,16.97845,433208
12652,tigerwill90,1,0.00023,73553,16.97868,433208
12653,Tigraine,1,0.00023,73554,16.97891,433208
12654,tigrato,1,0.00023,73555,16.97914,433208
12655,tijldullers,1,0.00023,73556,16.97937,433208
12656,tilal6991,1,0.00023,73557,16.97960,433208
12657,Tilden18,1,0.00023,73558,16.97983,433208
12658,tillig,1,0.00023,73559,16.98007,433208
12659,tillt,1,0.00023,73560,16.98030,433208
12660,timcappalli,1,0.00023,73561,16.98053,433208
12661,timcruciano,1,0.00023,73562,16.98076,433208
12662,timfong888,1,0.00023,73563,16.98099,433208
12663,timofurrer,1,0.00023,73564,16.98122,433208
12664,timothyb89,1,0.00023,73565,16.98145,433208
12665,timothy-spencer,1,0.00023,73566,16.98168,433208
12666,timr-dev,1,0.00023,73567,16.98191,433208
12667,TimtationOne,1,0.00023,73568,16.98214,433208
12668,timtorChen,1,0.00023,73569,16.98237,433208
12669,tingkai-zhang,1,0.00023,73570,16.98260,433208
12670,tino,1,0.00023,73571,16.98284,433208
12671,titou10titou10,1,0.00023,73572,16.98307,433208
12672,tivizi,1,0.00023,73573,16.98330,433208
12673,tj,1,0.00023,73574,16.98353,433208
12674,tjanh123,1,0.00023,73575,16.98376,433208
12675,tjappo,1,0.00023,73576,16.98399,433208
12676,Tjianke,1,0.00023,73577,16.98422,433208
12677,tjjjwxzq,1,0.00023,73578,16.98445,433208
12678,tkhkokd,1,0.00023,73579,16.98468,433208
12679,tkoeck,1,0.00023,73580,16.98491,433208
12680,tkumark,1,0.00023,73581,16.98514,433208
12681,tlaukkan,1,0.00023,73582,16.98537,433208
12682,tlawrie,1,0.00023,73583,16.98561,433208
12683,tleish,1,0.00023,73584,16.98584,433208
12684,tlkanthan2020,1,0.00023,73585,16.98607,433208
12685,tlperini,1,0.00023,73586,16.98630,433208
12686,tlynchpin,1,0.00023,73587,16.98653,433208
12687,tm1810,1,0.00023,73588,16.98676,433208
12688,tmcarr,1,0.00023,73589,16.98699,433208
12689,tmccnnll,1,0.00023,73590,16.98722,433208
12690,tmojlupo,1,0.00023,73591,16.98745,433208
12691,tmongkolsmai,1,0.00023,73592,16.98768,433208
12692,tmyroadctfig,1,0.00023,73593,16.98791,433208
12693,tnleeuw,1,0.00023,73594,16.98814,433208
12694,tnn2,1,0.00023,73595,16.98838,433208
12695,toabi,1,0.00023,73596,16.98861,433208
12696,tobg,1,0.00023,73597,16.98884,433208
12697,TobiasAhnert,1,0.00023,73598,16.98907,433208
12698,tobiasgiese,1,0.00023,73599,16.98930,433208
12699,TobiasGrave,1,0.00023,73600,16.98953,433208
12700,tobias-huebner,1,0.00023,73601,16.98976,433208
12701,tobiasmuecksch,1,0.00023,73602,16.98999,433208
12702,tobias-zeptio,1,0.00023,73603,16.99022,433208
12703,toddward,1,0.00023,73604,16.99045,433208
12704,tokheim,1,0.00023,73605,16.99068,433208
12705,tolgaingenc,1,0.00023,73606,16.99091,433208
12706,toloco,1,0.00023,73607,16.99115,433208
12707,toluwaanimi,1,0.00023,73608,16.99138,433208
12708,tomahawk-pilot,1,0.00023,73609,16.99161,433208
12709,tomasaschan,1,0.00023,73610,16.99184,433208
12710,tomasfse,1,0.00023,73611,16.99207,433208
12711,tomasliu-agora,1,0.00023,73612,16.99230,433208
12712,tomassatka,1,0.00023,73613,16.99253,433208
12713,TomasWeg,1,0.00023,73614,16.99276,433208
12714,tomaszgawlik,1,0.00023,73615,16.99299,433208
12715,tomasz-kuzemko,1,0.00023,73616,16.99322,433208
12716,tomekit,1,0.00023,73617,16.99345,433208
12717,tomelliff,1,0.00023,73618,16.99368,433208
12718,tomeriffic,1,0.00023,73619,16.99392,433208
12719,tomersolomon1,1,0.00023,73620,16.99415,433208
12720,TomFletcher0,1,0.00023,73621,16.99438,433208
12721,tomikmar,1,0.00023,73622,16.99461,433208
12722,tomikonio,1,0.00023,73623,16.99484,433208
12723,TomLan42,1,0.00023,73624,16.99507,433208
12724,tommasopozzetti,1,0.00023,73625,16.99530,433208
12725,tommazzo89,1,0.00023,73626,16.99553,433208
12726,TommyQuality,1,0.00023,73627,16.99576,433208
12727,tomoechan,1,0.00023,73628,16.99599,433208
12728,tomp61,1,0.00023,73629,16.99622,433208
12729,tompaschenda,1,0.00023,73630,16.99645,433208
12730,TomUnequals,1,0.00023,73631,16.99669,433208
12731,tonholis,1,0.00023,73632,16.99692,433208
12732,tonnyadhi,1,0.00023,73633,16.99715,433208
12733,tony2001,1,0.00023,73634,16.99738,433208
12734,tonyabbott,1,0.00023,73635,16.99761,433208
12735,tonybenchsci,1,0.00023,73636,16.99784,433208
12736,TonyK-T,1,0.00023,73637,16.99807,433208
12737,tonym97,1,0.00023,73638,16.99830,433208
12738,tooolbox,1,0.00023,73639,16.99853,433208
12739,torgeirl,1,0.00023,73640,16.99876,433208
12740,torpinouche,1,0.00023,73641,16.99899,433208
12741,torsten-liermann,1,0.00023,73642,16.99922,433208
12742,tot-ra,1,0.00023,73643,16.99946,433208
12743,Toxblh,1,0.00023,73644,16.99969,433208
12744,tp6m4fu6250071,1,0.00023,73645,16.99992,433208
12745,tpyo,1,0.00023,73646,17.00015,433208
12746,TracyRagan,1,0.00023,73647,17.00038,433208
12747,TranDinhKhang,1,0.00023,73648,17.00061,433208
12748,travnewmatic,1,0.00023,73649,17.00084,433208
12749,trearcul,1,0.00023,73650,17.00107,433208
12750,trexx,1,0.00023,73651,17.00130,433208
12751,TReZ42,1,0.00023,73652,17.00153,433208
12752,TrikkStar,1,0.00023,73653,17.00176,433208
12753,tristanlins,1,0.00023,73654,17.00199,433208
12754,TroyPang,1,0.00023,73655,17.00223,433208
12755,trtt,1,0.00023,73656,17.00246,433208
12756,trushant0501,1,0.00023,73657,17.00269,433208
12757,TSASM,1,0.00023,73658,17.00292,433208
12758,tsekine354,1,0.00023,73659,17.00315,433208
12759,tsellers-r7,1,0.00023,73660,17.00338,433208
12760,tsfullman,1,0.00023,73661,17.00361,433208
12761,tshaiman,1,0.00023,73662,17.00384,433208
12762,tsharju,1,0.00023,73663,17.00407,433208
12763,tsing,1,0.00023,73664,17.00430,433208
12764,tsk9,1,0.00023,73665,17.00453,433208
12765,tsterker,1,0.00023,73666,17.00476,433208
12766,tsyrfa,1,0.00023,73667,17.00500,433208
12767,TszKitLo40,1,0.00023,73668,17.00523,433208
12768,tterrace,1,0.00023,73669,17.00546,433208
12769,ttjohn,1,0.00023,73670,17.00569,433208
12770,tudorgrig,1,0.00023,73671,17.00592,433208
12771,tumbl3w33d,1,0.00023,73672,17.00615,433208
12772,tuxiem,1,0.00023,73673,17.00638,433208
12773,tux-o-matic,1,0.00023,73674,17.00661,433208
12774,tvkit,1,0.00023,73675,17.00684,433208
12775,twinkbot,1,0.00023,73676,17.00707,433208
12776,twood02,1,0.00023,73677,17.00730,433208
12777,tydra-wang,1,0.00023,73678,17.00753,433208
12778,TylerPachal,1,0.00023,73679,17.00777,433208
12779,tzuryby,1,0.00023,73680,17.00800,433208
12780,ualter,1,0.00023,73681,17.00823,433208
12781,ubergeek77,1,0.00023,73682,17.00846,433208
12782,ubhide,1,0.00023,73683,17.00869,433208
12783,Uburro,1,0.00023,73684,17.00892,433208
12784,ucloud-lee,1,0.00023,73685,17.00915,433208
12785,uculcarni-puma,1,0.00023,73686,17.00938,433208
12786,UdhavKumar,1,0.00023,73687,17.00961,433208
12787,UdokaVrede,1,0.00023,73688,17.00984,433208
12788,ulugbekov,1,0.00023,73689,17.01007,433208
12789,umang5195,1,0.00023,73690,17.01030,433208
12790,UmangGupta0409,1,0.00023,73691,17.01054,433208
12791,uma-sethuraman,1,0.00023,73692,17.01077,433208
12792,unalterable,1,0.00023,73693,17.01100,433208
12793,undisputed-seraphim,1,0.00023,73694,17.01123,433208
12794,unfor19,1,0.00023,73695,17.01146,433208
12795,unitto1,1,0.00023,73696,17.01169,433208
12796,UnluckyAj,1,0.00023,73697,17.01192,433208
12797,unullmass,1,0.00023,73698,17.01215,433208
12798,uronce-cc,1,0.00023,73699,17.01238,433208
12799,usmcgwg,1,0.00023,73700,17.01261,433208
12800,utajum,1,0.00023,73701,17.01284,433208
12801,Uter1007,1,0.00023,73702,17.01307,433208
12802,utkarsh231,1,0.00023,73703,17.01331,433208
12803,utkarsh2811,1,0.00023,73704,17.01354,433208
12804,utsavakru,1,0.00023,73705,17.01377,433208
12805,v0112358,1,0.00023,73706,17.01400,433208
12806,v1k7g85,1,0.00023,73707,17.01423,433208
12807,va1erian,1,0.00023,73708,17.01446,433208
12808,vadimsht,1,0.00023,73709,17.01469,433208
12809,vaidik,1,0.00023,73710,17.01492,433208
12810,vainu-lauri,1,0.00023,73711,17.01515,433208
12811,Vaishnavi-cyber-blip,1,0.00023,73712,17.01538,433208
12812,valdemarpavesi,1,0.00023,73713,17.01561,433208
12813,valouille,1,0.00023,73714,17.01584,433208
12814,VanBantam,1,0.00023,73715,17.01608,433208
12815,vangarp,1,0.00023,73716,17.01631,433208
12816,vaniha,1,0.00023,73717,17.01654,433208
12817,vanjohnson879,1,0.00023,73718,17.01677,433208
12818,vardani,1,0.00023,73719,17.01700,433208
12819,VarroReve,1,0.00023,73720,17.01723,433208
12820,varshabhijeet,1,0.00023,73721,17.01746,433208
12821,varunbpatil,1,0.00023,73722,17.01769,433208
12822,vasudeva78,1,0.00023,73723,17.01792,433208
12823,vasu-git,1,0.00023,73724,17.01815,433208
12824,VasylSamoilov,1,0.00023,73725,17.01838,433208
12825,vayyappaneni,1,0.00023,73726,17.01861,433208
12826,vbence,1,0.00023,73727,17.01885,433208
12827,v-byte-cpu,1,0.00023,73728,17.01908,433208
12828,vdharmap,1,0.00023,73729,17.01931,433208
12829,vDMG,1,0.00023,73730,17.01954,433208
12830,vdvince9874,1,0.00023,73731,17.01977,433208
12831,Veath,1,0.00023,73732,17.02000,433208
12832,vedantdave77,1,0.00023,73733,17.02023,433208
12833,veenagurram,1,0.00023,73734,17.02046,433208
12834,veera83372,1,0.00023,73735,17.02069,433208
12835,Venkat8123,1,0.00023,73736,17.02092,433208
12836,venkateshreddy1388,1,0.00023,73737,17.02115,433208
12837,VeselaHouba,1,0.00023,73738,17.02138,433208
12838,vetal2504,1,0.00023,73739,17.02162,433208
12839,vfolk30,1,0.00023,73740,17.02185,433208
12840,vgunapati,1,0.00023,73741,17.02208,433208
12841,vhbfernandes,1,0.00023,73742,17.02231,433208
12842,viceice,1,0.00023,73743,17.02254,433208
12843,vickeyrihal1,1,0.00023,73744,17.02277,433208
12844,vicpara,1,0.00023,73745,17.02300,433208
12845,VictorLee0321,1,0.00023,73746,17.02323,433208
12846,victorlevasseur,1,0.00023,73747,17.02346,433208
12847,viggyr,1,0.00023,73748,17.02369,433208
12848,vigneshashokan,1,0.00023,73749,17.02392,433208
12849,vigneshsolution,1,0.00023,73750,17.02415,433208
12850,vigneshsweekaran,1,0.00023,73751,17.02439,433208
12851,vigohe,1,0.00023,73752,17.02462,433208
12852,vijaynidhi85,1,0.00023,73753,17.02485,433208
12853,vijayraghavareddy,1,0.00023,73754,17.02508,433208
12854,VikashAbhay,1,0.00023,73755,17.02531,433208
12855,vikashviraj,1,0.00023,73756,17.02554,433208
12856,vikram-3118,1,0.00023,73757,17.02577,433208
12857,vikramraman,1,0.00023,73758,17.02600,433208
12858,viktoriaas,1,0.00023,73759,17.02623,433208
12859,viktor-nikolaev,1,0.00023,73760,17.02646,433208
12860,villesau,1,0.00023,73761,17.02669,433208
12861,Vilsol,1,0.00023,73762,17.02692,433208
12862,vimalgopal,1,0.00023,73763,17.02716,433208
12863,Vinamra2009,1,0.00023,73764,17.02739,433208
12864,vinayakshnd,1,0.00023,73765,17.02762,433208
12865,vinaynaidu07,1,0.00023,73766,17.02785,433208
12866,vincentwu0101,1,0.00023,73767,17.02808,433208
12867,Vinge1718,1,0.00023,73768,17.02831,433208
12868,vinglogn,1,0.00023,73769,17.02854,433208
12869,vinhha96,1,0.00023,73770,17.02877,433208
12870,viniciusd,1,0.00023,73771,17.02900,433208
12871,Vinigas,1,0.00023,73772,17.02923,433208
12872,vinkdong,1,0.00023,73773,17.02946,433208
12873,vinodkmrm,1,0.00023,73774,17.02969,433208
12874,vinsce,1,0.00023,73775,17.02993,433208
12875,vinzo99,1,0.00023,73776,17.03016,433208
12876,vinzydev,1,0.00023,73777,17.03039,433208
12877,vioan,1,0.00023,73778,17.03062,433208
12878,viorelcanja,1,0.00023,73779,17.03085,433208
12879,vipingupta5352,1,0.00023,73780,17.03108,433208
12880,vipup,1,0.00023,73781,17.03131,433208
12881,vishal3108,1,0.00023,73782,17.03154,433208
12882,vishal-swarankar-sdl,1,0.00023,73783,17.03177,433208
12883,vishnu123sai,1,0.00023,73784,17.03200,433208
12884,vishnujanardhanan,1,0.00023,73785,17.03223,433208
12885,Vishnuvardhan777,1,0.00023,73786,17.03246,433208
12886,vishu42,1,0.00023,73787,17.03270,433208
12887,VitaliyShevchenko,1,0.00023,73788,17.03293,433208
12888,vitali-zevako,1,0.00023,73789,17.03316,433208
12889,vitamins,1,0.00023,73790,17.03339,433208
12890,vitas,1,0.00023,73791,17.03362,433208
12891,vitlibar,1,0.00023,73792,17.03385,433208
12892,vitt-bagal,1,0.00023,73793,17.03408,433208
12893,vivekab,1,0.00023,73794,17.03431,433208
12894,vivekananda49,1,0.00023,73795,17.03454,433208
12895,vivekanandg,1,0.00023,73796,17.03477,433208
12896,vivekbasappa,1,0.00023,73797,17.03500,433208
12897,vivekgkwd,1,0.00023,73798,17.03523,433208
12898,vivekpd15,1,0.00023,73799,17.03547,433208
12899,vivekraj59,1,0.00023,73800,17.03570,433208
12900,viveksonar,1,0.00023,73801,17.03593,433208
12901,vizhur,1,0.00023,73802,17.03616,433208
12902,vjayaramrh,1,0.00023,73803,17.03639,433208
12903,vjove,1,0.00023,73804,17.03662,433208
12904,vkartik97,1,0.00023,73805,17.03685,433208
12905,vkmc,1,0.00023,73806,17.03708,433208
12906,vkotheka,1,0.00023,73807,17.03731,433208
12907,vkrishnasamy,1,0.00023,73808,17.03754,433208
12908,vladimirmyshkovski,1,0.00023,73809,17.03777,433208
12909,vlcinsky,1,0.00023,73810,17.03800,433208
12910,vldanch,1,0.00023,73811,17.03824,433208
12911,vmalhotra22,1,0.00023,73812,17.03847,433208
12912,vmaurin,1,0.00023,73813,17.03870,433208
12913,vmdude,1,0.00023,73814,17.03893,433208
12914,vmendis-stash,1,0.00023,73815,17.03916,433208
12915,voctex,1,0.00023,73816,17.03939,433208
12916,voiser,1,0.00023,73817,17.03962,433208
12917,volaka,1,0.00023,73818,17.03985,433208
12918,volk1234,1,0.00023,73819,17.04008,433208
12919,volnei,1,0.00023,73820,17.04031,433208
12920,vol-pi,1,0.00023,73821,17.04054,433208
12921,VoltBit,1,0.00023,73822,17.04077,433208
12922,vonsch,1,0.00023,73823,17.04101,433208
12923,voodoodror,1,0.00023,73824,17.04124,433208
12924,vorticalbox,1,0.00023,73825,17.04147,433208
12925,vosuyak,1,0.00023,73826,17.04170,433208
12926,vothanhbinhlt,1,0.00023,73827,17.04193,433208
12927,Voxis,1,0.00023,73828,17.04216,433208
12928,vpatodia,1,0.00023,73829,17.04239,433208
12929,vprus,1,0.00023,73830,17.04262,433208
12930,vputz,1,0.00023,73831,17.04285,433208
12931,vrao1020,1,0.00023,73832,17.04308,433208
12932,VRay27,1,0.00023,73833,17.04331,433208
12933,vrichmond499,1,0.00023,73834,17.04354,433208
12934,vrischmann,1,0.00023,73835,17.04378,433208
12935,vrushali3297,1,0.00023,73836,17.04401,433208
12936,vs268153,1,0.00023,73837,17.04424,433208
12937,vsbus,1,0.00023,73838,17.04447,433208
12938,VShox,1,0.00023,73839,17.04470,433208
12939,vtaranenko,1,0.00023,73840,17.04493,433208
12940,vterdunov,1,0.00023,73841,17.04516,433208
12941,vtitor,1,0.00023,73842,17.04539,433208
12942,vtopc,1,0.00023,73843,17.04562,433208
12943,vukdavid,1,0.00023,73844,17.04585,433208
12944,vvlookman,1,0.00023,73845,17.04608,433208
12945,vxavictor513,1,0.00023,73846,17.04631,433208
12946,v-yarotsky,1,0.00023,73847,17.04655,433208
12947,vyaslav,1,0.00023,73848,17.04678,433208
12948,v-y-l,1,0.00023,73849,17.04701,433208
12949,v-zhuravlev,1,0.00023,73850,17.04724,433208
12950,w0x12ef,1,0.00023,73851,17.04747,433208
12951,w3st3ry,1,0.00023,73852,17.04770,433208
12952,w564791,1,0.00023,73853,17.04793,433208
12953,wader,1,0.00023,73854,17.04816,433208
12954,wadkar,1,0.00023,73855,17.04839,433208
12955,waelghaith,1,0.00023,73856,17.04862,433208
12956,walec51,1,0.00023,73857,17.04885,433208
12957,Walid47,1,0.00023,73858,17.04908,433208
12958,walkthetalk,1,0.00023,73859,17.04932,433208
12959,walls00000,1,0.00023,73860,17.04955,433208
12960,Walther,1,0.00023,73861,17.04978,433208
12961,waluo,1,0.00023,73862,17.05001,433208
12962,Wander1024,1,0.00023,73863,17.05024,433208
12963,wangcrazy1,1,0.00023,73864,17.05047,433208
12964,wangfakang,1,0.00023,73865,17.05070,433208
12965,wanghong230,1,0.00023,73866,17.05093,433208
12966,WANGKE-InCodeWeTrust,1,0.00023,73867,17.05116,433208
12967,WangMinjie114,1,0.00023,73868,17.05139,433208
12968,wangtao131520,1,0.00023,73869,17.05162,433208
12969,wangting1995,1,0.00023,73870,17.05185,433208
12970,wangweisong,1,0.00023,73871,17.05209,433208
12971,wangyu8460958,1,0.00023,73872,17.05232,433208
12972,wangyun1517,1,0.00023,73873,17.05255,433208
12973,wangzhentaodehao,1,0.00023,73874,17.05278,433208
12974,wanlinMa-163,1,0.00023,73875,17.05301,433208
12975,wasd120d,1,0.00023,73876,17.05324,433208
12976,wassimbj,1,0.00023,73877,17.05347,433208
12977,wbagdon,1,0.00023,73878,17.05370,433208
12978,wcedmisten,1,0.00023,73879,17.05393,433208
12979,wchargin,1,0.00023,73880,17.05416,433208
12980,wchrt,1,0.00023,73881,17.05439,433208
12981,wdazhi2020,1,0.00023,73882,17.05463,433208
12982,wdfinch,1,0.00023,73883,17.05486,433208
12983,webchi,1,0.00023,73884,17.05509,433208
12984,weberc2-tempus,1,0.00023,73885,17.05532,433208
12985,webmat,1,0.00023,73886,17.05555,433208
12986,webornottoweb,1,0.00023,73887,17.05578,433208
12987,Wei32333,1,0.00023,73888,17.05601,433208
12988,weichenqi,1,0.00023,73889,17.05624,433208
12989,wei-lee,1,0.00023,73890,17.05647,433208
12990,weiliujia,1,0.00023,73891,17.05670,433208
12991,weimdall,1,0.00023,73892,17.05693,433208
12992,WeipingGan,1,0.00023,73893,17.05716,433208
12993,welsonjr,1,0.00023,73894,17.05740,433208
12994,wemiprog,1,0.00023,73895,17.05763,433208
12995,wendaotao,1,0.00023,73896,17.05786,433208
12996,Wenfeng-GAO,1,0.00023,73897,17.05809,433208
12997,wengang,1,0.00023,73898,17.05832,433208
12998,Wenhao-Xu,1,0.00023,73899,17.05855,433208
12999,wenn32,1,0.00023,73900,17.05878,433208
13000,wenwenxiong,1,0.00023,73901,17.05901,433208
13001,WenwuPeng,1,0.00023,73902,17.05924,433208
13002,weppos,1,0.00023,73903,17.05947,433208
13003,wernerb,1,0.00023,73904,17.05970,433208
13004,weshouman,1,0.00023,73905,17.05993,433208
13005,wesley9620,1,0.00023,73906,17.06017,433208
13006,WesleyBatista,1,0.00023,73907,17.06040,433208
13007,wesleyorama2,1,0.00023,73908,17.06063,433208
13008,whilp,1,0.00023,73909,17.06086,433208
13009,whoislb,1,0.00023,73910,17.06109,433208
13010,wiamsuri,1,0.00023,73911,17.06132,433208
13011,widgetpl,1,0.00023,73912,17.06155,433208
13012,wietse-gmail,1,0.00023,73913,17.06178,433208
13013,wildersachin,1,0.00023,73914,17.06201,433208
13014,wilinger,1,0.00023,73915,17.06224,433208
13015,williambrode,1,0.00023,73916,17.06247,433208
13016,william-lg,1,0.00023,73917,17.06270,433208
13017,willie,1,0.00023,73918,17.06294,433208
13018,Win32Sector,1,0.00023,73919,17.06317,433208
13019,winaterion,1,0.00023,73920,17.06340,433208
13020,windingroad100hf,1,0.00023,73921,17.06363,433208
13021,windmark,1,0.00023,73922,17.06386,433208
13022,windNight,1,0.00023,73923,17.06409,433208
13023,Win-Man,1,0.00023,73924,17.06432,433208
13024,winrono,1,0.00023,73925,17.06455,433208
13025,wiredmartian,1,0.00023,73926,17.06478,433208
13026,wirwolf,1,0.00023,73927,17.06501,433208
13027,WisWang,1,0.00023,73928,17.06524,433208
13028,wjdingman1,1,0.00023,73929,17.06547,433208
13029,wj-Mcat,1,0.00023,73930,17.06571,433208
13030,wjsi,1,0.00023,73931,17.06594,433208
13031,Wkkkkk,1,0.00023,73932,17.06617,433208
13032,wlchn,1,0.00023,73933,17.06640,433208
13033,wlin-jin,1,0.00023,73934,17.06663,433208
13034,wlritchi,1,0.00023,73935,17.06686,433208
13035,wobuhuisuanmin,1,0.00023,73936,17.06709,433208
13036,woelflone,1,0.00023,73937,17.06732,433208
13037,wojmaz,1,0.00023,73938,17.06755,433208
13038,WojoInc,1,0.00023,73939,17.06778,433208
13039,wojtek-viirtue,1,0.00023,73940,17.06801,433208
13040,Woland2k,1,0.00023,73941,17.06824,433208
13041,wolfeidau,1,0.00023,73942,17.06848,433208
13042,wolfewicz,1,0.00023,73943,17.06871,433208
13043,wondersd,1,0.00023,73944,17.06894,433208
13044,wongchao,1,0.00023,73945,17.06917,433208
13045,workhorse2020,1,0.00023,73946,17.06940,433208
13046,wouterhund,1,0.00023,73947,17.06963,433208
13047,wpjunior,1,0.00023,73948,17.06986,433208
13048,wrahmann,1,0.00023,73949,17.07009,433208
13049,wrenashe,1,0.00023,73950,17.07032,433208
13050,WrzocHoo,1,0.00023,73951,17.07055,433208
13051,wscart,1,0.00023,73952,17.07078,433208
13052,WSLUser,1,0.00023,73953,17.07101,433208
13053,wsq003,1,0.00023,73954,17.07125,433208
13054,wsq704252212,1,0.00023,73955,17.07148,433208
13055,wsx812585705,1,0.00023,73956,17.07171,433208
13056,wuwo1952368901,1,0.00023,73957,17.07194,433208
13057,wwyhy,1,0.00023,73958,17.07217,433208
13058,wyyl1,1,0.00023,73959,17.07240,433208
13059,wzbwzt,1,0.00023,73960,17.07263,433208
13060,wzcwts521,1,0.00023,73961,17.07286,433208
13061,X3NOSIZ,1,0.00023,73962,17.07309,433208
13062,xa4a,1,0.00023,73963,17.07332,433208
13063,xanecs,1,0.00023,73964,17.07355,433208
13064,xanmanning,1,0.00023,73965,17.07378,433208
13065,xasor,1,0.00023,73966,17.07402,433208
13066,xAt0mZ,1,0.00023,73967,17.07425,433208
13067,xaxa06,1,0.00023,73968,17.07448,433208
13068,xcellenceit,1,0.00023,73969,17.07471,433208
13069,XeCycle,1,0.00023,73970,17.07494,433208
13070,xenoterracide,1,0.00023,73971,17.07517,433208
13071,xerdink,1,0.00023,73972,17.07540,433208
13072,xgourmandin,1,0.00023,73973,17.07563,433208
13073,XianB,1,0.00023,73974,17.07586,433208
13074,XiaokangLiuCUG,1,0.00023,73975,17.07609,433208
13075,xiaolul,1,0.00023,73976,17.07632,433208
13076,xiaonancc77,1,0.00023,73977,17.07655,433208
13077,xiegeo,1,0.00023,73978,17.07679,433208
13078,xiejiangzhao,1,0.00023,73979,17.07702,433208
13079,xifanyan,1,0.00023,73980,17.07725,433208
13080,xinfengliu,1,0.00023,73981,17.07748,433208
13081,xinjiahui,1,0.00023,73982,17.07771,433208
13082,Xiodra,1,0.00023,73983,17.07794,433208
13083,xiujuan95,1,0.00023,73984,17.07817,433208
13084,xiviu123,1,0.00023,73985,17.07840,433208
13085,xizhang0919,1,0.00023,73986,17.07863,433208
13086,xjuric29,1,0.00023,73987,17.07886,433208
13087,xlanor,1,0.00023,73988,17.07909,433208
13088,xlrd,1,0.00023,73989,17.07932,433208
13089,xmath279,1,0.00023,73990,17.07956,433208
13090,xmwilldo,1,0.00023,73991,17.07979,433208
13091,xoanmi,1,0.00023,73992,17.08002,433208
13092,xolott,1,0.00023,73993,17.08025,433208
13093,xqzhang2015,1,0.00023,73994,17.08048,433208
13094,xriser,1,0.00023,73995,17.08071,433208
13095,xt94c4t9ce,1,0.00023,73996,17.08094,433208
13096,xtothp00,1,0.00023,73997,17.08117,433208
13097,xtroncode,1,0.00023,73998,17.08140,433208
13098,xuan200922702,1,0.00023,73999,17.08163,433208
13099,xuanaxuan,1,0.00023,74000,17.08186,433208
13100,xuanvinhln,1,0.00023,74001,17.08209,433208
13101,XuanYang-cn,1,0.00023,74002,17.08233,433208
13102,xuanyuanaosheng,1,0.00023,74003,17.08256,433208
13103,xuchengli,1,0.00023,74004,17.08279,433208
13104,XueCangQiuYe,1,0.00023,74005,17.08302,433208
13105,Xuehai-Chen,1,0.00023,74006,17.08325,433208
13106,XuHaoIgeneral,1,0.00023,74007,17.08348,433208
13107,xurei,1,0.00023,74008,17.08371,433208
13108,xussof,1,0.00023,74009,17.08394,433208
13109,xuxiaoguang666,1,0.00023,74010,17.08417,433208
13110,xvdy,1,0.00023,74011,17.08440,433208
13111,xwg1984,1,0.00023,74012,17.08463,433208
13112,xxjwxc,1,0.00023,74013,17.08486,433208
13113,xxpniu,1,0.00023,74014,17.08510,433208
13114,xygon,1,0.00023,74015,17.08533,433208
13115,xylix,1,0.00023,74016,17.08556,433208
13116,xyslion,1,0.00023,74017,17.08579,433208
13117,XY-Yolanda,1,0.00023,74018,17.08602,433208
13118,xyyp224,1,0.00023,74019,17.08625,433208
13119,y2030,1,0.00023,74020,17.08648,433208
13120,y6vmeq,1,0.00023,74021,17.08671,433208
13121,y805939188,1,0.00023,74022,17.08694,433208
13122,YahuiAn,1,0.00023,74023,17.08717,433208
13123,yajna-pandith,1,0.00023,74024,17.08740,433208
13124,yamajik,1,0.00023,74025,17.08763,433208
13125,yaminisridaran,1,0.00023,74026,17.08787,433208
13126,yanchenko-igor,1,0.00023,74027,17.08810,433208
13127,Yangstatus,1,0.00023,74028,17.08833,433208
13128,yangwenyanibm,1,0.00023,74029,17.08856,433208
13129,yangxinyi8,1,0.00023,74030,17.08879,433208
13130,yantk-hk,1,0.00023,74031,17.08902,433208
13131,yarnA,1,0.00023,74032,17.08925,433208
13132,yaron,1,0.00023,74033,17.08948,433208
13133,yashchoudhary8955,1,0.00023,74034,17.08971,433208
13134,Yash-Handa,1,0.00023,74035,17.08994,433208
13135,YashishDua,1,0.00023,74036,17.09017,433208
13136,YashMathur,1,0.00023,74037,17.09040,433208
13137,Yashs911,1,0.00023,74038,17.09064,433208
13138,YasukeXXX,1,0.00023,74039,17.09087,433208
13139,yboujallab,1,0.00023,74040,17.09110,433208
13140,ycfreeman,1,0.00023,74041,17.09133,433208
13141,ydarb,1,0.00023,74042,17.09156,433208
13142,yehaifeng,1,0.00023,74043,17.09179,433208
13143,yehudamakarov,1,0.00023,74044,17.09202,433208
13144,yehuda-sagron,1,0.00023,74045,17.09225,433208
13145,yertym,1,0.00023,74046,17.09248,433208
13146,yeshwanth1312,1,0.00023,74047,17.09271,433208
13147,yew1eb,1,0.00023,74048,17.09294,433208
13148,yexk,1,0.00023,74049,17.09317,433208
13149,yeyudetiankon1,1,0.00023,74050,17.09341,433208
13150,ygrosu,1,0.00023,74051,17.09364,433208
13151,yhding2003,1,0.00023,74052,17.09387,433208
13152,yhrn,1,0.00023,74053,17.09410,433208
13153,yhvicey,1,0.00023,74054,17.09433,433208
13154,yifan,1,0.00023,74055,17.09456,433208
13155,yindaheng98,1,0.00023,74056,17.09479,433208
13156,yiransheng,1,0.00023,74057,17.09502,433208
13157,yiyan-wish,1,0.00023,74058,17.09525,433208
13158,yks0000,1,0.00023,74059,17.09548,433208
13159,ylangisc,1,0.00023,74060,17.09571,433208
13160,yogihardi,1,0.00023,74061,17.09594,433208
13161,yogisau,1,0.00023,74062,17.09618,433208
13162,yogyad,1,0.00023,74063,17.09641,433208
13163,yokohama4580,1,0.00023,74064,17.09664,433208
13164,yonatankahana,1,0.00023,74065,17.09687,433208
13165,YongHaoWu,1,0.00023,74066,17.09710,433208
13166,yonirab,1,0.00023,74067,17.09733,433208
13167,yonwon01,1,0.00023,74068,17.09756,433208
13168,yoonkwon,1,0.00023,74069,17.09779,433208
13169,yoonmac,1,0.00023,74070,17.09802,433208
13170,yoonseok312,1,0.00023,74071,17.09825,433208
13171,yoshz,1,0.00023,74072,17.09848,433208
13172,yosshy,1,0.00023,74073,17.09871,433208
13173,yossisegev,1,0.00023,74074,17.09895,433208
13174,yourcodinsmas,1,0.00023,74075,17.09918,433208
13175,youxq,1,0.00023,74076,17.09941,433208
13176,yozaam,1,0.00023,74077,17.09964,433208
13177,ypadlyak,1,0.00023,74078,17.09987,433208
13178,ysagron1,1,0.00023,74079,17.10010,433208
13179,ysahil97,1,0.00023,74080,17.10033,433208
13180,yschimke,1,0.00023,74081,17.10056,433208
13181,ysde,1,0.00023,74082,17.10079,433208
13182,ysingla0580,1,0.00023,74083,17.10102,433208
13183,yttdj,1,0.00023,74084,17.10125,433208
13184,yuanjize,1,0.00023,74085,17.10148,433208
13185,yu-areznikov,1,0.00023,74086,17.10172,433208
13186,yubofredwang,1,0.00023,74087,17.10195,433208
13187,yudar1024,1,0.00023,74088,17.10218,433208
13188,yueseW,1,0.00023,74089,17.10241,433208
13189,YukSeungChan,1,0.00023,74090,17.10264,433208
13190,yunhailuo,1,0.00023,74091,17.10287,433208
13191,yuraxdrumz,1,0.00023,74092,17.10310,433208
13192,yurilaaziz,1,0.00023,74093,17.10333,433208
13193,yurmuki,1,0.00023,74094,17.10356,433208
13194,yurykats,1,0.00023,74095,17.10379,433208
13195,yusiwen,1,0.00023,74096,17.10402,433208
13196,yuzhaopeng,1,0.00023,74097,17.10425,433208
13197,yxliang01,1,0.00023,74098,17.10449,433208
13198,yxyx520,1,0.00023,74099,17.10472,433208
13199,yyf1986,1,0.00023,74100,17.10495,433208
13200,yzhao1012,1,0.00023,74101,17.10518,433208
13201,yzwdroid,1,0.00023,74102,17.10541,433208
13202,zach-robinson,1,0.00023,74103,17.10564,433208
13203,zak905,1,0.00023,74104,17.10587,433208
13204,zanven42,1,0.00023,74105,17.10610,433208
13205,zaourzag,1,0.00023,74106,17.10633,433208
13206,zaphod72,1,0.00023,74107,17.10656,433208
13207,zarbis,1,0.00023,74108,17.10679,433208
13208,zaro,1,0.00023,74109,17.10702,433208
13209,zatricky,1,0.00023,74110,17.10726,433208
13210,zcc35357949,1,0.00023,74111,17.10749,433208
13211,zcnewt,1,0.00023,74112,17.10772,433208
13212,zdenulo,1,0.00023,74113,17.10795,433208
13213,zdyj3170101136,1,0.00023,74114,17.10818,433208
13214,zdykstra,1,0.00023,74115,17.10841,433208
13215,zeddii,1,0.00023,74116,17.10864,433208
13216,ZedYeung,1,0.00023,74117,17.10887,433208
13217,zeeshanejaz,1,0.00023,74118,17.10910,433208
13218,zeeshanthedev590,1,0.00023,74119,17.10933,433208
13219,zeeshen,1,0.00023,74120,17.10956,433208
13220,zeldigas,1,0.00023,74121,17.10979,433208
13221,zentale,1,0.00023,74122,17.11003,433208
13222,zepatrik,1,0.00023,74123,17.11026,433208
13223,zerodayz,1,0.00023,74124,17.11049,433208
13224,zerospiel,1,0.00023,74125,17.11072,433208
13225,zewelor,1,0.00023,74126,17.11095,433208
13226,zfrank,1,0.00023,74127,17.11118,433208
13227,zgcbj,1,0.00023,74128,17.11141,433208
13228,zgramana,1,0.00023,74129,17.11164,433208
13229,zhangalex,1,0.00023,74130,17.11187,433208
13230,ZhangHanDong,1,0.00023,74131,17.11210,433208
13231,zhangnju,1,0.00023,74132,17.11233,433208
13232,zhangzhenhuajack,1,0.00023,74133,17.11256,433208
13233,zhaobei,1,0.00023,74134,17.11280,433208
13234,zhaofengli,1,0.00023,74135,17.11303,433208
13235,zhao-lang,1,0.00023,74136,17.11326,433208
13236,zhcsyncer,1,0.00023,74137,17.11349,433208
13237,zhengxiaomei123,1,0.00023,74138,17.11372,433208
13238,zhfish,1,0.00023,74139,17.11395,433208
13239,zhhray,1,0.00023,74140,17.11418,433208
13240,zhixiangjoy,1,0.00023,74141,17.11441,433208
13241,zhou880220,1,0.00023,74142,17.11464,433208
13242,zhoubonet,1,0.00023,74143,17.11487,433208
13243,zhoujinfu,1,0.00023,74144,17.11510,433208
13244,zhouxdd,1,0.00023,74145,17.11533,433208
13245,zhouyoufa,1,0.00023,74146,17.11557,433208
13246,zhranklin,1,0.00023,74147,17.11580,433208
13247,zhu20200720,1,0.00023,74148,17.11603,433208
13248,zhujiangyou,1,0.00023,74149,17.11626,433208
13249,Zierhut-IT,1,0.00023,74150,17.11649,433208
13250,zihad247414,1,0.00023,74151,17.11672,433208
13251,zikani03,1,0.00023,74152,17.11695,433208
13252,ziksha-tech,1,0.00023,74153,17.11718,433208
13253,ziqizh,1,0.00023,74154,17.11741,433208
13254,zivsalzmanappd,1,0.00023,74155,17.11764,433208
13255,Ziwi01,1,0.00023,74156,17.11787,433208
13256,zjiang91,1,0.00023,74157,17.11810,433208
13257,zjyuan,1,0.00023,74158,17.11834,433208
13258,zkmrgirish,1,0.00023,74159,17.11857,433208
13259,zlogic,1,0.00023,74160,17.11880,433208
13260,zm274310577,1,0.00023,74161,17.11903,433208
13261,Zodor,1,0.00023,74162,17.11926,433208
13262,zoeldjian,1,0.00023,74163,17.11949,433208
13263,zolij,1,0.00023,74164,17.11972,433208
13264,zomble,1,0.00023,74165,17.11995,433208
13265,zouchengli,1,0.00023,74166,17.12018,433208
13266,zouchengtao,1,0.00023,74167,17.12041,433208
13267,ZPerling,1,0.00023,74168,17.12064,433208
13268,zqingqing1,1,0.00023,74169,17.12087,433208
13269,zrhmn,1,0.00023,74170,17.12111,433208
13270,zsaurabhsabharwal,1,0.00023,74171,17.12134,433208
13271,zsuzhengdu,1,0.00023,74172,17.12157,433208
13272,ztj,1,0.00023,74173,17.12180,433208
13273,ztl8702,1,0.00023,74174,17.12203,433208
13274,zub0r,1,0.00023,74175,17.12226,433208
13275,zuiurs,1,0.00023,74176,17.12249,433208
13276,ZusorCode,1,0.00023,74177,17.12272,433208
13277,zxiang179,1,0.00023,74178,17.12295,433208
13278,zycon,1,0.00023,74179,17.12318,433208
13279,zyjiaobj,1,0.00023,74180,17.12341,433208
13280,zyt312074545,1,0.00023,74181,17.12364,433208
13281,zzarbi,1,0.00023,74182,17.12388,433208
13282,zzmg,1,0.00023,74183,17.12411,433208
13283,zzur,1,0.00023,74184,17.12434,433208
