rank_number,actor,contributions,percent,cumulative_sum,cumulative_percent,all_contributions
1,ti-srebot,2604,0.30252,2604,0.30252,860782
2,nsmbot,1543,0.17926,4147,0.48177,860782
3,J0zi,1228,0.14266,5375,0.62443,860782
4,floryut,1217,0.14138,6592,0.76582,860782
5,mvalahtv,970,0.11269,7562,0.87850,860782
6,jannfis,964,0.11199,8526,0.99049,860782
7,cynthia-sg,960,0.11153,9486,1.10202,860782
8,eddynaka,947,0.11002,10433,1.21204,860782
9,dfreilich,912,0.10595,11345,1.31799,860782
10,brianpursley,849,0.09863,12194,1.41662,860782
11,natalieparellano,849,0.09863,13043,1.51525,860782
12,im-konge,843,0.09793,13886,1.61318,860782
13,brandond,788,0.09154,14674,1.70473,860782
14,celestehorgan,769,0.08934,15443,1.79407,860782
15,jakub-dzon,755,0.08771,16198,1.88178,860782
16,maiqueb,751,0.08725,16949,1.96902,860782
17,yiqigao217,737,0.08562,17686,2.05464,860782
18,whynowy,717,0.08330,18403,2.13794,860782
19,RamLavi,660,0.07667,19063,2.21461,860782
20,joshimoo,627,0.07284,19690,2.28745,860782
21,ormergi,613,0.07121,20303,2.35867,860782
22,ocelotl,589,0.06843,20892,2.42710,860782
23,ryanzhang-oss,583,0.06773,21475,2.49482,860782
24,Riaankl,555,0.06448,22030,2.55930,860782
25,ariscahyadi,542,0.06297,22572,2.62227,860782
26,prasadkatti,523,0.06076,23095,2.68303,860782
27,jean-edouard,493,0.05727,23588,2.74030,860782
28,5kbpers,491,0.05704,24079,2.79734,860782
29,dthomson25,488,0.05669,24567,2.85403,860782
30,asmacdo,478,0.05553,25045,2.90956,860782
31,gaurav1086,450,0.05228,25495,2.96184,860782
32,ovirt-infra,445,0.05170,25940,3.01354,860782
33,shuuji3,439,0.05100,26379,3.06454,860782
34,phanimarupaka,436,0.05065,26815,3.11519,860782
35,CLAassistant,431,0.05007,27246,3.16526,860782
36,M00nF1sh,421,0.04891,27667,3.21417,860782
37,saikat-royc,378,0.04391,28045,3.25808,860782
38,mum4k,377,0.04380,28422,3.30188,860782
39,corneliusweig,373,0.04333,28795,3.34521,860782
40,PhanLe1010,369,0.04287,29164,3.38808,860782
41,Little-Wallace,365,0.04240,29529,3.43049,860782
42,boknowswiki,364,0.04229,29893,3.47277,860782
43,eric846,346,0.04020,30239,3.51297,860782
44,mattcary,339,0.03938,30578,3.55235,860782
45,khushboo-rancher,335,0.03892,30913,3.59127,860782
46,puerco,334,0.03880,31247,3.63007,860782
47,tosi3k,333,0.03869,31580,3.66876,860782
48,Yisaer,330,0.03834,31910,3.70709,860782
49,agentpoyo,319,0.03706,32229,3.74415,860782
50,omeryahud,317,0.03683,32546,3.78098,860782
51,MoShitrit,316,0.03671,32862,3.81769,860782
52,Jefftree,307,0.03567,33169,3.85336,860782
53,Aneurysm9,306,0.03555,33475,3.88891,860782
54,jprzychodzen,306,0.03555,33781,3.92445,860782
55,evantorrie,301,0.03497,34082,3.95942,860782
56,Renkai,300,0.03485,34382,3.99427,860782
57,fewdan,299,0.03474,34681,4.02901,860782
58,sbailey-arm,299,0.03474,34980,4.06375,860782
59,cumason123,296,0.03439,35276,4.09813,860782
60,Shell32-Natsu,295,0.03427,35571,4.13241,860782
61,evanap,288,0.03346,35859,4.16586,860782
62,lhy1024,283,0.03288,36142,4.19874,860782
63,sanderson042,280,0.03253,36422,4.23127,860782
64,xpivarc,279,0.03241,36701,4.26368,860782
65,kennytm,278,0.03230,36979,4.29598,860782
66,florincoras,276,0.03206,37255,4.32804,860782
67,sowmyav27,276,0.03206,37531,4.36011,860782
68,michaelmdresser,273,0.03172,37804,4.39182,860782
69,vbnrh,273,0.03172,38077,4.42354,860782
70,yosrym93,271,0.03148,38348,4.45502,860782
71,zhongzc,271,0.03148,38619,4.48650,860782
72,LuckySB,267,0.03102,38886,4.51752,860782
73,rleungx,267,0.03102,39153,4.54854,860782
74,ZhiFeng1993,267,0.03102,39420,4.57956,860782
75,chelseychen,266,0.03090,39686,4.61046,860782
76,lholmquist,261,0.03032,39947,4.64078,860782
77,GsssC,257,0.02986,40204,4.67064,860782
78,thotz,257,0.02986,40461,4.70049,860782
79,aabmass,256,0.02974,40717,4.73023,860782
80,GinnyJI,254,0.02951,40971,4.75974,860782
81,jqmichael,254,0.02951,41225,4.78925,860782
82,MushuEE,254,0.02951,41479,4.81876,860782
83,brybacki,247,0.02869,41726,4.84745,860782
84,donnadionne,246,0.02858,41972,4.87603,860782
85,mazzystr,246,0.02858,42218,4.90461,860782
86,rbreeze,236,0.02742,42454,4.93203,860782
87,cici37,232,0.02695,42686,4.95898,860782
88,harishsurf,232,0.02695,42918,4.98593,860782
89,JeremyOT,227,0.02637,43145,5.01230,860782
90,cindyxue,226,0.02626,43371,5.03856,860782
91,yodahekinsew,223,0.02591,43594,5.06446,860782
92,samflattery,221,0.02567,43815,5.09014,860782
93,JeffLuoo,220,0.02556,44035,5.11570,860782
94,wmcdona89,220,0.02556,44255,5.14126,860782
95,TBBle,219,0.02544,44474,5.16670,860782
96,codeblooded,217,0.02521,44691,5.19191,860782
97,Cweiping,215,0.02498,44906,5.21688,860782
98,chriswldenyer,214,0.02486,45120,5.24175,860782
99,Rainton,211,0.02451,45331,5.26626,860782
100,jwangyangls,208,0.02416,45539,5.29042,860782
101,qqustc,206,0.02393,45745,5.31435,860782
102,bsdnet,204,0.02370,45949,5.33805,860782
103,jianwen612,204,0.02370,46153,5.36175,860782
104,sethp-nr,203,0.02358,46356,5.38534,860782
105,cnnradams,197,0.02289,46553,5.40822,860782
106,AndiLi99,195,0.02265,46748,5.43088,860782
107,wangcanfengxs,194,0.02254,46942,5.45341,860782
108,ASOPVII,190,0.02207,47132,5.47549,860782
109,govargo,189,0.02196,47321,5.49744,860782
110,skyzh,186,0.02161,47507,5.51905,860782
111,AndrewAXue,185,0.02149,47692,5.54054,860782
112,SomtochiAma,185,0.02149,47877,5.56204,860782
113,ashleighgregory,182,0.02114,48059,5.58318,860782
114,g-easy,182,0.02114,48241,5.60432,860782
115,S-ayanide,181,0.02103,48422,5.62535,860782
116,tjoshum,179,0.02080,48601,5.64615,860782
117,yashrsharma44,178,0.02068,48779,5.66682,860782
118,chriskim06,177,0.02056,48956,5.68739,860782
119,michaelkolber,177,0.02056,49133,5.70795,860782
120,rohit-nayak-ps,177,0.02056,49310,5.72851,860782
121,sophieliu15,177,0.02056,49487,5.74907,860782
122,longfangsong,176,0.02045,49663,5.76952,860782
123,thesuperzapper,176,0.02045,49839,5.78997,860782
124,JmPotato,175,0.02033,50014,5.81030,860782
125,phlax,172,0.01998,50186,5.83028,860782
126,stedsome,172,0.01998,50358,5.85026,860782
127,EleanorRigby,171,0.01987,50529,5.87013,860782
128,macsux,171,0.01987,50700,5.88999,860782
129,b01901143,169,0.01963,50869,5.90963,860782
130,msedzins,168,0.01952,51037,5.92914,860782
131,animeshk08,167,0.01940,51204,5.94854,860782
132,dengliming,166,0.01928,51370,5.96783,860782
133,harshanarayana,166,0.01928,51536,5.98711,860782
134,kbrockhoff,166,0.01928,51702,6.00640,860782
135,subhamkrai,163,0.01894,51865,6.02534,860782
136,legendecas,161,0.01870,52026,6.04404,860782
137,nadiaciobanu,158,0.01836,52184,6.06239,860782
138,scgao,158,0.01836,52342,6.08075,860782
139,champtar,157,0.01824,52499,6.09899,860782
140,johncming,157,0.01824,52656,6.11723,860782
141,luogangyi,157,0.01824,52813,6.13547,860782
142,ranjithkumar007,157,0.01824,52970,6.15371,860782
143,soulseen,157,0.01824,53127,6.17195,860782
144,ityuhui,153,0.01777,53280,6.18972,860782
145,joechrisellis,150,0.01743,53430,6.20715,860782
146,svcbot-qecnsdp,150,0.01743,53580,6.22457,860782
147,nevill,149,0.01731,53729,6.24188,860782
148,Akilan1999,148,0.01719,53877,6.25908,860782
149,ansjsun,148,0.01719,54025,6.27627,860782
150,prmsrswt,145,0.01685,54170,6.29311,860782
151,yugantrana,145,0.01685,54315,6.30996,860782
152,kumarvin123,144,0.01673,54459,6.32669,860782
153,Sakuralbj,144,0.01673,54603,6.34342,860782
154,JingboWangGoogle,143,0.01661,54746,6.36003,860782
155,Thor-wl,143,0.01661,54889,6.37664,860782
156,vperi1730,143,0.01661,55032,6.39326,860782
157,davinci26,142,0.01650,55174,6.40975,860782
158,wangforthinker,142,0.01650,55316,6.42625,860782
159,heyams,141,0.01638,55457,6.44263,860782
160,mabdinur,141,0.01638,55598,6.45901,860782
161,WT-Liu,141,0.01638,55739,6.47539,860782
162,ericmustin,136,0.01580,55875,6.49119,860782
163,hencrice,136,0.01580,56011,6.50699,860782
164,reggiemcdonald,136,0.01580,56147,6.52279,860782
165,eapolinario,135,0.01568,56282,6.53847,860782
166,zhlhahaha,135,0.01568,56417,6.55416,860782
167,admilazz,134,0.01557,56551,6.56972,860782
168,akrejcir,134,0.01557,56685,6.58529,860782
169,javidiaz,134,0.01557,56819,6.60086,860782
170,lixiang233,134,0.01557,56953,6.61643,860782
171,thisisobate,133,0.01545,57086,6.63188,860782
172,ArthurSens,132,0.01533,57218,6.64721,860782
173,Hellcatlk,132,0.01533,57350,6.66255,860782
174,dfeldman,131,0.01522,57481,6.67777,860782
175,dubious90,130,0.01510,57611,6.69287,860782
176,johnbley,130,0.01510,57741,6.70797,860782
177,maxgio92,130,0.01510,57871,6.72307,860782
178,vemelin-epm,130,0.01510,58001,6.73818,860782
179,farah,129,0.01499,58130,6.75316,860782
180,liuming-dev,128,0.01487,58258,6.76803,860782
181,adriancole,126,0.01464,58384,6.78267,860782
182,foreseeable,126,0.01464,58510,6.79731,860782
183,KBaichoo,126,0.01464,58636,6.81195,860782
184,Nicolas-MacBeth,126,0.01464,58762,6.82658,860782
185,satac2,125,0.01452,58887,6.84110,860782
186,rajkumar-rangaraj,123,0.01429,59010,6.85539,860782
187,viniciusbds,123,0.01429,59133,6.86968,860782
188,yoonian,123,0.01429,59256,6.88397,860782
189,Fullstop000,122,0.01417,59378,6.89815,860782
190,khhirani,122,0.01417,59500,6.91232,860782
191,wbpcode,122,0.01417,59622,6.92649,860782
192,EdZou,121,0.01406,59743,6.94055,860782
193,Jiawei0227,119,0.01382,59862,6.95437,860782
194,tirelibirefe,119,0.01382,59981,6.96820,860782
195,vaniisgh,119,0.01382,60100,6.98202,860782
196,yulin-liang,118,0.01371,60218,6.99573,860782
197,Adirio,117,0.01359,60335,7.00932,860782
198,innerr,117,0.01359,60452,7.02292,860782
199,mark9white,117,0.01359,60569,7.03651,860782
200,Rustin-Liu,117,0.01359,60686,7.05010,860782
201,yannis218,117,0.01359,60803,7.06369,860782
202,ls889,116,0.01348,60919,7.07717,860782
203,pancernik,116,0.01348,61035,7.09065,860782
204,toddmgreer,115,0.01336,61150,7.10401,860782
205,yuvalturg,114,0.01324,61264,7.11725,860782
206,ashithasantosh,113,0.01313,61377,7.13038,860782
207,chengyu-l,113,0.01313,61490,7.14350,860782
208,matthew-chirgwin,113,0.01313,61603,7.15663,860782
209,frittentheke,112,0.01301,61715,7.16964,860782
210,numerodix,111,0.01290,61826,7.18254,860782
211,snakwu,111,0.01290,61937,7.19543,860782
212,swetharepakula,111,0.01290,62048,7.20833,860782
213,huyan0,110,0.01278,62158,7.22111,860782
214,vinaykul,110,0.01278,62268,7.23389,860782
215,chaoqin-li1123,109,0.01266,62377,7.24655,860782
216,chlins,109,0.01266,62486,7.25921,860782
217,Jonsy13,109,0.01266,62595,7.27188,860782
218,tjstansell,109,0.01266,62704,7.28454,860782
219,vamossagar12,109,0.01266,62813,7.29720,860782
220,hs0210,108,0.01255,62921,7.30975,860782
221,kishorj,108,0.01255,63029,7.32230,860782
222,kushthedude,108,0.01255,63137,7.33484,860782
223,jku,107,0.01243,63244,7.34727,860782
224,St0rmingBr4in,106,0.01231,63350,7.35959,860782
225,nholbrook,105,0.01220,63455,7.37179,860782
226,AngleNet,104,0.01208,63559,7.38387,860782
227,helio-frota,103,0.01197,63662,7.39583,860782
228,kasey,102,0.01185,63764,7.40768,860782
229,belm0,101,0.01173,63865,7.41942,860782
230,Brandon-Kimberly,101,0.01173,63966,7.43115,860782
231,mohanli-ml,101,0.01173,64067,7.44288,860782
232,Danil-Grigorev,99,0.01150,64166,7.45438,860782
233,AntonioCarlini,98,0.01138,64264,7.46577,860782
234,arthuryan-k,98,0.01138,64362,7.47715,860782
235,ESWZY,98,0.01138,64460,7.48854,860782
236,hafe,98,0.01138,64558,7.49992,860782
237,harshthakur9030,97,0.01127,64655,7.51119,860782
238,sechkova,97,0.01127,64752,7.52246,860782
239,yinlei-jinan,97,0.01127,64849,7.53373,860782
240,snehilchopra,95,0.01104,64944,7.54477,860782
241,srjames90,95,0.01104,65039,7.55580,860782
242,TheFoxAtWork,95,0.01104,65134,7.56684,860782
243,dddddai,94,0.01092,65228,7.57776,860782
244,tbickford,94,0.01092,65322,7.58868,860782
245,YangLu1031,94,0.01092,65416,7.59960,860782
246,atoulme,93,0.01080,65509,7.61041,860782
247,glorv,93,0.01080,65602,7.62121,860782
248,hadim,93,0.01080,65695,7.63201,860782
249,KTan1226,93,0.01080,65788,7.64282,860782
250,thschue,93,0.01080,65881,7.65362,860782
251,rachelwang20,92,0.01069,65973,7.66431,860782
252,jijiew,91,0.01057,66064,7.67488,860782
253,tomob,91,0.01057,66155,7.68545,860782
254,hiyokotaisa,90,0.01046,66245,7.69591,860782
255,shivkanya9146,90,0.01046,66335,7.70636,860782
256,thomacos,90,0.01046,66425,7.71682,860782
257,agile6v,89,0.01034,66514,7.72716,860782
258,hillbun,89,0.01034,66603,7.73750,860782
259,donggangcj,88,0.01022,66691,7.74772,860782
260,HudsonHumphries,88,0.01022,66779,7.75795,860782
261,majorgreys,88,0.01022,66867,7.76817,860782
262,SSebo,88,0.01022,66955,7.77839,860782
263,matejvasek,87,0.01011,67042,7.78850,860782
264,simrandhaliw,87,0.01011,67129,7.79861,860782
265,wjuan-AFK,87,0.01011,67216,7.80871,860782
266,captainroy-hy,86,0.00999,67302,7.81870,860782
267,cbdm,86,0.00999,67388,7.82870,860782
268,andykernahan,85,0.00987,67473,7.83857,860782
269,rajatsingh25aug,85,0.00987,67558,7.84844,860782
270,vinu2003,85,0.00987,67643,7.85832,860782
271,jarebudev,84,0.00976,67727,7.86808,860782
272,SaiHarshaK,84,0.00976,67811,7.87784,860782
273,TennyZhuang,84,0.00976,67895,7.88760,860782
274,bjrara,83,0.00964,67978,7.89724,860782
275,nishipy,83,0.00964,68061,7.90688,860782
276,sxd,83,0.00964,68144,7.91652,860782
277,soulxu,82,0.00953,68226,7.92605,860782
278,wtyanan,82,0.00953,68308,7.93557,860782
279,bg-chun,81,0.00941,68389,7.94498,860782
280,DotSpy,81,0.00941,68470,7.95439,860782
281,LeoLiuYan,81,0.00941,68551,7.96381,860782
282,mfilocha,81,0.00941,68632,7.97322,860782
283,ghostsquad,80,0.00929,68712,7.98251,860782
284,Andres-GC,79,0.00918,68791,7.99169,860782
285,accelsao,78,0.00906,68869,8.00075,860782
286,Pchelolo,78,0.00906,68947,8.00981,860782
287,anthonyrtong,77,0.00895,69024,8.01876,860782
288,davidwitten,77,0.00895,69101,8.02770,860782
289,Divya063,77,0.00895,69178,8.03665,860782
290,dmayle,77,0.00895,69255,8.04559,860782
291,howardlau1999,77,0.00895,69332,8.05454,860782
292,jgrumboe,77,0.00895,69409,8.06348,860782
293,kubotat,77,0.00895,69486,8.07243,860782
294,wgahnagl,77,0.00895,69563,8.08137,860782
295,aruniiird,76,0.00883,69639,8.09020,860782
296,di,76,0.00883,69715,8.09903,860782
297,jajanet,76,0.00883,69791,8.10786,860782
298,jhonmike,76,0.00883,69867,8.11669,860782
299,Lucas-Irvine,76,0.00883,69943,8.12552,860782
300,oraluben,76,0.00883,70019,8.13435,860782
301,pmm-sumo,76,0.00883,70095,8.14318,860782
302,scottslowe,76,0.00883,70171,8.15201,860782
303,TannerGabriel,76,0.00883,70247,8.16084,860782
304,tigrulya-exe,76,0.00883,70323,8.16966,860782
305,williamhu99,76,0.00883,70399,8.17849,860782
306,alexburnos,75,0.00871,70474,8.18721,860782
307,davidraskin,75,0.00871,70549,8.19592,860782
308,ffe4,75,0.00871,70624,8.20463,860782
309,lippertmarkus,75,0.00871,70699,8.21335,860782
310,olegz,75,0.00871,70774,8.22206,860782
311,Tianlin-Zhao,75,0.00871,70849,8.23077,860782
312,vinayakankugoyal,75,0.00871,70924,8.23948,860782
313,artem-prozorov,74,0.00860,70998,8.24808,860782
314,cyberblack28,74,0.00860,71072,8.25668,860782
315,jamie-0,74,0.00860,71146,8.26528,860782
316,shuzokato,74,0.00860,71220,8.27387,860782
317,tkashem,74,0.00860,71294,8.28247,860782
318,weijiehu,74,0.00860,71368,8.29107,860782
319,zenmoto,73,0.00848,71441,8.29955,860782
320,ziqizh,73,0.00848,71514,8.30803,860782
321,ckuduvalli,72,0.00836,71586,8.31639,860782
322,d-reidenbach,72,0.00836,71658,8.32476,860782
323,glightfoot,72,0.00836,71730,8.33312,860782
324,Augustyniak,71,0.00825,71801,8.34137,860782
325,fdegir,71,0.00825,71872,8.34962,860782
326,Nuru,71,0.00825,71943,8.35787,860782
327,songhu,71,0.00825,72014,8.36611,860782
328,ankit-bhargava,70,0.00813,72084,8.37425,860782
329,bmelbourne,70,0.00813,72154,8.38238,860782
330,davivcgarcia,70,0.00813,72224,8.39051,860782
331,gabbifish,70,0.00813,72294,8.39864,860782
332,GeoBK,70,0.00813,72364,8.40677,860782
333,jaybatra26,70,0.00813,72434,8.41491,860782
334,jroden,70,0.00813,72504,8.42304,860782
335,matthias50,70,0.00813,72574,8.43117,860782
336,MaxRink,70,0.00813,72644,8.43930,860782
337,Poor12,70,0.00813,72714,8.44744,860782
338,robertlaurin,70,0.00813,72784,8.45557,860782
339,spaced,70,0.00813,72854,8.46370,860782
340,Wing924,70,0.00813,72924,8.47183,860782
341,AWaterColorPen,69,0.00802,72993,8.47985,860782
342,femrtnz,69,0.00802,73062,8.48786,860782
343,jianzzha,69,0.00802,73131,8.49588,860782
344,pytimer,69,0.00802,73200,8.50390,860782
345,soniasingla,69,0.00802,73269,8.51191,860782
346,sqkerner,69,0.00802,73338,8.51993,860782
347,tomocy,69,0.00802,73407,8.52794,860782
348,andyfeller,68,0.00790,73475,8.53584,860782
349,annajung,68,0.00790,73543,8.54374,860782
350,jherrera123,68,0.00790,73611,8.55164,860782
351,crixo,67,0.00778,73678,8.55943,860782
352,davecheney,67,0.00778,73745,8.56721,860782
353,e-blackwelder,67,0.00778,73812,8.57499,860782
354,ekanufrienko,67,0.00778,73879,8.58278,860782
355,HunDunDM,67,0.00778,73946,8.59056,860782
356,iobuf,67,0.00778,74013,8.59834,860782
357,rezakrimi,67,0.00778,74080,8.60613,860782
358,s099064146,67,0.00778,74147,8.61391,860782
359,yanchicago,67,0.00778,74214,8.62170,860782
360,adrianchung,66,0.00767,74280,8.62936,860782
361,agargi,66,0.00767,74346,8.63703,860782
362,imrenagi,66,0.00767,74412,8.64470,860782
363,pashafirdous,66,0.00767,74478,8.65236,860782
364,XJangel,66,0.00767,74544,8.66003,860782
365,yuga711,66,0.00767,74610,8.66770,860782
366,zerkms,66,0.00767,74676,8.67537,860782
367,divya-mohan0209,65,0.00755,74741,8.68292,860782
368,ellistarn,65,0.00755,74806,8.69047,860782
369,gsemet,65,0.00755,74871,8.69802,860782
370,longility,65,0.00755,74936,8.70557,860782
371,spurin,65,0.00755,75001,8.71312,860782
372,t0rr3sp3dr0,65,0.00755,75066,8.72067,860782
373,terev,65,0.00755,75131,8.72823,860782
374,vitt-bagal,65,0.00755,75196,8.73578,860782
375,yu-kasuya,65,0.00755,75261,8.74333,860782
376,abansal4032,64,0.00744,75325,8.75076,860782
377,ajaykangare,64,0.00744,75389,8.75820,860782
378,drewsortega,64,0.00744,75453,8.76563,860782
379,michalxo,64,0.00744,75517,8.77307,860782
380,shalini-b,64,0.00744,75581,8.78050,860782
381,vmihailenco,64,0.00744,75645,8.78794,860782
382,calvinbui,63,0.00732,75708,8.79526,860782
383,erichsueh3,63,0.00732,75771,8.80258,860782
384,mateuszrzeszutek,63,0.00732,75834,8.80990,860782
385,nitrocode,63,0.00732,75897,8.81722,860782
386,kadern0,62,0.00720,75959,8.82442,860782
387,RashmiRam,62,0.00720,76021,8.83162,860782
388,thanos1983,62,0.00720,76083,8.83882,860782
389,ajborley,61,0.00709,76144,8.84591,860782
390,dcherman,61,0.00709,76205,8.85300,860782
391,eddycharly,61,0.00709,76266,8.86008,860782
392,fred-vogt,61,0.00709,76327,8.86717,860782
393,khyatisoneji,61,0.00709,76388,8.87426,860782
394,13567436138,60,0.00697,76448,8.88123,860782
395,akitok,60,0.00697,76508,8.88820,860782
396,hkamel,60,0.00697,76568,8.89517,860782
397,k-wiatrzyk,60,0.00697,76628,8.90214,860782
398,vpickard,60,0.00697,76688,8.90911,860782
399,xiaoanyunfei,60,0.00697,76748,8.91608,860782
400,asdf2014,59,0.00685,76807,8.92293,860782
401,ericsuhong,59,0.00685,76866,8.92979,860782
402,foobarbecue,59,0.00685,76925,8.93664,860782
403,maniSbindra,59,0.00685,76984,8.94350,860782
404,tensorchen,59,0.00685,77043,8.95035,860782
405,mattfenwick,58,0.00674,77101,8.95709,860782
406,jonahrosenblum,57,0.00662,77158,8.96371,860782
407,siyopao,57,0.00662,77215,8.97033,860782
408,varadaprasanth,57,0.00662,77272,8.97695,860782
409,anniefu,56,0.00651,77328,8.98346,860782
410,hikkie3110,56,0.00651,77384,8.98996,860782
411,klalafaryan,56,0.00651,77440,8.99647,860782
412,pgenera,56,0.00651,77496,9.00298,860782
413,PrinceS17,56,0.00651,77552,9.00948,860782
414,stefanprisca,56,0.00651,77608,9.01599,860782
415,afrouzMashaykhi,55,0.00639,77663,9.02238,860782
416,divyabhushan,55,0.00639,77718,9.02877,860782
417,elweb9858,55,0.00639,77773,9.03516,860782
418,fatedier,55,0.00639,77828,9.04155,860782
419,lgg42,55,0.00639,77883,9.04794,860782
420,murray-stripe,55,0.00639,77938,9.05433,860782
421,pmundt,55,0.00639,77993,9.06071,860782
422,showuon,55,0.00639,78048,9.06710,860782
423,wtong98,55,0.00639,78103,9.07349,860782
424,zasweq,55,0.00639,78158,9.07988,860782
425,7error,54,0.00627,78212,9.08616,860782
426,AGMETEOR,54,0.00627,78266,9.09243,860782
427,alexkross,54,0.00627,78320,9.09870,860782
428,artisticcheese,54,0.00627,78374,9.10498,860782
429,aubm,54,0.00627,78428,9.11125,860782
430,bagnaram,54,0.00627,78482,9.11752,860782
431,balchua,54,0.00627,78536,9.12380,860782
432,checkelmann,54,0.00627,78590,9.13007,860782
433,itsecforu,54,0.00627,78644,9.13634,860782
434,krichter722,54,0.00627,78698,9.14262,860782
435,ltagliamonte-dd,54,0.00627,78752,9.14889,860782
436,memory,54,0.00627,78806,9.15516,860782
437,n1r1,54,0.00627,78860,9.16144,860782
438,rjs211,54,0.00627,78914,9.16771,860782
439,tedgxt,54,0.00627,78968,9.17398,860782
440,irizzant,53,0.00616,79021,9.18014,860782
441,JayBeale,53,0.00616,79074,9.18630,860782
442,kferrone,53,0.00616,79127,9.19246,860782
443,pranav-bhatt,53,0.00616,79180,9.19861,860782
444,saranyaeu2987,53,0.00616,79233,9.20477,860782
445,storyicon,53,0.00616,79286,9.21093,860782
446,takaf04,53,0.00616,79339,9.21708,860782
447,Tim-Zhang,53,0.00616,79392,9.22324,860782
448,axw,52,0.00604,79444,9.22928,860782
449,dingyin,52,0.00604,79496,9.23532,860782
450,dwillist,52,0.00604,79548,9.24136,860782
451,elakito,52,0.00604,79600,9.24741,860782
452,jim3ma,52,0.00604,79652,9.25345,860782
453,MaXinjian,52,0.00604,79704,9.25949,860782
454,Morriz,52,0.00604,79756,9.26553,860782
455,wangxy518,52,0.00604,79808,9.27157,860782
456,hanumanthan,51,0.00592,79859,9.27749,860782
457,heartrobotninja,51,0.00592,79910,9.28342,860782
458,Illyrix,51,0.00592,79961,9.28934,860782
459,kangwoo,51,0.00592,80012,9.29527,860782
460,sequix,51,0.00592,80063,9.30119,860782
461,shengxil,51,0.00592,80114,9.30712,860782
462,svoskobo-vmware-com,51,0.00592,80165,9.31304,860782
463,wflms20110333,51,0.00592,80216,9.31897,860782
464,alexbegg,50,0.00581,80266,9.32478,860782
465,apyrgio,50,0.00581,80316,9.33059,860782
466,Ghazgkull,50,0.00581,80366,9.33639,860782
467,gotoxu,50,0.00581,80416,9.34220,860782
468,kintel,50,0.00581,80466,9.34801,860782
469,kubealex,50,0.00581,80516,9.35382,860782
470,mneverov,50,0.00581,80566,9.35963,860782
471,phroggyy,50,0.00581,80616,9.36544,860782
472,ThomsonTan,50,0.00581,80666,9.37125,860782
473,weiling61,50,0.00581,80716,9.37705,860782
474,zackzhangkai,50,0.00581,80766,9.38286,860782
475,zhoudayongdennis,50,0.00581,80816,9.38867,860782
476,alcorj-mizar,49,0.00569,80865,9.39436,860782
477,amckinley,49,0.00569,80914,9.40006,860782
478,andylokandy,49,0.00569,80963,9.40575,860782
479,aodinokov,49,0.00569,81012,9.41144,860782
480,emkornfield,49,0.00569,81061,9.41713,860782
481,Harshitha1234,49,0.00569,81110,9.42283,860782
482,reylejano-rxm,49,0.00569,81159,9.42852,860782
483,sayboras,49,0.00569,81208,9.43421,860782
484,staticdev,49,0.00569,81257,9.43990,860782
485,YANYZP,49,0.00569,81306,9.44560,860782
486,abbccdda,48,0.00558,81354,9.45117,860782
487,carolinee21,48,0.00558,81402,9.45675,860782
488,dgiebert,48,0.00558,81450,9.46233,860782
489,jebter,48,0.00558,81498,9.46790,860782
490,liguozhong,48,0.00558,81546,9.47348,860782
491,mansam,48,0.00558,81594,9.47906,860782
492,ssscottt,48,0.00558,81642,9.48463,860782
493,weihanglo,48,0.00558,81690,9.49021,860782
494,ajoysinha,47,0.00546,81737,9.49567,860782
495,chaseterry,47,0.00546,81784,9.50113,860782
496,developer-guy,47,0.00546,81831,9.50659,860782
497,Dhiraj240,47,0.00546,81878,9.51205,860782
498,HiveTraum,47,0.00546,81925,9.51751,860782
499,jeremyje,47,0.00546,81972,9.52297,860782
500,pamorgan,47,0.00546,82019,9.52843,860782
501,sa-spag,47,0.00546,82066,9.53389,860782
502,ShadowJonathan,47,0.00546,82113,9.53935,860782
503,sleighzy,47,0.00546,82160,9.54481,860782
504,trabbart,47,0.00546,82207,9.55027,860782
505,vladwa,47,0.00546,82254,9.55573,860782
506,Zheaoli,47,0.00546,82301,9.56119,860782
507,AndrewJSchofield,46,0.00534,82347,9.56653,860782
508,Bo0km4n,46,0.00534,82393,9.57188,860782
509,bryannaegele,46,0.00534,82439,9.57722,860782
510,connorlindsey,46,0.00534,82485,9.58257,860782
511,juliantaylor,46,0.00534,82531,9.58791,860782
512,kbruner,46,0.00534,82577,9.59325,860782
513,macrogreg,46,0.00534,82623,9.59860,860782
514,nigriMSFT,46,0.00534,82669,9.60394,860782
515,rajula96reddy,46,0.00534,82715,9.60929,860782
516,Sudhar287,46,0.00534,82761,9.61463,860782
517,yixin21,46,0.00534,82807,9.61997,860782
518,0x4b,45,0.00523,82852,9.62520,860782
519,belyalov,45,0.00523,82897,9.63043,860782
520,bernokl,45,0.00523,82942,9.63566,860782
521,clienthax,45,0.00523,82987,9.64088,860782
522,edwardecook,45,0.00523,83032,9.64611,860782
523,hamzazafar,45,0.00523,83077,9.65134,860782
524,HannahShiSFB,45,0.00523,83122,9.65657,860782
525,kprakasam,45,0.00523,83167,9.66180,860782
526,nocanstillbb,45,0.00523,83212,9.66702,860782
527,samuelmacko,45,0.00523,83257,9.67225,860782
528,tylerje,45,0.00523,83302,9.67748,860782
529,vparames86,45,0.00523,83347,9.68271,860782
530,v-xuxin,45,0.00523,83392,9.68793,860782
531,Wenshiqi222,45,0.00523,83437,9.69316,860782
532,yuanhuaiwang,45,0.00523,83482,9.69839,860782
533,zhangguanzhang,45,0.00523,83527,9.70362,860782
534,andrewmyhre,44,0.00511,83571,9.70873,860782
535,blueabysm,44,0.00511,83615,9.71384,860782
536,dan-j,44,0.00511,83659,9.71895,860782
537,lcmmhcc,44,0.00511,83703,9.72406,860782
538,marema31,44,0.00511,83747,9.72918,860782
539,notpad,44,0.00511,83791,9.73429,860782
540,oulin-coder,44,0.00511,83835,9.73940,860782
541,shashankram,44,0.00511,83879,9.74451,860782
542,sudeeptoroy,44,0.00511,83923,9.74962,860782
543,YuqiXiao,44,0.00511,83967,9.75473,860782
544,2339478391,43,0.00500,84010,9.75973,860782
545,aravinsiva,43,0.00500,84053,9.76473,860782
546,bai,43,0.00500,84096,9.76972,860782
547,demonCoder95,43,0.00500,84139,9.77472,860782
548,devOpsHelm,43,0.00500,84182,9.77971,860782
549,genofire,43,0.00500,84225,9.78471,860782
550,guojianyu,43,0.00500,84268,9.78970,860782
551,joao-luna-98,43,0.00500,84311,9.79470,860782
552,kaivalya97,43,0.00500,84354,9.79969,860782
553,kelvinwijaya,43,0.00500,84397,9.80469,860782
554,kenfinnigan,43,0.00500,84440,9.80968,860782
555,kmanghat,43,0.00500,84483,9.81468,860782
556,lalitb,43,0.00500,84526,9.81968,860782
557,marload,43,0.00500,84569,9.82467,860782
558,mchurichi,43,0.00500,84612,9.82967,860782
559,wicharypawel,43,0.00500,84655,9.83466,860782
560,xdzhai,43,0.00500,84698,9.83966,860782
561,Benjile,42,0.00488,84740,9.84454,860782
562,chgl,42,0.00488,84782,9.84942,860782
563,fxposter,42,0.00488,84824,9.85430,860782
564,Invictus17,42,0.00488,84866,9.85917,860782
565,jhdalek55,42,0.00488,84908,9.86405,860782
566,morigs,42,0.00488,84950,9.86893,860782
567,ordovicia,42,0.00488,84992,9.87381,860782
568,povsister,42,0.00488,85034,9.87869,860782
569,samath117,42,0.00488,85076,9.88357,860782
570,ShaileshSurya,42,0.00488,85118,9.88845,860782
571,sjbrunst,42,0.00488,85160,9.89333,860782
572,atef23,41,0.00476,85201,9.89809,860782
573,chief93,41,0.00476,85242,9.90286,860782
574,den-is,41,0.00476,85283,9.90762,860782
575,evalsocket,41,0.00476,85324,9.91238,860782
576,gnosek,41,0.00476,85365,9.91715,860782
577,r4f4,41,0.00476,85406,9.92191,860782
578,sc250024,41,0.00476,85447,9.92667,860782
579,seanschneeweiss,41,0.00476,85488,9.93143,860782
580,skilxn-go,41,0.00476,85529,9.93620,860782
581,tmshn,41,0.00476,85570,9.94096,860782
582,vazirim,41,0.00476,85611,9.94572,860782
583,vikkyomkar,41,0.00476,85652,9.95049,860782
584,afsilvasantos,40,0.00465,85692,9.95513,860782
585,asuffield,40,0.00465,85732,9.95978,860782
586,biuboombiuboom,40,0.00465,85772,9.96443,860782
587,bozzo,40,0.00465,85812,9.96907,860782
588,CunjunWang,40,0.00465,85852,9.97372,860782
589,katzchang,40,0.00465,85892,9.97837,860782
590,mem,40,0.00465,85932,9.98302,860782
591,michaelorr,40,0.00465,85972,9.98766,860782
592,Prabhakar-17,40,0.00465,86012,9.99231,860782
593,richardstartin,40,0.00465,86052,9.99696,860782
594,somesh2905,40,0.00465,86092,10.00160,860782
595,sonofachamp,40,0.00465,86132,10.00625,860782
596,wilsonehusin,40,0.00465,86172,10.01090,860782
597,anovis,39,0.00453,86211,10.01543,860782
598,ashrayjain,39,0.00453,86250,10.01996,860782
599,FrediWeber,39,0.00453,86289,10.02449,860782
600,IlyaKobelevskiy,39,0.00453,86328,10.02902,860782
601,jan-est,39,0.00453,86367,10.03355,860782
602,jvrplmlmn,39,0.00453,86406,10.03808,860782
603,kshitijcode,39,0.00453,86445,10.04261,860782
604,lazyniv,39,0.00453,86484,10.04714,860782
605,luigibk,39,0.00453,86523,10.05167,860782
606,mikeshng,39,0.00453,86562,10.05620,860782
607,mirahmed753,39,0.00453,86601,10.06074,860782
608,QianChenglong,39,0.00453,86640,10.06527,860782
609,RyuunoAelia,39,0.00453,86679,10.06980,860782
610,sattarfeizollahibarough,39,0.00453,86718,10.07433,860782
611,SolidifiedRay,39,0.00453,86757,10.07886,860782
612,yinzara,39,0.00453,86796,10.08339,860782
613,zackwine,39,0.00453,86835,10.08792,860782
614,3pointer,38,0.00441,86873,10.09233,860782
615,blackwith,38,0.00441,86911,10.09675,860782
616,borgerli,38,0.00441,86949,10.10116,860782
617,candlerb,38,0.00441,86987,10.10558,860782
618,cezaryzukowski,38,0.00441,87025,10.10999,860782
619,chaspy,38,0.00441,87063,10.11441,860782
620,crunchtime-ali,38,0.00441,87101,10.11882,860782
621,iamAzeem,38,0.00441,87139,10.12324,860782
622,lex111,38,0.00441,87177,10.12765,860782
623,mohamedsgap,38,0.00441,87215,10.13207,860782
624,prahaladdarkin,38,0.00441,87253,10.13648,860782
625,scbizu,38,0.00441,87291,10.14090,860782
626,ZenoTan,38,0.00441,87329,10.14531,860782
627,Boutheina-Dab,37,0.00430,87366,10.14961,860782
628,ekristen,37,0.00430,87403,10.15391,860782
629,janeczku,37,0.00430,87440,10.15820,860782
630,jlandowner,37,0.00430,87477,10.16250,860782
631,lemonli,37,0.00430,87514,10.16680,860782
632,liuximu,37,0.00430,87551,10.17110,860782
633,michaelywg,37,0.00430,87588,10.17540,860782
634,networkop,37,0.00430,87625,10.17970,860782
635,pims,37,0.00430,87662,10.18400,860782
636,scottilee,37,0.00430,87699,10.18829,860782
637,TakaoShimizu,37,0.00430,87736,10.19259,860782
638,tedpennings,37,0.00430,87773,10.19689,860782
639,vinny-sabatini,37,0.00430,87810,10.20119,860782
640,vrlo,37,0.00430,87847,10.20549,860782
641,cfzjywxk,36,0.00418,87883,10.20967,860782
642,Chanakya-Ekbote,36,0.00418,87919,10.21385,860782
643,Congrool,36,0.00418,87955,10.21803,860782
644,daniel-goldstein,36,0.00418,87991,10.22222,860782
645,EmilyM1,36,0.00418,88027,10.22640,860782
646,erdun,36,0.00418,88063,10.23058,860782
647,fz8770,36,0.00418,88099,10.23476,860782
648,Jake-Prickett,36,0.00418,88135,10.23895,860782
649,nevermyuk,36,0.00418,88171,10.24313,860782
650,PxyUp,36,0.00418,88207,10.24731,860782
651,rancherio-gh-m,36,0.00418,88243,10.25149,860782
652,renukamanavalan,36,0.00418,88279,10.25567,860782
653,robertjahn,36,0.00418,88315,10.25986,860782
654,sharkymcdongles,36,0.00418,88351,10.26404,860782
655,de-sh,35,0.00407,88386,10.26811,860782
656,ercl,35,0.00407,88421,10.27217,860782
657,gstaware,35,0.00407,88456,10.27624,860782
658,kwSeo,35,0.00407,88491,10.28030,860782
659,sailorvii,35,0.00407,88526,10.28437,860782
660,stefanlasiewski,35,0.00407,88561,10.28844,860782
661,tcnksm,35,0.00407,88596,10.29250,860782
662,translucens,35,0.00407,88631,10.29657,860782
663,wanlin31,35,0.00407,88666,10.30063,860782
664,yangqingxin1993,35,0.00407,88701,10.30470,860782
665,yylt,35,0.00407,88736,10.30877,860782
666,zeitlinger,35,0.00407,88771,10.31283,860782
667,AndrewGrachov,34,0.00395,88805,10.31678,860782
668,badsyntax,34,0.00395,88839,10.32073,860782
669,boranx,34,0.00395,88873,10.32468,860782
670,chradcliffe,34,0.00395,88907,10.32863,860782
671,enozcan,34,0.00395,88941,10.33258,860782
672,fscz,34,0.00395,88975,10.33653,860782
673,halcyondude,34,0.00395,89009,10.34048,860782
674,lujinda,34,0.00395,89043,10.34443,860782
675,lykkin,34,0.00395,89077,10.34838,860782
676,MitchellDumovic,34,0.00395,89111,10.35233,860782
677,neild,34,0.00395,89145,10.35628,860782
678,roelfdutoit,34,0.00395,89179,10.36023,860782
679,ryokotmng,34,0.00395,89213,10.36418,860782
680,spagno,34,0.00395,89247,10.36813,860782
681,tengpengli,34,0.00395,89281,10.37208,860782
682,TrishaChetani,34,0.00395,89315,10.37603,860782
683,xvzf,34,0.00395,89349,10.37998,860782
684,yogeek,34,0.00395,89383,10.38393,860782
685,arnongilboa,33,0.00383,89416,10.38776,860782
686,christyjacob4,33,0.00383,89449,10.39160,860782
687,fnord123,33,0.00383,89482,10.39543,860782
688,Frodez,33,0.00383,89515,10.39926,860782
689,gattytto,33,0.00383,89548,10.40310,860782
690,jeffalder,33,0.00383,89581,10.40693,860782
691,jihoon-seo,33,0.00383,89614,10.41077,860782
692,kvedurmu,33,0.00383,89647,10.41460,860782
693,kylejohnson514,33,0.00383,89680,10.41843,860782
694,mhansen,33,0.00383,89713,10.42227,860782
695,mseewooth,33,0.00383,89746,10.42610,860782
696,pai911,33,0.00383,89779,10.42993,860782
697,pgpx,33,0.00383,89812,10.43377,860782
698,pymander,33,0.00383,89845,10.43760,860782
699,samirsss,33,0.00383,89878,10.44144,860782
700,Sayrus,33,0.00383,89911,10.44527,860782
701,stevenbill,33,0.00383,89944,10.44910,860782
702,wangzlei,33,0.00383,89977,10.45294,860782
703,xmapst,33,0.00383,90010,10.45677,860782
704,Aakash2017,32,0.00372,90042,10.46049,860782
705,actions-user,32,0.00372,90074,10.46421,860782
706,AkashSarda,32,0.00372,90106,10.46792,860782
707,angelbarrera92,32,0.00372,90138,10.47164,860782
708,Asarew,32,0.00372,90170,10.47536,860782
709,awesomenix,32,0.00372,90202,10.47908,860782
710,chenguoquan1024,32,0.00372,90234,10.48279,860782
711,horazont,32,0.00372,90266,10.48651,860782
712,jsalinas29,32,0.00372,90298,10.49023,860782
713,justin-mp,32,0.00372,90330,10.49395,860782
714,kesavanvt,32,0.00372,90362,10.49766,860782
715,lostsquirrel,32,0.00372,90394,10.50138,860782
716,mufti1,32,0.00372,90426,10.50510,860782
717,ocervell,32,0.00372,90458,10.50882,860782
718,rsoika,32,0.00372,90490,10.51253,860782
719,sepich,32,0.00372,90522,10.51625,860782
720,SerialVelocity,32,0.00372,90554,10.51997,860782
721,shay-berman,32,0.00372,90586,10.52369,860782
722,smijolovic,32,0.00372,90618,10.52740,860782
723,tklever,32,0.00372,90650,10.53112,860782
724,vnorigoog,32,0.00372,90682,10.53484,860782
725,wangkai1994,32,0.00372,90714,10.53856,860782
726,wxsms,32,0.00372,90746,10.54227,860782
727,zenbones,32,0.00372,90778,10.54599,860782
728,bhargav-naik,31,0.00360,90809,10.54959,860782
729,digeler,31,0.00360,90840,10.55319,860782
730,Drugoy,31,0.00360,90871,10.55680,860782
731,ekexium,31,0.00360,90902,10.56040,860782
732,fl-max,31,0.00360,90933,10.56400,860782
733,GlennBullingham,31,0.00360,90964,10.56760,860782
734,haardikdharma10,31,0.00360,90995,10.57120,860782
735,iciclespider,31,0.00360,91026,10.57480,860782
736,jawabuu,31,0.00360,91057,10.57840,860782
737,LouisPlisso,31,0.00360,91088,10.58201,860782
738,moricho,31,0.00360,91119,10.58561,860782
739,mridulv,31,0.00360,91150,10.58921,860782
740,novegit,31,0.00360,91181,10.59281,860782
741,patricklundquist,31,0.00360,91212,10.59641,860782
742,prashantnitt07,31,0.00360,91243,10.60001,860782
743,ravikumar2000,31,0.00360,91274,10.60361,860782
744,samstride,31,0.00360,91305,10.60722,860782
745,tasekida,31,0.00360,91336,10.61082,860782
746,yiyangy,31,0.00360,91367,10.61442,860782
747,alvinlin123,30,0.00349,91397,10.61790,860782
748,ari-becker,30,0.00349,91427,10.62139,860782
749,bwagner5,30,0.00349,91457,10.62487,860782
750,championshuttler,30,0.00349,91487,10.62836,860782
751,churanchen,30,0.00349,91517,10.63184,860782
752,dnilasor,30,0.00349,91547,10.63533,860782
753,elegos,30,0.00349,91577,10.63881,860782
754,fktkrt,30,0.00349,91607,10.64230,860782
755,GMartinez-Sisti,30,0.00349,91637,10.64578,860782
756,hdost,30,0.00349,91667,10.64927,860782
757,holyketzer,30,0.00349,91697,10.65276,860782
758,ica10888,30,0.00349,91727,10.65624,860782
759,jgoeres,30,0.00349,91757,10.65973,860782
760,jrivers96,30,0.00349,91787,10.66321,860782
761,justinwalz,30,0.00349,91817,10.66670,860782
762,kaitaklam,30,0.00349,91847,10.67018,860782
763,kevindelgado,30,0.00349,91877,10.67367,860782
764,Lavie526,30,0.00349,91907,10.67715,860782
765,MeghnaPrabhu,30,0.00349,91937,10.68064,860782
766,ossareh,30,0.00349,91967,10.68412,860782
767,ramanNarasimhan77,30,0.00349,91997,10.68761,860782
768,robertsheehy-wf,30,0.00349,92027,10.69109,860782
769,sgarbour,30,0.00349,92057,10.69458,860782
770,smlx,30,0.00349,92087,10.69806,860782
771,wwjgit,30,0.00349,92117,10.70155,860782
772,zestrells,30,0.00349,92147,10.70503,860782
773,zvier,30,0.00349,92177,10.70852,860782
774,awiede,29,0.00337,92206,10.71189,860782
775,concaf,29,0.00337,92235,10.71526,860782
776,dza89,29,0.00337,92264,10.71863,860782
777,GBrawl,29,0.00337,92293,10.72199,860782
778,kaslin,29,0.00337,92322,10.72536,860782
779,mokua,29,0.00337,92351,10.72873,860782
780,moxious,29,0.00337,92380,10.73210,860782
781,pierreyves-lebrun,29,0.00337,92409,10.73547,860782
782,prabhatdubey1,29,0.00337,92438,10.73884,860782
783,qingchen1203,29,0.00337,92467,10.74221,860782
784,riking,29,0.00337,92496,10.74558,860782
785,rverma-jm,29,0.00337,92525,10.74895,860782
786,scheler,29,0.00337,92554,10.75232,860782
787,tranbaominh,29,0.00337,92583,10.75568,860782
788,Yiyiyimu,29,0.00337,92612,10.75905,860782
789,aistein,28,0.00325,92640,10.76231,860782
790,alesj,28,0.00325,92668,10.76556,860782
791,blumamir,28,0.00325,92696,10.76881,860782
792,BurtonQin,28,0.00325,92724,10.77207,860782
793,christopher-taormina-zocdoc,28,0.00325,92752,10.77532,860782
794,cuisongliu,28,0.00325,92780,10.77857,860782
795,cy-zheng,28,0.00325,92808,10.78182,860782
796,darwhs,28,0.00325,92836,10.78508,860782
797,demisx,28,0.00325,92864,10.78833,860782
798,ejsmith,28,0.00325,92892,10.79158,860782
799,fredgate,28,0.00325,92920,10.79484,860782
800,fylip97,28,0.00325,92948,10.79809,860782
801,fzyzcjy,28,0.00325,92976,10.80134,860782
802,gobomb,28,0.00325,93004,10.80459,860782
803,himmakam,28,0.00325,93032,10.80785,860782
804,hoffie,28,0.00325,93060,10.81110,860782
805,JackWindows,28,0.00325,93088,10.81435,860782
806,JohnGalt1717,28,0.00325,93116,10.81761,860782
807,lexxxel,28,0.00325,93144,10.82086,860782
808,lingsamuel,28,0.00325,93172,10.82411,860782
809,marwan-at-work,28,0.00325,93200,10.82736,860782
810,mclarke47,28,0.00325,93228,10.83062,860782
811,nigels-com,28,0.00325,93256,10.83387,860782
812,PurelyApplied,28,0.00325,93284,10.83712,860782
813,rancerbeta,28,0.00325,93312,10.84038,860782
814,ricoberger,28,0.00325,93340,10.84363,860782
815,romil-punetha,28,0.00325,93368,10.84688,860782
816,rvillablanca,28,0.00325,93396,10.85013,860782
817,sagarbhavsar4328,28,0.00325,93424,10.85339,860782
818,sheinbergon,28,0.00325,93452,10.85664,860782
819,shibataka000,28,0.00325,93480,10.85989,860782
820,shwetaap,28,0.00325,93508,10.86315,860782
821,sumo-drosiek,28,0.00325,93536,10.86640,860782
822,tdyas,28,0.00325,93564,10.86965,860782
823,theAkito,28,0.00325,93592,10.87290,860782
824,TomorJM,28,0.00325,93620,10.87616,860782
825,tpihl,28,0.00325,93648,10.87941,860782
826,tuananhnguyen-ct,28,0.00325,93676,10.88266,860782
827,VinodAnandan,28,0.00325,93704,10.88592,860782
828,waynr,28,0.00325,93732,10.88917,860782
829,Annegies,27,0.00314,93759,10.89230,860782
830,bhavyachoudhary,27,0.00314,93786,10.89544,860782
831,bjethwan,27,0.00314,93813,10.89858,860782
832,deshui123,27,0.00314,93840,10.90171,860782
833,DevasiaThomas,27,0.00314,93867,10.90485,860782
834,dudicoco,27,0.00314,93894,10.90799,860782
835,holmesb,27,0.00314,93921,10.91113,860782
836,jhutchings1,27,0.00314,93948,10.91426,860782
837,johnkost,27,0.00314,93975,10.91740,860782
838,jvanz,27,0.00314,94002,10.92054,860782
839,kfr2,27,0.00314,94029,10.92367,860782
840,kkeshavamurthy,27,0.00314,94056,10.92681,860782
841,linkvt,27,0.00314,94083,10.92995,860782
842,LionelCons,27,0.00314,94110,10.93308,860782
843,LKaemmerling,27,0.00314,94137,10.93622,860782
844,lueenavarro,27,0.00314,94164,10.93936,860782
845,muradmomani,27,0.00314,94191,10.94249,860782
846,oddlittlebird,27,0.00314,94218,10.94563,860782
847,odelucca,27,0.00314,94245,10.94877,860782
848,p37ruh4,27,0.00314,94272,10.95190,860782
849,phiphi282,27,0.00314,94299,10.95504,860782
850,rmohta,27,0.00314,94326,10.95818,860782
851,rptaylor,27,0.00314,94353,10.96131,860782
852,sergiitk,27,0.00314,94380,10.96445,860782
853,tapih,27,0.00314,94407,10.96759,860782
854,TheDavidKruse,27,0.00314,94434,10.97072,860782
855,tweks,27,0.00314,94461,10.97386,860782
856,utsav-dbx,27,0.00314,94488,10.97700,860782
857,valeriy-simakov,27,0.00314,94515,10.98013,860782
858,vicenteherrera,27,0.00314,94542,10.98327,860782
859,weinong,27,0.00314,94569,10.98641,860782
860,willzhang,27,0.00314,94596,10.98954,860782
861,yiyang5055,27,0.00314,94623,10.99268,860782
862,ysawa0,27,0.00314,94650,10.99582,860782
863,zhaocheng173,27,0.00314,94677,10.99895,860782
864,zhungxd,27,0.00314,94704,11.00209,860782
865,524119574,26,0.00302,94730,11.00511,860782
866,adityaalifn,26,0.00302,94756,11.00813,860782
867,aelmanaa,26,0.00302,94782,11.01115,860782
868,ahmedwaleedmalik,26,0.00302,94808,11.01417,860782
869,allenhaozi,26,0.00302,94834,11.01719,860782
870,ashokponkumar,26,0.00302,94860,11.02021,860782
871,Bessonov,26,0.00302,94886,11.02323,860782
872,binjip978,26,0.00302,94912,11.02625,860782
873,champak,26,0.00302,94938,11.02927,860782
874,dbarbashov,26,0.00302,94964,11.03229,860782
875,dcantah,26,0.00302,94990,11.03531,860782
876,dgl,26,0.00302,95016,11.03833,860782
877,harutyundermenjyan,26,0.00302,95042,11.04136,860782
878,hisener,26,0.00302,95068,11.04438,860782
879,JocelynBerrendonner,26,0.00302,95094,11.04740,860782
880,joshbranham,26,0.00302,95120,11.05042,860782
881,kbhandari,26,0.00302,95146,11.05344,860782
882,lidezhu,26,0.00302,95172,11.05646,860782
883,lysu,26,0.00302,95198,11.05948,860782
884,moluzhui,26,0.00302,95224,11.06250,860782
885,mujtaba-ahmed12,26,0.00302,95250,11.06552,860782
886,PaulMichaelArmstrong,26,0.00302,95276,11.06854,860782
887,polyrabbit,26,0.00302,95302,11.07156,860782
888,pyrl247,26,0.00302,95328,11.07458,860782
889,renatoviana12,26,0.00302,95354,11.07760,860782
890,rgarcia89,26,0.00302,95380,11.08062,860782
891,saneera,26,0.00302,95406,11.08364,860782
892,sergeyshaykhullin,26,0.00302,95432,11.08666,860782
893,survivant,26,0.00302,95458,11.08968,860782
894,tabbysable,26,0.00302,95484,11.09270,860782
895,tweenietomatoes,26,0.00302,95510,11.09572,860782
896,widgetpl,26,0.00302,95536,11.09875,860782
897,XavierDuthil,26,0.00302,95562,11.10177,860782
898,zbbkeepgoing,26,0.00302,95588,11.10479,860782
899,alex-berger,25,0.00290,95613,11.10769,860782
900,antoinedeschenes,25,0.00290,95638,11.11059,860782
901,Ashish-Bansal,25,0.00290,95663,11.11350,860782
902,cnphil,25,0.00290,95688,11.11640,860782
903,cyrus-mc,25,0.00290,95713,11.11931,860782
904,czs1993,25,0.00290,95738,11.12221,860782
905,deanorderly,25,0.00290,95763,11.12512,860782
906,deepak1725,25,0.00290,95788,11.12802,860782
907,deveshk0,25,0.00290,95813,11.13093,860782
908,dinesh4747,25,0.00290,95838,11.13383,860782
909,dneray,25,0.00290,95863,11.13673,860782
910,drbugfinder-work,25,0.00290,95888,11.13964,860782
911,e-backmark-ericsson,25,0.00290,95913,11.14254,860782
912,ephesused,25,0.00290,95938,11.14545,860782
913,ErikLundJensen,25,0.00290,95963,11.14835,860782
914,erinaboyd,25,0.00290,95988,11.15126,860782
915,faicker,25,0.00290,96013,11.15416,860782
916,ganga1980,25,0.00290,96038,11.15706,860782
917,hawran,25,0.00290,96063,11.15997,860782
918,howbazaar,25,0.00290,96088,11.16287,860782
919,HubertBos,25,0.00290,96113,11.16578,860782
920,hugebdu,25,0.00290,96138,11.16868,860782
921,hugoprudente,25,0.00290,96163,11.17159,860782
922,igorgonibm,25,0.00290,96188,11.17449,860782
923,itsbenwu,25,0.00290,96213,11.17739,860782
924,jeanluclariviere,25,0.00290,96238,11.18030,860782
925,KeisukeYamashita,25,0.00290,96263,11.18320,860782
926,krishchow,25,0.00290,96288,11.18611,860782
927,ks864148379,25,0.00290,96313,11.18901,860782
928,kubicgruenfeld,25,0.00290,96338,11.19192,860782
929,lolin9,25,0.00290,96363,11.19482,860782
930,Lucaber,25,0.00290,96388,11.19772,860782
931,mabukhovsky,25,0.00290,96413,11.20063,860782
932,MarinaShustowa,25,0.00290,96438,11.20353,860782
933,mcastellin,25,0.00290,96463,11.20644,860782
934,mewais,25,0.00290,96488,11.20934,860782
935,mlasevich,25,0.00290,96513,11.21225,860782
936,mmiller1,25,0.00290,96538,11.21515,860782
937,nicktming,25,0.00290,96563,11.21806,860782
938,pasqualet,25,0.00290,96588,11.22096,860782
939,phiremande,25,0.00290,96613,11.22386,860782
940,piequi,25,0.00290,96638,11.22677,860782
941,SanikaGawhane,25,0.00290,96663,11.22967,860782
942,scoulomb,25,0.00290,96688,11.23258,860782
943,sfynx,25,0.00290,96713,11.23548,860782
944,skycastlelily2,25,0.00290,96738,11.23839,860782
945,wangxiyuan,25,0.00290,96763,11.24129,860782
946,WinterZhou,25,0.00290,96788,11.24419,860782
947,yg,25,0.00290,96813,11.24710,860782
948,YKG,25,0.00290,96838,11.25000,860782
949,9kranti,24,0.00279,96862,11.25279,860782
950,aanno,24,0.00279,96886,11.25558,860782
951,aduffeck,24,0.00279,96910,11.25837,860782
952,afflom,24,0.00279,96934,11.26116,860782
953,agowa338,24,0.00279,96958,11.26394,860782
954,ajm188,24,0.00279,96982,11.26673,860782
955,AlphaWong,24,0.00279,97006,11.26952,860782
956,AndersonQ,24,0.00279,97030,11.27231,860782
957,bhiravabhatla,24,0.00279,97054,11.27510,860782
958,BlumAmir,24,0.00279,97078,11.27788,860782
959,Cajga,24,0.00279,97102,11.28067,860782
960,codyaray,24,0.00279,97126,11.28346,860782
961,ddymko,24,0.00279,97150,11.28625,860782
962,duchuanLX,24,0.00279,97174,11.28904,860782
963,eumel8,24,0.00279,97198,11.29183,860782
964,fishcakez,24,0.00279,97222,11.29461,860782
965,FreeZhang61,24,0.00279,97246,11.29740,860782
966,greggbjensen,24,0.00279,97270,11.30019,860782
967,hazbo,24,0.00279,97294,11.30298,860782
968,jiashiwen,24,0.00279,97318,11.30577,860782
969,jon-whit,24,0.00279,97342,11.30855,860782
970,karolinepauls,24,0.00279,97366,11.31134,860782
971,krmichel,24,0.00279,97390,11.31413,860782
972,marcredhat,24,0.00279,97414,11.31692,860782
973,mat-rumian,24,0.00279,97438,11.31971,860782
974,mbuccarello,24,0.00279,97462,11.32250,860782
975,mnussbaum,24,0.00279,97486,11.32528,860782
976,mrSeoDavid,24,0.00279,97510,11.32807,860782
977,nan-yu,24,0.00279,97534,11.33086,860782
978,nirsky,24,0.00279,97558,11.33365,860782
979,qingwave,24,0.00279,97582,11.33644,860782
980,radeksm,24,0.00279,97606,11.33922,860782
981,rgembalik,24,0.00279,97630,11.34201,860782
982,RouxAntoine,24,0.00279,97654,11.34480,860782
983,runlevel5,24,0.00279,97678,11.34759,860782
984,ruudk,24,0.00279,97702,11.35038,860782
985,sagor999,24,0.00279,97726,11.35316,860782
986,secret104278,24,0.00279,97750,11.35595,860782
987,servo1x,24,0.00279,97774,11.35874,860782
988,slott56,24,0.00279,97798,11.36153,860782
989,sopak,24,0.00279,97822,11.36432,860782
990,Syn3rman,24,0.00279,97846,11.36711,860782
991,taisho6339,24,0.00279,97870,11.36989,860782
992,titou10titou10,24,0.00279,97894,11.37268,860782
993,tuxpeople,24,0.00279,97918,11.37547,860782
994,v-pap,24,0.00279,97942,11.37826,860782
995,xtreme-conor-nosal,24,0.00279,97966,11.38105,860782
996,yzhao66,24,0.00279,97990,11.38383,860782
997,zzxgzgz,24,0.00279,98014,11.38662,860782
998,00arthur00,23,0.00267,98037,11.38929,860782
999,abhi1604,23,0.00267,98060,11.39197,860782
1000,aceeric,23,0.00267,98083,11.39464,860782
1001,AdamKorcz,23,0.00267,98106,11.39731,860782
1002,adityamandhare,23,0.00267,98129,11.39998,860782
1003,alolita,23,0.00267,98152,11.40265,860782
1004,ansonauhk,23,0.00267,98175,11.40533,860782
1005,atmosx,23,0.00267,98198,11.40800,860782
1006,Avatat,23,0.00267,98221,11.41067,860782
1007,Betula-L,23,0.00267,98244,11.41334,860782
1008,bhardwahnitish19,23,0.00267,98267,11.41601,860782
1009,bitvijays,23,0.00267,98290,11.41869,860782
1010,brandonkal,23,0.00267,98313,11.42136,860782
1011,eratnch,23,0.00267,98336,11.42403,860782
1012,erikbos,23,0.00267,98359,11.42670,860782
1013,Excpt0r,23,0.00267,98382,11.42937,860782
1014,gustav3d,23,0.00267,98405,11.43205,860782
1015,heckad,23,0.00267,98428,11.43472,860782
1016,IshaDave,23,0.00267,98451,11.43739,860782
1017,jamesbibby,23,0.00267,98474,11.44006,860782
1018,jurgenweber,23,0.00267,98497,11.44273,860782
1019,leopoldxx,23,0.00267,98520,11.44541,860782
1020,lipingxue,23,0.00267,98543,11.44808,860782
1021,lmq1999,23,0.00267,98566,11.45075,860782
1022,Lutzifer,23,0.00267,98589,11.45342,860782
1023,mandelsoft,23,0.00267,98612,11.45609,860782
1024,marcushyungseoklee,23,0.00267,98635,11.45877,860782
1025,michael-barker,23,0.00267,98658,11.46144,860782
1026,michalss,23,0.00267,98681,11.46411,860782
1027,Miftahunajat,23,0.00267,98704,11.46678,860782
1028,mochizuki875,23,0.00267,98727,11.46945,860782
1029,mohatb,23,0.00267,98750,11.47213,860782
1030,ncrothe,23,0.00267,98773,11.47480,860782
1031,phisco,23,0.00267,98796,11.47747,860782
1032,prasadborole1,23,0.00267,98819,11.48014,860782
1033,prashanthga,23,0.00267,98842,11.48281,860782
1034,Prims47,23,0.00267,98865,11.48549,860782
1035,Saad-Hussain1,23,0.00267,98888,11.48816,860782
1036,seddonm1,23,0.00267,98911,11.49083,860782
1037,skaven81,23,0.00267,98934,11.49350,860782
1038,spark4,23,0.00267,98957,11.49617,860782
1039,therahulbhati,23,0.00267,98980,11.49885,860782
1040,towolf,23,0.00267,99003,11.50152,860782
1041,vasanthakumars98,23,0.00267,99026,11.50419,860782
1042,vpnachev,23,0.00267,99049,11.50686,860782
1043,yashwant121,23,0.00267,99072,11.50953,860782
1044,yatender-oktalk,23,0.00267,99095,11.51221,860782
1045,youngbupark,23,0.00267,99118,11.51488,860782
1046,11janci,22,0.00256,99140,11.51743,860782
1047,acnodal-tc,22,0.00256,99162,11.51999,860782
1048,aermakov-zalando,22,0.00256,99184,11.52255,860782
1049,atrauzzi,22,0.00256,99206,11.52510,860782
1050,audig,22,0.00256,99228,11.52766,860782
1051,avorima,22,0.00256,99250,11.53021,860782
1052,bitscuit,22,0.00256,99272,11.53277,860782
1053,brianharwell,22,0.00256,99294,11.53532,860782
1054,chrishenzie,22,0.00256,99316,11.53788,860782
1055,dhc3800,22,0.00256,99338,11.54044,860782
1056,eriksywu,22,0.00256,99360,11.54299,860782
1057,fpliu233,22,0.00256,99382,11.54555,860782
1058,frigus02,22,0.00256,99404,11.54810,860782
1059,gbrail,22,0.00256,99426,11.55066,860782
1060,gimlichael,22,0.00256,99448,11.55322,860782
1061,gouthampacha,22,0.00256,99470,11.55577,860782
1062,goyalv,22,0.00256,99492,11.55833,860782
1063,grassiale,22,0.00256,99514,11.56088,860782
1064,han-so1omon,22,0.00256,99536,11.56344,860782
1065,ilujiez,22,0.00256,99558,11.56599,860782
1066,jakubgs,22,0.00256,99580,11.56855,860782
1067,jfernancordova,22,0.00256,99602,11.57111,860782
1068,jiazxjason,22,0.00256,99624,11.57366,860782
1069,jmuia,22,0.00256,99646,11.57622,860782
1070,kbasv,22,0.00256,99668,11.57877,860782
1071,kmlebedev,22,0.00256,99690,11.58133,860782
1072,lx-or-xxxl,22,0.00256,99712,11.58389,860782
1073,mRs-,22,0.00256,99734,11.58644,860782
1074,namrata-ibm,22,0.00256,99756,11.58900,860782
1075,nictownsend,22,0.00256,99778,11.59155,860782
1076,Nishikoh,22,0.00256,99800,11.59411,860782
1077,princespaghetti,22,0.00256,99822,11.59666,860782
1078,rblaine95,22,0.00256,99844,11.59922,860782
1079,rdxmb,22,0.00256,99866,11.60178,860782
1080,runzhliu,22,0.00256,99888,11.60433,860782
1081,ryanhorn,22,0.00256,99910,11.60689,860782
1082,saltFisher,22,0.00256,99932,11.60944,860782
1083,SayakMukhopadhyay,22,0.00256,99954,11.61200,860782
1084,scottd018,22,0.00256,99976,11.61456,860782
1085,sh-tatsuno,22,0.00256,99998,11.61711,860782
1086,shuijing198799,22,0.00256,100020,11.61967,860782
1087,skurtzemann,22,0.00256,100042,11.62222,860782
1088,Sryther,22,0.00256,100064,11.62478,860782
1089,stevefan1999-personal,22,0.00256,100086,11.62733,860782
1090,suab321321,22,0.00256,100108,11.62989,860782
1091,sullis,22,0.00256,100130,11.63245,860782
1092,thelinuxfoundation,22,0.00256,100152,11.63500,860782
1093,ti,22,0.00256,100174,11.63756,860782
1094,tomaaron,22,0.00256,100196,11.64011,860782
1095,tvalasek,22,0.00256,100218,11.64267,860782
1096,vrodomista,22,0.00256,100240,11.64522,860782
1097,woodruffw,22,0.00256,100262,11.64778,860782
1098,wutkemtt,22,0.00256,100284,11.65034,860782
1099,yichengliu58,22,0.00256,100306,11.65289,860782
1100,ytakaya,22,0.00256,100328,11.65545,860782
1101,zcc35357949,22,0.00256,100350,11.65800,860782
1102,AETDDraper,21,0.00244,100371,11.66044,860782
1103,AJEETRAI707,21,0.00244,100392,11.66288,860782
1104,alvarobacelar,21,0.00244,100413,11.66532,860782
1105,Amos-85,21,0.00244,100434,11.66776,860782
1106,AnjaliRajan24,21,0.00244,100455,11.67020,860782
1107,arminc,21,0.00244,100476,11.67264,860782
1108,babilen5,21,0.00244,100497,11.67508,860782
1109,baurine,21,0.00244,100518,11.67752,860782
1110,BryanHunt,21,0.00244,100539,11.67996,860782
1111,ChipWolf,21,0.00244,100560,11.68240,860782
1112,clarkbw,21,0.00244,100581,11.68484,860782
1113,cuotos,21,0.00244,100602,11.68728,860782
1114,D1abloRUS,21,0.00244,100623,11.68972,860782
1115,dkiser,21,0.00244,100644,11.69216,860782
1116,esweiss,21,0.00244,100665,11.69460,860782
1117,ezYakaEagle442,21,0.00244,100686,11.69704,860782
1118,FlorianLudwig,21,0.00244,100707,11.69948,860782
1119,flurreN,21,0.00244,100728,11.70192,860782
1120,franck102,21,0.00244,100749,11.70436,860782
1121,fxmumu,21,0.00244,100770,11.70680,860782
1122,gazal-k,21,0.00244,100791,11.70924,860782
1123,gongcon,21,0.00244,100812,11.71168,860782
1124,harridu,21,0.00244,100833,11.71412,860782
1125,helios741,21,0.00244,100854,11.71656,860782
1126,HillebrandtOldenberg,21,0.00244,100875,11.71900,860782
1127,ianychoi,21,0.00244,100896,11.72143,860782
1128,ipleten,21,0.00244,100917,11.72387,860782
1129,jasimmons,21,0.00244,100938,11.72631,860782
1130,jasper-d,21,0.00244,100959,11.72875,860782
1131,jbfavre,21,0.00244,100980,11.73119,860782
1132,jfrabaute,21,0.00244,101001,11.73363,860782
1133,jkld11,21,0.00244,101022,11.73607,860782
1134,joewilliams,21,0.00244,101043,11.73851,860782
1135,jpdstan,21,0.00244,101064,11.74095,860782
1136,Kanwaldeep,21,0.00244,101085,11.74339,860782
1137,kenotsolutions,21,0.00244,101106,11.74583,860782
1138,latteczy,21,0.00244,101127,11.74827,860782
1139,matskiv,21,0.00244,101148,11.75071,860782
1140,medaminenajjar,21,0.00244,101169,11.75315,860782
1141,NikPaushkin,21,0.00244,101190,11.75559,860782
1142,pmengelbert,21,0.00244,101211,11.75803,860782
1143,Pradyumnakashyap,21,0.00244,101232,11.76047,860782
1144,prathapar,21,0.00244,101253,11.76291,860782
1145,pschichtel,21,0.00244,101274,11.76535,860782
1146,QizhouYang,21,0.00244,101295,11.76779,860782
1147,quaff,21,0.00244,101316,11.77023,860782
1148,renperez,21,0.00244,101337,11.77267,860782
1149,s8k-37,21,0.00244,101358,11.77511,860782
1150,shenkonghui,21,0.00244,101379,11.77755,860782
1151,shravan-achar,21,0.00244,101400,11.77999,860782
1152,spkane,21,0.00244,101421,11.78243,860782
1153,sppwf,21,0.00244,101442,11.78487,860782
1154,susanhuhu,21,0.00244,101463,11.78731,860782
1155,suvsap,21,0.00244,101484,11.78974,860782
1156,udekel,21,0.00244,101505,11.79218,860782
1157,usamaahmadkhan,21,0.00244,101526,11.79462,860782
1158,wu105,21,0.00244,101547,11.79706,860782
1159,Xcalizorz,21,0.00244,101568,11.79950,860782
1160,ycwdaaaa,21,0.00244,101589,11.80194,860782
1161,zengyongjie,21,0.00244,101610,11.80438,860782
1162,zestyroxy,21,0.00244,101631,11.80682,860782
1163,ZhaoTianlin990121,21,0.00244,101652,11.80926,860782
1164,21h,20,0.00232,101672,11.81159,860782
1165,a7i,20,0.00232,101692,11.81391,860782
1166,alecjacobs5401,20,0.00232,101712,11.81623,860782
1167,amoore877,20,0.00232,101732,11.81856,860782
1168,arlingtonroad,20,0.00232,101752,11.82088,860782
1169,astorm,20,0.00232,101772,11.82320,860782
1170,bjzqhe,20,0.00232,101792,11.82553,860782
1171,chenfengjin,20,0.00232,101812,11.82785,860782
1172,chrisjholly,20,0.00232,101832,11.83017,860782
1173,chrono2002,20,0.00232,101852,11.83250,860782
1174,DanielQujun,20,0.00232,101872,11.83482,860782
1175,deekshahegde86,20,0.00232,101892,11.83714,860782
1176,del-zhenwu,20,0.00232,101912,11.83947,860782
1177,ericandrewmeadows,20,0.00232,101932,11.84179,860782
1178,evanfoster,20,0.00232,101952,11.84411,860782
1179,FeynmanZhou,20,0.00232,101972,11.84644,860782
1180,godev-learner,20,0.00232,101992,11.84876,860782
1181,hezhizhen,20,0.00232,102012,11.85108,860782
1182,hila3000,20,0.00232,102032,11.85341,860782
1183,Hokwang,20,0.00232,102052,11.85573,860782
1184,hornpolish,20,0.00232,102072,11.85805,860782
1185,Howie66,20,0.00232,102092,11.86038,860782
1186,j0n3lson,20,0.00232,102112,11.86270,860782
1187,janmaterne,20,0.00232,102132,11.86503,860782
1188,jdockter,20,0.00232,102152,11.86735,860782
1189,jonathan-mothership,20,0.00232,102172,11.86967,860782
1190,jrick,20,0.00232,102192,11.87200,860782
1191,kiyoshim55,20,0.00232,102212,11.87432,860782
1192,kkHAIKE,20,0.00232,102232,11.87664,860782
1193,kunzhijia,20,0.00232,102252,11.87897,860782
1194,l1b0k,20,0.00232,102272,11.88129,860782
1195,lalithvaka,20,0.00232,102292,11.88361,860782
1196,lucasvmiguel,20,0.00232,102312,11.88594,860782
1197,MarcusSorealheis,20,0.00232,102332,11.88826,860782
1198,mstrYoda,20,0.00232,102352,11.89058,860782
1199,musabmasood,20,0.00232,102372,11.89291,860782
1200,okossuth,20,0.00232,102392,11.89523,860782
1201,payall4u,20,0.00232,102412,11.89755,860782
1202,petorre,20,0.00232,102432,11.89988,860782
1203,pierDipi,20,0.00232,102452,11.90220,860782
1204,pjulien,20,0.00232,102472,11.90452,860782
1205,prashantkalkar,20,0.00232,102492,11.90685,860782
1206,qckzr,20,0.00232,102512,11.90917,860782
1207,qhh0205,20,0.00232,102532,11.91149,860782
1208,rakeshreddybandi,20,0.00232,102552,11.91382,860782
1209,rmgogogo,20,0.00232,102572,11.91614,860782
1210,scottstout,20,0.00232,102592,11.91846,860782
1211,sethev,20,0.00232,102612,11.92079,860782
1212,sevagh,20,0.00232,102632,11.92311,860782
1213,sfc-gh-pkrishnamurthy,20,0.00232,102652,11.92544,860782
1214,shouri007,20,0.00232,102672,11.92776,860782
1215,Shreyangi,20,0.00232,102692,11.93008,860782
1216,smileusd,20,0.00232,102712,11.93241,860782
1217,smoke,20,0.00232,102732,11.93473,860782
1218,Sramsel,20,0.00232,102752,11.93705,860782
1219,thaniri,20,0.00232,102772,11.93938,860782
1220,timmy59100,20,0.00232,102792,11.94170,860782
1221,timuthy,20,0.00232,102812,11.94402,860782
1222,user-name-is-taken,20,0.00232,102832,11.94635,860782
1223,varunshajimwang,20,0.00232,102852,11.94867,860782
1224,vijayto,20,0.00232,102872,11.95099,860782
1225,Vlaaaaaaad,20,0.00232,102892,11.95332,860782
1226,wknapik,20,0.00232,102912,11.95564,860782
1227,WywTed,20,0.00232,102932,11.95796,860782
1228,yeelinglam,20,0.00232,102952,11.96029,860782
1229,yutachaos,20,0.00232,102972,11.96261,860782
1230,zerefwayne,20,0.00232,102992,11.96493,860782
1231,Addono,19,0.00221,103011,11.96714,860782
1232,adityacs,19,0.00221,103030,11.96935,860782
1233,akshaysharama,19,0.00221,103049,11.97156,860782
1234,alexgaganashvili,19,0.00221,103068,11.97376,860782
1235,AlexZzz,19,0.00221,103087,11.97597,860782
1236,AliMirlou,19,0.00221,103106,11.97818,860782
1237,andy-wolf168,19,0.00221,103125,11.98039,860782
1238,arpitjindal97,19,0.00221,103144,11.98259,860782
1239,avimas,19,0.00221,103163,11.98480,860782
1240,axelgobletbdr,19,0.00221,103182,11.98701,860782
1241,borod108,19,0.00221,103201,11.98921,860782
1242,clarakosi,19,0.00221,103220,11.99142,860782
1243,ClSlaid,19,0.00221,103239,11.99363,860782
1244,cmiller-sq,19,0.00221,103258,11.99584,860782
1245,cryptk,19,0.00221,103277,11.99804,860782
1246,datatom-infinity,19,0.00221,103296,12.00025,860782
1247,DavidKorczynski,19,0.00221,103315,12.00246,860782
1248,defool,19,0.00221,103334,12.00467,860782
1249,drholmie,19,0.00221,103353,12.00687,860782
1250,droccom,19,0.00221,103372,12.00908,860782
1251,Emc1992,19,0.00221,103391,12.01129,860782
1252,fdupont-redhat,19,0.00221,103410,12.01349,860782
1253,Foxboron,19,0.00221,103429,12.01570,860782
1254,hbobenicio,19,0.00221,103448,12.01791,860782
1255,hsqlu,19,0.00221,103467,12.02012,860782
1256,huang-jy,19,0.00221,103486,12.02232,860782
1257,iamchuckss,19,0.00221,103505,12.02453,860782
1258,isra17,19,0.00221,103524,12.02674,860782
1259,jonnylangefeld,19,0.00221,103543,12.02895,860782
1260,jsuchome,19,0.00221,103562,12.03115,860782
1261,ksameersrk,19,0.00221,103581,12.03336,860782
1262,laggyluke,19,0.00221,103600,12.03557,860782
1263,Lercher,19,0.00221,103619,12.03777,860782
1264,llamerada-jp,19,0.00221,103638,12.03998,860782
1265,LokkaPatel,19,0.00221,103657,12.04219,860782
1266,mikechengwei,19,0.00221,103676,12.04440,860782
1267,morimoto-cybozu,19,0.00221,103695,12.04660,860782
1268,mswilson,19,0.00221,103714,12.04881,860782
1269,mxiamxia,19,0.00221,103733,12.05102,860782
1270,nathforge,19,0.00221,103752,12.05323,860782
1271,naxhh,19,0.00221,103771,12.05543,860782
1272,ntippabhatla,19,0.00221,103790,12.05764,860782
1273,ohdearaugustin,19,0.00221,103809,12.05985,860782
1274,opa-updater-automation,19,0.00221,103828,12.06206,860782
1275,opensourceonly,19,0.00221,103847,12.06426,860782
1276,pbxqdown,19,0.00221,103866,12.06647,860782
1277,picchipalarm,19,0.00221,103885,12.06868,860782
1278,prymitive,19,0.00221,103904,12.07088,860782
1279,pupapaik,19,0.00221,103923,12.07309,860782
1280,quadrinho,19,0.00221,103942,12.07530,860782
1281,raz-bn,19,0.00221,103961,12.07751,860782
1282,remraz,19,0.00221,103980,12.07971,860782
1283,rokrokss,19,0.00221,103999,12.08192,860782
1284,ron1,19,0.00221,104018,12.08413,860782
1285,rushins,19,0.00221,104037,12.08634,860782
1286,saikatharryc,19,0.00221,104056,12.08854,860782
1287,sarvaniy,19,0.00221,104075,12.09075,860782
1288,si458,19,0.00221,104094,12.09296,860782
1289,spoplavskiy,19,0.00221,104113,12.09516,860782
1290,sridharprasath,19,0.00221,104132,12.09737,860782
1291,tahmmee,19,0.00221,104151,12.09958,860782
1292,tebeco,19,0.00221,104170,12.10179,860782
1293,Tej-Singh-Rana,19,0.00221,104189,12.10399,860782
1294,TPX01,19,0.00221,104208,12.10620,860782
1295,treydock,19,0.00221,104227,12.10841,860782
1296,tsahiduek,19,0.00221,104246,12.11062,860782
1297,via-jordan-sokolic,19,0.00221,104265,12.11282,860782
1298,viggys,19,0.00221,104284,12.11503,860782
1299,vincenthcui,19,0.00221,104303,12.11724,860782
1300,yonatankahana,19,0.00221,104322,12.11944,860782
1301,zimmertr,19,0.00221,104341,12.12165,860782
1302,agniveshadhikari,18,0.00209,104359,12.12374,860782
1303,alexgeek,18,0.00209,104377,12.12583,860782
1304,arka-g,18,0.00209,104395,12.12793,860782
1305,bdaw,18,0.00209,104413,12.13002,860782
1306,bseenu,18,0.00209,104431,12.13211,860782
1307,cafeliker,18,0.00209,104449,12.13420,860782
1308,Catramen,18,0.00209,104467,12.13629,860782
1309,c-n-c,18,0.00209,104485,12.13838,860782
1310,code-haven,18,0.00209,104503,12.14047,860782
1311,daicoden,18,0.00209,104521,12.14256,860782
1312,dignajar,18,0.00209,104539,12.14465,860782
1313,DinoStray,18,0.00209,104557,12.14675,860782
1314,disposab1e,18,0.00209,104575,12.14884,860782
1315,djjayeeta,18,0.00209,104593,12.15093,860782
1316,enderv,18,0.00209,104611,12.15302,860782
1317,ewolff,18,0.00209,104629,12.15511,860782
1318,fuguohong1024,18,0.00209,104647,12.15720,860782
1319,gaga5lala,18,0.00209,104665,12.15929,860782
1320,gdetal,18,0.00209,104683,12.16138,860782
1321,gmcrobert,18,0.00209,104701,12.16347,860782
1322,hanneshoettinger,18,0.00209,104719,12.16557,860782
1323,hauleth,18,0.00209,104737,12.16766,860782
1324,inistor,18,0.00209,104755,12.16975,860782
1325,jabbors,18,0.00209,104773,12.17184,860782
1326,Jamlee,18,0.00209,104791,12.17393,860782
1327,jeffreyqw,18,0.00209,104809,12.17602,860782
1328,JNProtzman,18,0.00209,104827,12.17811,860782
1329,johejo,18,0.00209,104845,12.18020,860782
1330,joshuahlang,18,0.00209,104863,12.18229,860782
1331,jsandler18,18,0.00209,104881,12.18439,860782
1332,jufab,18,0.00209,104899,12.18648,860782
1333,JuliusSweetland,18,0.00209,104917,12.18857,860782
1334,kaushiksrinivas,18,0.00209,104935,12.19066,860782
1335,kubemq,18,0.00209,104953,12.19275,860782
1336,lfrancke,18,0.00209,104971,12.19484,860782
1337,liuyangc3,18,0.00209,104989,12.19693,860782
1338,lovemai073,18,0.00209,105007,12.19902,860782
1339,lvchenggang,18,0.00209,105025,12.20111,860782
1340,majoyz,18,0.00209,105043,12.20321,860782
1341,MarcPow,18,0.00209,105061,12.20530,860782
1342,masaeedu,18,0.00209,105079,12.20739,860782
1343,MaT1g3R,18,0.00209,105097,12.20948,860782
1344,mattiaperi,18,0.00209,105115,12.21157,860782
1345,mforutan,18,0.00209,105133,12.21366,860782
1346,MhdAna,18,0.00209,105151,12.21575,860782
1347,mhindery,18,0.00209,105169,12.21784,860782
1348,mkabischev,18,0.00209,105187,12.21993,860782
1349,mtl-wgtwo,18,0.00209,105205,12.22203,860782
1350,murilofv,18,0.00209,105223,12.22412,860782
1351,neemiasjnr,18,0.00209,105241,12.22621,860782
1352,neeraj97,18,0.00209,105259,12.22830,860782
1353,ning2008wisc,18,0.00209,105277,12.23039,860782
1354,nmaludy,18,0.00209,105295,12.23248,860782
1355,obowersa,18,0.00209,105313,12.23457,860782
1356,odidev,18,0.00209,105331,12.23666,860782
1357,phxnsharp,18,0.00209,105349,12.23875,860782
1358,pmahoney,18,0.00209,105367,12.24085,860782
1359,previ,18,0.00209,105385,12.24294,860782
1360,primeroz,18,0.00209,105403,12.24503,860782
1361,Promaethius,18,0.00209,105421,12.24712,860782
1362,Radha13,18,0.00209,105439,12.24921,860782
1363,rdkls,18,0.00209,105457,12.25130,860782
1364,replay,18,0.00209,105475,12.25339,860782
1365,salaxander,18,0.00209,105493,12.25548,860782
1366,satishbellapu,18,0.00209,105511,12.25758,860782
1367,scuzhanglei,18,0.00209,105529,12.25967,860782
1368,sharet-adl,18,0.00209,105547,12.26176,860782
1369,silverskyvicto,18,0.00209,105565,12.26385,860782
1370,SuxiangYundi,18,0.00209,105583,12.26594,860782
1371,tangwz,18,0.00209,105601,12.26803,860782
1372,thegreenbear,18,0.00209,105619,12.27012,860782
1373,timchenxiaoyu,18,0.00209,105637,12.27221,860782
1374,tkms0106,18,0.00209,105655,12.27430,860782
1375,tsyrfa,18,0.00209,105673,12.27640,860782
1376,ttlv,18,0.00209,105691,12.27849,860782
1377,weissi,18,0.00209,105709,12.28058,860782
1378,whitleykeith,18,0.00209,105727,12.28267,860782
1379,wswcfan,18,0.00209,105745,12.28476,860782
1380,yoninl2,18,0.00209,105763,12.28685,860782
1381,Abrishges,17,0.00197,105780,12.28883,860782
1382,ak800i,17,0.00197,105797,12.29080,860782
1383,akin-ozer,17,0.00197,105814,12.29278,860782
1384,alam0rt,17,0.00197,105831,12.29475,860782
1385,alburthoffman,17,0.00197,105848,12.29673,860782
1386,alexzimmer96,17,0.00197,105865,12.29870,860782
1387,alwaysastudent,17,0.00197,105882,12.30068,860782
1388,arunfung,17,0.00197,105899,12.30265,860782
1389,AWKIF,17,0.00197,105916,12.30463,860782
1390,BellaXiang,17,0.00197,105933,12.30660,860782
1391,chauncey-77,17,0.00197,105950,12.30858,860782
1392,chenjinxuan,17,0.00197,105967,12.31055,860782
1393,christle,17,0.00197,105984,12.31253,860782
1394,DaveOHenry,17,0.00197,106001,12.31450,860782
1395,d-ulyanov,17,0.00197,106018,12.31648,860782
1396,eazhilan-nagarajan,17,0.00197,106035,12.31845,860782
1397,egulatee,17,0.00197,106052,12.32042,860782
1398,eoinreilly93,17,0.00197,106069,12.32240,860782
1399,etanshaul,17,0.00197,106086,12.32437,860782
1400,eth0xFEED,17,0.00197,106103,12.32635,860782
1401,FlipEnergy,17,0.00197,106120,12.32832,860782
1402,fraserdarwent,17,0.00197,106137,12.33030,860782
1403,fujin,17,0.00197,106154,12.33227,860782
1404,fzhedu,17,0.00197,106171,12.33425,860782
1405,glademiller,17,0.00197,106188,12.33622,860782
1406,gm7y8,17,0.00197,106205,12.33820,860782
1407,hacst,17,0.00197,106222,12.34017,860782
1408,hashkanna,17,0.00197,106239,12.34215,860782
1409,HaveFun83,17,0.00197,106256,12.34412,860782
1410,Heena-PyCloud,17,0.00197,106273,12.34610,860782
1411,hooklee2000,17,0.00197,106290,12.34807,860782
1412,ide-rea,17,0.00197,106307,12.35005,860782
1413,IgorRosocha,17,0.00197,106324,12.35202,860782
1414,izzyleung,17,0.00197,106341,12.35400,860782
1415,jainshikha,17,0.00197,106358,12.35597,860782
1416,JCzz,17,0.00197,106375,12.35795,860782
1417,jeusdi,17,0.00197,106392,12.35992,860782
1418,jorgecarleitao,17,0.00197,106409,12.36190,860782
1419,jpatel-pivotal,17,0.00197,106426,12.36387,860782
1420,justnoise,17,0.00197,106443,12.36585,860782
1421,Karthik-13,17,0.00197,106460,12.36782,860782
1422,kerven88,17,0.00197,106477,12.36980,860782
1423,kgamanji,17,0.00197,106494,12.37177,860782
1424,kommulu,17,0.00197,106511,12.37375,860782
1425,kubawach,17,0.00197,106528,12.37572,860782
1426,kwangil-ha,17,0.00197,106545,12.37770,860782
1427,lalex,17,0.00197,106562,12.37967,860782
1428,loxley,17,0.00197,106579,12.38165,860782
1429,mailhari,17,0.00197,106596,12.38362,860782
1430,MarkSpencerTan,17,0.00197,106613,12.38560,860782
1431,matte21,17,0.00197,106630,12.38757,860782
1432,max-sixty,17,0.00197,106647,12.38955,860782
1433,MichelHollands,17,0.00197,106664,12.39152,860782
1434,mohsen0,17,0.00197,106681,12.39350,860782
1435,mosesyou,17,0.00197,106698,12.39547,860782
1436,mtiller,17,0.00197,106715,12.39745,860782
1437,My-pleasure,17,0.00197,106732,12.39942,860782
1438,nandeeshb09,17,0.00197,106749,12.40140,860782
1439,njingco,17,0.00197,106766,12.40337,860782
1440,NMFR,17,0.00197,106783,12.40535,860782
1441,odeng888,17,0.00197,106800,12.40732,860782
1442,plochon,17,0.00197,106817,12.40930,860782
1443,ragarcia26,17,0.00197,106834,12.41127,860782
1444,rficcaglia,17,0.00197,106851,12.41325,860782
1445,sachinmsft,17,0.00197,106868,12.41522,860782
1446,sadortun,17,0.00197,106885,12.41720,860782
1447,sbhnet,17,0.00197,106902,12.41917,860782
1448,selina-cui,17,0.00197,106919,12.42115,860782
1449,shivrajjadhav733,17,0.00197,106936,12.42312,860782
1450,silenceli,17,0.00197,106953,12.42510,860782
1451,smanolloff,17,0.00197,106970,12.42707,860782
1452,snorlaX-sleeps,17,0.00197,106987,12.42905,860782
1453,sshishov,17,0.00197,107004,12.43102,860782
1454,stv0g,17,0.00197,107021,12.43300,860782
1455,suhrud-kumar,17,0.00197,107038,12.43497,860782
1456,sunchill06,17,0.00197,107055,12.43695,860782
1457,sxllwx,17,0.00197,107072,12.43892,860782
1458,varac,17,0.00197,107089,12.44090,860782
1459,vespian,17,0.00197,107106,12.44287,860782
1460,vikram-yerneni,17,0.00197,107123,12.44485,860782
1461,vkvamsiopsmx,17,0.00197,107140,12.44682,860782
1462,WarpRat,17,0.00197,107157,12.44880,860782
1463,wikix,17,0.00197,107174,12.45077,860782
1464,wuxueyi19,17,0.00197,107191,12.45275,860782
1465,xd009642,17,0.00197,107208,12.45472,860782
1466,yachtcaptain23,17,0.00197,107225,12.45670,860782
1467,ycabrer,17,0.00197,107242,12.45867,860782
1468,yehlo,17,0.00197,107259,12.46065,860782
1469,Yellow-L,17,0.00197,107276,12.46262,860782
1470,yunhailuo,17,0.00197,107293,12.46460,860782
1471,yydzhou,17,0.00197,107310,12.46657,860782
1472,zedyeung,17,0.00197,107327,12.46855,860782
1473,zffocussss,17,0.00197,107344,12.47052,860782
1474,zhiweiyin318,17,0.00197,107361,12.47250,860782
1475,aemperador,16,0.00186,107377,12.47435,860782
1476,aimbot31,16,0.00186,107393,12.47621,860782
1477,alexanderccc,16,0.00186,107409,12.47807,860782
1478,alexandery,16,0.00186,107425,12.47993,860782
1479,AmithGanesh,16,0.00186,107441,12.48179,860782
1480,ankitm123,16,0.00186,107457,12.48365,860782
1481,Arash-Sabet,16,0.00186,107473,12.48551,860782
1482,arbielsk,16,0.00186,107489,12.48737,860782
1483,Asafb26,16,0.00186,107505,12.48922,860782
1484,berlin-ab,16,0.00186,107521,12.49108,860782
1485,bigkevmcd,16,0.00186,107537,12.49294,860782
1486,bitspradp,16,0.00186,107553,12.49480,860782
1487,blame19,16,0.00186,107569,12.49666,860782
1488,caslurjf,16,0.00186,107585,12.49852,860782
1489,cdoron,16,0.00186,107601,12.50038,860782
1490,chiaolun,16,0.00186,107617,12.50224,860782
1491,ComptonAlvaro,16,0.00186,107633,12.50410,860782
1492,crazycs520,16,0.00186,107649,12.50595,860782
1493,cretz,16,0.00186,107665,12.50781,860782
1494,danielbang907,16,0.00186,107681,12.50967,860782
1495,daocloudplf,16,0.00186,107697,12.51153,860782
1496,davebarda,16,0.00186,107713,12.51339,860782
1497,dove-young,16,0.00186,107729,12.51525,860782
1498,DRayX,16,0.00186,107745,12.51711,860782
1499,elgamal2020,16,0.00186,107761,12.51897,860782
1500,eliyahu77,16,0.00186,107777,12.52082,860782
1501,enderson-pan,16,0.00186,107793,12.52268,860782
1502,eox-dev,16,0.00186,107809,12.52454,860782
1503,ericlem,16,0.00186,107825,12.52640,860782
1504,farcop,16,0.00186,107841,12.52826,860782
1505,Gnoale,16,0.00186,107857,12.53012,860782
1506,guimou,16,0.00186,107873,12.53198,860782
1507,haines,16,0.00186,107889,12.53384,860782
1508,hakuna-matatah,16,0.00186,107905,12.53569,860782
1509,hanamantagoudvk,16,0.00186,107921,12.53755,860782
1510,hinch5,16,0.00186,107937,12.53941,860782
1511,hmlkao,16,0.00186,107953,12.54127,860782
1512,Hongbo-Miao,16,0.00186,107969,12.54313,860782
1513,jagobagascon,16,0.00186,107985,12.54499,860782
1514,jeanfabrice,16,0.00186,108001,12.54685,860782
1515,JessicaGreben,16,0.00186,108017,12.54871,860782
1516,jiajunye,16,0.00186,108033,12.55056,860782
1517,jiayun1997,16,0.00186,108049,12.55242,860782
1518,jimmyseto,16,0.00186,108065,12.55428,860782
1519,jmcdonagh,16,0.00186,108081,12.55614,860782
1520,jonesbr17,16,0.00186,108097,12.55800,860782
1521,jyz0309,16,0.00186,108113,12.55986,860782
1522,jzinkweg,16,0.00186,108129,12.56172,860782
1523,kenseitogari,16,0.00186,108145,12.56358,860782
1524,kong62,16,0.00186,108161,12.56543,860782
1525,krishnakvall,16,0.00186,108177,12.56729,860782
1526,KrzesloSzatan,16,0.00186,108193,12.56915,860782
1527,linecolumn,16,0.00186,108209,12.57101,860782
1528,macolso,16,0.00186,108225,12.57287,860782
1529,marcantoine-bibeau,16,0.00186,108241,12.57473,860782
1530,MengqiWu,16,0.00186,108257,12.57659,860782
1531,meurig,16,0.00186,108273,12.57845,860782
1532,mhurtrel,16,0.00186,108289,12.58030,860782
1533,michael-niemand,16,0.00186,108305,12.58216,860782
1534,misakwa,16,0.00186,108321,12.58402,860782
1535,mmiara,16,0.00186,108337,12.58588,860782
1536,mpritter76,16,0.00186,108353,12.58774,860782
1537,mydockergit,16,0.00186,108369,12.58960,860782
1538,needkane,16,0.00186,108385,12.59146,860782
1539,nikhilkathare,16,0.00186,108401,12.59332,860782
1540,nkelly75,16,0.00186,108417,12.59518,860782
1541,oe-hbk,16,0.00186,108433,12.59703,860782
1542,oulydna,16,0.00186,108449,12.59889,860782
1543,paulcarlton-ww,16,0.00186,108465,12.60075,860782
1544,pedjak,16,0.00186,108481,12.60261,860782
1545,PixelJonas,16,0.00186,108497,12.60447,860782
1546,pjferrell,16,0.00186,108513,12.60633,860782
1547,pranavmarla,16,0.00186,108529,12.60819,860782
1548,prudhvigodithi,16,0.00186,108545,12.61005,860782
1549,psarossy,16,0.00186,108561,12.61190,860782
1550,ranshn,16,0.00186,108577,12.61376,860782
1551,rayw000,16,0.00186,108593,12.61562,860782
1552,rrichardson,16,0.00186,108609,12.61748,860782
1553,Ryanfsdf,16,0.00186,108625,12.61934,860782
1554,sartx,16,0.00186,108641,12.62120,860782
1555,sashrith,16,0.00186,108657,12.62306,860782
1556,scotte,16,0.00186,108673,12.62492,860782
1557,shantpschauhan,16,0.00186,108689,12.62677,860782
1558,shashank-k,16,0.00186,108705,12.62863,860782
1559,silathdiir,16,0.00186,108721,12.63049,860782
1560,smitthakkar96,16,0.00186,108737,12.63235,860782
1561,snyksec,16,0.00186,108753,12.63421,860782
1562,sunny-b,16,0.00186,108769,12.63607,860782
1563,swapster,16,0.00186,108785,12.63793,860782
1564,tanenbaum,16,0.00186,108801,12.63979,860782
1565,tetrohed,16,0.00186,108817,12.64164,860782
1566,timebertt,16,0.00186,108833,12.64350,860782
1567,Toasterson,16,0.00186,108849,12.64536,860782
1568,tom-haines,16,0.00186,108865,12.64722,860782
1569,tweing,16,0.00186,108881,12.64908,860782
1570,vinayvenkat,16,0.00186,108897,12.65094,860782
1571,vishnubraj,16,0.00186,108913,12.65280,860782
1572,VitaliyShevchenko,16,0.00186,108929,12.65466,860782
1573,vitalyzhakov,16,0.00186,108945,12.65651,860782
1574,vivekanandpoojari,16,0.00186,108961,12.65837,860782
1575,vteratipally,16,0.00186,108977,12.66023,860782
1576,vvanouytsel,16,0.00186,108993,12.66209,860782
1577,wabernatScality,16,0.00186,109009,12.66395,860782
1578,wshi5985,16,0.00186,109025,12.66581,860782
1579,wuchaojing,16,0.00186,109041,12.66767,860782
1580,zerodayz,16,0.00186,109057,12.66953,860782
1581,zianke,16,0.00186,109073,12.67138,860782
1582,Abhishek-Srivastava,15,0.00174,109088,12.67313,860782
1583,Ajitesh13,15,0.00174,109103,12.67487,860782
1584,alcorf-mizar,15,0.00174,109118,12.67661,860782
1585,alemairebe,15,0.00174,109133,12.67836,860782
1586,alex-shpak,15,0.00174,109148,12.68010,860782
1587,amiga23,15,0.00174,109163,12.68184,860782
1588,Anonymous-Coward,15,0.00174,109178,12.68358,860782
1589,asettle,15,0.00174,109193,12.68533,860782
1590,aure-olli,15,0.00174,109208,12.68707,860782
1591,azihsoyn,15,0.00174,109223,12.68881,860782
1592,bamarni,15,0.00174,109238,12.69055,860782
1593,bartekzurawski,15,0.00174,109253,12.69230,860782
1594,barucoh,15,0.00174,109268,12.69404,860782
1595,bgsilvait,15,0.00174,109283,12.69578,860782
1596,bhardwajk,15,0.00174,109298,12.69752,860782
1597,brainsolution,15,0.00174,109313,12.69927,860782
1598,caitmulholland,15,0.00174,109328,12.70101,860782
1599,chipkent,15,0.00174,109343,12.70275,860782
1600,chrisLeeTW,15,0.00174,109358,12.70449,860782
1601,cprayer,15,0.00174,109373,12.70624,860782
1602,cten,15,0.00174,109388,12.70798,860782
1603,darfux,15,0.00174,109403,12.70972,860782
1604,dastbe,15,0.00174,109418,12.71146,860782
1605,davelosert,15,0.00174,109433,12.71321,860782
1606,daxtergithub,15,0.00174,109448,12.71495,860782
1607,deiga,15,0.00174,109463,12.71669,860782
1608,dmanchikalapudi,15,0.00174,109478,12.71844,860782
1609,DRuggeri,15,0.00174,109493,12.72018,860782
1610,duongnt,15,0.00174,109508,12.72192,860782
1611,eladm26,15,0.00174,109523,12.72366,860782
1612,entropitor,15,0.00174,109538,12.72541,860782
1613,EricLemieux,15,0.00174,109553,12.72715,860782
1614,ericmeadows,15,0.00174,109568,12.72889,860782
1615,ericrrath,15,0.00174,109583,12.73063,860782
1616,EricWittmann,15,0.00174,109598,12.73238,860782
1617,ezra-at-lumedic,15,0.00174,109613,12.73412,860782
1618,FabianKramm,15,0.00174,109628,12.73586,860782
1619,fabriziomello,15,0.00174,109643,12.73760,860782
1620,fabstu,15,0.00174,109658,12.73935,860782
1621,faust64,15,0.00174,109673,12.74109,860782
1622,fgiudici,15,0.00174,109688,12.74283,860782
1623,flavray,15,0.00174,109703,12.74457,860782
1624,flecno,15,0.00174,109718,12.74632,860782
1625,fml2,15,0.00174,109733,12.74806,860782
1626,foobarfran,15,0.00174,109748,12.74980,860782
1627,frgomes,15,0.00174,109763,12.75154,860782
1628,gdbelvin,15,0.00174,109778,12.75329,860782
1629,glodomorski,15,0.00174,109793,12.75503,860782
1630,gmrodgers,15,0.00174,109808,12.75677,860782
1631,hamburgerbun,15,0.00174,109823,12.75851,860782
1632,handywijaya,15,0.00174,109838,12.76026,860782
1633,hezise,15,0.00174,109853,12.76200,860782
1634,hgliu1985,15,0.00174,109868,12.76374,860782
1635,hossain-rayhan,15,0.00174,109883,12.76549,860782
1636,imrtfm,15,0.00174,109898,12.76723,860782
1637,iuriaranda,15,0.00174,109913,12.76897,860782
1638,iusergii,15,0.00174,109928,12.77071,860782
1639,JasonTruter,15,0.00174,109943,12.77246,860782
1640,jc-lab,15,0.00174,109958,12.77420,860782
1641,JeepNL,15,0.00174,109973,12.77594,860782
1642,Johnny-Three,15,0.00174,109988,12.77768,860782
1643,joshulyne,15,0.00174,110003,12.77943,860782
1644,jtackaberry,15,0.00174,110018,12.78117,860782
1645,junghyeonsu,15,0.00174,110033,12.78291,860782
1646,kirillta,15,0.00174,110048,12.78465,860782
1647,kk-src,15,0.00174,110063,12.78640,860782
1648,kkweon,15,0.00174,110078,12.78814,860782
1649,kotyara85,15,0.00174,110093,12.78988,860782
1650,krisis,15,0.00174,110108,12.79162,860782
1651,lazybetrayer,15,0.00174,110123,12.79337,860782
1652,lowang-bh,15,0.00174,110138,12.79511,860782
1653,luka223,15,0.00174,110153,12.79685,860782
1654,MacroPower,15,0.00174,110168,12.79859,860782
1655,marcobellaccini,15,0.00174,110183,12.80034,860782
1656,matthewgrossman,15,0.00174,110198,12.80208,860782
1657,maxisam,15,0.00174,110213,12.80382,860782
1658,maxisme,15,0.00174,110228,12.80557,860782
1659,ming-relax,15,0.00174,110243,12.80731,860782
1660,moorara,15,0.00174,110258,12.80905,860782
1661,morlay,15,0.00174,110273,12.81079,860782
1662,MrFishFinger,15,0.00174,110288,12.81254,860782
1663,mshack70,15,0.00174,110303,12.81428,860782
1664,msilvestre,15,0.00174,110318,12.81602,860782
1665,Murphylu1993,15,0.00174,110333,12.81776,860782
1666,mzzgaopeng,15,0.00174,110348,12.81951,860782
1667,NadamHL,15,0.00174,110363,12.82125,860782
1668,naeem98,15,0.00174,110378,12.82299,860782
1669,NasAmin,15,0.00174,110393,12.82473,860782
1670,nataraj24,15,0.00174,110408,12.82648,860782
1671,nikhileshva,15,0.00174,110423,12.82822,860782
1672,ninja-,15,0.00174,110438,12.82996,860782
1673,ozankabak,15,0.00174,110453,12.83170,860782
1674,Patrick-Remy,15,0.00174,110468,12.83345,860782
1675,PCatinean,15,0.00174,110483,12.83519,860782
1676,pperiyasamy,15,0.00174,110498,12.83693,860782
1677,PriyaKatkade,15,0.00174,110513,12.83867,860782
1678,quintans,15,0.00174,110528,12.84042,860782
1679,rahul-kr4604,15,0.00174,110543,12.84216,860782
1680,ravidbro,15,0.00174,110558,12.84390,860782
1681,sandys,15,0.00174,110573,12.84565,860782
1682,sergioregueira,15,0.00174,110588,12.84739,860782
1683,shambanna-u,15,0.00174,110603,12.84913,860782
1684,shreyasbapat,15,0.00174,110618,12.85087,860782
1685,shubhamc183,15,0.00174,110633,12.85262,860782
1686,SidneyShen,15,0.00174,110648,12.85436,860782
1687,ST-DDT,15,0.00174,110663,12.85610,860782
1688,stefan301,15,0.00174,110678,12.85784,860782
1689,stepherg,15,0.00174,110693,12.85959,860782
1690,SteveMattar,15,0.00174,110708,12.86133,860782
1691,stylianosrigas,15,0.00174,110723,12.86307,860782
1692,Svendegroote91,15,0.00174,110738,12.86481,860782
1693,tanrobotix,15,0.00174,110753,12.86656,860782
1694,TheCactusBlue,15,0.00174,110768,12.86830,860782
1695,thejasbabu,15,0.00174,110783,12.87004,860782
1696,tkumark,15,0.00174,110798,12.87178,860782
1697,tongchao199,15,0.00174,110813,12.87353,860782
1698,tumido,15,0.00174,110828,12.87527,860782
1699,vilmosnagy,15,0.00174,110843,12.87701,860782
1700,Vox1984,15,0.00174,110858,12.87875,860782
1701,waldyrious,15,0.00174,110873,12.88050,860782
1702,westonplatter,15,0.00174,110888,12.88224,860782
1703,xingfeng1234,15,0.00174,110903,12.88398,860782
1704,xoxbet,15,0.00174,110918,12.88572,860782
1705,xphoniex,15,0.00174,110933,12.88747,860782
1706,xxZap,15,0.00174,110948,12.88921,860782
1707,yan-dblinf,15,0.00174,110963,12.89095,860782
1708,YesterdayxD,15,0.00174,110978,12.89270,860782
1709,yxxhero,15,0.00174,110993,12.89444,860782
1710,zamanimehdi,15,0.00174,111008,12.89618,860782
1711,zerogvt,15,0.00174,111023,12.89792,860782
1712,zhaxzhax,15,0.00174,111038,12.89967,860782
1713,zhb127,15,0.00174,111053,12.90141,860782
1714,zhoudian64,15,0.00174,111068,12.90315,860782
1715,zichangg,15,0.00174,111083,12.90489,860782
1716,0xMH,14,0.00163,111097,12.90652,860782
1717,123BLiN,14,0.00163,111111,12.90815,860782
1718,532910,14,0.00163,111125,12.90977,860782
1719,abhty822,14,0.00163,111139,12.91140,860782
1720,adinhodovic,14,0.00163,111153,12.91303,860782
1721,adrian555,14,0.00163,111167,12.91465,860782
1722,Agent-Tao,14,0.00163,111181,12.91628,860782
1723,Alger7w,14,0.00163,111195,12.91790,860782
1724,AmitThakkar,14,0.00163,111209,12.91953,860782
1725,andrewbanchich,14,0.00163,111223,12.92116,860782
1726,ansarizafar,14,0.00163,111237,12.92278,860782
1727,avielb,14,0.00163,111251,12.92441,860782
1728,aviklai,14,0.00163,111265,12.92604,860782
1729,aviramha,14,0.00163,111279,12.92766,860782
1730,avmohan,14,0.00163,111293,12.92929,860782
1731,azarudeena,14,0.00163,111307,12.93092,860782
1732,bmailhe,14,0.00163,111321,12.93254,860782
1733,bpayt2,14,0.00163,111335,12.93417,860782
1734,brondum,14,0.00163,111349,12.93580,860782
1735,buildbreaker,14,0.00163,111363,12.93742,860782
1736,capoferro,14,0.00163,111377,12.93905,860782
1737,Catorpilor,14,0.00163,111391,12.94067,860782
1738,celiawa,14,0.00163,111405,12.94230,860782
1739,Climber22,14,0.00163,111419,12.94393,860782
1740,courageJ,14,0.00163,111433,12.94555,860782
1741,cquon,14,0.00163,111447,12.94718,860782
1742,cwansart,14,0.00163,111461,12.94881,860782
1743,cyboman32,14,0.00163,111475,12.95043,860782
1744,DasyDong,14,0.00163,111489,12.95206,860782
1745,demelvin,14,0.00163,111503,12.95369,860782
1746,dimstars,14,0.00163,111517,12.95531,860782
1747,DiptoChakrabarty,14,0.00163,111531,12.95694,860782
1748,djshow832,14,0.00163,111545,12.95857,860782
1749,dmc5179,14,0.00163,111559,12.96019,860782
1750,drewpca,14,0.00163,111573,12.96182,860782
1751,duduainankai,14,0.00163,111587,12.96344,860782
1752,eklockare,14,0.00163,111601,12.96507,860782
1753,fujitatomoya,14,0.00163,111615,12.96670,860782
1754,g9rga,14,0.00163,111629,12.96832,860782
1755,gavD,14,0.00163,111643,12.96995,860782
1756,ghoshankur1983,14,0.00163,111657,12.97158,860782
1757,gnadaban,14,0.00163,111671,12.97320,860782
1758,Gouthamkreddy1234,14,0.00163,111685,12.97483,860782
1759,gowrisankar22,14,0.00163,111699,12.97646,860782
1760,gsexton,14,0.00163,111713,12.97808,860782
1761,Gui13,14,0.00163,111727,12.97971,860782
1762,hifly81,14,0.00163,111741,12.98134,860782
1763,HKMglicks,14,0.00163,111755,12.98296,860782
1764,hligit,14,0.00163,111769,12.98459,860782
1765,hongli-my,14,0.00163,111783,12.98621,860782
1766,Hugome,14,0.00163,111797,12.98784,860782
1767,imclaren,14,0.00163,111811,12.98947,860782
1768,jacobmarble,14,0.00163,111825,12.99109,860782
1769,jai,14,0.00163,111839,12.99272,860782
1770,Jennnnny,14,0.00163,111853,12.99435,860782
1771,jiezhang,14,0.00163,111867,12.99597,860782
1772,jodavis-suse,14,0.00163,111881,12.99760,860782
1773,johannesfrey,14,0.00163,111895,12.99923,860782
1774,johnjeffers,14,0.00163,111909,13.00085,860782
1775,kashifsoofi,14,0.00163,111923,13.00248,860782
1776,kiuka,14,0.00163,111937,13.00411,860782
1777,KYannick,14,0.00163,111951,13.00573,860782
1778,KyleJFischer,14,0.00163,111965,13.00736,860782
1779,laymain,14,0.00163,111979,13.00898,860782
1780,leonardodalcin,14,0.00163,111993,13.01061,860782
1781,lianfulei,14,0.00163,112007,13.01224,860782
1782,linjmeyer,14,0.00163,112021,13.01386,860782
1783,lo24,14,0.00163,112035,13.01549,860782
1784,lorqor,14,0.00163,112049,13.01712,860782
1785,loveRhythm1990,14,0.00163,112063,13.01874,860782
1786,lpriima,14,0.00163,112077,13.02037,860782
1787,Mahmoud-Karam,14,0.00163,112091,13.02200,860782
1788,ManojDhanorkar,14,0.00163,112105,13.02362,860782
1789,may101,14,0.00163,112119,13.02525,860782
1790,mbroz2,14,0.00163,112133,13.02688,860782
1791,meenakshi123,14,0.00163,112147,13.02850,860782
1792,michaelrp,14,0.00163,112161,13.03013,860782
1793,mikebou,14,0.00163,112175,13.03175,860782
1794,mikonoid,14,0.00163,112189,13.03338,860782
1795,minxiaogang,14,0.00163,112203,13.03501,860782
1796,Mishra-Akash,14,0.00163,112217,13.03663,860782
1797,mmorejon,14,0.00163,112231,13.03826,860782
1798,mowangdk,14,0.00163,112245,13.03989,860782
1799,neilharris123,14,0.00163,112259,13.04151,860782
1800,nunokisc,14,0.00163,112273,13.04314,860782
1801,OhhhThatVarun,14,0.00163,112287,13.04477,860782
1802,orong-pp,14,0.00163,112301,13.04639,860782
1803,pablitoergosum,14,0.00163,112315,13.04802,860782
1804,parchk,14,0.00163,112329,13.04965,860782
1805,paulcaskey,14,0.00163,112343,13.05127,860782
1806,pburgisser-c2c,14,0.00163,112357,13.05290,860782
1807,pendyalal,14,0.00163,112371,13.05452,860782
1808,PierreF,14,0.00163,112385,13.05615,860782
1809,piyush94,14,0.00163,112399,13.05778,860782
1810,pragadeeshraju,14,0.00163,112413,13.05940,860782
1811,qhb1001,14,0.00163,112427,13.06103,860782
1812,ran-huang,14,0.00163,112441,13.06266,860782
1813,raresraf,14,0.00163,112455,13.06428,860782
1814,RayZhao1998,14,0.00163,112469,13.06591,860782
1815,rchenzheng,14,0.00163,112483,13.06754,860782
1816,reselbob,14,0.00163,112497,13.06916,860782
1817,RiRa12621,14,0.00163,112511,13.07079,860782
1818,rockaut,14,0.00163,112525,13.07242,860782
1819,ruicao93,14,0.00163,112539,13.07404,860782
1820,safris,14,0.00163,112553,13.07567,860782
1821,sahil-sawhney,14,0.00163,112567,13.07729,860782
1822,samitpal,14,0.00163,112581,13.07892,860782
1823,schlitzered,14,0.00163,112595,13.08055,860782
1824,schmurfy,14,0.00163,112609,13.08217,860782
1825,seperman,14,0.00163,112623,13.08380,860782
1826,s-h-a-d-o-w,14,0.00163,112637,13.08543,860782
1827,shmargum,14,0.00163,112651,13.08705,860782
1828,sk-,14,0.00163,112665,13.08868,860782
1829,smartkuk,14,0.00163,112679,13.09031,860782
1830,srikant-code,14,0.00163,112693,13.09193,860782
1831,staschuk-bungalow,14,0.00163,112707,13.09356,860782
1832,steakunderscore,14,0.00163,112721,13.09519,860782
1833,sunface,14,0.00163,112735,13.09681,860782
1834,supasteev0,14,0.00163,112749,13.09844,860782
1835,suruaku,14,0.00163,112763,13.10006,860782
1836,swilcox3,14,0.00163,112777,13.10169,860782
1837,taciomcosta,14,0.00163,112791,13.10332,860782
1838,teoyaomiqui,14,0.00163,112805,13.10494,860782
1839,tgalkovskyi,14,0.00163,112819,13.10657,860782
1840,thgao,14,0.00163,112833,13.10820,860782
1841,tiendc,14,0.00163,112847,13.10982,860782
1842,tomesm,14,0.00163,112861,13.11145,860782
1843,tustvold,14,0.00163,112875,13.11308,860782
1844,uhlhosting,14,0.00163,112889,13.11470,860782
1845,vijayrajput1,14,0.00163,112903,13.11633,860782
1846,vishaltak,14,0.00163,112917,13.11796,860782
1847,watermelon-brother,14,0.00163,112931,13.11958,860782
1848,webmutation,14,0.00163,112945,13.12121,860782
1849,WillsonHG,14,0.00163,112959,13.12283,860782
1850,wpjunior,14,0.00163,112973,13.12446,860782
1851,wrayzheng,14,0.00163,112987,13.12609,860782
1852,wuqihui0317,14,0.00163,113001,13.12771,860782
1853,xial-thu,14,0.00163,113015,13.12934,860782
1854,xjtustt,14,0.00163,113029,13.13097,860782
1855,xtreme-sameer-vohra,14,0.00163,113043,13.13259,860782
1856,xuchenCN,14,0.00163,113057,13.13422,860782
1857,yamlCase,14,0.00163,113071,13.13585,860782
1858,yanchenko-igor,14,0.00163,113085,13.13747,860782
1859,ydye,14,0.00163,113099,13.13910,860782
1860,zeromberto,14,0.00163,113113,13.14073,860782
1861,Zetanova,14,0.00163,113127,13.14235,860782
1862,Zsolt-LazarZsolt,14,0.00163,113141,13.14398,860782
1863,4ndr4s,13,0.00151,113154,13.14549,860782
1864,6ecuk,13,0.00151,113167,13.14700,860782
1865,adamegyed,13,0.00151,113180,13.14851,860782
1866,adamnovak,13,0.00151,113193,13.15002,860782
1867,adelasofia,13,0.00151,113206,13.15153,860782
1868,AdityaMisra,13,0.00151,113219,13.15304,860782
1869,adnanrahic,13,0.00151,113232,13.15455,860782
1870,a-hat,13,0.00151,113245,13.15606,860782
1871,Ailsa-Wu,13,0.00151,113258,13.15757,860782
1872,ajalab,13,0.00151,113271,13.15908,860782
1873,alarco-l,13,0.00151,113284,13.16059,860782
1874,alexeykudinkin,13,0.00151,113297,13.16210,860782
1875,Andrei-Stepanov,13,0.00151,113310,13.16361,860782
1876,andyrooster,13,0.00151,113323,13.16512,860782
1877,angelnu,13,0.00151,113336,13.16663,860782
1878,Arjunkrisha,13,0.00151,113349,13.16814,860782
1879,AugerC,13,0.00151,113362,13.16965,860782
1880,badashanren,13,0.00151,113375,13.17116,860782
1881,benibr,13,0.00151,113388,13.17267,860782
1882,Bowser1704,13,0.00151,113401,13.17418,860782
1883,bukowa,13,0.00151,113414,13.17569,860782
1884,burningalchemist,13,0.00151,113427,13.17720,860782
1885,bzurkowski,13,0.00151,113440,13.17871,860782
1886,caffeinism,13,0.00151,113453,13.18022,860782
1887,catweisun,13,0.00151,113466,13.18173,860782
1888,chrisse74,13,0.00151,113479,13.18325,860782
1889,cjreyn,13,0.00151,113492,13.18476,860782
1890,cmanzi,13,0.00151,113505,13.18627,860782
1891,darkl0rd,13,0.00151,113518,13.18778,860782
1892,davydog187,13,0.00151,113531,13.18929,860782
1893,dbaumgarten,13,0.00151,113544,13.19080,860782
1894,dcplaya,13,0.00151,113557,13.19231,860782
1895,debu99,13,0.00151,113570,13.19382,860782
1896,debugloop,13,0.00151,113583,13.19533,860782
1897,dekimsey,13,0.00151,113596,13.19684,860782
1898,DesistDaydream,13,0.00151,113609,13.19835,860782
1899,digibank-rons,13,0.00151,113622,13.19986,860782
1900,DoroGi,13,0.00151,113635,13.20137,860782
1901,dpeckett,13,0.00151,113648,13.20288,860782
1902,DrAuYueng,13,0.00151,113661,13.20439,860782
1903,drcwr,13,0.00151,113674,13.20590,860782
1904,drGrove,13,0.00151,113687,13.20741,860782
1905,dvulpe,13,0.00151,113700,13.20892,860782
1906,farodin91,13,0.00151,113713,13.21043,860782
1907,fernandocyder,13,0.00151,113726,13.21194,860782
1908,frittenlab,13,0.00151,113739,13.21345,860782
1909,gabrielecerami,13,0.00151,113752,13.21496,860782
1910,gauravsofat,13,0.00151,113765,13.21647,860782
1911,gautierdelorme,13,0.00151,113778,13.21798,860782
1912,georgekaz,13,0.00151,113791,13.21949,860782
1913,geragio,13,0.00151,113804,13.22100,860782
1914,gmaiztegi,13,0.00151,113817,13.22251,860782
1915,gracedo,13,0.00151,113830,13.22402,860782
1916,grapevineai,13,0.00151,113843,13.22553,860782
1917,harik8,13,0.00151,113856,13.22704,860782
1918,heidemn-faro,13,0.00151,113869,13.22855,860782
1919,herbrechtsmeier,13,0.00151,113882,13.23006,860782
1920,hhhhsdxxxx,13,0.00151,113895,13.23157,860782
1921,hmoravec,13,0.00151,113908,13.23308,860782
1922,hskang9,13,0.00151,113921,13.23459,860782
1923,huangwei2013,13,0.00151,113934,13.23610,860782
1924,huzhou,13,0.00151,113947,13.23761,860782
1925,hzliangbin,13,0.00151,113960,13.23912,860782
1926,Icedroid,13,0.00151,113973,13.24063,860782
1927,iHalt10,13,0.00151,113986,13.24214,860782
1928,ikhoon,13,0.00151,113999,13.24366,860782
1929,ilylia,13,0.00151,114012,13.24517,860782
1930,jiangguangpeng,13,0.00151,114025,13.24668,860782
1931,jiangkaihua,13,0.00151,114038,13.24819,860782
1932,jkassis,13,0.00151,114051,13.24970,860782
1933,jlcox1970,13,0.00151,114064,13.25121,860782
1934,jonahjon,13,0.00151,114077,13.25272,860782
1935,jpmsilva,13,0.00151,114090,13.25423,860782
1936,juliohm1978,13,0.00151,114103,13.25574,860782
1937,jyotishp,13,0.00151,114116,13.25725,860782
1938,katarzyna-z,13,0.00151,114129,13.25876,860782
1939,kaykhancheckpoint,13,0.00151,114142,13.26027,860782
1940,Kernald,13,0.00151,114155,13.26178,860782
1941,KilimAnnejaro,13,0.00151,114168,13.26329,860782
1942,KoyamaSohei,13,0.00151,114181,13.26480,860782
1943,kpucynski,13,0.00151,114194,13.26631,860782
1944,kushtrimjunuzi,13,0.00151,114207,13.26782,860782
1945,KVInventoR,13,0.00151,114220,13.26933,860782
1946,languitar,13,0.00151,114233,13.27084,860782
1947,LeeHampton,13,0.00151,114246,13.27235,860782
1948,liuming-tech,13,0.00151,114259,13.27386,860782
1949,liuzhenji,13,0.00151,114272,13.27537,860782
1950,loktionovam,13,0.00151,114285,13.27688,860782
1951,loozhengyuan,13,0.00151,114298,13.27839,860782
1952,LukeMathWalker,13,0.00151,114311,13.27990,860782
1953,majian159,13,0.00151,114324,13.28141,860782
1954,manavtidhan,13,0.00151,114337,13.28292,860782
1955,MarcBoissonneault,13,0.00151,114350,13.28443,860782
1956,marier-nico,13,0.00151,114363,13.28594,860782
1957,MatthiasLohr,13,0.00151,114376,13.28745,860782
1958,maunavarro,13,0.00151,114389,13.28896,860782
1959,mikaelcabot,13,0.00151,114402,13.29047,860782
1960,mikekamornikov,13,0.00151,114415,13.29198,860782
1961,mikelorant,13,0.00151,114428,13.29349,860782
1962,misberner,13,0.00151,114441,13.29500,860782
1963,mkhaas,13,0.00151,114454,13.29651,860782
1964,mtknapp,13,0.00151,114467,13.29802,860782
1965,nirroz93,13,0.00151,114480,13.29953,860782
1966,orj,13,0.00151,114493,13.30104,860782
1967,otherview,13,0.00151,114506,13.30256,860782
1968,paddy-hack,13,0.00151,114519,13.30407,860782
1969,pando85,13,0.00151,114532,13.30558,860782
1970,patrungel,13,0.00151,114545,13.30709,860782
1971,pbn4,13,0.00151,114558,13.30860,860782
1972,phsmith,13,0.00151,114571,13.31011,860782
1973,pramchan,13,0.00151,114584,13.31162,860782
1974,prithviramesh,13,0.00151,114597,13.31313,860782
1975,r0bj,13,0.00151,114610,13.31464,860782
1976,raul1991,13,0.00151,114623,13.31615,860782
1977,readerx,13,0.00151,114636,13.31766,860782
1978,rudy2steiner,13,0.00151,114649,13.31917,860782
1979,rumstead,13,0.00151,114662,13.32068,860782
1980,sabazubair,13,0.00151,114675,13.32219,860782
1981,saiharshitachava,13,0.00151,114688,13.32370,860782
1982,sammym1982,13,0.00151,114701,13.32521,860782
1983,saswatamcode,13,0.00151,114714,13.32672,860782
1984,scottslewis,13,0.00151,114727,13.32823,860782
1985,sdodsley,13,0.00151,114740,13.32974,860782
1986,sean-krail,13,0.00151,114753,13.33125,860782
1987,shaowenchen,13,0.00151,114766,13.33276,860782
1988,shivanshs9,13,0.00151,114779,13.33427,860782
1989,shivpathak,13,0.00151,114792,13.33578,860782
1990,Shpectator,13,0.00151,114805,13.33729,860782
1991,SimonHeimberg,13,0.00151,114818,13.33880,860782
1992,SimpCosm,13,0.00151,114831,13.34031,860782
1993,skyitachi,13,0.00151,114844,13.34182,860782
1994,slavovojacek,13,0.00151,114857,13.34333,860782
1995,smourapina,13,0.00151,114870,13.34484,860782
1996,smyrman,13,0.00151,114883,13.34635,860782
1997,spyvip,13,0.00151,114896,13.34786,860782
1998,Sreevani871,13,0.00151,114909,13.34937,860782
1999,srehanpk,13,0.00151,114922,13.35088,860782
2000,stefanandres,13,0.00151,114935,13.35239,860782
2001,stefannica,13,0.00151,114948,13.35390,860782
2002,stefreak,13,0.00151,114961,13.35541,860782
2003,Stuxend,13,0.00151,114974,13.35692,860782
2004,sundar-cs,13,0.00151,114987,13.35843,860782
2005,surekhakallam,13,0.00151,115000,13.35994,860782
2006,talcoh2x,13,0.00151,115013,13.36146,860782
2007,tedder,13,0.00151,115026,13.36297,860782
2008,thebsdbox,13,0.00151,115039,13.36448,860782
2009,ThomWright,13,0.00151,115052,13.36599,860782
2010,tony2001,13,0.00151,115065,13.36750,860782
2011,ts3ng,13,0.00151,115078,13.36901,860782
2012,twghu,13,0.00151,115091,13.37052,860782
2013,u007,13,0.00151,115104,13.37203,860782
2014,venkatbvc,13,0.00151,115117,13.37354,860782
2015,vijaymateti,13,0.00151,115130,13.37505,860782
2016,vipinvkmenon,13,0.00151,115143,13.37656,860782
2017,vrathore18,13,0.00151,115156,13.37807,860782
2018,vuggg,13,0.00151,115169,13.37958,860782
2019,vutny,13,0.00151,115182,13.38109,860782
2020,wapa5pow,13,0.00151,115195,13.38260,860782
2021,woodcockjosh,13,0.00151,115208,13.38411,860782
2022,wopl,13,0.00151,115221,13.38562,860782
2023,xhebox,13,0.00151,115234,13.38713,860782
2024,XiaochenCui,13,0.00151,115247,13.38864,860782
2025,xkilian,13,0.00151,115260,13.39015,860782
2026,xornivore,13,0.00151,115273,13.39166,860782
2027,yingxia2020,13,0.00151,115286,13.39317,860782
2028,Yoshiki0705,13,0.00151,115299,13.39468,860782
2029,yotsapon,13,0.00151,115312,13.39619,860782
2030,zanghao2,13,0.00151,115325,13.39770,860782
2031,Zhanxueyou,13,0.00151,115338,13.39921,860782
2032,zhiweiv,13,0.00151,115351,13.40072,860782
2033,zlozano,13,0.00151,115364,13.40223,860782
2034,zlseu-edu,13,0.00151,115377,13.40374,860782
2035,zsistla,13,0.00151,115390,13.40525,860782
2036,zzur,13,0.00151,115403,13.40676,860782
2037,13rentgen,12,0.00139,115415,13.40816,860782
2038,ab77,12,0.00139,115427,13.40955,860782
2039,ahilmathew,12,0.00139,115439,13.41094,860782
2040,ahpook,12,0.00139,115451,13.41234,860782
2041,aka-achu,12,0.00139,115463,13.41373,860782
2042,alex-lipkin-create,12,0.00139,115475,13.41513,860782
2043,aperigault,12,0.00139,115487,13.41652,860782
2044,asychev,12,0.00139,115499,13.41792,860782
2045,avarf,12,0.00139,115511,13.41931,860782
2046,avishayil,12,0.00139,115523,13.42070,860782
2047,bcheronn,12,0.00139,115535,13.42210,860782
2048,benridley,12,0.00139,115547,13.42349,860782
2049,bethforsyth,12,0.00139,115559,13.42489,860782
2050,Bledai,12,0.00139,115571,13.42628,860782
2051,cCloudSky,12,0.00139,115583,13.42767,860782
2052,chaseSpace,12,0.00139,115595,13.42907,860782
2053,chifu1234,12,0.00139,115607,13.43046,860782
2054,chirangaalwis,12,0.00139,115619,13.43186,860782
2055,chrisob,12,0.00139,115631,13.43325,860782
2056,christine-gong,12,0.00139,115643,13.43464,860782
2057,clarkmcc,12,0.00139,115655,13.43604,860782
2058,codeJack,12,0.00139,115667,13.43743,860782
2059,coolstang,12,0.00139,115679,13.43883,860782
2060,ctmuthu,12,0.00139,115691,13.44022,860782
2061,cykl,12,0.00139,115703,13.44161,860782
2062,danielmittelman,12,0.00139,115715,13.44301,860782
2063,danielzhanghl,12,0.00139,115727,13.44440,860782
2064,darkn3rd,12,0.00139,115739,13.44580,860782
2065,Devying,12,0.00139,115751,13.44719,860782
2066,dggonz,12,0.00139,115763,13.44859,860782
2067,DirtyCajunRice,12,0.00139,115775,13.44998,860782
2068,dissoupov,12,0.00139,115787,13.45137,860782
2069,dol,12,0.00139,115799,13.45277,860782
2070,dsebastien,12,0.00139,115811,13.45416,860782
2071,ernestas2k,12,0.00139,115823,13.45556,860782
2072,eurekaka,12,0.00139,115835,13.45695,860782
2073,Ewocker,12,0.00139,115847,13.45834,860782
2074,fankangbest,12,0.00139,115859,13.45974,860782
2075,fifar,12,0.00139,115871,13.46113,860782
2076,FL3SH,12,0.00139,115883,13.46253,860782
2077,fmhwong,12,0.00139,115895,13.46392,860782
2078,fsommar,12,0.00139,115907,13.46531,860782
2079,furkatgofurov7,12,0.00139,115919,13.46671,860782
2080,gaima8,12,0.00139,115931,13.46810,860782
2081,Giancarlo1974,12,0.00139,115943,13.46950,860782
2082,giorgos-apo,12,0.00139,115955,13.47089,860782
2083,glazychev-art,12,0.00139,115967,13.47228,860782
2084,glekner,12,0.00139,115979,13.47368,860782
2085,goreleaserbot,12,0.00139,115991,13.47507,860782
2086,hantmac,12,0.00139,116003,13.47647,860782
2087,harry671003,12,0.00139,116015,13.47786,860782
2088,Heraclitus,12,0.00139,116027,13.47925,860782
2089,hktime,12,0.00139,116039,13.48065,860782
2090,hmhagberg,12,0.00139,116051,13.48204,860782
2091,HugoRh,12,0.00139,116063,13.48344,860782
2092,hyper-23,12,0.00139,116075,13.48483,860782
2093,ideepika,12,0.00139,116087,13.48623,860782
2094,iirekm,12,0.00139,116099,13.48762,860782
2095,ijackcy,12,0.00139,116111,13.48901,860782
2096,ilmanzo,12,0.00139,116123,13.49041,860782
2097,imaramos,12,0.00139,116135,13.49180,860782
2098,iohenkies,12,0.00139,116147,13.49320,860782
2099,iWangJiaxiang,12,0.00139,116159,13.49459,860782
2100,Izano007,12,0.00139,116171,13.49598,860782
2101,jackiemazy,12,0.00139,116183,13.49738,860782
2102,jacky68147527,12,0.00139,116195,13.49877,860782
2103,jaerik,12,0.00139,116207,13.50017,860782
2104,jamesnetherton,12,0.00139,116219,13.50156,860782
2105,jdmarshall,12,0.00139,116231,13.50295,860782
2106,jextrevor,12,0.00139,116243,13.50435,860782
2107,jgallucci32,12,0.00139,116255,13.50574,860782
2108,jiping-s,12,0.00139,116267,13.50714,860782
2109,jknight-liatrio,12,0.00139,116279,13.50853,860782
2110,Jobava,12,0.00139,116291,13.50992,860782
2111,JokerDevops,12,0.00139,116303,13.51132,860782
2112,juanpicado,12,0.00139,116315,13.51271,860782
2113,kalta,12,0.00139,116327,13.51411,860782
2114,kathan24,12,0.00139,116339,13.51550,860782
2115,kbreit,12,0.00139,116351,13.51690,860782
2116,kedartal,12,0.00139,116363,13.51829,860782
2117,KentaYoshitani,12,0.00139,116375,13.51968,860782
2118,khairilushan,12,0.00139,116387,13.52108,860782
2119,kir4h,12,0.00139,116399,13.52247,860782
2120,kirbyquerby,12,0.00139,116411,13.52387,860782
2121,KIRY4,12,0.00139,116423,13.52526,860782
2122,KPostOffice,12,0.00139,116435,13.52665,860782
2123,laeo,12,0.00139,116447,13.52805,860782
2124,lanmarti,12,0.00139,116459,13.52944,860782
2125,leolb-aphp,12,0.00139,116471,13.53084,860782
2126,linbingdouzhe,12,0.00139,116483,13.53223,860782
2127,liorokman,12,0.00139,116495,13.53362,860782
2128,loetn,12,0.00139,116507,13.53502,860782
2129,long1eu,12,0.00139,116519,13.53641,860782
2130,loongify,12,0.00139,116531,13.53781,860782
2131,lyz-code,12,0.00139,116543,13.53920,860782
2132,m1o1,12,0.00139,116555,13.54059,860782
2133,mmat11,12,0.00139,116567,13.54199,860782
2134,modogo2000,12,0.00139,116579,13.54338,860782
2135,msk-,12,0.00139,116591,13.54478,860782
2136,mvaal,12,0.00139,116603,13.54617,860782
2137,mxxisv,12,0.00139,116615,13.54756,860782
2138,nadenf,12,0.00139,116627,13.54896,860782
2139,namco1992,12,0.00139,116639,13.55035,860782
2140,narthollis,12,0.00139,116651,13.55175,860782
2141,nemonik,12,0.00139,116663,13.55314,860782
2142,nezorflame,12,0.00139,116675,13.55454,860782
2143,nikhilbalekundargi,12,0.00139,116687,13.55593,860782
2144,ninjaslothx,12,0.00139,116699,13.55732,860782
2145,Noemata,12,0.00139,116711,13.55872,860782
2146,Oncilla,12,0.00139,116723,13.56011,860782
2147,orblazer,12,0.00139,116735,13.56151,860782
2148,pankajmt,12,0.00139,116747,13.56290,860782
2149,pantaoran,12,0.00139,116759,13.56429,860782
2150,PenelopeFudd,12,0.00139,116771,13.56569,860782
2151,pgaxatte,12,0.00139,116783,13.56708,860782
2152,phanhuy1502,12,0.00139,116795,13.56848,860782
2153,pierreilki,12,0.00139,116807,13.56987,860782
2154,pistoolster,12,0.00139,116819,13.57126,860782
2155,Quarky9,12,0.00139,116831,13.57266,860782
2156,rcjsuen,12,0.00139,116843,13.57405,860782
2157,Ressetkk,12,0.00139,116855,13.57545,860782
2158,rodmeurer,12,0.00139,116867,13.57684,860782
2159,roysahar-ibm,12,0.00139,116879,13.57823,860782
2160,ryan-a-baker,12,0.00139,116891,13.57963,860782
2161,salaboy,12,0.00139,116903,13.58102,860782
2162,sandeepbhojwani,12,0.00139,116915,13.58242,860782
2163,sanvir10,12,0.00139,116927,13.58381,860782
2164,semoac,12,0.00139,116939,13.58521,860782
2165,sev3ryn,12,0.00139,116951,13.58660,860782
2166,sguyennet,12,0.00139,116963,13.58799,860782
2167,shadiramadan,12,0.00139,116975,13.58939,860782
2168,shamilpd,12,0.00139,116987,13.59078,860782
2169,shellwedance,12,0.00139,116999,13.59218,860782
2170,shyamg28,12,0.00139,117011,13.59357,860782
2171,SidharthBansal,12,0.00139,117023,13.59496,860782
2172,sjentzsch,12,0.00139,117035,13.59636,860782
2173,Skarlso,12,0.00139,117047,13.59775,860782
2174,Slach,12,0.00139,117059,13.59915,860782
2175,slimm609,12,0.00139,117071,13.60054,860782
2176,SrinivReddy,12,0.00139,117083,13.60193,860782
2177,stepanselyuk,12,0.00139,117095,13.60333,860782
2178,stephaneey,12,0.00139,117107,13.60472,860782
2179,test-account-0,12,0.00139,117119,13.60612,860782
2180,thedewpoint,12,0.00139,117131,13.60751,860782
2181,timvaillancourt,12,0.00139,117143,13.60890,860782
2182,tnxgalaxy,12,0.00139,117155,13.61030,860782
2183,tomqwpl,12,0.00139,117167,13.61169,860782
2184,trustin,12,0.00139,117179,13.61309,860782
2185,uocxp,12,0.00139,117191,13.61448,860782
2186,vivainio,12,0.00139,117203,13.61587,860782
2187,v-y-l,12,0.00139,117215,13.61727,860782
2188,wanghq,12,0.00139,117227,13.61866,860782
2189,whaber,12,0.00139,117239,13.62006,860782
2190,whardier,12,0.00139,117251,13.62145,860782
2191,wktmeow,12,0.00139,117263,13.62285,860782
2192,woopyoung,12,0.00139,117275,13.62424,860782
2193,wRLSS,12,0.00139,117287,13.62563,860782
2194,wsj0000,12,0.00139,117299,13.62703,860782
2195,XiaoJiangWang,12,0.00139,117311,13.62842,860782
2196,xkeyideal,12,0.00139,117323,13.62982,860782
2197,yabli,12,0.00139,117335,13.63121,860782
2198,zishen,12,0.00139,117347,13.63260,860782
2199,aaron-ai,11,0.00128,117358,13.63388,860782
2200,abelal83,11,0.00128,117369,13.63516,860782
2201,adamglt,11,0.00128,117380,13.63644,860782
2202,adirgit84,11,0.00128,117391,13.63772,860782
2203,ahmednasir91,11,0.00128,117402,13.63899,860782
2204,ajchiarello,11,0.00128,117413,13.64027,860782
2205,ak89224,11,0.00128,117424,13.64155,860782
2206,alanpeng,11,0.00128,117435,13.64283,860782
2207,alexvolsh,11,0.00128,117446,13.64411,860782
2208,ali-sattari,11,0.00128,117457,13.64538,860782
2209,almahmoud,11,0.00128,117468,13.64666,860782
2210,Althea01,11,0.00128,117479,13.64794,860782
2211,amenzhinsky,11,0.00128,117490,13.64922,860782
2212,Andrewpk,11,0.00128,117501,13.65049,860782
2213,Anynou,11,0.00128,117512,13.65177,860782
2214,apmer,11,0.00128,117523,13.65305,860782
2215,apollocse,11,0.00128,117534,13.65433,860782
2216,ArijitDesai,11,0.00128,117545,13.65561,860782
2217,arisgi,11,0.00128,117556,13.65688,860782
2218,arjun-1,11,0.00128,117567,13.65816,860782
2219,arvindsv,11,0.00128,117578,13.65944,860782
2220,AurelienGasser,11,0.00128,117589,13.66072,860782
2221,avif,11,0.00128,117600,13.66200,860782
2222,ayushwebkul,11,0.00128,117611,13.66327,860782
2223,balraj111,11,0.00128,117622,13.66455,860782
2224,basch255,11,0.00128,117633,13.66583,860782
2225,Baykonur,11,0.00128,117644,13.66711,860782
2226,ben-turner,11,0.00128,117655,13.66839,860782
2227,BernardTolosajr,11,0.00128,117666,13.66966,860782
2228,birkb,11,0.00128,117677,13.67094,860782
2229,br0ziliy,11,0.00128,117688,13.67222,860782
2230,brokenjacobs,11,0.00128,117699,13.67350,860782
2231,bvwells,11,0.00128,117710,13.67477,860782
2232,carmiac,11,0.00128,117721,13.67605,860782
2233,cbrake,11,0.00128,117732,13.67733,860782
2234,cdmetcalf,11,0.00128,117743,13.67861,860782
2235,Cellebyte,11,0.00128,117754,13.67989,860782
2236,chaimch,11,0.00128,117765,13.68116,860782
2237,chenjiandongx,11,0.00128,117776,13.68244,860782
2238,chenzhikang,11,0.00128,117787,13.68372,860782
2239,chrisleavoy,11,0.00128,117798,13.68500,860782
2240,chungktran,11,0.00128,117809,13.68628,860782
2241,ckotzbauer,11,0.00128,117820,13.68755,860782
2242,clementnuss,11,0.00128,117831,13.68883,860782
2243,cpollard0,11,0.00128,117842,13.69011,860782
2244,danpopSD,11,0.00128,117853,13.69139,860782
2245,DarkBlaez,11,0.00128,117864,13.69267,860782
2246,davidsonff,11,0.00128,117875,13.69394,860782
2247,dcherniv,11,0.00128,117886,13.69522,860782
2248,d-cs,11,0.00128,117897,13.69650,860782
2249,ddziuda,11,0.00128,117908,13.69778,860782
2250,dexter-1,11,0.00128,117919,13.69906,860782
2251,dgdelahera,11,0.00128,117930,13.70033,860782
2252,dingsongjie,11,0.00128,117941,13.70161,860782
2253,dinvlad,11,0.00128,117952,13.70289,860782
2254,djbrown,11,0.00128,117963,13.70417,860782
2255,dntosas,11,0.00128,117974,13.70544,860782
2256,dojci,11,0.00128,117985,13.70672,860782
2257,drewboswell,11,0.00128,117996,13.70800,860782
2258,dsbos,11,0.00128,118007,13.70928,860782
2259,edrevo,11,0.00128,118018,13.71056,860782
2260,emrahcetiner,11,0.00128,118029,13.71183,860782
2261,eranrund,11,0.00128,118040,13.71311,860782
2262,fabrizior,11,0.00128,118051,13.71439,860782
2263,fahlke,11,0.00128,118062,13.71567,860782
2264,fatkun,11,0.00128,118073,13.71695,860782
2265,fragtom,11,0.00128,118084,13.71822,860782
2266,g3rzi,11,0.00128,118095,13.71950,860782
2267,gagata,11,0.00128,118106,13.72078,860782
2268,gaurimadhok,11,0.00128,118117,13.72206,860782
2269,geoleonsh,11,0.00128,118128,13.72334,860782
2270,gleichda,11,0.00128,118139,13.72461,860782
2271,Green7,11,0.00128,118150,13.72589,860782
2272,greenbice,11,0.00128,118161,13.72717,860782
2273,GTB3NW,11,0.00128,118172,13.72845,860782
2274,guillaumelfv,11,0.00128,118183,13.72972,860782
2275,h3poteto,11,0.00128,118194,13.73100,860782
2276,H3rman8,11,0.00128,118205,13.73228,860782
2277,haibingzhao,11,0.00128,118216,13.73356,860782
2278,haiduong87,11,0.00128,118227,13.73484,860782
2279,happywzy,11,0.00128,118238,13.73611,860782
2280,harnitsignalfx,11,0.00128,118249,13.73739,860782
2281,Hello-Linux,11,0.00128,118260,13.73867,860782
2282,iaoiui,11,0.00128,118271,13.73995,860782
2283,iii-i,11,0.00128,118282,13.74123,860782
2284,ilyamor,11,0.00128,118293,13.74250,860782
2285,itninja-hue,11,0.00128,118304,13.74378,860782
2286,Iverson-lena,11,0.00128,118315,13.74506,860782
2287,jabdoa2,11,0.00128,118326,13.74634,860782
2288,jakerbeck,11,0.00128,118337,13.74762,860782
2289,jalseth,11,0.00128,118348,13.74889,860782
2290,jasonliu747,11,0.00128,118359,13.75017,860782
2291,jasonltaylor,11,0.00128,118370,13.75145,860782
2292,jayaddison,11,0.00128,118381,13.75273,860782
2293,jayanthvn,11,0.00128,118392,13.75401,860782
2294,Jaycean,11,0.00128,118403,13.75528,860782
2295,jcambronero,11,0.00128,118414,13.75656,860782
2296,jdomag,11,0.00128,118425,13.75784,860782
2297,jeremybz,11,0.00128,118436,13.75912,860782
2298,jfcgaspar,11,0.00128,118447,13.76039,860782
2299,jidckii,11,0.00128,118458,13.76167,860782
2300,jkowall,11,0.00128,118469,13.76295,860782
2301,jlinder,11,0.00128,118480,13.76423,860782
2302,joekamibeppu,11,0.00128,118491,13.76551,860782
2303,jordanworner,11,0.00128,118502,13.76678,860782
2304,jorgemarey,11,0.00128,118513,13.76806,860782
2305,JosephKang,11,0.00128,118524,13.76934,860782
2306,jpds,11,0.00128,118535,13.77062,860782
2307,JPRbrs,11,0.00128,118546,13.77190,860782
2308,jradtilbrook,11,0.00128,118557,13.77317,860782
2309,jr-santos98,11,0.00128,118568,13.77445,860782
2310,jsarkar,11,0.00128,118579,13.77573,860782
2311,JubayerJoy,11,0.00128,118590,13.77701,860782
2312,jujugrrr,11,0.00128,118601,13.77829,860782
2313,jvandemark,11,0.00128,118612,13.77956,860782
2314,keshto,11,0.00128,118623,13.78084,860782
2315,kittaakos,11,0.00128,118634,13.78212,860782
2316,kkendzia,11,0.00128,118645,13.78340,860782
2317,kpiyush17,11,0.00128,118656,13.78467,860782
2318,Krishan-Sharma,11,0.00128,118667,13.78595,860782
2319,krvarma,11,0.00128,118678,13.78723,860782
2320,ktchen14,11,0.00128,118689,13.78851,860782
2321,kurokochin,11,0.00128,118700,13.78979,860782
2322,lddlww,11,0.00128,118711,13.79106,860782
2323,leeavital,11,0.00128,118722,13.79234,860782
2324,leoskyrocker,11,0.00128,118733,13.79362,860782
2325,leox-phq,11,0.00128,118744,13.79490,860782
2326,lijujntao120,11,0.00128,118755,13.79618,860782
2327,lizhuqi,11,0.00128,118766,13.79745,860782
2328,loopingz,11,0.00128,118777,13.79873,860782
2329,LucaPrete,11,0.00128,118788,13.80001,860782
2330,lukasz-bielinski,11,0.00128,118799,13.80129,860782
2331,ly5156,11,0.00128,118810,13.80257,860782
2332,manojvs157,11,0.00128,118821,13.80384,860782
2333,manueltellez,11,0.00128,118832,13.80512,860782
2334,mape90,11,0.00128,118843,13.80640,860782
2335,marcindulak,11,0.00128,118854,13.80768,860782
2336,mark-church,11,0.00128,118865,13.80896,860782
2337,mattdowdell,11,0.00128,118876,13.81023,860782
2338,matthchr,11,0.00128,118887,13.81151,860782
2339,mdouglass,11,0.00128,118898,13.81279,860782
2340,michaelwittig,11,0.00128,118909,13.81407,860782
2341,MOZGIII,11,0.00128,118920,13.81534,860782
2342,mshalak-nix,11,0.00128,118931,13.81662,860782
2343,mzahor,11,0.00128,118942,13.81790,860782
2344,nehagupta84,11,0.00128,118953,13.81918,860782
2345,nharper,11,0.00128,118964,13.82046,860782
2346,nickgerace,11,0.00128,118975,13.82173,860782
2347,nickhaskins,11,0.00128,118986,13.82301,860782
2348,nickperry,11,0.00128,118997,13.82429,860782
2349,nitrag,11,0.00128,119008,13.82557,860782
2350,nmtulloch27,11,0.00128,119019,13.82685,860782
2351,norman-kern,11,0.00128,119030,13.82812,860782
2352,OmegaVVeapon,11,0.00128,119041,13.82940,860782
2353,omninonsense,11,0.00128,119052,13.83068,860782
2354,orgads,11,0.00128,119063,13.83196,860782
2355,pas2k,11,0.00128,119074,13.83324,860782
2356,piotr1212,11,0.00128,119085,13.83451,860782
2357,PontusTideman,11,0.00128,119096,13.83579,860782
2358,pratikgupta123,11,0.00128,119107,13.83707,860782
2359,Rahul7794,11,0.00128,119118,13.83835,860782
2360,RahulArora31,11,0.00128,119129,13.83962,860782
2361,rally25rs,11,0.00128,119140,13.84090,860782
2362,ranasheel2000,11,0.00128,119151,13.84218,860782
2363,rbenzair,11,0.00128,119162,13.84346,860782
2364,rgo3,11,0.00128,119173,13.84474,860782
2365,rharding6373,11,0.00128,119184,13.84601,860782
2366,rubensa,11,0.00128,119195,13.84729,860782
2367,ryandotclair,11,0.00128,119206,13.84857,860782
2368,sachaos,11,0.00128,119217,13.84985,860782
2369,saintdle,11,0.00128,119228,13.85113,860782
2370,saintube,11,0.00128,119239,13.85240,860782
2371,samudralavamshi54,11,0.00128,119250,13.85368,860782
2372,SDR0512,11,0.00128,119261,13.85496,860782
2373,searsaw,11,0.00128,119272,13.85624,860782
2374,sethmaxwl,11,0.00128,119283,13.85752,860782
2375,shabicheng,11,0.00128,119294,13.85879,860782
2376,shokohsc,11,0.00128,119305,13.86007,860782
2377,shubhindia,11,0.00128,119316,13.86135,860782
2378,sjc960115,11,0.00128,119327,13.86263,860782
2379,snuggie12,11,0.00128,119338,13.86391,860782
2380,sonicaj,11,0.00128,119349,13.86518,860782
2381,spykermj,11,0.00128,119360,13.86646,860782
2382,sribalakumar,11,0.00128,119371,13.86774,860782
2383,sridhav,11,0.00128,119382,13.86902,860782
2384,staust,11,0.00128,119393,13.87029,860782
2385,stevensu1977,11,0.00128,119404,13.87157,860782
2386,Stijn98s,11,0.00128,119415,13.87285,860782
2387,sujaypillai,11,0.00128,119426,13.87413,860782
2388,sumodirjo,11,0.00128,119437,13.87541,860782
2389,tangmingming1,11,0.00128,119448,13.87668,860782
2390,tannaga,11,0.00128,119459,13.87796,860782
2391,tanxiaoning007,11,0.00128,119470,13.87924,860782
2392,tarko,11,0.00128,119481,13.88052,860782
2393,techwhizbang,11,0.00128,119492,13.88180,860782
2394,thobianchi,11,0.00128,119503,13.88307,860782
2395,thpham,11,0.00128,119514,13.88435,860782
2396,tiagonapoli,11,0.00128,119525,13.88563,860782
2397,timakin,11,0.00128,119536,13.88691,860782
2398,timdeluxe,11,0.00128,119547,13.88819,860782
2399,time-and-fate,11,0.00128,119558,13.88946,860782
2400,tobiaszheller,11,0.00128,119569,13.89074,860782
2401,tommasopozzetti,11,0.00128,119580,13.89202,860782
2402,TrevorNodeJS,11,0.00128,119591,13.89330,860782
2403,twisted-sres,11,0.00128,119602,13.89457,860782
2404,tylern91,11,0.00128,119613,13.89585,860782
2405,ulikl,11,0.00128,119624,13.89713,860782
2406,valouille,11,0.00128,119635,13.89841,860782
2407,vishal8k,11,0.00128,119646,13.89969,860782
2408,VladimirYushkevich,11,0.00128,119657,13.90096,860782
2409,vnline,11,0.00128,119668,13.90224,860782
2410,vvvprabhakar,11,0.00128,119679,13.90352,860782
2411,wangjuns,11,0.00128,119690,13.90480,860782
2412,wangzheng422,11,0.00128,119701,13.90608,860782
2413,WeetA34,11,0.00128,119712,13.90735,860782
2414,Wenfeng-GAO,11,0.00128,119723,13.90863,860782
2415,whites11,11,0.00128,119734,13.90991,860782
2416,windnod,11,0.00128,119745,13.91119,860782
2417,woblerr,11,0.00128,119756,13.91247,860782
2418,wouter2397,11,0.00128,119767,13.91374,860782
2419,xantrix,11,0.00128,119778,13.91502,860782
2420,Xercoy,11,0.00128,119789,13.91630,860782
2421,xiang17,11,0.00128,119800,13.91758,860782
2422,xiongjiwei,11,0.00128,119811,13.91886,860782
2423,yafernandes,11,0.00128,119822,13.92013,860782
2424,yang-padawan,11,0.00128,119833,13.92141,860782
2425,yechenglin007,11,0.00128,119844,13.92269,860782
2426,yishuT,11,0.00128,119855,13.92397,860782
2427,ynntg,11,0.00128,119866,13.92524,860782
2428,yoichiwo7,11,0.00128,119877,13.92652,860782
2429,yufeiminds,11,0.00128,119888,13.92780,860782
2430,yveshield,11,0.00128,119899,13.92908,860782
2431,Z3r0Sum,11,0.00128,119910,13.93036,860782
2432,Zageron,11,0.00128,119921,13.93163,860782
2433,zengyuxing007,11,0.00128,119932,13.93291,860782
2434,ZhangSIming-blyq,11,0.00128,119943,13.93419,860782
2435,ZiweiZhao,11,0.00128,119954,13.93547,860782
2436,ziyi-yan,11,0.00128,119965,13.93675,860782
2437,zongke,11,0.00128,119976,13.93802,860782
2438,zryfish,11,0.00128,119987,13.93930,860782
2439,aakifshaikh,10,0.00116,119997,13.94046,860782
2440,abhay-krishna,10,0.00116,120007,13.94163,860782
2441,addname,10,0.00116,120017,13.94279,860782
2442,Adolph-An,10,0.00116,120027,13.94395,860782
2443,adriantabirta,10,0.00116,120037,13.94511,860782
2444,aespinosa,10,0.00116,120047,13.94627,860782
2445,aidanranney,10,0.00116,120057,13.94743,860782
2446,ainiml,10,0.00116,120067,13.94860,860782
2447,alejandrodnm,10,0.00116,120077,13.94976,860782
2448,AlexanderMann,10,0.00116,120087,13.95092,860782
2449,ananthk01,10,0.00116,120097,13.95208,860782
2450,andrew-pickin-epi,10,0.00116,120107,13.95324,860782
2451,antojobai,10,0.00116,120117,13.95440,860782
2452,antonbashir,10,0.00116,120127,13.95557,860782
2453,appanycd,10,0.00116,120137,13.95673,860782
2454,Argha-2890,10,0.00116,120147,13.95789,860782
2455,arnoldcui,10,0.00116,120157,13.95905,860782
2456,artemkoslenkov,10,0.00116,120167,13.96021,860782
2457,arturmon,10,0.00116,120177,13.96137,860782
2458,aryulianto,10,0.00116,120187,13.96254,860782
2459,Asgoret,10,0.00116,120197,13.96370,860782
2460,aspettl,10,0.00116,120207,13.96486,860782
2461,AudriusButkevicius,10,0.00116,120217,13.96602,860782
2462,austinbv,10,0.00116,120227,13.96718,860782
2463,bahtou,10,0.00116,120237,13.96835,860782
2464,baijunyao,10,0.00116,120247,13.96951,860782
2465,BarthV,10,0.00116,120257,13.97067,860782
2466,bartier,10,0.00116,120267,13.97183,860782
2467,belak,10,0.00116,120277,13.97299,860782
2468,bernyfox,10,0.00116,120287,13.97415,860782
2469,bigHave,10,0.00116,120297,13.97532,860782
2470,bittopaz,10,0.00116,120307,13.97648,860782
2471,bkimbrough88,10,0.00116,120317,13.97764,860782
2472,bkonyi,10,0.00116,120327,13.97880,860782
2473,bodhif4,10,0.00116,120337,13.97996,860782
2474,boekkooi-fresh,10,0.00116,120347,13.98112,860782
2475,brunomasantos,10,0.00116,120357,13.98229,860782
2476,bruno-ortiz,10,0.00116,120367,13.98345,860782
2477,bruth,10,0.00116,120377,13.98461,860782
2478,c4m4,10,0.00116,120387,13.98577,860782
2479,cedarkuo,10,0.00116,120397,13.98693,860782
2480,CeeBeeCee,10,0.00116,120407,13.98809,860782
2481,celenechang,10,0.00116,120417,13.98926,860782
2482,charith-elastic,10,0.00116,120427,13.99042,860782
2483,ChenYida,10,0.00116,120437,13.99158,860782
2484,civilizeddev,10,0.00116,120447,13.99274,860782
2485,cloudengineers,10,0.00116,120457,13.99390,860782
2486,cmastr,10,0.00116,120467,13.99506,860782
2487,Cobra1978,10,0.00116,120477,13.99623,860782
2488,coderkk,10,0.00116,120487,13.99739,860782
2489,csandiri11,10,0.00116,120497,13.99855,860782
2490,cyron,10,0.00116,120507,13.99971,860782
2491,DanFTRX,10,0.00116,120517,14.00087,860782
2492,danilo404,10,0.00116,120527,14.00204,860782
2493,dare-darryl,10,0.00116,120537,14.00320,860782
2494,datamattsson,10,0.00116,120547,14.00436,860782
2495,davejhahn,10,0.00116,120557,14.00552,860782
2496,dearchap,10,0.00116,120567,14.00668,860782
2497,dellkeji,10,0.00116,120577,14.00784,860782
2498,denissabramovs,10,0.00116,120587,14.00901,860782
2499,Diddaa,10,0.00116,120597,14.01017,860782
2500,diegolima,10,0.00116,120607,14.01133,860782
2501,dilox,10,0.00116,120617,14.01249,860782
2502,dlong-1,10,0.00116,120627,14.01365,860782
2503,dpolivaev,10,0.00116,120637,14.01481,860782
2504,dthorsen,10,0.00116,120647,14.01598,860782
2505,duylong,10,0.00116,120657,14.01714,860782
2506,DylanGuedes,10,0.00116,120667,14.01830,860782
2507,emcay,10,0.00116,120677,14.01946,860782
2508,enkov,10,0.00116,120687,14.02062,860782
2509,etashsingh,10,0.00116,120697,14.02178,860782
2510,etefera,10,0.00116,120707,14.02295,860782
2511,etwillbefine,10,0.00116,120717,14.02411,860782
2512,everflux,10,0.00116,120727,14.02527,860782
2513,Filius-Patris,10,0.00116,120737,14.02643,860782
2514,firefixmaarten,10,0.00116,120747,14.02759,860782
2515,fmehrdad,10,0.00116,120757,14.02876,860782
2516,francisminu,10,0.00116,120767,14.02992,860782
2517,francobep,10,0.00116,120777,14.03108,860782
2518,FrankPetrilli,10,0.00116,120787,14.03224,860782
2519,freedomljc,10,0.00116,120797,14.03340,860782
2520,FriendshipBridge,10,0.00116,120807,14.03456,860782
2521,FroMage,10,0.00116,120817,14.03573,860782
2522,GabyCT,10,0.00116,120827,14.03689,860782
2523,gentcys,10,0.00116,120837,14.03805,860782
2524,gerlt,10,0.00116,120847,14.03921,860782
2525,gethinzhang,10,0.00116,120857,14.04037,860782
2526,gillg,10,0.00116,120867,14.04153,860782
2527,gokula-krishna-dev,10,0.00116,120877,14.04270,860782
2528,govinda-attal,10,0.00116,120887,14.04386,860782
2529,guni1192,10,0.00116,120897,14.04502,860782
2530,guoliangshuai,10,0.00116,120907,14.04618,860782
2531,habibali95,10,0.00116,120917,14.04734,860782
2532,hakuno,10,0.00116,120927,14.04850,860782
2533,hawkaa,10,0.00116,120937,14.04967,860782
2534,HEllRZA,10,0.00116,120947,14.05083,860782
2535,hintofbasil,10,0.00116,120957,14.05199,860782
2536,Hsiny,10,0.00116,120967,14.05315,860782
2537,hussainsaify,10,0.00116,120977,14.05431,860782
2538,hustclf,10,0.00116,120987,14.05548,860782
2539,ianhundere,10,0.00116,120997,14.05664,860782
2540,Iceber,10,0.00116,121007,14.05780,860782
2541,icheikhrouhou,10,0.00116,121017,14.05896,860782
2542,ideal,10,0.00116,121027,14.06012,860782
2543,Illia-M,10,0.00116,121037,14.06128,860782
2544,ingbyr,10,0.00116,121047,14.06245,860782
2545,ivang,10,0.00116,121057,14.06361,860782
2546,Jaakko-Os,10,0.00116,121067,14.06477,860782
2547,JerryCBH,10,0.00116,121077,14.06593,860782
2548,jethrogb,10,0.00116,121087,14.06709,860782
2549,jgato,10,0.00116,121097,14.06825,860782
2550,joshuabezaleel,10,0.00116,121107,14.06942,860782
2551,JPZ13,10,0.00116,121117,14.07058,860782
2552,jtyr,10,0.00116,121127,14.07174,860782
2553,judos,10,0.00116,121137,14.07290,860782
2554,JuergenSimon,10,0.00116,121147,14.07406,860782
2555,junchil,10,0.00116,121157,14.07522,860782
2556,jvmlet,10,0.00116,121167,14.07639,860782
2557,k00p,10,0.00116,121177,14.07755,860782
2558,katsew,10,0.00116,121187,14.07871,860782
2559,kingkorf,10,0.00116,121197,14.07987,860782
2560,KinsheX,10,0.00116,121207,14.08103,860782
2561,KodrAus,10,0.00116,121217,14.08220,860782
2562,koreno,10,0.00116,121227,14.08336,860782
2563,koxu1996,10,0.00116,121237,14.08452,860782
2564,kristinnardal2,10,0.00116,121247,14.08568,860782
2565,Lazzaretti,10,0.00116,121257,14.08684,860782
2566,leexiaominghub,10,0.00116,121267,14.08800,860782
2567,linweiyuan,10,0.00116,121277,14.08917,860782
2568,lirlia,10,0.00116,121287,14.09033,860782
2569,listenerme,10,0.00116,121297,14.09149,860782
2570,liuzhiyi1993,10,0.00116,121307,14.09265,860782
2571,llhuii,10,0.00116,121317,14.09381,860782
2572,lonnix,10,0.00116,121327,14.09497,860782
2573,lukeplausin,10,0.00116,121337,14.09614,860782
2574,lweitzman,10,0.00116,121347,14.09730,860782
2575,lxm,10,0.00116,121357,14.09846,860782
2576,m8rge,10,0.00116,121367,14.09962,860782
2577,Macrame,10,0.00116,121377,14.10078,860782
2578,majst01,10,0.00116,121387,14.10194,860782
2579,makochu,10,0.00116,121397,14.10311,860782
2580,mallick370,10,0.00116,121407,14.10427,860782
2581,mantzas,10,0.00116,121417,14.10543,860782
2582,Manvi07,10,0.00116,121427,14.10659,860782
2583,marcosfsch,10,0.00116,121437,14.10775,860782
2584,markrity,10,0.00116,121447,14.10891,860782
2585,masonse,10,0.00116,121457,14.11008,860782
2586,matthieuprat,10,0.00116,121467,14.11124,860782
2587,MaximGurschi,10,0.00116,121477,14.11240,860782
2588,mcginne,10,0.00116,121487,14.11356,860782
2589,mesosphere-teamcity,10,0.00116,121497,14.11472,860782
2590,mirkop-mattr,10,0.00116,121507,14.11589,860782
2591,mittalsuraj18,10,0.00116,121517,14.11705,860782
2592,mmakaay,10,0.00116,121527,14.11821,860782
2593,MNTMDEV,10,0.00116,121537,14.11937,860782
2594,mochizuki-pg,10,0.00116,121547,14.12053,860782
2595,mojumah,10,0.00116,121557,14.12169,860782
2596,moloch--,10,0.00116,121567,14.12286,860782
2597,MrAmbiG,10,0.00116,121577,14.12402,860782
2598,MrYourM,10,0.00116,121587,14.12518,860782
2599,nathanhleung,10,0.00116,121597,14.12634,860782
2600,neargle,10,0.00116,121607,14.12750,860782
2601,NeoTse,10,0.00116,121617,14.12866,860782
2602,nicklasfrahm,10,0.00116,121627,14.12983,860782
2603,nirgilboa,10,0.00116,121637,14.13099,860782
2604,njuptlzf,10,0.00116,121647,14.13215,860782
2605,Nowaker,10,0.00116,121657,14.13331,860782
2606,npuichigo,10,0.00116,121667,14.13447,860782
2607,oif,10,0.00116,121677,14.13563,860782
2608,olifka,10,0.00116,121687,14.13680,860782
2609,olivierboudet,10,0.00116,121697,14.13796,860782
2610,omkarprabhu-98,10,0.00116,121707,14.13912,860782
2611,oneoneonepig,10,0.00116,121717,14.14028,860782
2612,onmyflow,10,0.00116,121727,14.14144,860782
2613,oskapt,10,0.00116,121737,14.14261,860782
2614,Oznup,10,0.00116,121747,14.14377,860782
2615,P1ng-W1n,10,0.00116,121757,14.14493,860782
2616,packagewjx,10,0.00116,121767,14.14609,860782
2617,pandaamanda,10,0.00116,121777,14.14725,860782
2618,pdf,10,0.00116,121787,14.14841,860782
2619,PDVJAM,10,0.00116,121797,14.14958,860782
2620,philipp1992,10,0.00116,121807,14.15074,860782
2621,pieterv-icloud-com,10,0.00116,121817,14.15190,860782
2622,pjhdld,10,0.00116,121827,14.15306,860782
2623,Place1,10,0.00116,121837,14.15422,860782
2624,prateekkhera,10,0.00116,121847,14.15538,860782
2625,programaka,10,0.00116,121857,14.15655,860782
2626,rakeshnambiar,10,0.00116,121867,14.15771,860782
2627,ramirezag,10,0.00116,121877,14.15887,860782
2628,rbvigilante,10,0.00116,121887,14.16003,860782
2629,rendynoviyanto4,10,0.00116,121897,14.16119,860782
2630,Rested,10,0.00116,121907,14.16235,860782
2631,rivencxl,10,0.00116,121917,14.16352,860782
2632,robsonmeemo,10,0.00116,121927,14.16468,860782
2633,rstreics,10,0.00116,121937,14.16584,860782
2634,rstuberg-ib,10,0.00116,121947,14.16700,860782
2635,ryan4yin,10,0.00116,121957,14.16816,860782
2636,sanarena,10,0.00116,121967,14.16933,860782
2637,saraAlizadeh,10,0.00116,121977,14.17049,860782
2638,schmichri,10,0.00116,121987,14.17165,860782
2639,sean-zou,10,0.00116,121997,14.17281,860782
2640,sergeyzenchenko,10,0.00116,122007,14.17397,860782
2641,shabbir-taulia,10,0.00116,122017,14.17513,860782
2642,shanmukha511,10,0.00116,122027,14.17630,860782
2643,ShivamGoyal1899,10,0.00116,122037,14.17746,860782
2644,sirsikar-lalit,10,0.00116,122047,14.17862,860782
2645,Skyego,10,0.00116,122057,14.17978,860782
2646,smartczy,10,0.00116,122067,14.18094,860782
2647,snehix,10,0.00116,122077,14.18210,860782
2648,sonirico,10,0.00116,122087,14.18327,860782
2649,spencer-p,10,0.00116,122097,14.18443,860782
2650,srehmanproov,10,0.00116,122107,14.18559,860782
2651,sresthas,10,0.00116,122117,14.18675,860782
2652,ssasso,10,0.00116,122127,14.18791,860782
2653,sshankaregowda,10,0.00116,122137,14.18907,860782
2654,svenstaro,10,0.00116,122147,14.19024,860782
2655,SwanSpouse,10,0.00116,122157,14.19140,860782
2656,szihai,10,0.00116,122167,14.19256,860782
2657,tenzen-y,10,0.00116,122177,14.19372,860782
2658,teoincontatto,10,0.00116,122187,14.19488,860782
2659,terror96,10,0.00116,122197,14.19604,860782
2660,thatsk,10,0.00116,122207,14.19721,860782
2661,theggelund,10,0.00116,122217,14.19837,860782
2662,thephw,10,0.00116,122227,14.19953,860782
2663,thesamet,10,0.00116,122237,14.20069,860782
2664,Thoemmeli,10,0.00116,122247,14.20185,860782
2665,thomasco,10,0.00116,122257,14.20302,860782
2666,tiagoposse,10,0.00116,122267,14.20418,860782
2667,tianyime,10,0.00116,122277,14.20534,860782
2668,torsten-liermann,10,0.00116,122287,14.20650,860782
2669,trallnag,10,0.00116,122297,14.20766,860782
2670,TreeKat71,10,0.00116,122307,14.20882,860782
2671,trondhindenes,10,0.00116,122317,14.20999,860782
2672,trutx,10,0.00116,122327,14.21115,860782
2673,TTRh,10,0.00116,122337,14.21231,860782
2674,ukreddy-erwin,10,0.00116,122347,14.21347,860782
2675,unai-ttxu,10,0.00116,122357,14.21463,860782
2676,UnderMyBed,10,0.00116,122367,14.21579,860782
2677,uwburn,10,0.00116,122377,14.21696,860782
2678,vbfox,10,0.00116,122387,14.21812,860782
2679,vishnu667,10,0.00116,122397,14.21928,860782
2680,vizv,10,0.00116,122407,14.22044,860782
2681,vladfr,10,0.00116,122417,14.22160,860782
2682,vsbogd,10,0.00116,122427,14.22276,860782
2683,wangyira,10,0.00116,122437,14.22393,860782
2684,wavezhang,10,0.00116,122447,14.22509,860782
2685,Weil0ng,10,0.00116,122457,14.22625,860782
2686,weng271190436,10,0.00116,122467,14.22741,860782
2687,WillWcchan,10,0.00116,122477,14.22857,860782
2688,wilstoff,10,0.00116,122487,14.22974,860782
2689,witalisoft,10,0.00116,122497,14.23090,860782
2690,wjimenez5271,10,0.00116,122507,14.23206,860782
2691,wpeng102,10,0.00116,122517,14.23322,860782
2692,xinau,10,0.00116,122527,14.23438,860782
2693,xin-au,10,0.00116,122537,14.23554,860782
2694,xishengcai,10,0.00116,122547,14.23671,860782
2695,xmath279,10,0.00116,122557,14.23787,860782
2696,xmwilldo,10,0.00116,122567,14.23903,860782
2697,xq2005,10,0.00116,122577,14.24019,860782
2698,yash97,10,0.00116,122587,14.24135,860782
2699,yborovikov,10,0.00116,122597,14.24251,860782
2700,yhaenggi,10,0.00116,122607,14.24368,860782
2701,yhvicey,10,0.00116,122617,14.24484,860782
2702,ynsta,10,0.00116,122627,14.24600,860782
2703,yydzxz,10,0.00116,122637,14.24716,860782
2704,zagr0,10,0.00116,122647,14.24832,860782
2705,zeroone-shreeram,10,0.00116,122657,14.24948,860782
2706,zhanghaobin,10,0.00116,122667,14.25065,860782
2707,ZhangLei-cn,10,0.00116,122677,14.25181,860782
2708,zhangzhenguang2017,10,0.00116,122687,14.25297,860782
2709,030,9,0.00105,122696,14.25402,860782
2710,0x4c6565,9,0.00105,122705,14.25506,860782
2711,0xVox,9,0.00105,122714,14.25611,860782
2712,85matthew,9,0.00105,122723,14.25715,860782
2713,893949088,9,0.00105,122732,14.25820,860782
2714,AakashMasand,9,0.00105,122741,14.25924,860782
2715,AbhiPrasad,9,0.00105,122750,14.26029,860782
2716,abstulo,9,0.00105,122759,14.26133,860782
2717,ACXLM,9,0.00105,122768,14.26238,860782
2718,AdaephonBen,9,0.00105,122777,14.26343,860782
2719,adaptivecorporation,9,0.00105,122786,14.26447,860782
2720,adityashirodkar,9,0.00105,122795,14.26552,860782
2721,ajoysinhactc,9,0.00105,122804,14.26656,860782
2722,Akhilesh2412,9,0.00105,122813,14.26761,860782
2723,AlexandrePicosson,9,0.00105,122822,14.26865,860782
2724,alexklibisz,9,0.00105,122831,14.26970,860782
2725,alexpatow,9,0.00105,122840,14.27074,860782
2726,allisonis,9,0.00105,122849,14.27179,860782
2727,alokhom,9,0.00105,122858,14.27284,860782
2728,AmitVishwash,9,0.00105,122867,14.27388,860782
2729,andloh,9,0.00105,122876,14.27493,860782
2730,andrewmelis,9,0.00105,122885,14.27597,860782
2731,andrewsali,9,0.00105,122894,14.27702,860782
2732,AndreZiviani,9,0.00105,122903,14.27806,860782
2733,aneesh-joseph,9,0.00105,122912,14.27911,860782
2734,AnilKumarBandi27,9,0.00105,122921,14.28015,860782
2735,Anorlondo448,9,0.00105,122930,14.28120,860782
2736,Arabus,9,0.00105,122939,14.28225,860782
2737,arahamad,9,0.00105,122948,14.28329,860782
2738,arberx,9,0.00105,122957,14.28434,860782
2739,Arsen-Uulu,9,0.00105,122966,14.28538,860782
2740,arthurlogilab,9,0.00105,122975,14.28643,860782
2741,ashrafgt,9,0.00105,122984,14.28747,860782
2742,autarchprinceps,9,0.00105,122993,14.28852,860782
2743,Avangarda-ghost,9,0.00105,123002,14.28956,860782
2744,avinashkumar1289,9,0.00105,123011,14.29061,860782
2745,AyushCloud,9,0.00105,123020,14.29166,860782
2746,Baoqiang-Zhang,9,0.00105,123029,14.29270,860782
2747,barrymichaeldoyle,9,0.00105,123038,14.29375,860782
2748,beavenj,9,0.00105,123047,14.29479,860782
2749,bengadbois,9,0.00105,123056,14.29584,860782
2750,BEvgeniyS,9,0.00105,123065,14.29688,860782
2751,bgarber,9,0.00105,123074,14.29793,860782
2752,bhagwat070919,9,0.00105,123083,14.29897,860782
2753,Bhargavamacha,9,0.00105,123092,14.30002,860782
2754,billykwooten,9,0.00105,123101,14.30107,860782
2755,bitsofinfo,9,0.00105,123110,14.30211,860782
2756,BjoernT,9,0.00105,123119,14.30316,860782
2757,blackgold,9,0.00105,123128,14.30420,860782
2758,bluven,9,0.00105,123137,14.30525,860782
2759,bndn,9,0.00105,123146,14.30629,860782
2760,bubalush,9,0.00105,123155,14.30734,860782
2761,camelus0211,9,0.00105,123164,14.30838,860782
2762,carlosescura,9,0.00105,123173,14.30943,860782
2763,casibbald,9,0.00105,123182,14.31048,860782
2764,cfabio,9,0.00105,123191,14.31152,860782
2765,chenlein,9,0.00105,123200,14.31257,860782
2766,chetan-rns,9,0.00105,123209,14.31361,860782
2767,chinglinwen,9,0.00105,123218,14.31466,860782
2768,chriskinsman,9,0.00105,123227,14.31570,860782
2769,christian-bromann,9,0.00105,123236,14.31675,860782
2770,chrstnwhlrt,9,0.00105,123245,14.31779,860782
2771,ciiiii,9,0.00105,123254,14.31884,860782
2772,codifierr,9,0.00105,123263,14.31989,860782
2773,codiophile,9,0.00105,123272,14.32093,860782
2774,CoinCheung,9,0.00105,123281,14.32198,860782
2775,cparadal,9,0.00105,123290,14.32302,860782
2776,cprivite,9,0.00105,123299,14.32407,860782
2777,cristichiru,9,0.00105,123308,14.32511,860782
2778,cwallsfdc,9,0.00105,123317,14.32616,860782
2779,cyrilcros,9,0.00105,123326,14.32720,860782
2780,danielcooperxyz,9,0.00105,123335,14.32825,860782
2781,DanielZhangQD,9,0.00105,123344,14.32930,860782
2782,DannyPat44,9,0.00105,123353,14.33034,860782
2783,DatzAtWork,9,0.00105,123362,14.33139,860782
2784,dbrennand,9,0.00105,123371,14.33243,860782
2785,dcyoung,9,0.00105,123380,14.33348,860782
2786,ddavison,9,0.00105,123389,14.33452,860782
2787,deancn,9,0.00105,123398,14.33557,860782
2788,deeghuge,9,0.00105,123407,14.33661,860782
2789,defaultcute12,9,0.00105,123416,14.33766,860782
2790,didier-durand,9,0.00105,123425,14.33871,860782
2791,dleurs,9,0.00105,123434,14.33975,860782
2792,domgoer,9,0.00105,123443,14.34080,860782
2793,dominikmessner,9,0.00105,123452,14.34184,860782
2794,Donghui-Sudo,9,0.00105,123461,14.34289,860782
2795,dopelsunce,9,0.00105,123470,14.34393,860782
2796,dorny,9,0.00105,123479,14.34498,860782
2797,dotbalo,9,0.00105,123488,14.34602,860782
2798,droessmj,9,0.00105,123497,14.34707,860782
2799,DrPhil,9,0.00105,123506,14.34812,860782
2800,DrumSergio,9,0.00105,123515,14.34916,860782
2801,dtomcej,9,0.00105,123524,14.35021,860782
2802,duboisph,9,0.00105,123533,14.35125,860782
2803,dweber019,9,0.00105,123542,14.35230,860782
2804,dzr201732120115,9,0.00105,123551,14.35334,860782
2805,edernucci,9,0.00105,123560,14.35439,860782
2806,edmondsw,9,0.00105,123569,14.35543,860782
2807,Elegant996,9,0.00105,123578,14.35648,860782
2808,elimuhub,9,0.00105,123587,14.35753,860782
2809,emreodabas,9,0.00105,123596,14.35857,860782
2810,Enrico2,9,0.00105,123605,14.35962,860782
2811,enviel,9,0.00105,123614,14.36066,860782
2812,Erog38,9,0.00105,123623,14.36171,860782
2813,evgmoskalenko,9,0.00105,123632,14.36275,860782
2814,f35f0ef9d0e827dae86552d3899f78fc,9,0.00105,123641,14.36380,860782
2815,fangpenlin,9,0.00105,123650,14.36484,860782
2816,faruryo,9,0.00105,123659,14.36589,860782
2817,fblanke,9,0.00105,123668,14.36694,860782
2818,fjudith,9,0.00105,123677,14.36798,860782
2819,forvaidya,9,0.00105,123686,14.36903,860782
2820,frezbo,9,0.00105,123695,14.37007,860782
2821,gastonqiu,9,0.00105,123704,14.37112,860782
2822,gituserjava,9,0.00105,123713,14.37216,860782
2823,gizmosense,9,0.00105,123722,14.37321,860782
2824,gky360,9,0.00105,123731,14.37426,860782
2825,gobozov,9,0.00105,123740,14.37530,860782
2826,govardhangdg,9,0.00105,123749,14.37635,860782
2827,gricuk,9,0.00105,123758,14.37739,860782
2828,grifx,9,0.00105,123767,14.37844,860782
2829,gtnao0219,9,0.00105,123776,14.37948,860782
2830,guoweis-outreach,9,0.00105,123785,14.38053,860782
2831,gurjeet,9,0.00105,123794,14.38157,860782
2832,HaichaoLii,9,0.00105,123803,14.38262,860782
2833,HansK-p,9,0.00105,123812,14.38367,860782
2834,hendisantika,9,0.00105,123821,14.38471,860782
2835,heroku-miraheze,9,0.00105,123830,14.38576,860782
2836,herrberk,9,0.00105,123839,14.38680,860782
2837,hikhvar,9,0.00105,123848,14.38785,860782
2838,himanshigpta,9,0.00105,123857,14.38889,860782
2839,hobbytp,9,0.00105,123866,14.38994,860782
2840,hqq-get,9,0.00105,123875,14.39098,860782
2841,huapox,9,0.00105,123884,14.39203,860782
2842,hummerd,9,0.00105,123893,14.39308,860782
2843,hyorigo,9,0.00105,123902,14.39412,860782
2844,iam-TJ,9,0.00105,123911,14.39517,860782
2845,IIFE,9,0.00105,123920,14.39621,860782
2846,ildikov,9,0.00105,123929,14.39726,860782
2847,imba-tjd,9,0.00105,123938,14.39830,860782
2848,imsazzad,9,0.00105,123947,14.39935,860782
2849,infa-bsurber,9,0.00105,123956,14.40039,860782
2850,ipnextgen,9,0.00105,123965,14.40144,860782
2851,J0,9,0.00105,123974,14.40249,860782
2852,jackfarzan,9,0.00105,123983,14.40353,860782
2853,jaimehrubiks,9,0.00105,123992,14.40458,860782
2854,jakubkrzywda,9,0.00105,124001,14.40562,860782
2855,jamiebuxxx,9,0.00105,124010,14.40667,860782
2856,jcasman,9,0.00105,124019,14.40771,860782
2857,jcmcken,9,0.00105,124028,14.40876,860782
2858,jcstr,9,0.00105,124037,14.40980,860782
2859,jejer,9,0.00105,124046,14.41085,860782
2860,JeremyShih,9,0.00105,124055,14.41190,860782
2861,jfbai,9,0.00105,124064,14.41294,860782
2862,jfehlig,9,0.00105,124073,14.41399,860782
2863,JiaoDean,9,0.00105,124082,14.41503,860782
2864,jmlrt,9,0.00105,124091,14.41608,860782
2865,joshmue,9,0.00105,124100,14.41712,860782
2866,jrcjoro,9,0.00105,124109,14.41817,860782
2867,jrsapi,9,0.00105,124118,14.41921,860782
2868,jschwinger23,9,0.00105,124127,14.42026,860782
2869,jsgf,9,0.00105,124136,14.42131,860782
2870,juanvasquezreyes,9,0.00105,124145,14.42235,860782
2871,julian3xl,9,0.00105,124154,14.42340,860782
2872,juliusvonkohout,9,0.00105,124163,14.42444,860782
2873,justinmurray,9,0.00105,124172,14.42549,860782
2874,justinrush,9,0.00105,124181,14.42653,860782
2875,jvaibhav123,9,0.00105,124190,14.42758,860782
2876,jyobeer,9,0.00105,124199,14.42862,860782
2877,kannappa06,9,0.00105,124208,14.42967,860782
2878,karlism,9,0.00105,124217,14.43072,860782
2879,kashinoki38,9,0.00105,124226,14.43176,860782
2880,keyingliu,9,0.00105,124235,14.43281,860782
2881,khatrig,9,0.00105,124244,14.43385,860782
2882,kifeo,9,0.00105,124253,14.43490,860782
2883,kimullaa,9,0.00105,124262,14.43594,860782
2884,klinux,9,0.00105,124271,14.43699,860782
2885,kmarcell,9,0.00105,124280,14.43803,860782
2886,KR411-prog,9,0.00105,124289,14.43908,860782
2887,krader1961,9,0.00105,124298,14.44013,860782
2888,krajapraveen,9,0.00105,124307,14.44117,860782
2889,KrissiWi,9,0.00105,124316,14.44222,860782
2890,kurosakisora,9,0.00105,124325,14.44326,860782
2891,Larswa,9,0.00105,124334,14.44431,860782
2892,lenhattan86,9,0.00105,124343,14.44535,860782
2893,LeonsChun,9,0.00105,124352,14.44640,860782
2894,LeonSebastianCoimbra,9,0.00105,124361,14.44744,860782
2895,lerit,9,0.00105,124370,14.44849,860782
2896,limbuu,9,0.00105,124379,14.44954,860782
2897,liu4480,9,0.00105,124388,14.45058,860782
2898,loftkun,9,0.00105,124397,14.45163,860782
2899,loganmzz,9,0.00105,124406,14.45267,860782
2900,lorenz,9,0.00105,124415,14.45372,860782
2901,luckyvs1,9,0.00105,124424,14.45476,860782
2902,luwang-vmware,9,0.00105,124433,14.45581,860782
2903,lvangool,9,0.00105,124442,14.45685,860782
2904,maciekm,9,0.00105,124451,14.45790,860782
2905,maguowei,9,0.00105,124460,14.45895,860782
2906,mancini0,9,0.00105,124469,14.45999,860782
2907,MaPing01,9,0.00105,124478,14.46104,860782
2908,marcusjwhelan,9,0.00105,124487,14.46208,860782
2909,mark-au,9,0.00105,124496,14.46313,860782
2910,mattirantakomi,9,0.00105,124505,14.46417,860782
2911,matveym,9,0.00105,124514,14.46522,860782
2912,maulikjs,9,0.00105,124523,14.46626,860782
2913,mecampbellsoup,9,0.00105,124532,14.46731,860782
2914,mecseid,9,0.00105,124541,14.46836,860782
2915,medined,9,0.00105,124550,14.46940,860782
2916,mfykmn,9,0.00105,124559,14.47045,860782
2917,mgaurav,9,0.00105,124568,14.47149,860782
2918,mikechen66,9,0.00105,124577,14.47254,860782
2919,mikekuzak,9,0.00105,124586,14.47358,860782
2920,MirzaSikander,9,0.00105,124595,14.47463,860782
2921,mkuendig,9,0.00105,124604,14.47567,860782
2922,Moglum,9,0.00105,124613,14.47672,860782
2923,moltar,9,0.00105,124622,14.47777,860782
2924,mustafa-torun,9,0.00105,124631,14.47881,860782
2925,mvz27,9,0.00105,124640,14.47986,860782
2926,Naterd,9,0.00105,124649,14.48090,860782
2927,nbeny,9,0.00105,124658,14.48195,860782
2928,nerddelphi,9,0.00105,124667,14.48299,860782
2929,nettoclaudio,9,0.00105,124676,14.48404,860782
2930,nfyxhan,9,0.00105,124685,14.48508,860782
2931,nielsbasjes,9,0.00105,124694,14.48613,860782
2932,nirmalpathak,9,0.00105,124703,14.48718,860782
2933,NiteshKoushik,9,0.00105,124712,14.48822,860782
2934,nnashok,9,0.00105,124721,14.48927,860782
2935,noahdav,9,0.00105,124730,14.49031,860782
2936,Odilhao,9,0.00105,124739,14.49136,860782
2937,oliversalzburg,9,0.00105,124748,14.49240,860782
2938,omertsur,9,0.00105,124757,14.49345,860782
2939,paprickar,9,0.00105,124766,14.49449,860782
2940,parekhha,9,0.00105,124775,14.49554,860782
2941,patsonluk,9,0.00105,124784,14.49659,860782
2942,PauloFavero,9,0.00105,124793,14.49763,860782
2943,paulschwarz,9,0.00105,124802,14.49868,860782
2944,paulstelian97,9,0.00105,124811,14.49972,860782
2945,pestebogdan,9,0.00105,124820,14.50077,860782
2946,philjb,9,0.00105,124829,14.50181,860782
2947,phoefflin,9,0.00105,124838,14.50286,860782
2948,Pick1a1username,9,0.00105,124847,14.50390,860782
2949,pingyu,9,0.00105,124856,14.50495,860782
2950,princeanurag2011,9,0.00105,124865,14.50600,860782
2951,pupimvictor,9,0.00105,124874,14.50704,860782
2952,Purushotham233,9,0.00105,124883,14.50809,860782
2953,pysiekytel,9,0.00105,124892,14.50913,860782
2954,Qeas,9,0.00105,124901,14.51018,860782
2955,qlyoung,9,0.00105,124910,14.51122,860782
2956,quodlibetor,9,0.00105,124919,14.51227,860782
2957,ragunathan23,9,0.00105,124928,14.51331,860782
2958,rahulwagh,9,0.00105,124937,14.51436,860782
2959,rajaskakodkar,9,0.00105,124946,14.51541,860782
2960,Rajeskumar,9,0.00105,124955,14.51645,860782
2961,RalfJung,9,0.00105,124964,14.51750,860782
2962,RameshJampana,9,0.00105,124973,14.51854,860782
2963,randomanderson,9,0.00105,124982,14.51959,860782
2964,rangapv,9,0.00105,124991,14.52063,860782
2965,rbkaspr,9,0.00105,125000,14.52168,860782
2966,regardfs,9,0.00105,125009,14.52272,860782
2967,rehevkor5,9,0.00105,125018,14.52377,860782
2968,ridhoq,9,0.00105,125027,14.52482,860782
2969,Roarain,9,0.00105,125036,14.52586,860782
2970,rob8714,9,0.00105,125045,14.52691,860782
2971,robotica72,9,0.00105,125054,14.52795,860782
2972,rohan07,9,0.00105,125063,14.52900,860782
2973,romeo-delta-sierra,9,0.00105,125072,14.53004,860782
2974,roncohen,9,0.00105,125081,14.53109,860782
2975,rootsami,9,0.00105,125090,14.53213,860782
2976,rubenhak,9,0.00105,125099,14.53318,860782
2977,rubensayshi,9,0.00105,125108,14.53423,860782
2978,ruimaranhao,9,0.00105,125117,14.53527,860782
2979,ruruiye,9,0.00105,125126,14.53632,860782
2980,saddique164,9,0.00105,125135,14.53736,860782
2981,saikrishnaa,9,0.00105,125144,14.53841,860782
2982,salmon7,9,0.00105,125153,14.53945,860782
2983,SaraDavilaMendez,9,0.00105,125162,14.54050,860782
2984,saranicole,9,0.00105,125171,14.54154,860782
2985,SatyKrish,9,0.00105,125180,14.54259,860782
2986,seizadi,9,0.00105,125189,14.54364,860782
2987,senthilrameshjv,9,0.00105,125198,14.54468,860782
2988,sfriberg,9,0.00105,125207,14.54573,860782
2989,shane-lawrence,9,0.00105,125216,14.54677,860782
2990,shaunc,9,0.00105,125225,14.54782,860782
2991,shivani-hotstar,9,0.00105,125234,14.54886,860782
2992,simingweng,9,0.00105,125243,14.54991,860782
2993,Sjnahak,9,0.00105,125252,14.55095,860782
2994,sk2991,9,0.00105,125261,14.55200,860782
2995,slj211,9,0.00105,125270,14.55305,860782
2996,sluetze,9,0.00105,125279,14.55409,860782
2997,smirnov-mi,9,0.00105,125288,14.55514,860782
2998,smitaraut,9,0.00105,125297,14.55618,860782
2999,snyderdb,9,0.00105,125306,14.55723,860782
3000,spookytime,9,0.00105,125315,14.55827,860782
3001,STASiAN,9,0.00105,125324,14.55932,860782
3002,stavalfi,9,0.00105,125333,14.56036,860782
3003,stoyanr,9,0.00105,125342,14.56141,860782
3004,sweeneyb,9,0.00105,125351,14.56246,860782
3005,sxmatch,9,0.00105,125360,14.56350,860782
3006,talhairfanbentley,9,0.00105,125369,14.56455,860782
3007,tarunwadhwa13,9,0.00105,125378,14.56559,860782
3008,tdihp,9,0.00105,125387,14.56664,860782
3009,TechnoChimp,9,0.00105,125396,14.56768,860782
3010,thomasv314,9,0.00105,125405,14.56873,860782
3011,thousandhu,9,0.00105,125414,14.56977,860782
3012,tibers,9,0.00105,125423,14.57082,860782
3013,TJM,9,0.00105,125432,14.57187,860782
3014,tmckayus,9,0.00105,125441,14.57291,860782
3015,TomasKohout,9,0.00105,125450,14.57396,860782
3016,torpinouche,9,0.00105,125459,14.57500,860782
3017,tscswcn,9,0.00105,125468,14.57605,860782
3018,ulm0,9,0.00105,125477,14.57709,860782
3019,utsukprani,9,0.00105,125486,14.57814,860782
3020,VGerris,9,0.00105,125495,14.57918,860782
3021,vikneshgs,9,0.00105,125504,14.58023,860782
3022,vir2albulb,9,0.00105,125513,14.58128,860782
3023,vishalk-rafay,9,0.00105,125522,14.58232,860782
3024,vivekzhere,9,0.00105,125531,14.58337,860782
3025,vixus0,9,0.00105,125540,14.58441,860782
3026,WaldoFR,9,0.00105,125549,14.58546,860782
3027,walk1ng,9,0.00105,125558,14.58650,860782
3028,wangggong,9,0.00105,125567,14.58755,860782
3029,Weaverzhu,9,0.00105,125576,14.58860,860782
3030,weihai4099,9,0.00105,125585,14.58964,860782
3031,weili10,9,0.00105,125594,14.59069,860782
3032,w-huaqiang,9,0.00105,125603,14.59173,860782
3033,wshwsh12,9,0.00105,125612,14.59278,860782
3034,wyTrivail,9,0.00105,125621,14.59382,860782
3035,xhh1989,9,0.00105,125630,14.59487,860782
3036,xnavnai,9,0.00105,125639,14.59591,860782
3037,Xyrion,9,0.00105,125648,14.59696,860782
3038,xyzxyxzxzxyz,9,0.00105,125657,14.59801,860782
3039,y2kenny,9,0.00105,125666,14.59905,860782
3040,yangmarcyang,9,0.00105,125675,14.60010,860782
3041,yuha0,9,0.00105,125684,14.60114,860782
3042,yurymuski,9,0.00105,125693,14.60219,860782
3043,yvespp,9,0.00105,125702,14.60323,860782
3044,zackgalbreath,9,0.00105,125711,14.60428,860782
3045,zajdee,9,0.00105,125720,14.60532,860782
3046,zeyadkhaled,9,0.00105,125729,14.60637,860782
3047,zhsgao,9,0.00105,125738,14.60742,860782
3048,zischknall,9,0.00105,125747,14.60846,860782
3049,zjuwangcai,9,0.00105,125756,14.60951,860782
3050,117sparta,8,0.00093,125764,14.61044,860782
3051,2020testuser,8,0.00093,125772,14.61137,860782
3052,2044smile,8,0.00093,125780,14.61229,860782
3053,372046933,8,0.00093,125788,14.61322,860782
3054,54markov,8,0.00093,125796,14.61415,860782
3055,AcidAngel21,8,0.00093,125804,14.61508,860782
3056,adam-olema,8,0.00093,125812,14.61601,860782
3057,adampeklay,8,0.00093,125820,14.61694,860782
3058,adnxn,8,0.00093,125828,14.61787,860782
3059,adriangb,8,0.00093,125836,14.61880,860782
3060,aedorado,8,0.00093,125844,14.61973,860782
3061,agaudreault-jive,8,0.00093,125852,14.62066,860782
3062,AkshayDubey29,8,0.00093,125860,14.62159,860782
3063,alewis001,8,0.00093,125868,14.62252,860782
3064,alex1a,8,0.00093,125876,14.62345,860782
3065,alexakr,8,0.00093,125884,14.62438,860782
3066,alexeadem,8,0.00093,125892,14.62531,860782
3067,AlexEyler,8,0.00093,125900,14.62624,860782
3068,AlexMichaelJonesNC,8,0.00093,125908,14.62716,860782
3069,alstolten,8,0.00093,125916,14.62809,860782
3070,AMoghrabi,8,0.00093,125924,14.62902,860782
3071,ananda1066,8,0.00093,125932,14.62995,860782
3072,andrewparmet,8,0.00093,125940,14.63088,860782
3073,andy-retailnext,8,0.00093,125948,14.63181,860782
3074,Ankitchandre,8,0.00093,125956,14.63274,860782
3075,ansinlee,8,0.00093,125964,14.63367,860782
3076,antoninoromeo,8,0.00093,125972,14.63460,860782
3077,artemlive,8,0.00093,125980,14.63553,860782
3078,arunbsar,8,0.00093,125988,14.63646,860782
3079,arvtiwar,8,0.00093,125996,14.63739,860782
3080,asgoel,8,0.00093,126004,14.63832,860782
3081,aspnet4you,8,0.00093,126012,14.63925,860782
3082,Asuforce,8,0.00093,126020,14.64018,860782
3083,atheriel,8,0.00093,126028,14.64111,860782
3084,autodidaddict,8,0.00093,126036,14.64203,860782
3085,avik-so,8,0.00093,126044,14.64296,860782
3086,axk7812,8,0.00093,126052,14.64389,860782
3087,bangwu,8,0.00093,126060,14.64482,860782
3088,bcc829,8,0.00093,126068,14.64575,860782
3089,bfabec,8,0.00093,126076,14.64668,860782
3090,BhagathSeelam,8,0.00093,126084,14.64761,860782
3091,BigJerBD,8,0.00093,126092,14.64854,860782
3092,Bin360,8,0.00093,126100,14.64947,860782
3093,bingerambo,8,0.00093,126108,14.65040,860782
3094,bingoku,8,0.00093,126116,14.65133,860782
3095,BitFis,8,0.00093,126124,14.65226,860782
3096,blackredscarf,8,0.00093,126132,14.65319,860782
3097,bobasl,8,0.00093,126140,14.65412,860782
3098,BoBiene,8,0.00093,126148,14.65505,860782
3099,bobwanglyft,8,0.00093,126156,14.65598,860782
3100,bodymindarts,8,0.00093,126164,14.65691,860782
3101,brendarearden,8,0.00093,126172,14.65783,860782
3102,brew,8,0.00093,126180,14.65876,860782
3103,brianpham,8,0.00093,126188,14.65969,860782
3104,brpaz,8,0.00093,126196,14.66062,860782
3105,bryanhorstmann,8,0.00093,126204,14.66155,860782
3106,bryan-taylor,8,0.00093,126212,14.66248,860782
3107,bszeti,8,0.00093,126220,14.66341,860782
3108,btai24,8,0.00093,126228,14.66434,860782
3109,btannous,8,0.00093,126236,14.66527,860782
3110,bueti,8,0.00093,126244,14.66620,860782
3111,byblakeorriver,8,0.00093,126252,14.66713,860782
3112,candonov,8,0.00093,126260,14.66806,860782
3113,carlobongiovanni,8,0.00093,126268,14.66899,860782
3114,cblomart,8,0.00093,126276,14.66992,860782
3115,ccampo133,8,0.00093,126284,14.67085,860782
3116,Ccaomei,8,0.00093,126292,14.67178,860782
3117,cemsusal,8,0.00093,126300,14.67270,860782
3118,chainlink,8,0.00093,126308,14.67363,860782
3119,chamilad,8,0.00093,126316,14.67456,860782
3120,chensun,8,0.00093,126324,14.67549,860782
3121,chinadragon0515,8,0.00093,126332,14.67642,860782
3122,chittu11,8,0.00093,126340,14.67735,860782
3123,chriserik,8,0.00093,126348,14.67828,860782
3124,ChristianWeyer,8,0.00093,126356,14.67921,860782
3125,claflico,8,0.00093,126364,14.68014,860782
3126,clayvan,8,0.00093,126372,14.68107,860782
3127,cobolbaby,8,0.00093,126380,14.68200,860782
3128,CocoPapa1995,8,0.00093,126388,14.68293,860782
3129,codearky,8,0.00093,126396,14.68386,860782
3130,colega,8,0.00093,126404,14.68479,860782
3131,colin404,8,0.00093,126412,14.68572,860782
3132,colvin,8,0.00093,126420,14.68665,860782
3133,Cosmosmay,8,0.00093,126428,14.68757,860782
3134,cosven,8,0.00093,126436,14.68850,860782
3135,cr22rc,8,0.00093,126444,14.68943,860782
3136,crazybg321,8,0.00093,126452,14.69036,860782
3137,crisesw,8,0.00093,126460,14.69129,860782
3138,cyclingwithelephants,8,0.00093,126468,14.69222,860782
3139,DancingLinks,8,0.00093,126476,14.69315,860782
3140,dandragut,8,0.00093,126484,14.69408,860782
3141,danielkucera,8,0.00093,126492,14.69501,860782
3142,danniel1205,8,0.00093,126500,14.69594,860782
3143,darewreck54,8,0.00093,126508,14.69687,860782
3144,darose,8,0.00093,126516,14.69780,860782
3145,darunshen,8,0.00093,126524,14.69873,860782
3146,davidcollom,8,0.00093,126532,14.69966,860782
3147,dbluxo,8,0.00093,126540,14.70059,860782
3148,dcswbdias,8,0.00093,126548,14.70152,860782
3149,ddiawara,8,0.00093,126556,14.70244,860782
3150,Deardrops,8,0.00093,126564,14.70337,860782
3151,dellwon,8,0.00093,126572,14.70430,860782
3152,demon,8,0.00093,126580,14.70523,860782
3153,descrepes,8,0.00093,126588,14.70616,860782
3154,devopstales,8,0.00093,126596,14.70709,860782
3155,devries,8,0.00093,126604,14.70802,860782
3156,devsentient,8,0.00093,126612,14.70895,860782
3157,dmitry-irtegov,8,0.00093,126620,14.70988,860782
3158,doeg,8,0.00093,126628,14.71081,860782
3159,doru1004,8,0.00093,126636,14.71174,860782
3160,dragon2611,8,0.00093,126644,14.71267,860782
3161,drauch,8,0.00093,126652,14.71360,860782
3162,dujiulun,8,0.00093,126660,14.71453,860782
3163,echo80313,8,0.00093,126668,14.71546,860782
3164,edselwang,8,0.00093,126676,14.71639,860782
3165,efe-selcuk,8,0.00093,126684,14.71732,860782
3166,Eji4h,8,0.00093,126692,14.71824,860782
3167,elshanakberov,8,0.00093,126700,14.71917,860782
3168,emirot,8,0.00093,126708,14.72010,860782
3169,endocrimes,8,0.00093,126716,14.72103,860782
3170,ercpereda,8,0.00093,126724,14.72196,860782
3171,ericzhang08,8,0.00093,126732,14.72289,860782
3172,eschizoid,8,0.00093,126740,14.72382,860782
3173,excieve,8,0.00093,126748,14.72475,860782
3174,exherb,8,0.00093,126756,14.72568,860782
3175,Fahmy-Mohammed,8,0.00093,126764,14.72661,860782
3176,farzadmf,8,0.00093,126772,14.72754,860782
3177,fashing,8,0.00093,126780,14.72847,860782
3178,feber,8,0.00093,126788,14.72940,860782
3179,feranwq,8,0.00093,126796,14.73033,860782
3180,fernandosilvacornejo,8,0.00093,126804,14.73126,860782
3181,FestivalBobcats,8,0.00093,126812,14.73219,860782
3182,fischerman,8,0.00093,126820,14.73311,860782
3183,florimondmanca,8,0.00093,126828,14.73404,860782
3184,Fly0905,8,0.00093,126836,14.73497,860782
3185,foxsin10,8,0.00093,126844,14.73590,860782
3186,FranzBusch,8,0.00093,126852,14.73683,860782
3187,fredczj,8,0.00093,126860,14.73776,860782
3188,fuzeto,8,0.00093,126868,14.73869,860782
3189,fydrah,8,0.00093,126876,14.73962,860782
3190,Gal-Zaidman,8,0.00093,126884,14.74055,860782
3191,gaopeiliang,8,0.00093,126892,14.74148,860782
3192,gargankur2008,8,0.00093,126900,14.74241,860782
3193,gbbr,8,0.00093,126908,14.74334,860782
3194,gemfield,8,0.00093,126916,14.74427,860782
3195,genehynson,8,0.00093,126924,14.74520,860782
3196,geota,8,0.00093,126932,14.74613,860782
3197,Gerrit-K,8,0.00093,126940,14.74706,860782
3198,getafixx,8,0.00093,126948,14.74798,860782
3199,ggjjlldd,8,0.00093,126956,14.74891,860782
3200,gireeshpunathil,8,0.00093,126964,14.74984,860782
3201,givip,8,0.00093,126972,14.75077,860782
3202,GJKrupa,8,0.00093,126980,14.75170,860782
3203,gkramer,8,0.00093,126988,14.75263,860782
3204,gmahomarf,8,0.00093,126996,14.75356,860782
3205,gorquan,8,0.00093,127004,14.75449,860782
3206,grahamoptibrium,8,0.00093,127012,14.75542,860782
3207,GregoryIan,8,0.00093,127020,14.75635,860782
3208,Gsealy,8,0.00093,127028,14.75728,860782
3209,guangbaowan,8,0.00093,127036,14.75821,860782
3210,guitarrapc,8,0.00093,127044,14.75914,860782
3211,gunsluo,8,0.00093,127052,14.76007,860782
3212,haemyung,8,0.00093,127060,14.76100,860782
3213,haslersn,8,0.00093,127068,14.76193,860782
3214,hawksight,8,0.00093,127076,14.76286,860782
3215,hcavalieri,8,0.00093,127084,14.76378,860782
3216,hguerrero,8,0.00093,127092,14.76471,860782
3217,hhbti,8,0.00093,127100,14.76564,860782
3218,hodgesds,8,0.00093,127108,14.76657,860782
3219,hrasadi,8,0.00093,127116,14.76750,860782
3220,hubaxis,8,0.00093,127124,14.76843,860782
3221,hzhou97,8,0.00093,127132,14.76936,860782
3222,iamjaekim,8,0.00093,127140,14.77029,860782
3223,iAnomaly,8,0.00093,127148,14.77122,860782
3224,ibudasov,8,0.00093,127156,14.77215,860782
3225,iDube,8,0.00093,127164,14.77308,860782
3226,ifilonenko,8,0.00093,127172,14.77401,860782
3227,ifooth,8,0.00093,127180,14.77494,860782
3228,iKarthik,8,0.00093,127188,14.77587,860782
3229,inigohu,8,0.00093,127196,14.77680,860782
3230,IrisChanTW,8,0.00093,127204,14.77773,860782
3231,ishg,8,0.00093,127212,14.77865,860782
3232,ishitasequeira,8,0.00093,127220,14.77958,860782
3233,iyacontrol,8,0.00093,127228,14.78051,860782
3234,iyashu,8,0.00093,127236,14.78144,860782
3235,izeye,8,0.00093,127244,14.78237,860782
3236,jaccosteur,8,0.00093,127252,14.78330,860782
3237,JaeGeunBang,8,0.00093,127260,14.78423,860782
3238,jakob-o,8,0.00093,127268,14.78516,860782
3239,JarrodCColburn,8,0.00093,127276,14.78609,860782
3240,JasonPad19,8,0.00093,127284,14.78702,860782
3241,jawlitkp,8,0.00093,127292,14.78795,860782
3242,jaychan-q,8,0.00093,127300,14.78888,860782
3243,JBerny,8,0.00093,127308,14.78981,860782
3244,jcferretti72,8,0.00093,127316,14.79074,860782
3245,jeli8-cor,8,0.00093,127324,14.79167,860782
3246,jeremysf,8,0.00093,127332,14.79260,860782
3247,Jeroen0494,8,0.00093,127340,14.79352,860782
3248,joelbyronbarker,8,0.00093,127348,14.79445,860782
3249,johnkassebaum,8,0.00093,127356,14.79538,860782
3250,john-mcgowan-wowza,8,0.00093,127364,14.79631,860782
3251,john-mcpeek,8,0.00093,127372,14.79724,860782
3252,johny-mnemonic,8,0.00093,127380,14.79817,860782
3253,joneal,8,0.00093,127388,14.79910,860782
3254,joohee,8,0.00093,127396,14.80003,860782
3255,jotrobin,8,0.00093,127404,14.80096,860782
3256,jpambrun,8,0.00093,127412,14.80189,860782
3257,jrdemasi,8,0.00093,127420,14.80282,860782
3258,jrroman,8,0.00093,127428,14.80375,860782
3259,juampynr,8,0.00093,127436,14.80468,860782
3260,k3a,8,0.00093,127444,14.80561,860782
3261,kabilan6,8,0.00093,127452,14.80654,860782
3262,kangning1,8,0.00093,127460,14.80747,860782
3263,KateGo520,8,0.00093,127468,14.80840,860782
3264,kaushalNEC,8,0.00093,127476,14.80932,860782
3265,kaviarasan-ex2,8,0.00093,127484,14.81025,860782
3266,kbarukhov,8,0.00093,127492,14.81118,860782
3267,keer25,8,0.00093,127500,14.81211,860782
3268,kempy007,8,0.00093,127508,14.81304,860782
3269,kenntun,8,0.00093,127516,14.81397,860782
3270,kevinsimons-wf,8,0.00093,127524,14.81490,860782
3271,keyboardfann,8,0.00093,127532,14.81583,860782
3272,kgreenek,8,0.00093,127540,14.81676,860782
3273,kingli-crypto,8,0.00093,127548,14.81769,860782
3274,kkushal05,8,0.00093,127556,14.81862,860782
3275,KOGI,8,0.00093,127564,14.81955,860782
3276,Komey,8,0.00093,127572,14.82048,860782
3277,korney4eg,8,0.00093,127580,14.82141,860782
3278,koziez,8,0.00093,127588,14.82234,860782
3279,kuberkaul,8,0.00093,127596,14.82327,860782
3280,kvp-cs,8,0.00093,127604,14.82419,860782
3281,laike9m,8,0.00093,127612,14.82512,860782
3282,larryck,8,0.00093,127620,14.82605,860782
3283,latelee,8,0.00093,127628,14.82698,860782
3284,lentil1016,8,0.00093,127636,14.82791,860782
3285,lij3,8,0.00093,127644,14.82884,860782
3286,likakuli,8,0.00093,127652,14.82977,860782
3287,LinQing2017,8,0.00093,127660,14.83070,860782
3288,lithiumoxide,8,0.00093,127668,14.83163,860782
3289,liuchjlu,8,0.00093,127676,14.83256,860782
3290,lljstar,8,0.00093,127684,14.83349,860782
3291,lmgnid,8,0.00093,127692,14.83442,860782
3292,Lonor,8,0.00093,127700,14.83535,860782
3293,loopever,8,0.00093,127708,14.83628,860782
3294,lschmierer,8,0.00093,127716,14.83721,860782
3295,lstyles,8,0.00093,127724,14.83814,860782
3296,lubingfeng,8,0.00093,127732,14.83906,860782
3297,LukasGentele,8,0.00093,127740,14.83999,860782
3298,luozhaoyu,8,0.00093,127748,14.84092,860782
3299,lyonsaj,8,0.00093,127756,14.84185,860782
3300,maateen,8,0.00093,127764,14.84278,860782
3301,machao23,8,0.00093,127772,14.84371,860782
3302,maennchen,8,0.00093,127780,14.84464,860782
3303,maikelvl,8,0.00093,127788,14.84557,860782
3304,marcatos,8,0.00093,127796,14.84650,860782
3305,mardim91,8,0.00093,127804,14.84743,860782
3306,martinwoods,8,0.00093,127812,14.84836,860782
3307,masters3d,8,0.00093,127820,14.84929,860782
3308,matclab,8,0.00093,127828,14.85022,860782
3309,matjung,8,0.00093,127836,14.85115,860782
3310,mcavoyk,8,0.00093,127844,14.85208,860782
3311,mclarkson,8,0.00093,127852,14.85301,860782
3312,meastp,8,0.00093,127860,14.85394,860782
3313,mgcrea,8,0.00093,127868,14.85486,860782
3314,mhaddon,8,0.00093,127876,14.85579,860782
3315,michael-db,8,0.00093,127884,14.85672,860782
3316,MichaelJDrK,8,0.00093,127892,14.85765,860782
3317,micli,8,0.00093,127900,14.85858,860782
3318,microyahoo,8,0.00093,127908,14.85951,860782
3319,milkwine,8,0.00093,127916,14.86044,860782
3320,Misosooup,8,0.00093,127924,14.86137,860782
3321,mnff,8,0.00093,127932,14.86230,860782
3322,moon-bits,8,0.00093,127940,14.86323,860782
3323,Morishiri,8,0.00093,127948,14.86416,860782
3324,Moulick,8,0.00093,127956,14.86509,860782
3325,MrVentzi,8,0.00093,127964,14.86602,860782
3326,mugugnu,8,0.00093,127972,14.86695,860782
3327,muldoon2007,8,0.00093,127980,14.86788,860782
3328,my1990,8,0.00093,127988,14.86881,860782
3329,nalbam,8,0.00093,127996,14.86973,860782
3330,newrelic-eheinlein,8,0.00093,128004,14.87066,860782
3331,nfickas,8,0.00093,128012,14.87159,860782
3332,NicoleYson,8,0.00093,128020,14.87252,860782
3333,nikitayuratkin,8,0.00093,128028,14.87345,860782
3334,NingPekin,8,0.00093,128036,14.87438,860782
3335,niraj2587,8,0.00093,128044,14.87531,860782
3336,nirex0,8,0.00093,128052,14.87624,860782
3337,nirupbbnk,8,0.00093,128060,14.87717,860782
3338,nmousouros,8,0.00093,128068,14.87810,860782
3339,nqdrizzt,8,0.00093,128076,14.87903,860782
3340,nsvijay04b1,8,0.00093,128084,14.87996,860782
3341,nysan,8,0.00093,128092,14.88089,860782
3342,oassuncao,8,0.00093,128100,14.88182,860782
3343,oatakan,8,0.00093,128108,14.88275,860782
3344,ohayon,8,0.00093,128116,14.88368,860782
3345,okozachenko1203,8,0.00093,128124,14.88460,860782
3346,omer-sd,8,0.00093,128132,14.88553,860782
3347,otmanel31,8,0.00093,128140,14.88646,860782
3348,outime,8,0.00093,128148,14.88739,860782
3349,palixthepalalix,8,0.00093,128156,14.88832,860782
3350,paroque28,8,0.00093,128164,14.88925,860782
3351,parthyadav3105,8,0.00093,128172,14.89018,860782
3352,patsevanton,8,0.00093,128180,14.89111,860782
3353,paulmckeown,8,0.00093,128188,14.89204,860782
3354,pchmielowski,8,0.00093,128196,14.89297,860782
3355,peterlin741,8,0.00093,128204,14.89390,860782
3356,phyrog,8,0.00093,128212,14.89483,860782
3357,pierresouchay,8,0.00093,128220,14.89576,860782
3358,PinchasLev,8,0.00093,128228,14.89669,860782
3359,polskikiel,8,0.00093,128236,14.89762,860782
3360,poogurgaon,8,0.00093,128244,14.89855,860782
3361,pooneh-m,8,0.00093,128252,14.89948,860782
3362,potiuk,8,0.00093,128260,14.90040,860782
3363,pradeepnss,8,0.00093,128268,14.90133,860782
3364,pranavbmcloud,8,0.00093,128276,14.90226,860782
3365,pretendhigh,8,0.00093,128284,14.90319,860782
3366,PSanetra,8,0.00093,128292,14.90412,860782
3367,psavva,8,0.00093,128300,14.90505,860782
3368,psibi,8,0.00093,128308,14.90598,860782
3369,Punkoivan,8,0.00093,128316,14.90691,860782
3370,pzqu,8,0.00093,128324,14.90784,860782
3371,qingguee,8,0.00093,128332,14.90877,860782
3372,rafal-prasal,8,0.00093,128340,14.90970,860782
3373,rbo54,8,0.00093,128348,14.91063,860782
3374,Reamer,8,0.00093,128356,14.91156,860782
3375,reith,8,0.00093,128364,14.91249,860782
3376,remal,8,0.00093,128372,14.91342,860782
3377,Reminiscent,8,0.00093,128380,14.91435,860782
3378,renjikari,8,0.00093,128388,14.91527,860782
3379,research-sudo,8,0.00093,128396,14.91620,860782
3380,retinio,8,0.00093,128404,14.91713,860782
3381,rg2011,8,0.00093,128412,14.91806,860782
3382,richardpringle,8,0.00093,128420,14.91899,860782
3383,rihardssceredins,8,0.00093,128428,14.91992,860782
3384,rittneje,8,0.00093,128436,14.92085,860782
3385,riuvshyn,8,0.00093,128444,14.92178,860782
3386,r-kotagudem,8,0.00093,128452,14.92271,860782
3387,Roasbeef,8,0.00093,128460,14.92364,860782
3388,robross0606,8,0.00093,128468,14.92457,860782
3389,robstoll,8,0.00093,128476,14.92550,860782
3390,roobert,8,0.00093,128484,14.92643,860782
3391,rootdeep,8,0.00093,128492,14.92736,860782
3392,rothsa,8,0.00093,128500,14.92829,860782
3393,Routhinator,8,0.00093,128508,14.92922,860782
3394,r-suresh-kumar,8,0.00093,128516,14.93014,860782
3395,rurus9,8,0.00093,128524,14.93107,860782
3396,rust84,8,0.00093,128532,14.93200,860782
3397,ryok-0319,8,0.00093,128540,14.93293,860782
3398,saberrey,8,0.00093,128548,14.93386,860782
3399,sabyadi,8,0.00093,128556,14.93479,860782
3400,Sad-polar-bear,8,0.00093,128564,14.93572,860782
3401,SamKirsch10,8,0.00093,128572,14.93665,860782
3402,sanamsarath,8,0.00093,128580,14.93758,860782
3403,sandyleo26,8,0.00093,128588,14.93851,860782
3404,scardena,8,0.00093,128596,14.93944,860782
3405,schretzi,8,0.00093,128604,14.94037,860782
3406,scottdhowell3,8,0.00093,128612,14.94130,860782
3407,sdil,8,0.00093,128620,14.94223,860782
3408,secustor,8,0.00093,128628,14.94316,860782
3409,sekka1,8,0.00093,128636,14.94409,860782
3410,septuagint,8,0.00093,128644,14.94502,860782
3411,serrodcal,8,0.00093,128652,14.94594,860782
3412,sguidos,8,0.00093,128660,14.94687,860782
3413,shivanjanip007,8,0.00093,128668,14.94780,860782
3414,shiyiyue1102,8,0.00093,128676,14.94873,860782
3415,shonge,8,0.00093,128684,14.94966,860782
3416,shubhambadkur,8,0.00093,128692,14.95059,860782
3417,sidharthv96,8,0.00093,128700,14.95152,860782
3418,silasdavis,8,0.00093,128708,14.95245,860782
3419,simitt,8,0.00093,128716,14.95338,860782
3420,simonasr,8,0.00093,128724,14.95431,860782
3421,sixcorners,8,0.00093,128732,14.95524,860782
3422,SmittyCooger,8,0.00093,128740,14.95617,860782
3423,s-m-sufyian,8,0.00093,128748,14.95710,860782
3424,solovyevt,8,0.00093,128756,14.95803,860782
3425,sri-05,8,0.00093,128764,14.95896,860782
3426,ssharma2089,8,0.00093,128772,14.95989,860782
3427,sstoner,8,0.00093,128780,14.96081,860782
3428,starofys,8,0.00093,128788,14.96174,860782
3429,steled,8,0.00093,128796,14.96267,860782
3430,stephanos,8,0.00093,128804,14.96360,860782
3431,stevencl1013,8,0.00093,128812,14.96453,860782
3432,stewartshea,8,0.00093,128820,14.96546,860782
3433,ston1th,8,0.00093,128828,14.96639,860782
3434,strigona-worksight,8,0.00093,128836,14.96732,860782
3435,sulochan,8,0.00093,128844,14.96825,860782
3436,sungwonkim-muhayu,8,0.00093,128852,14.96918,860782
3437,sunyuhan19981208,8,0.00093,128860,14.97011,860782
3438,surlyengineer,8,0.00093,128868,14.97104,860782
3439,symbian4sj,8,0.00093,128876,14.97197,860782
3440,szhnet,8,0.00093,128884,14.97290,860782
3441,t33m,8,0.00093,128892,14.97383,860782
3442,tchainzzz,8,0.00093,128900,14.97476,860782
3443,teq0,8,0.00093,128908,14.97568,860782
3444,ThatRickGuy,8,0.00093,128916,14.97661,860782
3445,thavlik,8,0.00093,128924,14.97754,860782
3446,thehajime,8,0.00093,128932,14.97847,860782
3447,ThoreKr,8,0.00093,128940,14.97940,860782
3448,threedliteguy,8,0.00093,128948,14.98033,860782
3449,ticapix,8,0.00093,128956,14.98126,860782
3450,TigerHe7,8,0.00093,128964,14.98219,860782
3451,timfong888,8,0.00093,128972,14.98312,860782
3452,timkalanai,8,0.00093,128980,14.98405,860782
3453,Timoses,8,0.00093,128988,14.98498,860782
3454,TimothyMothra,8,0.00093,128996,14.98591,860782
3455,tolbrino,8,0.00093,129004,14.98684,860782
3456,tomqijianbo,8,0.00093,129012,14.98777,860782
3457,Trackhe,8,0.00093,129020,14.98870,860782
3458,TracyRagan,8,0.00093,129028,14.98963,860782
3459,tringuyen-yw,8,0.00093,129036,14.99056,860782
3460,tsubasaxZZZ,8,0.00093,129044,14.99148,860782
3461,u5surf,8,0.00093,129052,14.99241,860782
3462,ugodiggi,8,0.00093,129060,14.99334,860782
3463,Ultra4life,8,0.00093,129068,14.99427,860782
3464,umanwizard,8,0.00093,129076,14.99520,860782
3465,unixlab,8,0.00093,129084,14.99613,860782
3466,urre,8,0.00093,129092,14.99706,860782
3467,valcharo92,8,0.00093,129100,14.99799,860782
3468,vbotez,8,0.00093,129108,14.99892,860782
3469,veera2019,8,0.00093,129116,14.99985,860782
3470,VenkateshwaraUsirikayala,8,0.00093,129124,15.00078,860782
3471,vetbijaya,8,0.00093,129132,15.00171,860782
3472,ViBiOh,8,0.00093,129140,15.00264,860782
3473,viperKiran,8,0.00093,129148,15.00357,860782
3474,vipulagarwal,8,0.00093,129156,15.00450,860782
3475,vishnukarthikl,8,0.00093,129164,15.00543,860782
3476,vjpie2002,8,0.00093,129172,15.00635,860782
3477,vmasutin,8,0.00093,129180,15.00728,860782
3478,vsel,8,0.00093,129188,15.00821,860782
3479,wanghe-fit2cloud,8,0.00093,129196,15.00914,860782
3480,wangtenghe,8,0.00093,129204,15.01007,860782
3481,wangzhipeng,8,0.00093,129212,15.01100,860782
3482,weii666,8,0.00093,129220,15.01193,860782
3483,whitecolor,8,0.00093,129228,15.01286,860782
3484,wilinger,8,0.00093,129236,15.01379,860782
3485,willjw1,8,0.00093,129244,15.01472,860782
3486,windtalker,8,0.00093,129252,15.01565,860782
3487,wmgroot,8,0.00093,129260,15.01658,860782
3488,wonleing,8,0.00093,129268,15.01751,860782
3489,Wujunqi-1996,8,0.00093,129276,15.01844,860782
3490,Wykiki,8,0.00093,129284,15.01937,860782
3491,xgdgsc,8,0.00093,129292,15.02030,860782
3492,xinbinhuang,8,0.00093,129300,15.02122,860782
3493,xirzec,8,0.00093,129308,15.02215,860782
3494,xMAC94x,8,0.00093,129316,15.02308,860782
3495,xriser,8,0.00093,129324,15.02401,860782
3496,xsreality,8,0.00093,129332,15.02494,860782
3497,Xtizainy,8,0.00093,129340,15.02587,860782
3498,yangkev,8,0.00093,129348,15.02680,860782
3499,yangwang888,8,0.00093,129356,15.02773,860782
3500,yangyefei-bj,8,0.00093,129364,15.02866,860782
3501,yaphetsglhf,8,0.00093,129372,15.02959,860782
3502,yardenshoham,8,0.00093,129380,15.03052,860782
3503,yerzhant,8,0.00093,129388,15.03145,860782
3504,YeSei,8,0.00093,129396,15.03238,860782
3505,yimtun,8,0.00093,129404,15.03331,860782
3506,yodarshafrir1,8,0.00093,129412,15.03424,860782
3507,Yogendra0Sharma,8,0.00093,129420,15.03517,860782
3508,yokaze,8,0.00093,129428,15.03610,860782
3509,youwithouto,8,0.00093,129436,15.03702,860782
3510,yshteinm,8,0.00093,129444,15.03795,860782
3511,y-taka-23,8,0.00093,129452,15.03888,860782
3512,yttan,8,0.00093,129460,15.03981,860782
3513,yuchen-sun,8,0.00093,129468,15.04074,860782
3514,yushanjin,8,0.00093,129476,15.04167,860782
3515,zeodtr,8,0.00093,129484,15.04260,860782
3516,zeusro,8,0.00093,129492,15.04353,860782
3517,zewelor,8,0.00093,129500,15.04446,860782
3518,zhalas,8,0.00093,129508,15.04539,860782
3519,Zhang-Jianming,8,0.00093,129516,15.04632,860782
3520,zi-l,8,0.00093,129524,15.04725,860782
3521,ZxYuan,8,0.00093,129532,15.04818,860782
3522,zzvara,8,0.00093,129540,15.04911,860782
3523,404notfoundhard,7,0.00081,129547,15.04992,860782
3524,4ops,7,0.00081,129554,15.05073,860782
3525,504274990,7,0.00081,129561,15.05155,860782
3526,aarononeal,7,0.00081,129568,15.05236,860782
3527,abergmeier,7,0.00081,129575,15.05317,860782
3528,abh,7,0.00081,129582,15.05399,860782
3529,abohmeed,7,0.00081,129589,15.05480,860782
3530,adamhjk,7,0.00081,129596,15.05561,860782
3531,Adarsh096,7,0.00081,129603,15.05643,860782
3532,Adhira-Deogade,7,0.00081,129610,15.05724,860782
3533,a-dyakov-mercuryo,7,0.00081,129617,15.05805,860782
3534,ahmedtalhakhan,7,0.00081,129624,15.05887,860782
3535,albertrdixon,7,0.00081,129631,15.05968,860782
3536,aleveille,7,0.00081,129638,15.06049,860782
3537,alex-leonhardt,7,0.00081,129645,15.06130,860782
3538,alexppg,7,0.00081,129652,15.06212,860782
3539,alextes,7,0.00081,129659,15.06293,860782
3540,alita91,7,0.00081,129666,15.06374,860782
3541,alittlec,7,0.00081,129673,15.06456,860782
3542,almorgv,7,0.00081,129680,15.06537,860782
3543,Alok0587,7,0.00081,129687,15.06618,860782
3544,Alon-Katz,7,0.00081,129694,15.06700,860782
3545,alpaca2333,7,0.00081,129701,15.06781,860782
3546,amitdah4,7,0.00081,129708,15.06862,860782
3547,anand-c-goog,7,0.00081,129715,15.06944,860782
3548,andk,7,0.00081,129722,15.07025,860782
3549,AndreiBamboi,7,0.00081,129729,15.07106,860782
3550,andrewtikhonov,7,0.00081,129736,15.07188,860782
3551,andriyfomenko,7,0.00081,129743,15.07269,860782
3552,angristan,7,0.00081,129750,15.07350,860782
3553,anilkusc,7,0.00081,129757,15.07432,860782
3554,Anil-YadavK8s,7,0.00081,129764,15.07513,860782
3555,AnwarArifa,7,0.00081,129771,15.07594,860782
3556,apocello2008,7,0.00081,129778,15.07676,860782
3557,aregnier42,7,0.00081,129785,15.07757,860782
3558,arivatibm,7,0.00081,129792,15.07838,860782
3559,ArtemAlagizov,7,0.00081,129799,15.07920,860782
3560,arunreddykaithe,7,0.00081,129806,15.08001,860782
3561,asadali,7,0.00081,129813,15.08082,860782
3562,asaroyan,7,0.00081,129820,15.08164,860782
3563,AshutoshNirkhe,7,0.00081,129827,15.08245,860782
3564,asos-craigmorten,7,0.00081,129834,15.08326,860782
3565,astoycos,7,0.00081,129841,15.08407,860782
3566,atamgp,7,0.00081,129848,15.08489,860782
3567,Athosone,7,0.00081,129855,15.08570,860782
3568,aureq,7,0.00081,129862,15.08651,860782
3569,avr1254,7,0.00081,129869,15.08733,860782
3570,awlleon,7,0.00081,129876,15.08814,860782
3571,ayanamist,7,0.00081,129883,15.08895,860782
3572,azye,7,0.00081,129890,15.08977,860782
3573,Banck,7,0.00081,129897,15.09058,860782
3574,bartjkdp,7,0.00081,129904,15.09139,860782
3575,bcanozter,7,0.00081,129911,15.09221,860782
3576,bcdady,7,0.00081,129918,15.09302,860782
3577,bdelsaz,7,0.00081,129925,15.09383,860782
3578,BedivereZero,7,0.00081,129932,15.09465,860782
3579,bigangryrobot,7,0.00081,129939,15.09546,860782
3580,bitva77,7,0.00081,129946,15.09627,860782
3581,bjayanth,7,0.00081,129953,15.09709,860782
3582,blt,7,0.00081,129960,15.09790,860782
3583,bozaro,7,0.00081,129967,15.09871,860782
3584,brandonc,7,0.00081,129974,15.09953,860782
3585,brandondoran,7,0.00081,129981,15.10034,860782
3586,brannondorsey,7,0.00081,129988,15.10115,860782
3587,brianthelion,7,0.00081,129995,15.10197,860782
3588,brumer,7,0.00081,130002,15.10278,860782
3589,bubilla,7,0.00081,130009,15.10359,860782
3590,buker,7,0.00081,130016,15.10441,860782
3591,bztech1,7,0.00081,130023,15.10522,860782
3592,Canavell,7,0.00081,130030,15.10603,860782
3593,catalinmer,7,0.00081,130037,15.10684,860782
3594,cbeck88,7,0.00081,130044,15.10766,860782
3595,cburbridge,7,0.00081,130051,15.10847,860782
3596,ccremer,7,0.00081,130058,15.10928,860782
3597,Cerberussian,7,0.00081,130065,15.11010,860782
3598,chadeLin,7,0.00081,130072,15.11091,860782
3599,chandanpasunoori,7,0.00081,130079,15.11172,860782
3600,chenpfeisoo,7,0.00081,130086,15.11254,860782
3601,chicknsoup,7,0.00081,130093,15.11335,860782
3602,chinazj,7,0.00081,130100,15.11416,860782
3603,christiangda,7,0.00081,130107,15.11498,860782
3604,christian-korneck,7,0.00081,130114,15.11579,860782
3605,chrsas,7,0.00081,130121,15.11660,860782
3606,cityofships,7,0.00081,130128,15.11742,860782
3607,ckvtvm-arch,7,0.00081,130135,15.11823,860782
3608,ClaudiuPID,7,0.00081,130142,15.11904,860782
3609,clausa20,7,0.00081,130149,15.11986,860782
3610,clee,7,0.00081,130156,15.12067,860782
3611,codinaut,7,0.00081,130163,15.12148,860782
3612,codyseavey,7,0.00081,130170,15.12230,860782
3613,colonwq,7,0.00081,130177,15.12311,860782
3614,corvofeng,7,0.00081,130184,15.12392,860782
3615,coulof,7,0.00081,130191,15.12474,860782
3616,cowwoc,7,0.00081,130198,15.12555,860782
3617,c-pius,7,0.00081,130205,15.12636,860782
3618,Cryptonex7,7,0.00081,130212,15.12718,860782
3619,ctison,7,0.00081,130219,15.12799,860782
3620,CYarros10,7,0.00081,130226,15.12880,860782
3621,cyberpau,7,0.00081,130233,15.12961,860782
3622,cycwll,7,0.00081,130240,15.13043,860782
3623,d46,7,0.00081,130247,15.13124,860782
3624,dad264,7,0.00081,130254,15.13205,860782
3625,dagn0,7,0.00081,130261,15.13287,860782
3626,danjo133,7,0.00081,130268,15.13368,860782
3627,DaveTCode,7,0.00081,130275,15.13449,860782
3628,davidtseng,7,0.00081,130282,15.13531,860782
3629,DavitSo,7,0.00081,130289,15.13612,860782
3630,dchen71,7,0.00081,130296,15.13693,860782
3631,DeamonMV,7,0.00081,130303,15.13775,860782
3632,deccico,7,0.00081,130310,15.13856,860782
3633,deusnefum,7,0.00081,130317,15.13937,860782
3634,devsharma1979,7,0.00081,130324,15.14019,860782
3635,dguendisch,7,0.00081,130331,15.14100,860782
3636,dirathea,7,0.00081,130338,15.14181,860782
3637,dj80hd,7,0.00081,130345,15.14263,860782
3638,djaglowski,7,0.00081,130352,15.14344,860782
3639,djklim87,7,0.00081,130359,15.14425,860782
3640,dlbas,7,0.00081,130366,15.14507,860782
3641,dmaixner,7,0.00081,130373,15.14588,860782
3642,dwaiba,7,0.00081,130380,15.14669,860782
3643,dynamicmindset,7,0.00081,130387,15.14751,860782
3644,ebullient,7,0.00081,130394,15.14832,860782
3645,EdgeXS,7,0.00081,130401,15.14913,860782
3646,elad-yosifon,7,0.00081,130408,15.14995,860782
3647,emichaf,7,0.00081,130415,15.15076,860782
3648,EmoinLanyu,7,0.00081,130422,15.15157,860782
3649,encigem,7,0.00081,130429,15.15238,860782
3650,erbiao3k,7,0.00081,130436,15.15320,860782
3651,eredi93,7,0.00081,130443,15.15401,860782
3652,ergoz,7,0.00081,130450,15.15482,860782
3653,ericwooley,7,0.00081,130457,15.15564,860782
3654,eswdd,7,0.00081,130464,15.15645,860782
3655,evanstucker-hates-2fa,7,0.00081,130471,15.15726,860782
3656,fallion,7,0.00081,130478,15.15808,860782
3657,faseyiks,7,0.00081,130485,15.15889,860782
3658,ffazzini,7,0.00081,130492,15.15970,860782
3659,FireDrunk,7,0.00081,130499,15.16052,860782
3660,Fl0pZz,7,0.00081,130506,15.16133,860782
3661,Flusinerd,7,0.00081,130513,15.16214,860782
3662,FNSdev,7,0.00081,130520,15.16296,860782
3663,Frankgad,7,0.00081,130527,15.16377,860782
3664,FrankYang0529,7,0.00081,130534,15.16458,860782
3665,fredericve,7,0.00081,130541,15.16540,860782
3666,freesnowCL,7,0.00081,130548,15.16621,860782
3667,fukuta-tatsuya-intec,7,0.00081,130555,15.16702,860782
3668,fvigotti,7,0.00081,130562,15.16784,860782
3669,gajus,7,0.00081,130569,15.16865,860782
3670,gaozhekang,7,0.00081,130576,15.16946,860782
3671,garrettlish,7,0.00081,130583,15.17028,860782
3672,gary-lo,7,0.00081,130590,15.17109,860782
3673,getjack,7,0.00081,130597,15.17190,860782
3674,ggpaue,7,0.00081,130604,15.17272,860782
3675,ghglza,7,0.00081,130611,15.17353,860782
3676,gianmarcomurru,7,0.00081,130618,15.17434,860782
3677,GideonStowell,7,0.00081,130625,15.17515,860782
3678,gknepper,7,0.00081,130632,15.17597,860782
3679,gldraphael,7,0.00081,130639,15.17678,860782
3680,golgoth31,7,0.00081,130646,15.17759,860782
3681,gorbondiga,7,0.00081,130653,15.17841,860782
3682,gordonbondon,7,0.00081,130660,15.17922,860782
3683,gregnsk,7,0.00081,130667,15.18003,860782
3684,grissius,7,0.00081,130674,15.18085,860782
3685,gsharm2020,7,0.00081,130681,15.18166,860782
3686,guidoffm,7,0.00081,130688,15.18247,860782
3687,guleng,7,0.00081,130695,15.18329,860782
3688,gunnypatel,7,0.00081,130702,15.18410,860782
3689,gurrpi,7,0.00081,130709,15.18491,860782
3690,gutorc92,7,0.00081,130716,15.18573,860782
3691,gwang550,7,0.00081,130723,15.18654,860782
3692,hadrien-toma,7,0.00081,130730,15.18735,860782
3693,Haiba8,7,0.00081,130737,15.18817,860782
3694,haitang5445,7,0.00081,130744,15.18898,860782
3695,hamiltont,7,0.00081,130751,15.18979,860782
3696,HankTheCrank,7,0.00081,130758,15.19061,860782
3697,happy-machine,7,0.00081,130765,15.19142,860782
3698,haraldng,7,0.00081,130772,15.19223,860782
3699,hardoverflow,7,0.00081,130779,15.19305,860782
3700,harjis,7,0.00081,130786,15.19386,860782
3701,hatharom,7,0.00081,130793,15.19467,860782
3702,hazcod,7,0.00081,130800,15.19549,860782
3703,Hedingber,7,0.00081,130807,15.19630,860782
3704,hien,7,0.00081,130814,15.19711,860782
3705,Hi-Fi,7,0.00081,130821,15.19792,860782
3706,hihihuhu,7,0.00081,130828,15.19874,860782
3707,hojongs,7,0.00081,130835,15.19955,860782
3708,hookak,7,0.00081,130842,15.20036,860782
3709,howarddierking,7,0.00081,130849,15.20118,860782
3710,hryamzik,7,0.00081,130856,15.20199,860782
3711,hutr,7,0.00081,130863,15.20280,860782
3712,ibexmonj,7,0.00081,130870,15.20362,860782
3713,iboware,7,0.00081,130877,15.20443,860782
3714,identitymonk,7,0.00081,130884,15.20524,860782
3715,ijelliti,7,0.00081,130891,15.20606,860782
3716,immanuelfodor,7,0.00081,130898,15.20687,860782
3717,Incarnation-p-lee,7,0.00081,130905,15.20768,860782
3718,ionutbalutoiu,7,0.00081,130912,15.20850,860782
3719,irons,7,0.00081,130919,15.20931,860782
3720,irtaza909,7,0.00081,130926,15.21012,860782
3721,ishigoya,7,0.00081,130933,15.21094,860782
3722,iszhyang,7,0.00081,130940,15.21175,860782
3723,ivomarino,7,0.00081,130947,15.21256,860782
3724,iwwwwwwi,7,0.00081,130954,15.21338,860782
3725,JadeQin,7,0.00081,130961,15.21419,860782
3726,jafferaws,7,0.00081,130968,15.21500,860782
3727,jake15,7,0.00081,130975,15.21582,860782
3728,Jakob3xD,7,0.00081,130982,15.21663,860782
3729,jameOne,7,0.00081,130989,15.21744,860782
3730,jamesorlakin,7,0.00081,130996,15.21826,860782
3731,janaka,7,0.00081,131003,15.21907,860782
3732,JarHMJ,7,0.00081,131010,15.21988,860782
3733,javierlga,7,0.00081,131017,15.22069,860782
3734,jayendra13,7,0.00081,131024,15.22151,860782
3735,jayrajput,7,0.00081,131031,15.22232,860782
3736,jbradleynh,7,0.00081,131038,15.22313,860782
3737,jdallen-a10,7,0.00081,131045,15.22395,860782
3738,jeanpbond,7,0.00081,131052,15.22476,860782
3739,jeff-hillman,7,0.00081,131059,15.22557,860782
3740,jeffrey-hui,7,0.00081,131066,15.22639,860782
3741,jfcg,7,0.00081,131073,15.22720,860782
3742,jfdumont,7,0.00081,131080,15.22801,860782
3743,jhead-slg,7,0.00081,131087,15.22883,860782
3744,jiafujiang,7,0.00081,131094,15.22964,860782
3745,jinseu,7,0.00081,131101,15.23045,860782
3746,jishminor,7,0.00081,131108,15.23127,860782
3747,jjzeng-seattle,7,0.00081,131115,15.23208,860782
3748,jlhuilier-1a,7,0.00081,131122,15.23289,860782
3749,joaosilva15,7,0.00081,131129,15.23371,860782
3750,joconnor-openet,7,0.00081,131136,15.23452,860782
3751,joe-getcouragenow,7,0.00081,131143,15.23533,860782
3752,joel-bluedata,7,0.00081,131150,15.23615,860782
3753,johnlane,7,0.00081,131157,15.23696,860782
3754,JonJagger,7,0.00081,131164,15.23777,860782
3755,jordanrinke,7,0.00081,131171,15.23859,860782
3756,joshti,7,0.00081,131178,15.23940,860782
3757,jrj-d,7,0.00081,131185,15.24021,860782
3758,jrweldon,7,0.00081,131192,15.24103,860782
3759,jsbucy,7,0.00081,131199,15.24184,860782
3760,juanpedromoreno,7,0.00081,131206,15.24265,860782
3761,Juggels,7,0.00081,131213,15.24346,860782
3762,justinkillen,7,0.00081,131220,15.24428,860782
3763,juyiwang7,7,0.00081,131227,15.24509,860782
3764,jwelch92,7,0.00081,131234,15.24590,860782
3765,kaskavalci,7,0.00081,131241,15.24672,860782
3766,kcao3,7,0.00081,131248,15.24753,860782
3767,kd7lxl,7,0.00081,131255,15.24834,860782
3768,kevingentile,7,0.00081,131262,15.24916,860782
3769,kiddingl,7,0.00081,131269,15.24997,860782
3770,kmmanto,7,0.00081,131276,15.25078,860782
3771,korablin,7,0.00081,131283,15.25160,860782
3772,Kristof-Mattei,7,0.00081,131290,15.25241,860782
3773,KristopherKram,7,0.00081,131297,15.25322,860782
3774,kruftik,7,0.00081,131304,15.25404,860782
3775,ksaritek,7,0.00081,131311,15.25485,860782
3776,ksummersill2,7,0.00081,131318,15.25566,860782
3777,kumaranshu72,7,0.00081,131325,15.25648,860782
3778,kunalekawde,7,0.00081,131332,15.25729,860782
3779,lallydd,7,0.00081,131339,15.25810,860782
3780,LandoVMW,7,0.00081,131346,15.25892,860782
3781,laszbalo,7,0.00081,131353,15.25973,860782
3782,laszlocph,7,0.00081,131360,15.26054,860782
3783,ldue,7,0.00081,131367,15.26136,860782
3784,Leeladitya,7,0.00081,131374,15.26217,860782
3785,leiw324,7,0.00081,131381,15.26298,860782
3786,lelandsindttouchnet,7,0.00081,131388,15.26380,860782
3787,Lemmons,7,0.00081,131395,15.26461,860782
3788,Leozhanggg,7,0.00081,131402,15.26542,860782
3789,lexmovrx,7,0.00081,131409,15.26623,860782
3790,lht,7,0.00081,131416,15.26705,860782
3791,li-ang,7,0.00081,131423,15.26786,860782
3792,licaishui88,7,0.00081,131430,15.26867,860782
3793,lightoze,7,0.00081,131437,15.26949,860782
3794,limburgher,7,0.00081,131444,15.27030,860782
3795,linhuisheng,7,0.00081,131451,15.27111,860782
3796,liranmauda,7,0.00081,131458,15.27193,860782
3797,lmm,7,0.00081,131465,15.27274,860782
3798,longwa,7,0.00081,131472,15.27355,860782
3799,loomsen,7,0.00081,131479,15.27437,860782
3800,lopezator,7,0.00081,131486,15.27518,860782
3801,louhde,7,0.00081,131493,15.27599,860782
3802,lpakula,7,0.00081,131500,15.27681,860782
3803,lshmouse,7,0.00081,131507,15.27762,860782
3804,lucbas,7,0.00081,131514,15.27843,860782
3805,LukaszRacon,7,0.00081,131521,15.27925,860782
3806,lyveng,7,0.00081,131528,15.28006,860782
3807,mabouchalkha,7,0.00081,131535,15.28087,860782
3808,machine424,7,0.00081,131542,15.28169,860782
3809,madeinindiadot,7,0.00081,131549,15.28250,860782
3810,madhukar93,7,0.00081,131556,15.28331,860782
3811,majorinche,7,0.00081,131563,15.28413,860782
3812,mapshen,7,0.00081,131570,15.28494,860782
3813,marek-obuchowicz,7,0.00081,131577,15.28575,860782
3814,mariobris,7,0.00081,131584,15.28657,860782
3815,markwangC,7,0.00081,131591,15.28738,860782
3816,markzhang0928,7,0.00081,131598,15.28819,860782
3817,martinjaimem,7,0.00081,131605,15.28900,860782
3818,marvinestreet,7,0.00081,131612,15.28982,860782
3819,mateustanaka,7,0.00081,131619,15.29063,860782
3820,mattfox,7,0.00081,131626,15.29144,860782
3821,MaxRenaud,7,0.00081,131633,15.29226,860782
3822,mboutet,7,0.00081,131640,15.29307,860782
3823,Melissa-lu,7,0.00081,131647,15.29388,860782
3824,metost,7,0.00081,131654,15.29470,860782
3825,mhabicht,7,0.00081,131661,15.29551,860782
3826,MicahDShackelford,7,0.00081,131668,15.29632,860782
3827,Michael-Sinz,7,0.00081,131675,15.29714,860782
3828,michazt,7,0.00081,131682,15.29795,860782
3829,micke,7,0.00081,131689,15.29876,860782
3830,miguelsorianod,7,0.00081,131696,15.29958,860782
3831,mikeccuk2005,7,0.00081,131703,15.30039,860782
3832,milgradesec,7,0.00081,131710,15.30120,860782
3833,MirkoRuggiero,7,0.00081,131717,15.30202,860782
3834,mislavcimpersak,7,0.00081,131724,15.30283,860782
3835,miton18,7,0.00081,131731,15.30364,860782
3836,mitsuthar,7,0.00081,131738,15.30446,860782
3837,mittyorz,7,0.00081,131745,15.30527,860782
3838,mkjoerg,7,0.00081,131752,15.30608,860782
3839,mkjpryor-stfc,7,0.00081,131759,15.30690,860782
3840,mklemann90,7,0.00081,131766,15.30771,860782
3841,mltsy,7,0.00081,131773,15.30852,860782
3842,MMeent,7,0.00081,131780,15.30934,860782
3843,mmiranda,7,0.00081,131787,15.31015,860782
3844,MohamedTalhaoui,7,0.00081,131794,15.31096,860782
3845,mohideen,7,0.00081,131801,15.31177,860782
3846,mooperd,7,0.00081,131808,15.31259,860782
3847,mootezbessifi,7,0.00081,131815,15.31340,860782
3848,morhook,7,0.00081,131822,15.31421,860782
3849,mprzygrodzki,7,0.00081,131829,15.31503,860782
3850,MRamos62786,7,0.00081,131836,15.31584,860782
3851,mrparkers,7,0.00081,131843,15.31665,860782
3852,mrudangit,7,0.00081,131850,15.31747,860782
3853,MrZhaoAtBJ,7,0.00081,131857,15.31828,860782
3854,mscrivo,7,0.00081,131864,15.31909,860782
3855,mseiwald,7,0.00081,131871,15.31991,860782
3856,mtsmfm,7,0.00081,131878,15.32072,860782
3857,murat-kilic,7,0.00081,131885,15.32153,860782
3858,murphpdx,7,0.00081,131892,15.32235,860782
3859,m-yosefpor,7,0.00081,131899,15.32316,860782
3860,NamikoToriyama,7,0.00081,131906,15.32397,860782
3861,nareshnayini,7,0.00081,131913,15.32479,860782
3862,nblumhardt,7,0.00081,131920,15.32560,860782
3863,ncepuwanghui,7,0.00081,131927,15.32641,860782
3864,neil-n-brown,7,0.00081,131934,15.32723,860782
3865,NerdSec,7,0.00081,131941,15.32804,860782
3866,netflash,7,0.00081,131948,15.32885,860782
3867,newly12,7,0.00081,131955,15.32967,860782
3868,newtoworld999,7,0.00081,131962,15.33048,860782
3869,nfd9001,7,0.00081,131969,15.33129,860782
3870,NickMetz,7,0.00081,131976,15.33210,860782
3871,NickyBoy89,7,0.00081,131983,15.33292,860782
3872,nikitakalyanov,7,0.00081,131990,15.33373,860782
3873,nilsboeh,7,0.00081,131997,15.33454,860782
3874,nishaad78,7,0.00081,132004,15.33536,860782
3875,njoaquim,7,0.00081,132011,15.33617,860782
3876,njtman,7,0.00081,132018,15.33698,860782
3877,nkiraly,7,0.00081,132025,15.33780,860782
3878,nnt1054,7,0.00081,132032,15.33861,860782
3879,nnz1024,7,0.00081,132039,15.33942,860782
3880,noah-de,7,0.00081,132046,15.34024,860782
3881,nreddipalle,7,0.00081,132053,15.34105,860782
3882,nsoubelet,7,0.00081,132060,15.34186,860782
3883,nyarly,7,0.00081,132067,15.34268,860782
3884,oana-s,7,0.00081,132074,15.34349,860782
3885,Okabe-Kurisu,7,0.00081,132081,15.34430,860782
3886,olakunleoladimeji,7,0.00081,132088,15.34512,860782
3887,olivierots,7,0.00081,132095,15.34593,860782
3888,onlynone,7,0.00081,132102,15.34674,860782
3889,opcache,7,0.00081,132109,15.34756,860782
3890,OpsPita,7,0.00081,132116,15.34837,860782
3891,orefalo,7,0.00081,132123,15.34918,860782
3892,oyb001,7,0.00081,132130,15.35000,860782
3893,ozanminez,7,0.00081,132137,15.35081,860782
3894,paleozogt,7,0.00081,132144,15.35162,860782
3895,pankajgavit,7,0.00081,132151,15.35244,860782
3896,parkee,7,0.00081,132158,15.35325,860782
3897,pascal-hofmann,7,0.00081,132165,15.35406,860782
3898,pauloduartepinho,7,0.00081,132172,15.35487,860782
3899,paulosjca,7,0.00081,132179,15.35569,860782
3900,pchico83,7,0.00081,132186,15.35650,860782
3901,pengdu30,7,0.00081,132193,15.35731,860782
3902,perret34,7,0.00081,132200,15.35813,860782
3903,phantomlsh,7,0.00081,132207,15.35894,860782
3904,philomory,7,0.00081,132214,15.35975,860782
3905,PierreC1024,7,0.00081,132221,15.36057,860782
3906,pietervincken,7,0.00081,132228,15.36138,860782
3907,piyush0609,7,0.00081,132235,15.36219,860782
3908,Point-less,7,0.00081,132242,15.36301,860782
3909,polarathene,7,0.00081,132249,15.36382,860782
3910,polygonhell,7,0.00081,132256,15.36463,860782
3911,povils,7,0.00081,132263,15.36545,860782
3912,pranshu-s18,7,0.00081,132270,15.36626,860782
3913,prydin,7,0.00081,132277,15.36707,860782
3914,Psykepro,7,0.00081,132284,15.36789,860782
3915,pururaj1908,7,0.00081,132291,15.36870,860782
3916,pynandan,7,0.00081,132298,15.36951,860782
3917,qinggniq,7,0.00081,132305,15.37033,860782
3918,qq843700497,7,0.00081,132312,15.37114,860782
3919,qqbuby,7,0.00081,132319,15.37195,860782
3920,qrr1995,7,0.00081,132326,15.37277,860782
3921,r4mbo7,7,0.00081,132333,15.37358,860782
3922,rahulrai-in,7,0.00081,132340,15.37439,860782
3923,Rajalakshmi-Girish,7,0.00081,132347,15.37521,860782
3924,rakhbari,7,0.00081,132354,15.37602,860782
3925,raonitimo,7,0.00081,132361,15.37683,860782
3926,RashaHaj,7,0.00081,132368,15.37764,860782
3927,raunakkumar,7,0.00081,132375,15.37846,860782
3928,realnikhilkumar,7,0.00081,132382,15.37927,860782
3929,reneklootwijk,7,0.00081,132389,15.38008,860782
3930,rjdp,7,0.00081,132396,15.38090,860782
3931,Robinsir,7,0.00081,132403,15.38171,860782
3932,roeera,7,0.00081,132410,15.38252,860782
3933,roligupt,7,0.00081,132417,15.38334,860782
3934,RomanDvorsky,7,0.00081,132424,15.38415,860782
3935,roman-geraskin,7,0.00081,132431,15.38496,860782
3936,ronald,7,0.00081,132438,15.38578,860782
3937,roysha1,7,0.00081,132445,15.38659,860782
3938,rsmolins,7,0.00081,132452,15.38740,860782
3939,ruccoon,7,0.00081,132459,15.38822,860782
3940,ruchirvaninasdaq,7,0.00081,132466,15.38903,860782
3941,rvirdiz,7,0.00081,132473,15.38984,860782
3942,rvmzes,7,0.00081,132480,15.39066,860782
3943,ryphon,7,0.00081,132487,15.39147,860782
3944,RyuCaelum,7,0.00081,132494,15.39228,860782
3945,sadoMasupilami,7,0.00081,132501,15.39310,860782
3946,sadovnikov,7,0.00081,132508,15.39391,860782
3947,sagarvilas,7,0.00081,132515,15.39472,860782
3948,saitoy1,7,0.00081,132522,15.39554,860782
3949,sami-alajrami,7,0.00081,132529,15.39635,860782
3950,Sami-svmx,7,0.00081,132536,15.39716,860782
3951,samsalisbury,7,0.00081,132543,15.39798,860782
3952,sarabjeetdhawan,7,0.00081,132550,15.39879,860782
3953,sasadangelo,7,0.00081,132557,15.39960,860782
3954,SAZZ1313,7,0.00081,132564,15.40041,860782
3955,scallopboat,7,0.00081,132571,15.40123,860782
3956,scottrobertson,7,0.00081,132578,15.40204,860782
3957,sdarwin,7,0.00081,132585,15.40285,860782
3958,sean-quinn,7,0.00081,132592,15.40367,860782
3959,sebbrandt87,7,0.00081,132599,15.40448,860782
3960,segevfiner,7,0.00081,132606,15.40529,860782
3961,Seitanas,7,0.00081,132613,15.40611,860782
3962,senique,7,0.00081,132620,15.40692,860782
3963,serut,7,0.00081,132627,15.40773,860782
3964,sfllaw,7,0.00081,132634,15.40855,860782
3965,sharuk123,7,0.00081,132641,15.40936,860782
3966,shashank-g172,7,0.00081,132648,15.41017,860782
3967,shikha0208,7,0.00081,132655,15.41099,860782
3968,shmsr,7,0.00081,132662,15.41180,860782
3969,sid-agrawal,7,0.00081,132669,15.41261,860782
3970,Silvanoc,7,0.00081,132676,15.41343,860782
3971,simu,7,0.00081,132683,15.41424,860782
3972,sinall,7,0.00081,132690,15.41505,860782
3973,singh-brajesh247,7,0.00081,132697,15.41587,860782
3974,sjmiller609,7,0.00081,132704,15.41668,860782
3975,skandix,7,0.00081,132711,15.41749,860782
3976,SmiffyJ,7,0.00081,132718,15.41831,860782
3977,smira,7,0.00081,132725,15.41912,860782
3978,sober-wang,7,0.00081,132732,15.41993,860782
3979,songjiayang,7,0.00081,132739,15.42075,860782
3980,soorya79,7,0.00081,132746,15.42156,860782
3981,SpeedEX,7,0.00081,132753,15.42237,860782
3982,spetrashov,7,0.00081,132760,15.42318,860782
3983,sporykhin,7,0.00081,132767,15.42400,860782
3984,sreejit-a,7,0.00081,132774,15.42481,860782
3985,ssurovich,7,0.00081,132781,15.42562,860782
3986,stacktasec,7,0.00081,132788,15.42644,860782
3987,StefanSa,7,0.00081,132795,15.42725,860782
3988,stevef1uk,7,0.00081,132802,15.42806,860782
3989,stevenshuang,7,0.00081,132809,15.42888,860782
3990,steveteuber,7,0.00081,132816,15.42969,860782
3991,stoader,7,0.00081,132823,15.43050,860782
3992,stoiev,7,0.00081,132830,15.43132,860782
3993,sudarshntn,7,0.00081,132837,15.43213,860782
3994,sudhirjangir,7,0.00081,132844,15.43294,860782
3995,sumankumarz,7,0.00081,132851,15.43376,860782
3996,suzuki-shunsuke,7,0.00081,132858,15.43457,860782
3997,sverch,7,0.00081,132865,15.43538,860782
3998,swamymsft,7,0.00081,132872,15.43620,860782
3999,swarkentin,7,0.00081,132879,15.43701,860782
4000,swhan91,7,0.00081,132886,15.43782,860782
4001,sxb12345,7,0.00081,132893,15.43864,860782
4002,tagantroy,7,0.00081,132900,15.43945,860782
4003,tahirali-endurance,7,0.00081,132907,15.44026,860782
4004,terrificdm,7,0.00081,132914,15.44108,860782
4005,tgdfool2,7,0.00081,132921,15.44189,860782
4006,tharrold,7,0.00081,132928,15.44270,860782
4007,ThatAIXGuy,7,0.00081,132935,15.44352,860782
4008,TheYkk,7,0.00081,132942,15.44433,860782
4009,ThisIsQasim,7,0.00081,132949,15.44514,860782
4010,thomasetter,7,0.00081,132956,15.44595,860782
4011,thomasfrederikhoeck,7,0.00081,132963,15.44677,860782
4012,threestoneliu,7,0.00081,132970,15.44758,860782
4013,tinproject,7,0.00081,132977,15.44839,860782
4014,tjamet,7,0.00081,132984,15.44921,860782
4015,tmehlinger,7,0.00081,132991,15.45002,860782
4016,tmeneau,7,0.00081,132998,15.45083,860782
4017,tmrekk121,7,0.00081,133005,15.45165,860782
4018,tobiasbp,7,0.00081,133012,15.45246,860782
4019,tom1299,7,0.00081,133019,15.45327,860782
4020,TomaszKlosinski,7,0.00081,133026,15.45409,860782
4021,tomfaulhaber,7,0.00081,133033,15.45490,860782
4022,tomstreet,7,0.00081,133040,15.45571,860782
4023,Toper2035,7,0.00081,133047,15.45653,860782
4024,Topographic0cean,7,0.00081,133054,15.45734,860782
4025,tristanlins,7,0.00081,133061,15.45815,860782
4026,tschirmer,7,0.00081,133068,15.45897,860782
4027,tseelbach,7,0.00081,133075,15.45978,860782
4028,tsthght,7,0.00081,133082,15.46059,860782
4029,tunoat,7,0.00081,133089,15.46141,860782
4030,Tyrrrz,7,0.00081,133096,15.46222,860782
4031,ucabsdp,7,0.00081,133103,15.46303,860782
4032,udit249,7,0.00081,133110,15.46385,860782
4033,UlyssesCB,7,0.00081,133117,15.46466,860782
4034,umezawatakeshi,7,0.00081,133124,15.46547,860782
4035,umialpha,7,0.00081,133131,15.46629,860782
4036,varun-krishna,7,0.00081,133138,15.46710,860782
4037,Vascko,7,0.00081,133145,15.46791,860782
4038,VassoSof,7,0.00081,133152,15.46872,860782
4039,veronicagarciavazquez,7,0.00081,133159,15.46954,860782
4040,Vexet83,7,0.00081,133166,15.47035,860782
4041,victorfrancax1,7,0.00081,133173,15.47116,860782
4042,VihanAgarwal97,7,0.00081,133180,15.47198,860782
4043,vijayk13,7,0.00081,133187,15.47279,860782
4044,vikas4cloud,7,0.00081,133194,15.47360,860782
4045,Vishwanath-GitHub,7,0.00081,133201,15.47442,860782
4046,vlinevych,7,0.00081,133208,15.47523,860782
4047,vlsi,7,0.00081,133215,15.47604,860782
4048,Vohz,7,0.00081,133222,15.47686,860782
4049,vsaibinaysoma,7,0.00081,133229,15.47767,860782
4050,vugardzhamalov,7,0.00081,133236,15.47848,860782
4051,vutkin,7,0.00081,133243,15.47930,860782
4052,wasker,7,0.00081,133250,15.48011,860782
4053,wcjohnson,7,0.00081,133257,15.48092,860782
4054,wdalmut,7,0.00081,133264,15.48174,860782
4055,wdullaer,7,0.00081,133271,15.48255,860782
4056,webees,7,0.00081,133278,15.48336,860782
4057,weiranzhixin,7,0.00081,133285,15.48418,860782
4058,whoan,7,0.00081,133292,15.48499,860782
4059,Whyeasy,7,0.00081,133299,15.48580,860782
4060,windniw,7,0.00081,133306,15.48662,860782
4061,wnagele,7,0.00081,133313,15.48743,860782
4062,wuzhuoqing,7,0.00081,133320,15.48824,860782
4063,xiaochenluo,7,0.00081,133327,15.48906,860782
4064,XinLin,7,0.00081,133334,15.48987,860782
4065,xixi-A,7,0.00081,133341,15.49068,860782
4066,xkbarkar,7,0.00081,133348,15.49149,860782
4067,xuboom,7,0.00081,133355,15.49231,860782
4068,yankeexe,7,0.00081,133362,15.49312,860782
4069,yanshao373,7,0.00081,133369,15.49393,860782
4070,yeganeahmadnejad,7,0.00081,133376,15.49475,860782
4071,yelhouti,7,0.00081,133383,15.49556,860782
4072,ygapon-mio,7,0.00081,133390,15.49637,860782
4073,YiniXu9506,7,0.00081,133397,15.49719,860782
4074,yiwenshao,7,0.00081,133404,15.49800,860782
4075,ykvichare,7,0.00081,133411,15.49881,860782
4076,ylhyh,7,0.00081,133418,15.49963,860782
4077,YngwieWang,7,0.00081,133425,15.50044,860782
4078,yogeshkk,7,0.00081,133432,15.50125,860782
4079,YoshieraHuang,7,0.00081,133439,15.50207,860782
4080,YourPsychiatrist,7,0.00081,133446,15.50288,860782
4081,ysksuzuki,7,0.00081,133453,15.50369,860782
4082,yupvr,7,0.00081,133460,15.50451,860782
4083,yuyiying,7,0.00081,133467,15.50532,860782
4084,zagaria,7,0.00081,133474,15.50613,860782
4085,zamnuts,7,0.00081,133481,15.50695,860782
4086,zhengyi,7,0.00081,133488,15.50776,860782
4087,ZhuGongpu,7,0.00081,133495,15.50857,860782
4088,zoramthanga,7,0.00081,133502,15.50939,860782
4089,zzzkl,7,0.00081,133509,15.51020,860782
4090,0x0I,6,0.00070,133515,15.51090,860782
4091,0x9060,6,0.00070,133521,15.51159,860782
4092,2637309949,6,0.00070,133527,15.51229,860782
4093,2dev2,6,0.00070,133533,15.51299,860782
4094,4integration,6,0.00070,133539,15.51368,860782
4095,AaronKalair,6,0.00070,133545,15.51438,860782
4096,Abhishek1121-tech,6,0.00070,133551,15.51508,860782
4097,abyth,6,0.00070,133557,15.51578,860782
4098,acharaj,6,0.00070,133563,15.51647,860782
4099,acheraime,6,0.00070,133569,15.51717,860782
4100,AdamGS,6,0.00070,133575,15.51787,860782
4101,adamko147,6,0.00070,133581,15.51856,860782
4102,adamstirk-ct,6,0.00070,133587,15.51926,860782
4103,adityasaxena88,6,0.00070,133593,15.51996,860782
4104,adrian-gierakowski,6,0.00070,133599,15.52065,860782
4105,ahachete,6,0.00070,133605,15.52135,860782
4106,ahurtaud,6,0.00070,133611,15.52205,860782
4107,ailox,6,0.00070,133617,15.52275,860782
4108,ajaykmis,6,0.00070,133623,15.52344,860782
4109,ajizkai,6,0.00070,133629,15.52414,860782
4110,akhil-rane,6,0.00070,133635,15.52484,860782
4111,aksenk,6,0.00070,133641,15.52553,860782
4112,akshatgit,6,0.00070,133647,15.52623,860782
4113,akshat-kmr,6,0.00070,133653,15.52693,860782
4114,alaa,6,0.00070,133659,15.52762,860782
4115,albertyfwu,6,0.00070,133665,15.52832,860782
4116,aleksey005,6,0.00070,133671,15.52902,860782
4117,alexanderscott,6,0.00070,133677,15.52972,860782
4118,AlexanderThaller,6,0.00070,133683,15.53041,860782
4119,AlexandreRoba,6,0.00070,133689,15.53111,860782
4120,alex-gab,6,0.00070,133695,15.53181,860782
4121,aleybovich,6,0.00070,133701,15.53250,860782
4122,alifpay,6,0.00070,133707,15.53320,860782
4123,alipatton10,6,0.00070,133713,15.53390,860782
4124,alpire,6,0.00070,133719,15.53460,860782
4125,alter,6,0.00070,133725,15.53529,860782
4126,Alxspb,6,0.00070,133731,15.53599,860782
4127,alyzidi222,6,0.00070,133737,15.53669,860782
4128,ambarishg,6,0.00070,133743,15.53738,860782
4129,amirschw,6,0.00070,133749,15.53808,860782
4130,andelhie,6,0.00070,133755,15.53878,860782
4131,andersonkxiass,6,0.00070,133761,15.53947,860782
4132,andreicojocaru,6,0.00070,133767,15.54017,860782
4133,AndrewDryga,6,0.00070,133773,15.54087,860782
4134,andrewrotherham,6,0.00070,133779,15.54157,860782
4135,andrew-teirney,6,0.00070,133785,15.54226,860782
4136,andrew-whiriskey,6,0.00070,133791,15.54296,860782
4137,AndreyUtka,6,0.00070,133797,15.54366,860782
4138,andrisak,6,0.00070,133803,15.54435,860782
4139,andro-ajp,6,0.00070,133809,15.54505,860782
4140,andyadamides,6,0.00070,133815,15.54575,860782
4141,andyliumstar,6,0.00070,133821,15.54644,860782
4142,andyyumiao,6,0.00070,133827,15.54714,860782
4143,anekar10,6,0.00070,133833,15.54784,860782
4144,angulito,6,0.00070,133839,15.54854,860782
4145,Anjingkegui,6,0.00070,133845,15.54923,860782
4146,ankitsrao,6,0.00070,133851,15.54993,860782
4147,Annih,6,0.00070,133857,15.55063,860782
4148,anthonynsimon,6,0.00070,133863,15.55132,860782
4149,AntonNep,6,0.00070,133869,15.55202,860782
4150,AntonSmolkov,6,0.00070,133875,15.55272,860782
4151,antranvn,6,0.00070,133881,15.55342,860782
4152,anupash147,6,0.00070,133887,15.55411,860782
4153,apmasell,6,0.00070,133893,15.55481,860782
4154,appunni-dishq,6,0.00070,133899,15.55551,860782
4155,AqD,6,0.00070,133905,15.55620,860782
4156,arafato,6,0.00070,133911,15.55690,860782
4157,arahayrabedian,6,0.00070,133917,15.55760,860782
4158,arcana261,6,0.00070,133923,15.55829,860782
4159,ArchangelX360,6,0.00070,133929,15.55899,860782
4160,ArmaanT,6,0.00070,133935,15.55969,860782
4161,arnonki,6,0.00070,133941,15.56039,860782
4162,artiship,6,0.00070,133947,15.56108,860782
4163,arugal,6,0.00070,133953,15.56178,860782
4164,asatish,6,0.00070,133959,15.56248,860782
4165,ashish202,6,0.00070,133965,15.56317,860782
4166,ashishsecdev,6,0.00070,133971,15.56387,860782
4167,ashishsingh700,6,0.00070,133977,15.56457,860782
4168,ashokc27,6,0.00070,133983,15.56527,860782
4169,asoltesz,6,0.00070,133989,15.56596,860782
4170,atkinson137,6,0.00070,133995,15.56666,860782
4171,atoom,6,0.00070,134001,15.56736,860782
4172,atoptsoglou,6,0.00070,134007,15.56805,860782
4173,audunsol,6,0.00070,134013,15.56875,860782
4174,avenda,6,0.00070,134019,15.56945,860782
4175,azman0101,6,0.00070,134025,15.57014,860782
4176,baliame,6,0.00070,134031,15.57084,860782
4177,balonik,6,0.00070,134037,15.57154,860782
4178,bananabele,6,0.00070,134043,15.57224,860782
4179,base698,6,0.00070,134049,15.57293,860782
4180,batiati,6,0.00070,134055,15.57363,860782
4181,bausano,6,0.00070,134061,15.57433,860782
4182,bcaton85,6,0.00070,134067,15.57502,860782
4183,Beardface123,6,0.00070,134073,15.57572,860782
4184,ben-crowhurst,6,0.00070,134079,15.57642,860782
4185,benjamin-wright,6,0.00070,134085,15.57711,860782
4186,benjojo,6,0.00070,134091,15.57781,860782
4187,bewing,6,0.00070,134097,15.57851,860782
4188,binkkatal,6,0.00070,134103,15.57921,860782
4189,biskit,6,0.00070,134109,15.57990,860782
4190,bittner,6,0.00070,134115,15.58060,860782
4191,biwwy0,6,0.00070,134121,15.58130,860782
4192,blackjackyau,6,0.00070,134127,15.58199,860782
4193,blastdan,6,0.00070,134133,15.58269,860782
4194,bloudman,6,0.00070,134139,15.58339,860782
4195,bmgeek,6,0.00070,134145,15.58409,860782
4196,bmorelli25,6,0.00070,134151,15.58478,860782
4197,boostchicken,6,0.00070,134157,15.58548,860782
4198,Booster2ooo,6,0.00070,134163,15.58618,860782
4199,boraozkan,6,0.00070,134169,15.58687,860782
4200,bradwood,6,0.00070,134175,15.58757,860782
4201,brandong954,6,0.00070,134181,15.58827,860782
4202,bravitejareddy,6,0.00070,134187,15.58896,860782
4203,brazooka,6,0.00070,134193,15.58966,860782
4204,breizh5729,6,0.00070,134199,15.59036,860782
4205,bretagne-peiqi,6,0.00070,134205,15.59106,860782
4206,brettjenkins,6,0.00070,134211,15.59175,860782
4207,brianoh,6,0.00070,134217,15.59245,860782
4208,briend,6,0.00070,134223,15.59315,860782
4209,britcey,6,0.00070,134229,15.59384,860782
4210,bs444,6,0.00070,134235,15.59454,860782
4211,bvarner,6,0.00070,134241,15.59524,860782
4212,bycEEE,6,0.00070,134247,15.59593,860782
4213,cainzhong,6,0.00070,134253,15.59663,860782
4214,cakecatz,6,0.00070,134259,15.59733,860782
4215,calebwoofenden,6,0.00070,134265,15.59803,860782
4216,canberkkoc,6,0.00070,134271,15.59872,860782
4217,caneGuy,6,0.00070,134277,15.59942,860782
4218,cardil,6,0.00070,134283,15.60012,860782
4219,carstenkoester,6,0.00070,134289,15.60081,860782
4220,cccs-cat001,6,0.00070,134295,15.60151,860782
4221,cfmack,6,0.00070,134301,15.60221,860782
4222,Champ-Goblem,6,0.00070,134307,15.60291,860782
4223,charneykaye,6,0.00070,134313,15.60360,860782
4224,chemikadze,6,0.00070,134319,15.60430,860782
4225,chensp0668,6,0.00070,134325,15.60500,860782
4226,chenzhihao,6,0.00070,134331,15.60569,860782
4227,chewrocca,6,0.00070,134337,15.60639,860782
4228,chiducaf,6,0.00070,134343,15.60709,860782
4229,ChiefInnovator,6,0.00070,134349,15.60778,860782
4230,chornlgscout,6,0.00070,134355,15.60848,860782
4231,ChrisJBurns,6,0.00070,134361,15.60918,860782
4232,chrislusf,6,0.00070,134367,15.60988,860782
4233,chris-parker-za,6,0.00070,134373,15.61057,860782
4234,christianjoun,6,0.00070,134379,15.61127,860782
4235,ChristofSchwarz,6,0.00070,134385,15.61197,860782
4236,chriswells0,6,0.00070,134391,15.61266,860782
4237,chukka,6,0.00070,134397,15.61336,860782
4238,chuonglh,6,0.00070,134403,15.61406,860782
4239,cindykimxp,6,0.00070,134409,15.61475,860782
4240,ckranz,6,0.00070,134415,15.61545,860782
4241,clearday4,6,0.00070,134421,15.61615,860782
4242,clemi2408,6,0.00070,134427,15.61685,860782
4243,cmeans,6,0.00070,134433,15.61754,860782
4244,codeaprendiz,6,0.00070,134439,15.61824,860782
4245,CoderPoet,6,0.00070,134445,15.61894,860782
4246,colltoaction,6,0.00070,134451,15.61963,860782
4247,ComradeAkko,6,0.00070,134457,15.62033,860782
4248,connect2satz,6,0.00070,134463,15.62103,860782
4249,cxt90730,6,0.00070,134469,15.62173,860782
4250,d2r2,6,0.00070,134475,15.62242,860782
4251,dackroyd,6,0.00070,134481,15.62312,860782
4252,daddonpa,6,0.00070,134487,15.62382,860782
4253,DanielFallon,6,0.00070,134493,15.62451,860782
4254,DanielHabenicht,6,0.00070,134499,15.62521,860782
4255,danielyaa5,6,0.00070,134505,15.62591,860782
4256,dannyburke1,6,0.00070,134511,15.62660,860782
4257,danopia,6,0.00070,134517,15.62730,860782
4258,darksied9x,6,0.00070,134523,15.62800,860782
4259,darsh-b88,6,0.00070,134529,15.62870,860782
4260,david-enli,6,0.00070,134535,15.62939,860782
4261,davidham,6,0.00070,134541,15.63009,860782
4262,davidpasztor,6,0.00070,134547,15.63079,860782
4263,davis-gomes,6,0.00070,134553,15.63148,860782
4264,dboyleitrs,6,0.00070,134559,15.63218,860782
4265,ddevault,6,0.00070,134565,15.63288,860782
4266,dedyks,6,0.00070,134571,15.63358,860782
4267,deedf,6,0.00070,134577,15.63427,860782
4268,Deepak-Pandey,6,0.00070,134583,15.63497,860782
4269,Deeps-1989,6,0.00070,134589,15.63567,860782
4270,DekelMalul,6,0.00070,134595,15.63636,860782
4271,Dentrax,6,0.00070,134601,15.63706,860782
4272,dery168,6,0.00070,134607,15.63776,860782
4273,dhouhamaa,6,0.00070,134613,15.63845,860782
4274,dian-xh,6,0.00070,134619,15.63915,860782
4275,didentifier,6,0.00070,134625,15.63985,860782
4276,dionysius,6,0.00070,134631,15.64055,860782
4277,disfluxly,6,0.00070,134637,15.64124,860782
4278,divolgin,6,0.00070,134643,15.64194,860782
4279,djpbessems,6,0.00070,134649,15.64264,860782
4280,dkrizic,6,0.00070,134655,15.64333,860782
4281,dmarkhas,6,0.00070,134661,15.64403,860782
4282,dmilde,6,0.00070,134667,15.64473,860782
4283,Dominik2000,6,0.00070,134673,15.64542,860782
4284,dominiquehunziker,6,0.00070,134679,15.64612,860782
4285,dongdaoguang,6,0.00070,134685,15.64682,860782
4286,DP19,6,0.00070,134691,15.64752,860782
4287,drewbitt,6,0.00070,134697,15.64821,860782
4288,Drtuna,6,0.00070,134703,15.64891,860782
4289,dsever,6,0.00070,134709,15.64961,860782
4290,dumlutimuralp,6,0.00070,134715,15.65030,860782
4291,duncanhall,6,0.00070,134721,15.65100,860782
4292,dwiner,6,0.00070,134727,15.65170,860782
4293,dwschulze,6,0.00070,134733,15.65240,860782
4294,Dyllaann,6,0.00070,134739,15.65309,860782
4295,ebeigarts,6,0.00070,134745,15.65379,860782
4296,edemen,6,0.00070,134751,15.65449,860782
4297,edobry,6,0.00070,134757,15.65518,860782
4298,edyu,6,0.00070,134763,15.65588,860782
4299,eiswind,6,0.00070,134769,15.65658,860782
4300,EItanya,6,0.00070,134775,15.65727,860782
4301,EKwongChum,6,0.00070,134781,15.65797,860782
4302,ElisaMeng,6,0.00070,134787,15.65867,860782
4303,elmartinno,6,0.00070,134793,15.65937,860782
4304,embcla,6,0.00070,134799,15.66006,860782
4305,EraYaN,6,0.00070,134805,15.66076,860782
4306,erhhung,6,0.00070,134811,15.66146,860782
4307,ericlin0101,6,0.00070,134817,15.66215,860782
4308,erikcostlow,6,0.00070,134823,15.66285,860782
4309,ErrReporter,6,0.00070,134829,15.66355,860782
4310,Escaflow,6,0.00070,134835,15.66424,860782
4311,Eslamanwar,6,0.00070,134841,15.66494,860782
4312,Evendger,6,0.00070,134847,15.66564,860782
4313,evil-dog,6,0.00070,134853,15.66634,860782
4314,evnsio,6,0.00070,134859,15.66703,860782
4315,excavador,6,0.00070,134865,15.66773,860782
4316,eyakimov-bbg,6,0.00070,134871,15.66843,860782
4317,f41gh7,6,0.00070,134877,15.66912,860782
4318,FakeNameSE,6,0.00070,134883,15.66982,860782
4319,FarhadF,6,0.00070,134889,15.67052,860782
4320,felpasl,6,0.00070,134895,15.67122,860782
4321,fengpf,6,0.00070,134901,15.67191,860782
4322,fernandokarnagi,6,0.00070,134907,15.67261,860782
4323,FernFerret,6,0.00070,134913,15.67331,860782
4324,ferrandinand,6,0.00070,134919,15.67400,860782
4325,FilBot3,6,0.00070,134925,15.67470,860782
4326,FillZpp,6,0.00070,134931,15.67540,860782
4327,fireba11,6,0.00070,134937,15.67609,860782
4328,flaviamissi,6,0.00070,134943,15.67679,860782
4329,fooevr,6,0.00070,134949,15.67749,860782
4330,forsberg,6,0.00070,134955,15.67819,860782
4331,Fossil01,6,0.00070,134961,15.67888,860782
4332,foxdalas,6,0.00070,134967,15.67958,860782
4333,froggyling,6,0.00070,134973,15.68028,860782
4334,fsckzy,6,0.00070,134979,15.68097,860782
4335,fyangd,6,0.00070,134985,15.68167,860782
4336,g4njawizard,6,0.00070,134991,15.68237,860782
4337,Gandem,6,0.00070,134997,15.68306,860782
4338,GaneshKumarKannan,6,0.00070,135003,15.68376,860782
4339,gangadharmgithub,6,0.00070,135009,15.68446,860782
4340,garretwilson,6,0.00070,135015,15.68516,860782
4341,garrmark,6,0.00070,135021,15.68585,860782
4342,Gatsby-Lee,6,0.00070,135027,15.68655,860782
4343,gball14,6,0.00070,135033,15.68725,860782
4344,gburek-fastly,6,0.00070,135039,15.68794,860782
4345,gecgooden,6,0.00070,135045,15.68864,860782
4346,geekette86,6,0.00070,135051,15.68934,860782
4347,gendolf3d,6,0.00070,135057,15.69004,860782
4348,GeorgeGuo2018,6,0.00070,135063,15.69073,860782
4349,gionapaolini,6,0.00070,135069,15.69143,860782
4350,GiottoLee,6,0.00070,135075,15.69213,860782
4351,gitkent,6,0.00070,135081,15.69282,860782
4352,gitOlf,6,0.00070,135087,15.69352,860782
4353,gladdiologist,6,0.00070,135093,15.69422,860782
4354,gmehrotr,6,0.00070,135099,15.69491,860782
4355,gophobic,6,0.00070,135105,15.69561,860782
4356,gorantornqvist,6,0.00070,135111,15.69631,860782
4357,gotliuyan,6,0.00070,135117,15.69701,860782
4358,grantstephens,6,0.00070,135123,15.69770,860782
4359,gregbacchus,6,0.00070,135129,15.69840,860782
4360,grksharma999,6,0.00070,135135,15.69910,860782
4361,Grovespaz,6,0.00070,135141,15.69979,860782
4362,gugahoa,6,0.00070,135147,15.70049,860782
4363,guillaumelecerf,6,0.00070,135153,15.70119,860782
4364,guyradford,6,0.00070,135159,15.70189,860782
4365,h4wkmoon,6,0.00070,135165,15.70258,860782
4366,HackRanger,6,0.00070,135171,15.70328,860782
4367,Hakob,6,0.00070,135177,15.70398,860782
4368,hanabi1224,6,0.00070,135183,15.70467,860782
4369,Hansen1-ELS,6,0.00070,135189,15.70537,860782
4370,hanyouqing,6,0.00070,135195,15.70607,860782
4371,harmful1980,6,0.00070,135201,15.70676,860782
4372,harrison-kim,6,0.00070,135207,15.70746,860782
4373,hatzhang,6,0.00070,135213,15.70816,860782
4374,havenp,6,0.00070,135219,15.70886,860782
4375,hdnn,6,0.00070,135225,15.70955,860782
4376,HeavyHorst,6,0.00070,135231,15.71025,860782
4377,hectoralicea,6,0.00070,135237,15.71095,860782
4378,hehechen,6,0.00070,135243,15.71164,860782
4379,hellerve,6,0.00070,135249,15.71234,860782
4380,hellogdc,6,0.00070,135255,15.71304,860782
4381,hennersz,6,0.00070,135261,15.71373,860782
4382,heyaWorld,6,0.00070,135267,15.71443,860782
4383,hhollenstain,6,0.00070,135273,15.71513,860782
4384,hickeng,6,0.00070,135279,15.71583,860782
4385,hikimochi,6,0.00070,135285,15.71652,860782
4386,hjmodi,6,0.00070,135291,15.71722,860782
4387,HorseLuke,6,0.00070,135297,15.71792,860782
4388,huangleilz,6,0.00070,135303,15.71861,860782
4389,husoule,6,0.00070,135309,15.71931,860782
4390,huynhthanhbinh,6,0.00070,135315,15.72001,860782
4391,hylitjob,6,0.00070,135321,15.72071,860782
4392,iamaverrick,6,0.00070,135327,15.72140,860782
4393,iamejboy,6,0.00070,135333,15.72210,860782
4394,iamsoorya,6,0.00070,135339,15.72280,860782
4395,ianks,6,0.00070,135345,15.72349,860782
4396,ianvari,6,0.00070,135351,15.72419,860782
4397,iblackman,6,0.00070,135357,15.72489,860782
4398,igcherkaev,6,0.00070,135363,15.72558,860782
4399,ikarlashov,6,0.00070,135369,15.72628,860782
4400,infa-ddeore,6,0.00070,135375,15.72698,860782
4401,ingshtrom,6,0.00070,135381,15.72768,860782
4402,inoam,6,0.00070,135387,15.72837,860782
4403,instigardo,6,0.00070,135393,15.72907,860782
4404,ioquatix,6,0.00070,135399,15.72977,860782
4405,ipochi,6,0.00070,135405,15.73046,860782
4406,irbekrm,6,0.00070,135411,15.73116,860782
4407,isaldana,6,0.00070,135417,15.73186,860782
4408,isueyoon,6,0.00070,135423,15.73255,860782
4409,its-dave,6,0.00070,135429,15.73325,860782
4410,itsx,6,0.00070,135435,15.73395,860782
4411,IurmanJ,6,0.00070,135441,15.73465,860782
4412,ivan-section-io,6,0.00070,135447,15.73534,860782
4413,ivanvtimofeev,6,0.00070,135453,15.73604,860782
4414,j771,6,0.00070,135459,15.73674,860782
4415,jaalle,6,0.00070,135465,15.73743,860782
4416,jaegchoi,6,0.00070,135471,15.73813,860782
4417,jaffcheng,6,0.00070,135477,15.73883,860782
4418,jaggerwang,6,0.00070,135483,15.73953,860782
4419,jakedipity,6,0.00070,135489,15.74022,860782
4420,jamesla,6,0.00070,135495,15.74092,860782
4421,james-mchugh,6,0.00070,135501,15.74162,860782
4422,jamesread,6,0.00070,135507,15.74231,860782
4423,james-w,6,0.00070,135513,15.74301,860782
4424,janoszen,6,0.00070,135519,15.74371,860782
4425,janvdvegt,6,0.00070,135525,15.74440,860782
4426,JasonRD,6,0.00070,135531,15.74510,860782
4427,JavaScriptBach,6,0.00070,135537,15.74580,860782
4428,jayeshmahajan,6,0.00070,135543,15.74650,860782
4429,jcaesar,6,0.00070,135549,15.74719,860782
4430,jdevelop,6,0.00070,135555,15.74789,860782
4431,jecnua,6,0.00070,135561,15.74859,860782
4432,jemygraw,6,0.00070,135567,15.74928,860782
4433,jeremybaumont,6,0.00070,135573,15.74998,860782
4434,JeremyWx,6,0.00070,135579,15.75068,860782
4435,jessey316,6,0.00070,135585,15.75137,860782
4436,jfalameda,6,0.00070,135591,15.75207,860782
4437,J-Ha,6,0.00070,135597,15.75277,860782
4438,jhengy,6,0.00070,135603,15.75347,860782
4439,jim-barber-he,6,0.00070,135609,15.75416,860782
4440,jingnanzhou,6,0.00070,135615,15.75486,860782
4441,jinyuttt,6,0.00070,135621,15.75556,860782
4442,jirib,6,0.00070,135627,15.75625,860782
4443,JKapostins,6,0.00070,135633,15.75695,860782
4444,jmoldow,6,0.00070,135639,15.75765,860782
4445,joaopdelboni,6,0.00070,135645,15.75835,860782
4446,jobec,6,0.00070,135651,15.75904,860782
4447,jobin-AT,6,0.00070,135657,15.75974,860782
4448,johdandc,6,0.00070,135663,15.76044,860782
4449,JohnJAS,6,0.00070,135669,15.76113,860782
4450,johnm,6,0.00070,135675,15.76183,860782
4451,Jojoooo1,6,0.00070,135681,15.76253,860782
4452,jonhatallasf,6,0.00070,135687,15.76322,860782
4453,Jonpez2,6,0.00070,135693,15.76392,860782
4454,jontkong,6,0.00070,135699,15.76462,860782
4455,jrepp,6,0.00070,135705,15.76532,860782
4456,jsen-,6,0.00070,135711,15.76601,860782
4457,jspdown,6,0.00070,135717,15.76671,860782
4458,jtzwu,6,0.00070,135723,15.76741,860782
4459,junorouse,6,0.00070,135729,15.76810,860782
4460,jwitrick,6,0.00070,135735,15.76880,860782
4461,jychen7,6,0.00070,135741,15.76950,860782
4462,kaboo-dev,6,0.00070,135747,15.77020,860782
4463,kaisellgren,6,0.00070,135753,15.77089,860782
4464,kammous,6,0.00070,135759,15.77159,860782
4465,kanikashah90,6,0.00070,135765,15.77229,860782
4466,kartik-tavisca,6,0.00070,135771,15.77298,860782
4467,kasonglee,6,0.00070,135777,15.77368,860782
4468,keksecops,6,0.00070,135783,15.77438,860782
4469,kengan,6,0.00070,135789,15.77507,860782
4470,khacminh,6,0.00070,135795,15.77577,860782
4471,khos2ow,6,0.00070,135801,15.77647,860782
4472,KidLinus,6,0.00070,135807,15.77717,860782
4473,kisieland,6,0.00070,135813,15.77786,860782
4474,Klohto,6,0.00070,135819,15.77856,860782
4475,KnotGud,6,0.00070,135825,15.77926,860782
4476,kobynet,6,0.00070,135831,15.77995,860782
4477,kofan,6,0.00070,135837,15.78065,860782
4478,korivka,6,0.00070,135843,15.78135,860782
4479,korjek,6,0.00070,135849,15.78204,860782
4480,kostyaplis,6,0.00070,135855,15.78274,860782
4481,kraney,6,0.00070,135861,15.78344,860782
4482,kratos81,6,0.00070,135867,15.78414,860782
4483,kravvcu,6,0.00070,135873,15.78483,860782
4484,Krenair,6,0.00070,135879,15.78553,860782
4485,krezovic,6,0.00070,135885,15.78623,860782
4486,krishofmans,6,0.00070,135891,15.78692,860782
4487,kristelfung,6,0.00070,135897,15.78762,860782
4488,KristianWindsor,6,0.00070,135903,15.78832,860782
4489,krol3,6,0.00070,135909,15.78902,860782
4490,KSVarun,6,0.00070,135915,15.78971,860782
4491,kthomas,6,0.00070,135921,15.79041,860782
4492,kuburoman,6,0.00070,135927,15.79111,860782
4493,kumoroku,6,0.00070,135933,15.79180,860782
4494,kyfelipe,6,0.00070,135939,15.79250,860782
4495,kyprifog,6,0.00070,135945,15.79320,860782
4496,laik,6,0.00070,135951,15.79389,860782
4497,laltralt,6,0.00070,135957,15.79459,860782
4498,lance6716,6,0.00070,135963,15.79529,860782
4499,landesherr,6,0.00070,135969,15.79599,860782
4500,lathspell,6,0.00070,135975,15.79668,860782
4501,lee3164,6,0.00070,135981,15.79738,860782
4502,leiless,6,0.00070,135987,15.79808,860782
4503,lesovsky,6,0.00070,135993,15.79877,860782
4504,lewandom,6,0.00070,135999,15.79947,860782
4505,liadavid,6,0.00070,136005,15.80017,860782
4506,liangguohun,6,0.00070,136011,15.80086,860782
4507,lidajia,6,0.00070,136017,15.80156,860782
4508,LilyaBu,6,0.00070,136023,15.80226,860782
4509,Li-Menglong,6,0.00070,136029,15.80296,860782
4510,liminghua999,6,0.00070,136035,15.80365,860782
4511,linclaus,6,0.00070,136041,15.80435,860782
4512,Lincoln-dac,6,0.00070,136047,15.80505,860782
4513,linehrr,6,0.00070,136053,15.80574,860782
4514,linww,6,0.00070,136059,15.80644,860782
4515,LiviuCornel,6,0.00070,136065,15.80714,860782
4516,lixwlixw,6,0.00070,136071,15.80784,860782
4517,lizongshen,6,0.00070,136077,15.80853,860782
4518,llange,6,0.00070,136083,15.80923,860782
4519,lluzza,6,0.00070,136089,15.80993,860782
4520,LogicalShark,6,0.00070,136095,15.81062,860782
4521,lonsdale8734,6,0.00070,136101,15.81132,860782
4522,LouisStAmour,6,0.00070,136107,15.81202,860782
4523,loxp,6,0.00070,136113,15.81271,860782
4524,lucaskjaero,6,0.00070,136119,15.81341,860782
4525,luckyfengyong,6,0.00070,136125,15.81411,860782
4526,ludusrusso,6,0.00070,136131,15.81481,860782
4527,lujiajing1126,6,0.00070,136137,15.81550,860782
4528,luyisa,6,0.00070,136143,15.81620,860782
4529,lvuch,6,0.00070,136149,15.81690,860782
4530,lvxiaohu,6,0.00070,136155,15.81759,860782
4531,lwmqwer,6,0.00070,136161,15.81829,860782
4532,lyd911,6,0.00070,136167,15.81899,860782
4533,Lyrwon,6,0.00070,136173,15.81968,860782
4534,macotutu,6,0.00070,136179,15.82038,860782
4535,MacPower,6,0.00070,136185,15.82108,860782
4536,madianas,6,0.00070,136191,15.82178,860782
4537,majelbstoat,6,0.00070,136197,15.82247,860782
4538,manjeetsorout,6,0.00070,136203,15.82317,860782
4539,mans2singh,6,0.00070,136209,15.82387,860782
4540,mapleFU,6,0.00070,136215,15.82456,860782
4541,marclamberti,6,0.00070,136221,15.82526,860782
4542,marcoaleixo,6,0.00070,136227,15.82596,860782
4543,marcocello,6,0.00070,136233,15.82666,860782
4544,marcoreni,6,0.00070,136239,15.82735,860782
4545,markcartertm,6,0.00070,136245,15.82805,860782
4546,martinhaus,6,0.00070,136251,15.82875,860782
4547,MartinX3,6,0.00070,136257,15.82944,860782
4548,MarwaOuledElHadjAli,6,0.00070,136263,15.83014,860782
4549,maryoush,6,0.00070,136269,15.83084,860782
4550,masalinas,6,0.00070,136275,15.83153,860782
4551,matoszz,6,0.00070,136281,15.83223,860782
4552,matrixji,6,0.00070,136287,15.83293,860782
4553,mattiabasone,6,0.00070,136293,15.83363,860782
4554,matty1979,6,0.00070,136299,15.83432,860782
4555,maust,6,0.00070,136305,15.83502,860782
4556,mavrick,6,0.00070,136311,15.83572,860782
4557,MaxNosov,6,0.00070,136317,15.83641,860782
4558,mb-m,6,0.00070,136323,15.83711,860782
4559,mbwhite,6,0.00070,136329,15.83781,860782
4560,McCoyAle,6,0.00070,136335,15.83850,860782
4561,mdraijer,6,0.00070,136341,15.83920,860782
4562,Med-All,6,0.00070,136347,15.83990,860782
4563,megastallman,6,0.00070,136353,15.84060,860782
4564,mehdihadeli,6,0.00070,136359,15.84129,860782
4565,mel1nn,6,0.00070,136365,15.84199,860782
4566,MemberIT,6,0.00070,136371,15.84269,860782
4567,MFAshby,6,0.00070,136377,15.84338,860782
4568,mfraioli,6,0.00070,136383,15.84408,860782
4569,mgabeler-lee-6rs,6,0.00070,136389,15.84478,860782
4570,mgfritch,6,0.00070,136395,15.84548,860782
4571,mhd999,6,0.00070,136401,15.84617,860782
4572,mheers,6,0.00070,136407,15.84687,860782
4573,MichaelDavisTSN,6,0.00070,136413,15.84757,860782
4574,MichaelMedvedskiy,6,0.00070,136419,15.84826,860782
4575,mick88,6,0.00070,136425,15.84896,860782
4576,micnguyen266,6,0.00070,136431,15.84966,860782
4577,midestefanis,6,0.00070,136437,15.85035,860782
4578,mihail-sky,6,0.00070,136443,15.85105,860782
4579,Minipada,6,0.00070,136449,15.85175,860782
4580,mixalako,6,0.00070,136455,15.85245,860782
4581,mllu,6,0.00070,136461,15.85314,860782
4582,mndrix,6,0.00070,136467,15.85384,860782
4583,mnottheone,6,0.00070,136473,15.85454,860782
4584,mohit-a21,6,0.00070,136479,15.85523,860782
4585,mohit-chawla,6,0.00070,136485,15.85593,860782
4586,momon,6,0.00070,136491,15.85663,860782
4587,mopsfelder,6,0.00070,136497,15.85733,860782
4588,morrme,6,0.00070,136503,15.85802,860782
4589,morty,6,0.00070,136509,15.85872,860782
4590,mpradeep23,6,0.00070,136515,15.85942,860782
4591,mraszplewicz,6,0.00070,136521,15.86011,860782
4592,msheiny,6,0.00070,136527,15.86081,860782
4593,msvechla,6,0.00070,136533,15.86151,860782
4594,mulatinho,6,0.00070,136539,15.86220,860782
4595,Mystigan,6,0.00070,136545,15.86290,860782
4596,n1dtec,6,0.00070,136551,15.86360,860782
4597,nagukothapalli,6,0.00070,136557,15.86430,860782
4598,nairb774,6,0.00070,136563,15.86499,860782
4599,narendrakangralkar,6,0.00070,136569,15.86569,860782
4600,Nashluffy,6,0.00070,136575,15.86639,860782
4601,nathwill,6,0.00070,136581,15.86708,860782
4602,nbhargava,6,0.00070,136587,15.86778,860782
4603,ncthbrt,6,0.00070,136593,15.86848,860782
4604,ndrpnt,6,0.00070,136599,15.86917,860782
4605,ndrwrbgs,6,0.00070,136605,15.86987,860782
4606,neb14,6,0.00070,136611,15.87057,860782
4607,nemoo,6,0.00070,136617,15.87127,860782
4608,neoncloth,6,0.00070,136623,15.87196,860782
4609,nerumo,6,0.00070,136629,15.87266,860782
4610,nestajah,6,0.00070,136635,15.87336,860782
4611,Neustradamus,6,0.00070,136641,15.87405,860782
4612,nfisher,6,0.00070,136647,15.87475,860782
4613,nielsn,6,0.00070,136653,15.87545,860782
4614,nightmared,6,0.00070,136659,15.87615,860782
4615,nirlo,6,0.00070,136665,15.87684,860782
4616,nishuihan,6,0.00070,136671,15.87754,860782
4617,nitinkansal1984,6,0.00070,136677,15.87824,860782
4618,nmarier1,6,0.00070,136683,15.87893,860782
4619,nnsense,6,0.00070,136689,15.87963,860782
4620,nomopo45,6,0.00070,136695,15.88033,860782
4621,NonStatic2014,6,0.00070,136701,15.88102,860782
4622,Novitoll,6,0.00070,136707,15.88172,860782
4623,nprokopic,6,0.00070,136713,15.88242,860782
4624,nrockwell3,6,0.00070,136719,15.88312,860782
4625,nugored,6,0.00070,136725,15.88381,860782
4626,nveenjain,6,0.00070,136731,15.88451,860782
4627,nvenkatapavan,6,0.00070,136737,15.88521,860782
4628,obiesmans,6,0.00070,136743,15.88590,860782
4629,obvionaoe,6,0.00070,136749,15.88660,860782
4630,Ohiogeek8215,6,0.00070,136755,15.88730,860782
4631,olfway,6,0.00070,136761,15.88799,860782
4632,oliverbaehler,6,0.00070,136767,15.88869,860782
4633,olivercodes,6,0.00070,136773,15.88939,860782
4634,omaskery,6,0.00070,136779,15.89009,860782
4635,OnAzureCloud9,6,0.00070,136785,15.89078,860782
4636,ondrowan,6,0.00070,136791,15.89148,860782
4637,OojaxoO,6,0.00070,136797,15.89218,860782
4638,oopsoh,6,0.00070,136803,15.89287,860782
4639,openedhardware,6,0.00070,136809,15.89357,860782
4640,optimisticanshul,6,0.00070,136815,15.89427,860782
4641,oronboni,6,0.00070,136821,15.89497,860782
4642,oudwud,6,0.00070,136827,15.89566,860782
4643,p53,6,0.00070,136833,15.89636,860782
4644,packyzbq,6,0.00070,136839,15.89706,860782
4645,PacoDu,6,0.00070,136845,15.89775,860782
4646,pankajme7,6,0.00070,136851,15.89845,860782
4647,pankona,6,0.00070,136857,15.89915,860782
4648,patelvi1,6,0.00070,136863,15.89984,860782
4649,paulkilla,6,0.00070,136869,15.90054,860782
4650,paurosello,6,0.00070,136875,15.90124,860782
4651,pavankrish123,6,0.00070,136881,15.90194,860782
4652,pawalt,6,0.00070,136887,15.90263,860782
4653,pentolone,6,0.00070,136893,15.90333,860782
4654,petr-motejlek,6,0.00070,136899,15.90403,860782
4655,Phantal,6,0.00070,136905,15.90472,860782
4656,phinphing,6,0.00070,136911,15.90542,860782
4657,piazera,6,0.00070,136917,15.90612,860782
4658,pierreneter,6,0.00070,136923,15.90681,860782
4659,pikhovkin,6,0.00070,136929,15.90751,860782
4660,pinglamb,6,0.00070,136935,15.90821,860782
4661,piotr-szybicki,6,0.00070,136941,15.90891,860782
4662,piperun,6,0.00070,136947,15.90960,860782
4663,pirDOL,6,0.00070,136953,15.91030,860782
4664,plnordquist,6,0.00070,136959,15.91100,860782
4665,pmorelli92,6,0.00070,136965,15.91169,860782
4666,pnavarro,6,0.00070,136971,15.91239,860782
4667,polzka90,6,0.00070,136977,15.91309,860782
4668,porytskyi,6,0.00070,136983,15.91379,860782
4669,possani,6,0.00070,136989,15.91448,860782
4670,poul1x,6,0.00070,136995,15.91518,860782
4671,PoulpiFr,6,0.00070,137001,15.91588,860782
4672,ppgutkus,6,0.00070,137007,15.91657,860782
4673,pptfz,6,0.00070,137013,15.91727,860782
4674,pradaelli,6,0.00070,137019,15.91797,860782
4675,predakanga,6,0.00070,137025,15.91866,860782
4676,predatorray,6,0.00070,137031,15.91936,860782
4677,pricy,6,0.00070,137037,15.92006,860782
4678,prondubuisi,6,0.00070,137043,15.92076,860782
4679,ProNic-QY,6,0.00070,137049,15.92145,860782
4680,PRosenb,6,0.00070,137055,15.92215,860782
4681,PrzemyslawSwiderski,6,0.00070,137061,15.92285,860782
4682,ptman,6,0.00070,137067,15.92354,860782
4683,punkdata,6,0.00070,137073,15.92424,860782
4684,quarkie,6,0.00070,137079,15.92494,860782
4685,rafaeleyng,6,0.00070,137085,15.92564,860782
4686,RafaelKr,6,0.00070,137091,15.92633,860782
4687,raghuchinnannan,6,0.00070,137097,15.92703,860782
4688,rahulkjoshi,6,0.00070,137103,15.92773,860782
4689,raittes,6,0.00070,137109,15.92842,860782
4690,rajat404,6,0.00070,137115,15.92912,860782
4691,rajsenthil,6,0.00070,137121,15.92982,860782
4692,ramesh-kumarjha,6,0.00070,137127,15.93051,860782
4693,ramrodo,6,0.00070,137133,15.93121,860782
4694,RamyasreeChakka,6,0.00070,137139,15.93191,860782
4695,ranton256,6,0.00070,137145,15.93261,860782
4696,rayjlinden,6,0.00070,137151,15.93330,860782
4697,raymonddeng99,6,0.00070,137157,15.93400,860782
4698,rbankole,6,0.00070,137163,15.93470,860782
4699,rbren,6,0.00070,137169,15.93539,860782
4700,realmgic,6,0.00070,137175,15.93609,860782
4701,redopalfruit,6,0.00070,137181,15.93679,860782
4702,renanqts,6,0.00070,137187,15.93748,860782
4703,renatosuero,6,0.00070,137193,15.93818,860782
4704,renier,6,0.00070,137199,15.93888,860782
4705,ReyRen,6,0.00070,137205,15.93958,860782
4706,rhinodavid,6,0.00070,137211,15.94027,860782
4707,rimaulana,6,0.00070,137217,15.94097,860782
4708,rishi-anand,6,0.00070,137223,15.94167,860782
4709,rishikeshr,6,0.00070,137229,15.94236,860782
4710,rivernews,6,0.00070,137235,15.94306,860782
4711,rizi,6,0.00070,137241,15.94376,860782
4712,rkasa,6,0.00070,137247,15.94446,860782
4713,rmartinez3,6,0.00070,137253,15.94515,860782
4714,rnsv,6,0.00070,137259,15.94585,860782
4715,roastario,6,0.00070,137265,15.94655,860782
4716,RobertLucian,6,0.00070,137271,15.94724,860782
4717,rockxsj,6,0.00070,137277,15.94794,860782
4718,romanseidl,6,0.00070,137283,15.94864,860782
4719,romoy,6,0.00070,137289,15.94933,860782
4720,rtfee,6,0.00070,137295,15.95003,860782
4721,RubenAtPA,6,0.00070,137301,15.95073,860782
4722,RyanAoh,6,0.00070,137307,15.95143,860782
4723,Ryan-Git,6,0.00070,137313,15.95212,860782
4724,saarram,6,0.00070,137319,15.95282,860782
4725,SabaPing,6,0.00070,137325,15.95352,860782
4726,sacherus,6,0.00070,137331,15.95421,860782
4727,Sadzeih,6,0.00070,137337,15.95491,860782
4728,safoueneraddaoui,6,0.00070,137343,15.95561,860782
4729,sagarvelankar,6,0.00070,137349,15.95630,860782
4730,sakshamkhanna,6,0.00070,137355,15.95700,860782
4731,salarali,6,0.00070,137361,15.95770,860782
4732,saltbo,6,0.00070,137367,15.95840,860782
4733,samarara,6,0.00070,137373,15.95909,860782
4734,santoshborse,6,0.00070,137379,15.95979,860782
4735,saraedum,6,0.00070,137385,15.96049,860782
4736,SaralSaxena,6,0.00070,137391,15.96118,860782
4737,SarielTang,6,0.00070,137397,15.96188,860782
4738,SaschaHeyer,6,0.00070,137403,15.96258,860782
4739,SatoruItaya,6,0.00070,137409,15.96328,860782
4740,sccoe,6,0.00070,137415,15.96397,860782
4741,scottrangerio,6,0.00070,137421,15.96467,860782
4742,sd018,6,0.00070,137427,15.96537,860782
4743,seanforyou23,6,0.00070,137433,15.96606,860782
4744,sebastianortizs4n,6,0.00070,137439,15.96676,860782
4745,seflerZ,6,0.00070,137445,15.96746,860782
4746,segabond,6,0.00070,137451,15.96815,860782
4747,sepetrov,6,0.00070,137457,15.96885,860782
4748,seredot,6,0.00070,137463,15.96955,860782
4749,sergeyberezansky,6,0.00070,137469,15.97025,860782
4750,Serrvosky,6,0.00070,137475,15.97094,860782
4751,sgnatonski,6,0.00070,137481,15.97164,860782
4752,shashankv02,6,0.00070,137487,15.97234,860782
4753,shdxiang,6,0.00070,137493,15.97303,860782
4754,sheep94lion,6,0.00070,137499,15.97373,860782
4755,shibi1989,6,0.00070,137505,15.97443,860782
4756,shiftux,6,0.00070,137511,15.97512,860782
4757,shiju-tech,6,0.00070,137517,15.97582,860782
4758,shivaylamba,6,0.00070,137523,15.97652,860782
4759,shiyuan-extreme,6,0.00070,137529,15.97722,860782
4760,Shobhit29,6,0.00070,137535,15.97791,860782
4761,shooshx,6,0.00070,137541,15.97861,860782
4762,shuaijinchao,6,0.00070,137547,15.97931,860782
4763,shubhamdang,6,0.00070,137553,15.98000,860782
4764,shuhaowu,6,0.00070,137559,15.98070,860782
4765,shurup,6,0.00070,137565,15.98140,860782
4766,Siddhesh-Ghadi,6,0.00070,137571,15.98210,860782
4767,silenceper,6,0.00070,137577,15.98279,860782
4768,simonfrey,6,0.00070,137583,15.98349,860782
4769,sinycn,6,0.00070,137589,15.98419,860782
4770,sirpeanut,6,0.00070,137595,15.98488,860782
4771,sknat,6,0.00070,137601,15.98558,860782
4772,skomp,6,0.00070,137607,15.98628,860782
4773,slikk66,6,0.00070,137613,15.98697,860782
4774,smark88,6,0.00070,137619,15.98767,860782
4775,smckend,6,0.00070,137625,15.98837,860782
4776,smeeklai,6,0.00070,137631,15.98907,860782
4777,SMillerDev,6,0.00070,137637,15.98976,860782
4778,snooyen,6,0.00070,137643,15.99046,860782
4779,sobi3ch,6,0.00070,137649,15.99116,860782
4780,SockenSalat,6,0.00070,137655,15.99185,860782
4781,socketpair,6,0.00070,137661,15.99255,860782
4782,soncaocc,6,0.00070,137667,15.99325,860782
4783,sonyafenge,6,0.00070,137673,15.99395,860782
4784,Sophy417,6,0.00070,137679,15.99464,860782
4785,soufianem370,6,0.00070,137685,15.99534,860782
4786,SouleBA,6,0.00070,137691,15.99604,860782
4787,sp185503,6,0.00070,137697,15.99673,860782
4788,spiderGX,6,0.00070,137703,15.99743,860782
4789,spirilis,6,0.00070,137709,15.99813,860782
4790,spiritman1990,6,0.00070,137715,15.99882,860782
4791,spohner,6,0.00070,137721,15.99952,860782
4792,spyroot,6,0.00070,137727,16.00022,860782
4793,sraillard,6,0.00070,137733,16.00092,860782
4794,srinathganesh1,6,0.00070,137739,16.00161,860782
4795,srinivasa-vasu,6,0.00070,137745,16.00231,860782
4796,stackempty,6,0.00070,137751,16.00301,860782
4797,stadaki,6,0.00070,137757,16.00370,860782
4798,startoday,6,0.00070,137763,16.00440,860782
4799,stbenjam,6,0.00070,137769,16.00510,860782
4800,stealthHat,6,0.00070,137775,16.00579,860782
4801,steigr,6,0.00070,137781,16.00649,860782
4802,stephenwolfe1,6,0.00070,137787,16.00719,860782
4803,steve-gray,6,0.00070,137793,16.00789,860782
4804,stevenj,6,0.00070,137799,16.00858,860782
4805,StodaraHodan,6,0.00070,137805,16.00928,860782
4806,stonecheung,6,0.00070,137811,16.00998,860782
4807,str8edgedave,6,0.00070,137817,16.01067,860782
4808,Stratouklos,6,0.00070,137823,16.01137,860782
4809,Stroppel,6,0.00070,137829,16.01207,860782
4810,Subreptivus,6,0.00070,137835,16.01277,860782
4811,subudear,6,0.00070,137841,16.01346,860782
4812,summed,6,0.00070,137847,16.01416,860782
4813,sumsarj,6,0.00070,137853,16.01486,860782
4814,supermqB,6,0.00070,137859,16.01555,860782
4815,supirman,6,0.00070,137865,16.01625,860782
4816,suratsuriya,6,0.00070,137871,16.01695,860782
4817,Surbowl,6,0.00070,137877,16.01764,860782
4818,susu3621,6,0.00070,137883,16.01834,860782
4819,sylvainblot,6,0.00070,137889,16.01904,860782
4820,szy441687879,6,0.00070,137895,16.01974,860782
4821,T00mm,6,0.00070,137901,16.02043,860782
4822,taegyunkim,6,0.00070,137907,16.02113,860782
4823,talhalatifkhan,6,0.00070,137913,16.02183,860782
4824,tarioch,6,0.00070,137919,16.02252,860782
4825,TaylorHere,6,0.00070,137925,16.02322,860782
4826,tbrockman,6,0.00070,137931,16.02392,860782
4827,tehleet,6,0.00070,137937,16.02461,860782
4828,tehmoon,6,0.00070,137943,16.02531,860782
4829,ThePumpingLemma,6,0.00070,137949,16.02601,860782
4830,therealbubbasour,6,0.00070,137955,16.02671,860782
4831,theunisbotha,6,0.00070,137961,16.02740,860782
4832,thomasgaozx,6,0.00070,137967,16.02810,860782
4833,thotypous,6,0.00070,137973,16.02880,860782
4834,thynquest,6,0.00070,137979,16.02949,860782
4835,tianchengli,6,0.00070,137985,16.03019,860782
4836,timmjd,6,0.00070,137991,16.03089,860782
4837,tinyzimmer,6,0.00070,137997,16.03159,860782
4838,tkleczek,6,0.00070,138003,16.03228,860782
4839,tlaukkan,6,0.00070,138009,16.03298,860782
4840,toastyblast,6,0.00070,138015,16.03368,860782
4841,tobiaskohlbau,6,0.00070,138021,16.03437,860782
4842,tokyowizard,6,0.00070,138027,16.03507,860782
4843,TomMorant,6,0.00070,138033,16.03577,860782
4844,TommyUnger,6,0.00070,138039,16.03646,860782
4845,torgeirl,6,0.00070,138045,16.03716,860782
4846,tottoto,6,0.00070,138051,16.03786,860782
4847,Tovi163,6,0.00070,138057,16.03856,860782
4848,tranquanghuy0801,6,0.00070,138063,16.03925,860782
4849,trey2001,6,0.00070,138069,16.03995,860782
4850,tsarna,6,0.00070,138075,16.04065,860782
4851,tskdsb,6,0.00070,138081,16.04134,860782
4852,ttt43ttt,6,0.00070,138087,16.04204,860782
4853,turbotankist,6,0.00070,138093,16.04274,860782
4854,tux-rampage,6,0.00070,138099,16.04343,860782
4855,tyuhara,6,0.00070,138105,16.04413,860782
4856,UnwashedMeme,6,0.00070,138111,16.04483,860782
4857,utkudarilmaz,6,0.00070,138117,16.04553,860782
4858,vainkop,6,0.00070,138123,16.04622,860782
4859,vankop,6,0.00070,138129,16.04692,860782
4860,vanneback,6,0.00070,138135,16.04762,860782
4861,vasanth89,6,0.00070,138141,16.04831,860782
4862,vassilvk,6,0.00070,138147,16.04901,860782
4863,venkatalolla,6,0.00070,138153,16.04971,860782
4864,ventz,6,0.00070,138159,16.05041,860782
4865,veRYANgry,6,0.00070,138165,16.05110,860782
4866,vgunapati,6,0.00070,138171,16.05180,860782
4867,vicnoah,6,0.00070,138177,16.05250,860782
4868,Vijay5775,6,0.00070,138183,16.05319,860782
4869,vijaynvk-321,6,0.00070,138189,16.05389,860782
4870,vikranth06,6,0.00070,138195,16.05459,860782
4871,vinhdiesal,6,0.00070,138201,16.05528,860782
4872,vinzo99,6,0.00070,138207,16.05598,860782
4873,vladiceanu,6,0.00070,138213,16.05668,860782
4874,vrischmann,6,0.00070,138219,16.05738,860782
4875,vroyer,6,0.00070,138225,16.05807,860782
4876,wadefelix,6,0.00070,138231,16.05877,860782
4877,waelghaith,6,0.00070,138237,16.05947,860782
4878,wangrzneu,6,0.00070,138243,16.06016,860782
4879,wanyaoqi,6,0.00070,138249,16.06086,860782
4880,weibaohui,6,0.00070,138255,16.06156,860782
4881,weppos,6,0.00070,138261,16.06226,860782
4882,whfuyn,6,0.00070,138267,16.06295,860782
4883,whilesoftware,6,0.00070,138273,16.06365,860782
4884,WhitePhoera,6,0.00070,138279,16.06435,860782
4885,Wihrt,6,0.00070,138285,16.06504,860782
4886,wildk1w1,6,0.00070,138291,16.06574,860782
4887,williamzhao87,6,0.00070,138297,16.06644,860782
4888,winkee01,6,0.00070,138303,16.06713,860782
4889,withnale,6,0.00070,138309,16.06783,860782
4890,wk60807430,6,0.00070,138315,16.06853,860782
4891,WLun001,6,0.00070,138321,16.06923,860782
4892,wmcnamee-tunein,6,0.00070,138327,16.06992,860782
4893,wmiller112,6,0.00070,138333,16.07062,860782
4894,woa7,6,0.00070,138339,16.07132,860782
4895,wonko,6,0.00070,138345,16.07201,860782
4896,worldtiki,6,0.00070,138351,16.07271,860782
4897,wtc-hf,6,0.00070,138357,16.07341,860782
4898,wuchenyanghaoshuai,6,0.00070,138363,16.07410,860782
4899,wuguanyu,6,0.00070,138369,16.07480,860782
4900,wushujames,6,0.00070,138375,16.07550,860782
4901,wxmiked,6,0.00070,138381,16.07620,860782
4902,Wyntuition,6,0.00070,138387,16.07689,860782
4903,wzg0120,6,0.00070,138393,16.07759,860782
4904,xander-sh,6,0.00070,138399,16.07829,860782
4905,xibuka,6,0.00070,138405,16.07898,860782
4906,xiegeo,6,0.00070,138411,16.07968,860782
4907,xtroncode,6,0.00070,138417,16.08038,860782
4908,xunchangguo,6,0.00070,138423,16.08108,860782
4909,Y0UZ45,6,0.00070,138429,16.08177,860782
4910,yangbor,6,0.00070,138435,16.08247,860782
4911,yangmingbai,6,0.00070,138441,16.08317,860782
4912,yann9,6,0.00070,138447,16.08386,860782
4913,yaseenhamdulay,6,0.00070,138453,16.08456,860782
4914,yashmehrotra,6,0.00070,138459,16.08526,860782
4915,YassineHk,6,0.00070,138465,16.08595,860782
4916,ydnar,6,0.00070,138471,16.08665,860782
4917,yene,6,0.00070,138477,16.08735,860782
4918,yfstein,6,0.00070,138483,16.08805,860782
4919,yiduyangyi,6,0.00070,138489,16.08874,860782
4920,yinjianjin,6,0.00070,138495,16.08944,860782
4921,ynqa,6,0.00070,138501,16.09014,860782
4922,yoave23,6,0.00070,138507,16.09083,860782
4923,yohix,6,0.00070,138513,16.09153,860782
4924,yongseokoh,6,0.00070,138519,16.09223,860782
4925,yoni-taranis,6,0.00070,138525,16.09292,860782
4926,yovizzle,6,0.00070,138531,16.09362,860782
4927,yusufgungor,6,0.00070,138537,16.09432,860782
4928,yuvraj9,6,0.00070,138543,16.09502,860782
4929,yuzeshan,6,0.00070,138549,16.09571,860782
4930,yyx,6,0.00070,138555,16.09641,860782
4931,zahiyo,6,0.00070,138561,16.09711,860782
4932,zcola,6,0.00070,138567,16.09780,860782
4933,zecke,6,0.00070,138573,16.09850,860782
4934,zhangweidongyyl,6,0.00070,138579,16.09920,860782
4935,zhaowencheng1991,6,0.00070,138585,16.09990,860782
4936,zhcsyncer,6,0.00070,138591,16.10059,860782
4937,zheng199512,6,0.00070,138597,16.10129,860782
4938,zhming0,6,0.00070,138603,16.10199,860782
4939,zhx828,6,0.00070,138609,16.10268,860782
4940,ZiyunYang,6,0.00070,138615,16.10338,860782
4941,zjcnew,6,0.00070,138621,16.10408,860782
4942,zuh0,6,0.00070,138627,16.10477,860782
4943,zx8,6,0.00070,138633,16.10547,860782
4944,zzhao2010,6,0.00070,138639,16.10617,860782
4945,0pendev,5,0.00058,138644,16.10675,860782
4946,12101111,5,0.00058,138649,16.10733,860782
4947,1542254356,5,0.00058,138654,16.10791,860782
4948,1995parham,5,0.00058,138659,16.10849,860782
4949,379763376,5,0.00058,138664,16.10907,860782
4950,a1zk,5,0.00058,138669,16.10965,860782
4951,aadatkhanna,5,0.00058,138674,16.11023,860782
4952,aanastasiou,5,0.00058,138679,16.11082,860782
4953,aandrushchenko,5,0.00058,138684,16.11140,860782
4954,AATHITH,5,0.00058,138689,16.11198,860782
4955,abdulsalama,5,0.00058,138694,16.11256,860782
4956,aberfeldy,5,0.00058,138699,16.11314,860782
4957,abessifi,5,0.00058,138704,16.11372,860782
4958,abjrcode,5,0.00058,138709,16.11430,860782
4959,abmybgx,5,0.00058,138714,16.11488,860782
4960,acm-073,5,0.00058,138719,16.11546,860782
4961,acobaugh,5,0.00058,138724,16.11604,860782
4962,adamjstewart,5,0.00058,138729,16.11662,860782
4963,AdarShaked,5,0.00058,138734,16.11721,860782
4964,adeelx,5,0.00058,138739,16.11779,860782
4965,adelbot,5,0.00058,138744,16.11837,860782
4966,aditya1808,5,0.00058,138749,16.11895,860782
4967,AdlerFleurant,5,0.00058,138754,16.11953,860782
4968,adriananeci,5,0.00058,138759,16.12011,860782
4969,aeber,5,0.00058,138764,16.12069,860782
4970,AechLyons,5,0.00058,138769,16.12127,860782
4971,af12066,5,0.00058,138774,16.12185,860782
4972,afmsavage,5,0.00058,138779,16.12243,860782
4973,afsalcodehack,5,0.00058,138784,16.12301,860782
4974,agconti,5,0.00058,138789,16.12359,860782
4975,aharrisson,5,0.00058,138794,16.12418,860782
4976,ahenan,5,0.00058,138799,16.12476,860782
4977,ahjohannessen,5,0.00058,138804,16.12534,860782
4978,ahrtr,5,0.00058,138809,16.12592,860782
4979,ahtik,5,0.00058,138814,16.12650,860782
4980,Ajay250496,5,0.00058,138819,16.12708,860782
4981,ajayanaj,5,0.00058,138824,16.12766,860782
4982,AJCandfield,5,0.00058,138829,16.12824,860782
4983,ajitspendse,5,0.00058,138834,16.12882,860782
4984,ajkr,5,0.00058,138839,16.12940,860782
4985,ajosep514,5,0.00058,138844,16.12998,860782
4986,ajp-io,5,0.00058,138849,16.13056,860782
4987,akhilles,5,0.00058,138854,16.13115,860782
4988,akloss-cibo,5,0.00058,138859,16.13173,860782
4989,alaimo,5,0.00058,138864,16.13231,860782
4990,alapidas,5,0.00058,138869,16.13289,860782
4991,alastairpat,5,0.00058,138874,16.13347,860782
4992,albertofem,5,0.00058,138879,16.13405,860782
4993,alberto-sbp,5,0.00058,138884,16.13463,860782
4994,albqmasqeet,5,0.00058,138889,16.13521,860782
4995,ale8k,5,0.00058,138894,16.13579,860782
4996,alexanderConstantinescu,5,0.00058,138899,16.13637,860782
4997,alexandru-tetelea,5,0.00058,138904,16.13695,860782
4998,Alexis01,5,0.00058,138909,16.13754,860782
4999,alexmojo,5,0.00058,138914,16.13812,860782
5000,alexnoz,5,0.00058,138919,16.13870,860782
5001,alex-vmw,5,0.00058,138924,16.13928,860782
5002,alienvspredator,5,0.00058,138929,16.13986,860782
5003,aliwo,5,0.00058,138934,16.14044,860782
5004,allanlewis,5,0.00058,138939,16.14102,860782
5005,allanmoso,5,0.00058,138944,16.14160,860782
5006,AllenzhLi,5,0.00058,138949,16.14218,860782
5007,allir,5,0.00058,138954,16.14276,860782
5008,alokvk1234,5,0.00058,138959,16.14334,860782
5009,amadeuszkryze,5,0.00058,138964,16.14392,860782
5010,amarflybot18,5,0.00058,138969,16.14451,860782
5011,ambition-consulting,5,0.00058,138974,16.14509,860782
5012,amenasiddiqi,5,0.00058,138979,16.14567,860782
5013,Amiedeep,5,0.00058,138984,16.14625,860782
5014,amitabh91,5,0.00058,138989,16.14683,860782
5015,amitmaurya001,5,0.00058,138994,16.14741,860782
5016,amit-uc,5,0.00058,138999,16.14799,860782
5017,amitwaisel,5,0.00058,139004,16.14857,860782
5018,AmjadHussainSyed,5,0.00058,139009,16.14915,860782
5019,anastyakulyk,5,0.00058,139014,16.14973,860782
5020,Andreiaotto,5,0.00058,139019,16.15031,860782
5021,andy-caruso,5,0.00058,139024,16.15090,860782
5022,anemade,5,0.00058,139029,16.15148,860782
5023,ankitjain28may,5,0.00058,139034,16.15206,860782
5024,ankitthakwani,5,0.00058,139039,16.15264,860782
5025,anlutro,5,0.00058,139044,16.15322,860782
5026,anon17,5,0.00058,139049,16.15380,860782
5027,an-tex,5,0.00058,139054,16.15438,860782
5028,anthonyt123,5,0.00058,139059,16.15496,860782
5029,antitree,5,0.00058,139064,16.15554,860782
5030,antoinetran,5,0.00058,139069,16.15612,860782
5031,antoinne85,5,0.00058,139074,16.15670,860782
5032,anumercian,5,0.00058,139079,16.15728,860782
5033,anuragp0010,5,0.00058,139084,16.15787,860782
5034,anusha-maheshwarappa-ip,5,0.00058,139089,16.15845,860782
5035,aperullo,5,0.00058,139094,16.15903,860782
5036,aphelionz,5,0.00058,139099,16.15961,860782
5037,appliedprivacy,5,0.00058,139104,16.16019,860782
5038,applike-ss,5,0.00058,139109,16.16077,860782
5039,apurvchandra,5,0.00058,139114,16.16135,860782
5040,aqua-terra,5,0.00058,139119,16.16193,860782
5041,arch1ve,5,0.00058,139124,16.16251,860782
5042,areina,5,0.00058,139129,16.16309,860782
5043,armisz,5,0.00058,139134,16.16367,860782
5044,Arnold1,5,0.00058,139139,16.16426,860782
5045,arno-snop,5,0.00058,139144,16.16484,860782
5046,arroadie,5,0.00058,139149,16.16542,860782
5047,arthurh4,5,0.00058,139154,16.16600,860782
5048,arukaen,5,0.00058,139159,16.16658,860782
5049,Arvoreen,5,0.00058,139164,16.16716,860782
5050,Asday,5,0.00058,139169,16.16774,860782
5051,ashenoy-hedvig,5,0.00058,139174,16.16832,860782
5052,ashish246,5,0.00058,139179,16.16890,860782
5053,ashutoshgngwr,5,0.00058,139184,16.16948,860782
5054,astraldawn,5,0.00058,139189,16.17006,860782
5055,astrived,5,0.00058,139194,16.17064,860782
5056,AstroProfundis,5,0.00058,139199,16.17123,860782
5057,asubb,5,0.00058,139204,16.17181,860782
5058,atlanmatrix,5,0.00058,139209,16.17239,860782
5059,atrn0,5,0.00058,139214,16.17297,860782
5060,augustrh,5,0.00058,139219,16.17355,860782
5061,austinpray,5,0.00058,139224,16.17413,860782
5062,avolution,5,0.00058,139229,16.17471,860782
5063,axbarsan,5,0.00058,139234,16.17529,860782
5064,ayusheesingh,5,0.00058,139239,16.17587,860782
5065,azban,5,0.00058,139244,16.17645,860782
5066,azbpa,5,0.00058,139249,16.17703,860782
5067,azush26,5,0.00058,139254,16.17762,860782
5068,b0nete,5,0.00058,139259,16.17820,860782
5069,bad,5,0.00058,139264,16.17878,860782
5070,bahlo,5,0.00058,139269,16.17936,860782
5071,BahmaniAlireza,5,0.00058,139274,16.17994,860782
5072,baiyunsong,5,0.00058,139279,16.18052,860782
5073,balpert89,5,0.00058,139284,16.18110,860782
5074,bamboox,5,0.00058,139289,16.18168,860782
5075,bandwiches,5,0.00058,139294,16.18226,860782
5076,banksyian,5,0.00058,139299,16.18284,860782
5077,bartversluijs,5,0.00058,139304,16.18342,860782
5078,Baryczka,5,0.00058,139309,16.18400,860782
5079,Basster,5,0.00058,139314,16.18459,860782
5080,bcarlsson,5,0.00058,139319,16.18517,860782
5081,bcashier,5,0.00058,139324,16.18575,860782
5082,bcouetil,5,0.00058,139329,16.18633,860782
5083,bdudelsack,5,0.00058,139334,16.18691,860782
5084,behos,5,0.00058,139339,16.18749,860782
5085,belolap,5,0.00058,139344,16.18807,860782
5086,BenoitPerrot,5,0.00058,139349,16.18865,860782
5087,bfmiv,5,0.00058,139354,16.18923,860782
5088,bfoxstudio,5,0.00058,139359,16.18981,860782
5089,BharathB23,5,0.00058,139364,16.19039,860782
5090,Bhavanaashok33,5,0.00058,139369,16.19098,860782
5091,bhavesh83,5,0.00058,139374,16.19156,860782
5092,bidipeppercrap,5,0.00058,139379,16.19214,860782
5093,bigdnf,5,0.00058,139384,16.19272,860782
5094,birdiesanders,5,0.00058,139389,16.19330,860782
5095,bkayranci,5,0.00058,139394,16.19388,860782
5096,blagojts,5,0.00058,139399,16.19446,860782
5097,blakestoddard,5,0.00058,139404,16.19504,860782
5098,Blanko2,5,0.00058,139409,16.19562,860782
5099,blencoff,5,0.00058,139414,16.19620,860782
5100,Bliamoh,5,0.00058,139419,16.19678,860782
5101,bmacauley,5,0.00058,139424,16.19736,860782
5102,bmfp,5,0.00058,139429,16.19795,860782
5103,BMonsalvatge,5,0.00058,139434,16.19853,860782
5104,bnrjee,5,0.00058,139439,16.19911,860782
5105,BobkovS,5,0.00058,139444,16.19969,860782
5106,bobpiece,5,0.00058,139449,16.20027,860782
5107,BoOgatti,5,0.00058,139454,16.20085,860782
5108,brantcolemanthis,5,0.00058,139459,16.20143,860782
5109,brant-ruan,5,0.00058,139464,16.20201,860782
5110,Britvich,5,0.00058,139469,16.20259,860782
5111,brokencode64,5,0.00058,139474,16.20317,860782
5112,brtasavpatel,5,0.00058,139479,16.20375,860782
5113,bryanasdev000,5,0.00058,139484,16.20434,860782
5114,bryanhanner,5,0.00058,139489,16.20492,860782
5115,Bryce-huang,5,0.00058,139494,16.20550,860782
5116,brysonshepherd,5,0.00058,139499,16.20608,860782
5117,bsmid,5,0.00058,139504,16.20666,860782
5118,BstevensG4G,5,0.00058,139509,16.20724,860782
5119,buctwbzs,5,0.00058,139514,16.20782,860782
5120,bugre,5,0.00058,139519,16.20840,860782
5121,burkempers,5,0.00058,139524,16.20898,860782
5122,bvivi57,5,0.00058,139529,16.20956,860782
5123,BZM708,5,0.00058,139534,16.21014,860782
5124,calvinyv,5,0.00058,139539,16.21072,860782
5125,camo-f,5,0.00058,139544,16.21131,860782
5126,cannontrodder,5,0.00058,139549,16.21189,860782
5127,carlbordum,5,0.00058,139554,16.21247,860782
5128,carlosdoordash,5,0.00058,139559,16.21305,860782
5129,catap,5,0.00058,139564,16.21363,860782
5130,catenacyber,5,0.00058,139569,16.21421,860782
5131,cbajumpaa,5,0.00058,139574,16.21479,860782
5132,cbayle,5,0.00058,139579,16.21537,860782
5133,cbrand,5,0.00058,139584,16.21595,860782
5134,cemsbr,5,0.00058,139589,16.21653,860782
5135,cetiberiojr,5,0.00058,139594,16.21711,860782
5136,cgsimmons,5,0.00058,139599,16.21770,860782
5137,chaimchaim,5,0.00058,139604,16.21828,860782
5138,chancejin,5,0.00058,139609,16.21886,860782
5139,chandankashyap19,5,0.00058,139614,16.21944,860782
5140,changlidong68,5,0.00058,139619,16.22002,860782
5141,Charana123,5,0.00058,139624,16.22060,860782
5142,charithe,5,0.00058,139629,16.22118,860782
5143,ChengjinWu,5,0.00058,139634,16.22176,860782
5144,chenguoquan,5,0.00058,139639,16.22234,860782
5145,chenqiangzhishen,5,0.00058,139644,16.22292,860782
5146,chenshuyuhhh,5,0.00058,139649,16.22350,860782
5147,Chivolta,5,0.00058,139654,16.22408,860782
5148,CHneger,5,0.00058,139659,16.22467,860782
5149,chrisdoherty4,5,0.00058,139664,16.22525,860782
5150,chris-downs,5,0.00058,139669,16.22583,860782
5151,chrish42,5,0.00058,139674,16.22641,860782
5152,christianri,5,0.00058,139679,16.22699,860782
5153,cicilee,5,0.00058,139684,16.22757,860782
5154,clebs,5,0.00058,139689,16.22815,860782
5155,clementrey,5,0.00058,139694,16.22873,860782
5156,clinta,5,0.00058,139699,16.22931,860782
5157,Cloud-Mak,5,0.00058,139704,16.22989,860782
5158,clyso,5,0.00058,139709,16.23047,860782
5159,cobookman,5,0.00058,139714,16.23106,860782
5160,cocampbe,5,0.00058,139719,16.23164,860782
5161,cOckTHell,5,0.00058,139724,16.23222,860782
5162,Codebreaker101,5,0.00058,139729,16.23280,860782
5163,colinmai123,5,0.00058,139734,16.23338,860782
5164,colt415,5,0.00058,139739,16.23396,860782
5165,configurator,5,0.00058,139744,16.23454,860782
5166,constambeys,5,0.00058,139749,16.23512,860782
5167,coopernetes,5,0.00058,139754,16.23570,860782
5168,coufalja,5,0.00058,139759,16.23628,860782
5169,crazy-max,5,0.00058,139764,16.23686,860782
5170,crazywjj,5,0.00058,139769,16.23744,860782
5171,creker,5,0.00058,139774,16.23803,860782
5172,Crystal-w,5,0.00058,139779,16.23861,860782
5173,csb1582,5,0.00058,139784,16.23919,860782
5174,csharpknife2002,5,0.00058,139789,16.23977,860782
5175,cswindle,5,0.00058,139794,16.24035,860782
5176,CuBiC3D,5,0.00058,139799,16.24093,860782
5177,Cynocracy,5,0.00058,139804,16.24151,860782
5178,Cytram,5,0.00058,139809,16.24209,860782
5179,dabde,5,0.00058,139814,16.24267,860782
5180,daganibhanu,5,0.00058,139819,16.24325,860782
5181,danielgblanco,5,0.00058,139824,16.24383,860782
5182,danil-smirnov,5,0.00058,139829,16.24441,860782
5183,DanOfir,5,0.00058,139834,16.24500,860782
5184,dan-slinky-ckpd,5,0.00058,139839,16.24558,860782
5185,darshandeshmukh11,5,0.00058,139844,16.24616,860782
5186,david972,5,0.00058,139849,16.24674,860782
5187,davidalger,5,0.00058,139854,16.24732,860782
5188,davidbtucker,5,0.00058,139859,16.24790,860782
5189,davix,5,0.00058,139864,16.24848,860782
5190,dbalzan,5,0.00058,139869,16.24906,860782
5191,dbirks,5,0.00058,139874,16.24964,860782
5192,dbpolito,5,0.00058,139879,16.25022,860782
5193,dcommisso,5,0.00058,139884,16.25080,860782
5194,dcroe,5,0.00058,139889,16.25139,860782
5195,deadjoker,5,0.00058,139894,16.25197,860782
5196,deathgaze,5,0.00058,139899,16.25255,860782
5197,deepakgrewal,5,0.00058,139904,16.25313,860782
5198,defreng,5,0.00058,139909,16.25371,860782
5199,DenisRazinkin,5,0.00058,139914,16.25429,860782
5200,Denis-Razinkin,5,0.00058,139919,16.25487,860782
5201,DennisKehrig,5,0.00058,139924,16.25545,860782
5202,devbharat,5,0.00058,139929,16.25603,860782
5203,dexhunter,5,0.00058,139934,16.25661,860782
5204,Dextroz,5,0.00058,139939,16.25719,860782
5205,dgrnd4,5,0.00058,139944,16.25777,860782
5206,dhineshbabuelango,5,0.00058,139949,16.25836,860782
5207,dineshgowda24,5,0.00058,139954,16.25894,860782
5208,DinshKW44,5,0.00058,139959,16.25952,860782
5209,diplodok-oleg,5,0.00058,139964,16.26010,860782
5210,DirtySoc,5,0.00058,139969,16.26068,860782
5211,divyaKalusulingam,5,0.00058,139974,16.26126,860782
5212,dkeightley,5,0.00058,139979,16.26184,860782
5213,dlopes7,5,0.00058,139984,16.26242,860782
5214,Dlougach,5,0.00058,139989,16.26300,860782
5215,Dominik-K,5,0.00058,139994,16.26358,860782
5216,Dong-wook94,5,0.00058,139999,16.26416,860782
5217,doron-fediuck,5,0.00058,140004,16.26475,860782
5218,double73,5,0.00058,140009,16.26533,860782
5219,DragD,5,0.00058,140014,16.26591,860782
5220,DrPyser,5,0.00058,140019,16.26649,860782
5221,drtriumph,5,0.00058,140024,16.26707,860782
5222,dsargent3220,5,0.00058,140029,16.26765,860782
5223,dschulten,5,0.00058,140034,16.26823,860782
5224,dschwar,5,0.00058,140039,16.26881,860782
5225,dsharp-pivotal,5,0.00058,140044,16.26939,860782
5226,dsindatry,5,0.00058,140049,16.26997,860782
5227,dsx,5,0.00058,140054,16.27055,860782
5228,dtw45,5,0.00058,140059,16.27113,860782
5229,Duanzhiwei,5,0.00058,140064,16.27172,860782
5230,dvaerum,5,0.00058,140069,16.27230,860782
5231,dwdraju,5,0.00058,140074,16.27288,860782
5232,dxvgef,5,0.00058,140079,16.27346,860782
5233,dylanpiergies,5,0.00058,140084,16.27404,860782
5234,dzirg44,5,0.00058,140089,16.27462,860782
5235,eafzali,5,0.00058,140094,16.27520,860782
5236,ecktom,5,0.00058,140099,16.27578,860782
5237,ecout,5,0.00058,140104,16.27636,860782
5238,eddycjy,5,0.00058,140109,16.27694,860782
5239,edjwhho,5,0.00058,140114,16.27752,860782
5240,e-infotech,5,0.00058,140119,16.27811,860782
5241,ekesken,5,0.00058,140124,16.27869,860782
5242,emaayan,5,0.00058,140129,16.27927,860782
5243,endurancetest20380119,5,0.00058,140134,16.27985,860782
5244,engineerdev,5,0.00058,140139,16.28043,860782
5245,EngRajabi,5,0.00058,140144,16.28101,860782
5246,enunio,5,0.00058,140149,16.28159,860782
5247,ephemeral,5,0.00058,140154,16.28217,860782
5248,ereOn,5,0.00058,140159,16.28275,860782
5249,erick-thompson,5,0.00058,140164,16.28333,860782
5250,etomitsue,5,0.00058,140169,16.28391,860782
5251,everops-john,5,0.00058,140174,16.28449,860782
5252,Evesy,5,0.00058,140179,16.28508,860782
5253,evgenii-petrov-arrival,5,0.00058,140184,16.28566,860782
5254,evilrussian,5,0.00058,140189,16.28624,860782
5255,Fab-T,5,0.00058,140194,16.28682,860782
5256,faceair,5,0.00058,140199,16.28740,860782
5257,fangfuhaomin,5,0.00058,140204,16.28798,860782
5258,fans3210,5,0.00058,140209,16.28856,860782
5259,FaristaS,5,0.00058,140214,16.28914,860782
5260,farookhus,5,0.00058,140219,16.28972,860782
5261,farooqdevops,5,0.00058,140224,16.29030,860782
5262,fathalls,5,0.00058,140229,16.29088,860782
5263,fcastello,5,0.00058,140234,16.29147,860782
5264,fcu3dx,5,0.00058,140239,16.29205,860782
5265,fearlesschenc,5,0.00058,140244,16.29263,860782
5266,felipegcampos,5,0.00058,140249,16.29321,860782
5267,ferbar,5,0.00058,140254,16.29379,860782
5268,fffffreedom,5,0.00058,140259,16.29437,860782
5269,fkshom,5,0.00058,140264,16.29495,860782
5270,floriankoch,5,0.00058,140269,16.29553,860782
5271,ForestCold,5,0.00058,140274,16.29611,860782
5272,forkjoseph,5,0.00058,140279,16.29669,860782
5273,fradee,5,0.00058,140284,16.29727,860782
5274,francescsanjuanmrf,5,0.00058,140289,16.29785,860782
5275,FranciscoMSM,5,0.00058,140294,16.29844,860782
5276,frank-berlin,5,0.00058,140299,16.29902,860782
5277,fredwangwang,5,0.00058,140304,16.29960,860782
5278,FrelDX,5,0.00058,140309,16.30018,860782
5279,fridex,5,0.00058,140314,16.30076,860782
5280,frincon,5,0.00058,140319,16.30134,860782
5281,frodriguez-sr,5,0.00058,140324,16.30192,860782
5282,Fryuni,5,0.00058,140329,16.30250,860782
5283,fttyX,5,0.00058,140334,16.30308,860782
5284,fukunagt,5,0.00058,140339,16.30366,860782
5285,gadinaor,5,0.00058,140344,16.30424,860782
5286,gangkui2008,5,0.00058,140349,16.30483,860782
5287,Gaukas,5,0.00058,140354,16.30541,860782
5288,GauravJain98,5,0.00058,140359,16.30599,860782
5289,gauravsjc02,5,0.00058,140364,16.30657,860782
5290,gdonlyathw,5,0.00058,140369,16.30715,860782
5291,GeminiAgaloos,5,0.00058,140374,16.30773,860782
5292,geofffranks,5,0.00058,140379,16.30831,860782
5293,GeorgFleig,5,0.00058,140384,16.30889,860782
5294,gep,5,0.00058,140389,16.30947,860782
5295,gergo-nyiro-oi,5,0.00058,140394,16.31005,860782
5296,GerryWilko,5,0.00058,140399,16.31063,860782
5297,gfrankliu,5,0.00058,140404,16.31121,860782
5298,ghnacker,5,0.00058,140409,16.31180,860782
5299,gigkokman,5,0.00058,140414,16.31238,860782
5300,gillespiejim78,5,0.00058,140419,16.31296,860782
5301,gitdotvaibhav,5,0.00058,140424,16.31354,860782
5302,git-heera,5,0.00058,140429,16.31412,860782
5303,gitlijian,5,0.00058,140434,16.31470,860782
5304,gitpushdashf,5,0.00058,140439,16.31528,860782
5305,gkao123,5,0.00058,140444,16.31586,860782
5306,glittershark,5,0.00058,140449,16.31644,860782
5307,GloriaPG,5,0.00058,140454,16.31702,860782
5308,gmichels,5,0.00058,140459,16.31760,860782
5309,gmlexx,5,0.00058,140464,16.31819,860782
5310,gnatseira,5,0.00058,140469,16.31877,860782
5311,gohilankit,5,0.00058,140474,16.31935,860782
5312,gouki777,5,0.00058,140479,16.31993,860782
5313,greed42,5,0.00058,140484,16.32051,860782
5314,grischdian,5,0.00058,140489,16.32109,860782
5315,GSokol,5,0.00058,140494,16.32167,860782
5316,gthb,5,0.00058,140499,16.32225,860782
5317,gunboe,5,0.00058,140504,16.32283,860782
5318,gustavovalverde,5,0.00058,140509,16.32341,860782
5319,gvenzl,5,0.00058,140514,16.32399,860782
5320,gyant,5,0.00058,140519,16.32457,860782
5321,gytxmu,5,0.00058,140524,16.32516,860782
5322,h1de27,5,0.00058,140529,16.32574,860782
5323,haibeey,5,0.00058,140534,16.32632,860782
5324,haisum,5,0.00058,140539,16.32690,860782
5325,HaithemSouala,5,0.00058,140544,16.32748,860782
5326,hajowieland,5,0.00058,140549,16.32806,860782
5327,hamza-tumturk,5,0.00058,140554,16.32864,860782
5328,hanjm,5,0.00058,140559,16.32922,860782
5329,hantsy,5,0.00058,140564,16.32980,860782
5330,HappyCerberus,5,0.00058,140569,16.33038,860782
5331,Harkole,5,0.00058,140574,16.33096,860782
5332,hazemm96,5,0.00058,140579,16.33155,860782
5333,hdoro,5,0.00058,140584,16.33213,860782
5334,heavenwing,5,0.00058,140589,16.33271,860782
5335,hedeesa,5,0.00058,140594,16.33329,860782
5336,hendrikhalkow,5,0.00058,140599,16.33387,860782
5337,hendrikmaus,5,0.00058,140604,16.33445,860782
5338,herbyderby,5,0.00058,140609,16.33503,860782
5339,heubeck,5,0.00058,140614,16.33561,860782
5340,heydonovan,5,0.00058,140619,16.33619,860782
5341,hofmannmich,5,0.00058,140624,16.33677,860782
5342,horovits,5,0.00058,140629,16.33735,860782
5343,hoyho,5,0.00058,140634,16.33793,860782
5344,huangnauh,5,0.00058,140639,16.33852,860782
5345,hugovk,5,0.00058,140644,16.33910,860782
5346,huhaipeng,5,0.00058,140649,16.33968,860782
5347,huizengaJoe,5,0.00058,140654,16.34026,860782
5348,HumairAK,5,0.00058,140659,16.34084,860782
5349,hxquangnhat,5,0.00058,140664,16.34142,860782
5350,HyungJune,5,0.00058,140669,16.34200,860782
5351,iamtheindian,5,0.00058,140674,16.34258,860782
5352,ianfoo,5,0.00058,140679,16.34316,860782
5353,ianhe8x,5,0.00058,140684,16.34374,860782
5354,iCovarrubias,5,0.00058,140689,16.34432,860782
5355,ifree613,5,0.00058,140694,16.34490,860782
5356,IKSIN,5,0.00058,140699,16.34549,860782
5357,iliasbhal,5,0.00058,140704,16.34607,860782
5358,ilyam8,5,0.00058,140709,16.34665,860782
5359,impala454,5,0.00058,140714,16.34723,860782
5360,imulot,5,0.00058,140719,16.34781,860782
5361,IndicatorFluid,5,0.00058,140724,16.34839,860782
5362,infa-kparida,5,0.00058,140729,16.34897,860782
5363,inosvaruag,5,0.00058,140734,16.34955,860782
5364,iojas,5,0.00058,140739,16.35013,860782
5365,IppX,5,0.00058,140744,16.35071,860782
5366,isaachui,5,0.00058,140749,16.35129,860782
5367,ishanmkh,5,0.00058,140754,16.35188,860782
5368,isheik,5,0.00058,140759,16.35246,860782
5369,isshwar,5,0.00058,140764,16.35304,860782
5370,itkq,5,0.00058,140769,16.35362,860782
5371,itkroplis,5,0.00058,140774,16.35420,860782
5372,itshikanov,5,0.00058,140779,16.35478,860782
5373,IuriGarcia,5,0.00058,140784,16.35536,860782
5374,ivanangelov,5,0.00058,140789,16.35594,860782
5375,ivanmp91,5,0.00058,140794,16.35652,860782
5376,JabusKotze,5,0.00058,140799,16.35710,860782
5377,JaccyLi,5,0.00058,140804,16.35768,860782
5378,jacobsmith928,5,0.00058,140809,16.35826,860782
5379,jaiminsh,5,0.00058,140814,16.35885,860782
5380,jaitaiwan,5,0.00058,140819,16.35943,860782
5381,jakepaw,5,0.00058,140824,16.36001,860782
5382,jameshochadel,5,0.00058,140829,16.36059,860782
5383,jamisonhyatt,5,0.00058,140834,16.36117,860782
5384,janotav,5,0.00058,140839,16.36175,860782
5385,jasperf,5,0.00058,140844,16.36233,860782
5386,javimox,5,0.00058,140849,16.36291,860782
5387,Jawenba,5,0.00058,140854,16.36349,860782
5388,JayG-EBSCO,5,0.00058,140859,16.36407,860782
5389,jbampton,5,0.00058,140864,16.36465,860782
5390,jbrandli,5,0.00058,140869,16.36524,860782
5391,jc1e100,5,0.00058,140874,16.36582,860782
5392,jcxian,5,0.00058,140879,16.36640,860782
5393,jdbohrman,5,0.00058,140884,16.36698,860782
5394,jeffdoolittle,5,0.00058,140889,16.36756,860782
5395,jeffhubLR,5,0.00058,140894,16.36814,860782
5396,jeffplesko,5,0.00058,140899,16.36872,860782
5397,jeffrom,5,0.00058,140904,16.36930,860782
5398,jemershaw,5,0.00058,140909,16.36988,860782
5399,jeremy-lq,5,0.00058,140914,16.37046,860782
5400,jerome-quere,5,0.00058,140919,16.37104,860782
5401,JesseObrien,5,0.00058,140924,16.37162,860782
5402,jgardiner68,5,0.00058,140929,16.37221,860782
5403,jgiannuzzi,5,0.00058,140934,16.37279,860782
5404,jgustie,5,0.00058,140939,16.37337,860782
5405,jhawk28,5,0.00058,140944,16.37395,860782
5406,jiangxiaoqiang,5,0.00058,140949,16.37453,860782
5407,Jiboxiake,5,0.00058,140954,16.37511,860782
5408,jing2uo,5,0.00058,140959,16.37569,860782
5409,jjtroberts,5,0.00058,140964,16.37627,860782
5410,jlawrienyt,5,0.00058,140969,16.37685,860782
5411,jlindholm,5,0.00058,140974,16.37743,860782
5412,jlsalmon,5,0.00058,140979,16.37801,860782
5413,jmbkeyes,5,0.00058,140984,16.37860,860782
5414,jmcelwain,5,0.00058,140989,16.37918,860782
5415,jmichalek132,5,0.00058,140994,16.37976,860782
5416,jmontroy90,5,0.00058,140999,16.38034,860782
5417,jmp0x0000,5,0.00058,141004,16.38092,860782
5418,joachimmathes,5,0.00058,141009,16.38150,860782
5419,Joelbear5,5,0.00058,141014,16.38208,860782
5420,JohannesKnauft,5,0.00058,141019,16.38266,860782
5421,John402-cloud,5,0.00058,141024,16.38324,860782
5422,johnduhart,5,0.00058,141029,16.38382,860782
5423,jonmun93,5,0.00058,141034,16.38440,860782
5424,JornShen,5,0.00058,141039,16.38498,860782
5425,JorrieB,5,0.00058,141044,16.38557,860782
5426,joshisagar92,5,0.00058,141049,16.38615,860782
5427,joshuacox,5,0.00058,141054,16.38673,860782
5428,josiah14,5,0.00058,141059,16.38731,860782
5429,jtigger,5,0.00058,141064,16.38789,860782
5430,juanjoDiaz,5,0.00058,141069,16.38847,860782
5431,juchaosong,5,0.00058,141074,16.38905,860782
5432,juliangiuca,5,0.00058,141079,16.38963,860782
5433,JulianZhang,5,0.00058,141084,16.39021,860782
5434,julienlefur,5,0.00058,141089,16.39079,860782
5435,JustDoItSascha,5,0.00058,141094,16.39137,860782
5436,justenwalker,5,0.00058,141099,16.39196,860782
5437,jvanwygerden,5,0.00058,141104,16.39254,860782
5438,jvleminc,5,0.00058,141109,16.39312,860782
5439,k2n,5,0.00058,141114,16.39370,860782
5440,Ka1wa,5,0.00058,141119,16.39428,860782
5441,Kafei59,5,0.00058,141124,16.39486,860782
5442,Kaggggggga,5,0.00058,141129,16.39544,860782
5443,kailashyogeshwar85,5,0.00058,141134,16.39602,860782
5444,kaitoii11,5,0.00058,141139,16.39660,860782
5445,kakaNo1,5,0.00058,141144,16.39718,860782
5446,kantica,5,0.00058,141149,16.39776,860782
5447,karolyi,5,0.00058,141154,16.39834,860782
5448,karthikm83,5,0.00058,141159,16.39893,860782
5449,kebyn,5,0.00058,141164,16.39951,860782
5450,keithnull,5,0.00058,141169,16.40009,860782
5451,kenzieschmoll,5,0.00058,141174,16.40067,860782
5452,Kerstin08,5,0.00058,141179,16.40125,860782
5453,keslerm,5,0.00058,141184,16.40183,860782
5454,kevinprotoss,5,0.00058,141189,16.40241,860782
5455,keweishang,5,0.00058,141194,16.40299,860782
5456,kienbd,5,0.00058,141199,16.40357,860782
5457,killianmuldoon,5,0.00058,141204,16.40415,860782
5458,Kindrat,5,0.00058,141209,16.40473,860782
5459,kingamarton,5,0.00058,141214,16.40532,860782
5460,kirill256,5,0.00058,141219,16.40590,860782
5461,Kiruthikameena,5,0.00058,141224,16.40648,860782
5462,kishan-patel,5,0.00058,141229,16.40706,860782
5463,kkBill,5,0.00058,141234,16.40764,860782
5464,kkocel,5,0.00058,141239,16.40822,860782
5465,kluzny,5,0.00058,141244,16.40880,860782
5466,knappe,5,0.00058,141249,16.40938,860782
5467,Konpon96,5,0.00058,141254,16.40996,860782
5468,kornelbicskei,5,0.00058,141259,16.41054,860782
5469,kortatu,5,0.00058,141264,16.41112,860782
5470,krisbai,5,0.00058,141269,16.41170,860782
5471,krishna1250,5,0.00058,141274,16.41229,860782
5472,kritika-singh3,5,0.00058,141279,16.41287,860782
5473,krufab,5,0.00058,141284,16.41345,860782
5474,krukkrz,5,0.00058,141289,16.41403,860782
5475,krzysdabro,5,0.00058,141294,16.41461,860782
5476,krzysztof-miemiec,5,0.00058,141299,16.41519,860782
5477,ksimka,5,0.00058,141304,16.41577,860782
5478,ktoso,5,0.00058,141309,16.41635,860782
5479,kuange,5,0.00058,141314,16.41693,860782
5480,Kubelancer,5,0.00058,141319,16.41751,860782
5481,kvaidas,5,0.00058,141324,16.41809,860782
5482,kwontae,5,0.00058,141329,16.41868,860782
5483,KylinVnne,5,0.00058,141334,16.41926,860782
5484,lallinger-arbeit,5,0.00058,141339,16.41984,860782
5485,lalonde,5,0.00058,141344,16.42042,860782
5486,lancelot1989,5,0.00058,141349,16.42100,860782
5487,lanox,5,0.00058,141354,16.42158,860782
5488,lars-olsson,5,0.00058,141359,16.42216,860782
5489,LasTshaMAN,5,0.00058,141364,16.42274,860782
5490,laurovenancio,5,0.00058,141369,16.42332,860782
5491,lcapaldo,5,0.00058,141374,16.42390,860782
5492,lccro,5,0.00058,141379,16.42448,860782
5493,ldpliu,5,0.00058,141384,16.42506,860782
5494,LenzGr,5,0.00058,141389,16.42565,860782
5495,leongor,5,0.00058,141394,16.42623,860782
5496,leosunmo,5,0.00058,141399,16.42681,860782
5497,leroy-chen,5,0.00058,141404,16.42739,860782
5498,lescactus,5,0.00058,141409,16.42797,860782
5499,Leulz,5,0.00058,141414,16.42855,860782
5500,lewisay,5,0.00058,141419,16.42913,860782
5501,lgypro,5,0.00058,141424,16.42971,860782
5502,lheinlen,5,0.00058,141429,16.43029,860782
5503,liabio,5,0.00058,141434,16.43087,860782
5504,li-adrienloiseau,5,0.00058,141439,16.43145,860782
5505,lining2020,5,0.00058,141444,16.43204,860782
5506,Lin-Liang,5,0.00058,141449,16.43262,860782
5507,linuxauditor,5,0.00058,141454,16.43320,860782
5508,liruishan,5,0.00058,141459,16.43378,860782
5509,liticia-hub,5,0.00058,141464,16.43436,860782
5510,ljch2018,5,0.00058,141469,16.43494,860782
5511,lli-hiya,5,0.00058,141474,16.43552,860782
5512,lnattrass,5,0.00058,141479,16.43610,860782
5513,lnovara,5,0.00058,141484,16.43668,860782
5514,logdnalf,5,0.00058,141489,16.43726,860782
5515,logicbomb421,5,0.00058,141494,16.43784,860782
5516,logicflakes,5,0.00058,141499,16.43842,860782
5517,logileifs,5,0.00058,141504,16.43901,860782
5518,lomori,5,0.00058,141509,16.43959,860782
5519,longfei-zhang,5,0.00058,141514,16.44017,860782
5520,lovexiongmao,5,0.00058,141519,16.44075,860782
5521,lowkeyliesmyth,5,0.00058,141524,16.44133,860782
5522,lr-carmichael,5,0.00058,141529,16.44191,860782
5523,lrodorigo,5,0.00058,141534,16.44249,860782
5524,lu4t,5,0.00058,141539,16.44307,860782
5525,lucascollino,5,0.00058,141544,16.44365,860782
5526,lucheeseng827,5,0.00058,141549,16.44423,860782
5527,luckyl3,5,0.00058,141554,16.44481,860782
5528,lugeng,5,0.00058,141559,16.44540,860782
5529,luisfmcalado,5,0.00058,141564,16.44598,860782
5530,lukaszbudnik,5,0.00058,141569,16.44656,860782
5531,LukeBalizetPatriot,5,0.00058,141574,16.44714,860782
5532,LukeChannings,5,0.00058,141579,16.44772,860782
5533,LukeCz,5,0.00058,141584,16.44830,860782
5534,lukeschlather,5,0.00058,141589,16.44888,860782
5535,LukeWood,5,0.00058,141594,16.44946,860782
5536,LunaticZorr,5,0.00058,141599,16.45004,860782
5537,lurenjia528,5,0.00058,141604,16.45062,860782
5538,lut777,5,0.00058,141609,16.45120,860782
5539,lwmxiaobei,5,0.00058,141614,16.45178,860782
5540,lxnch,5,0.00058,141619,16.45237,860782
5541,lyind,5,0.00058,141624,16.45295,860782
5542,lz006,5,0.00058,141629,16.45353,860782
5543,mac2000,5,0.00058,141634,16.45411,860782
5544,maelfosso,5,0.00058,141639,16.45469,860782
5545,maelvls,5,0.00058,141644,16.45527,860782
5546,Magnitus-,5,0.00058,141649,16.45585,860782
5547,mahendrabagul,5,0.00058,141654,16.45643,860782
5548,Mahesh-MSFT,5,0.00058,141659,16.45701,860782
5549,mahmoudshirivaramini,5,0.00058,141664,16.45759,860782
5550,MaksimKiselev,5,0.00058,141669,16.45817,860782
5551,malmuzaini,5,0.00058,141674,16.45875,860782
5552,mandre,5,0.00058,141679,16.45934,860782
5553,Manjul1987,5,0.00058,141684,16.45992,860782
5554,maozza,5,0.00058,141689,16.46050,860782
5555,mar1ged,5,0.00058,141694,16.46108,860782
5556,marcoferrer,5,0.00058,141699,16.46166,860782
5557,mariuskiessling,5,0.00058,141704,16.46224,860782
5558,mariusmarais,5,0.00058,141709,16.46282,860782
5559,mariusziemke,5,0.00058,141714,16.46340,860782
5560,MarlonGamez,5,0.00058,141719,16.46398,860782
5561,martijn,5,0.00058,141724,16.46456,860782
5562,martinisoft,5,0.00058,141729,16.46514,860782
5563,martinlevesque,5,0.00058,141734,16.46573,860782
5564,MartinLogan,5,0.00058,141739,16.46631,860782
5565,martinounap,5,0.00058,141744,16.46689,860782
5566,MaruHyl,5,0.00058,141749,16.46747,860782
5567,Marx2,5,0.00058,141754,16.46805,860782
5568,masih,5,0.00058,141759,16.46863,860782
5569,masihtehrani,5,0.00058,141764,16.46921,860782
5570,maskeda,5,0.00058,141769,16.46979,860782
5571,MatthewDolan,5,0.00058,141774,16.47037,860782
5572,maxliu007,5,0.00058,141779,16.47095,860782
5573,maxmil7,5,0.00058,141784,16.47153,860782
5574,maxweisel,5,0.00058,141789,16.47211,860782
5575,mbaglole,5,0.00058,141794,16.47270,860782
5576,mbolek,5,0.00058,141799,16.47328,860782
5577,mcritchlow,5,0.00058,141804,16.47386,860782
5578,medzin,5,0.00058,141809,16.47444,860782
5579,megian,5,0.00058,141814,16.47502,860782
5580,mei2015,5,0.00058,141819,16.47560,860782
5581,melissajenner22,5,0.00058,141824,16.47618,860782
5582,MelissaOS,5,0.00058,141829,16.47676,860782
5583,MeNsaaH,5,0.00058,141834,16.47734,860782
5584,merryzhou,5,0.00058,141839,16.47792,860782
5585,mgsnuno,5,0.00058,141844,16.47850,860782
5586,mhr3,5,0.00058,141849,16.47909,860782
5587,michelefa1988,5,0.00058,141854,16.47967,860782
5588,michel-zimmer,5,0.00058,141859,16.48025,860782
5589,mickkael,5,0.00058,141864,16.48083,860782
5590,mike1808,5,0.00058,141869,16.48141,860782
5591,MikeGoltsov,5,0.00058,141874,16.48199,860782
5592,mik-laj,5,0.00058,141879,16.48257,860782
5593,mikroskeem,5,0.00058,141884,16.48315,860782
5594,mimoo,5,0.00058,141889,16.48373,860782
5595,mindyor,5,0.00058,141894,16.48431,860782
5596,minond,5,0.00058,141899,16.48489,860782
5597,minskiter,5,0.00058,141904,16.48547,860782
5598,miyakz1192,5,0.00058,141909,16.48606,860782
5599,mkilchhofer,5,0.00058,141914,16.48664,860782
5600,mkmojo,5,0.00058,141919,16.48722,860782
5601,mochja,5,0.00058,141924,16.48780,860782
5602,mohitevishal,5,0.00058,141929,16.48838,860782
5603,mohsenmottaghi,5,0.00058,141934,16.48896,860782
5604,moikot,5,0.00058,141939,16.48954,860782
5605,moljor,5,0.00058,141944,16.49012,860782
5606,mortenhauberg,5,0.00058,141949,16.49070,860782
5607,MOURYA00,5,0.00058,141954,16.49128,860782
5608,mrfaizal,5,0.00058,141959,16.49186,860782
5609,mrsimo,5,0.00058,141964,16.49245,860782
5610,mscholze,5,0.00058,141969,16.49303,860782
5611,msgongora,5,0.00058,141974,16.49361,860782
5612,msrinivascharan,5,0.00058,141979,16.49419,860782
5613,mszabo-wikia,5,0.00058,141984,16.49477,860782
5614,mtahmed,5,0.00058,141989,16.49535,860782
5615,mudasar187,5,0.00058,141994,16.49593,860782
5616,mukuntharajaa,5,0.00058,141999,16.49651,860782
5617,mumrau,5,0.00058,142004,16.49709,860782
5618,muralikri32,5,0.00058,142009,16.49767,860782
5619,mvalliath,5,0.00058,142014,16.49825,860782
5620,mvgijssel,5,0.00058,142019,16.49883,860782
5621,mycrEEpy,5,0.00058,142024,16.49942,860782
5622,MyIgel,5,0.00058,142029,16.50000,860782
5623,NadavkOptimalQ,5,0.00058,142034,16.50058,860782
5624,nairb,5,0.00058,142039,16.50116,860782
5625,nakatamixi,5,0.00058,142044,16.50174,860782
5626,Namphibian,5,0.00058,142049,16.50232,860782
5627,nanorobocop,5,0.00058,142054,16.50290,860782
5628,NareshBhanawat,5,0.00058,142059,16.50348,860782
5629,nareshdesh,5,0.00058,142064,16.50406,860782
5630,nateshmbhat,5,0.00058,142069,16.50464,860782
5631,nathan-beneke,5,0.00058,142074,16.50522,860782
5632,nccurry,5,0.00058,142079,16.50581,860782
5633,ncioj10,5,0.00058,142084,16.50639,860782
5634,ncreated,5,0.00058,142089,16.50697,860782
5635,neel8989,5,0.00058,142094,16.50755,860782
5636,neetuom,5,0.00058,142099,16.50813,860782
5637,neilstevenson,5,0.00058,142104,16.50871,860782
5638,nextrevision,5,0.00058,142109,16.50929,860782
5639,nextus,5,0.00058,142114,16.50987,860782
5640,nguse,5,0.00058,142119,16.51045,860782
5641,NickTaporuk,5,0.00058,142124,16.51103,860782
5642,nico0olas,5,0.00058,142129,16.51161,860782
5643,nicolacdnll,5,0.00058,142134,16.51219,860782
5644,niedhui,5,0.00058,142139,16.51278,860782
5645,nigelellis,5,0.00058,142144,16.51336,860782
5646,nikhilc89,5,0.00058,142149,16.51394,860782
5647,nikhilmuz,5,0.00058,142154,16.51452,860782
5648,nikhil-zadoo,5,0.00058,142159,16.51510,860782
5649,nilium,5,0.00058,142164,16.51568,860782
5650,nirmal-mehta,5,0.00058,142169,16.51626,860782
5651,nirrozenbaum,5,0.00058,142174,16.51684,860782
5652,nisargshah95,5,0.00058,142179,16.51742,860782
5653,nithu0115,5,0.00058,142184,16.51800,860782
5654,nitishpt,5,0.00058,142189,16.51858,860782
5655,nitishvu,5,0.00058,142194,16.51917,860782
5656,nlykkei,5,0.00058,142199,16.51975,860782
5657,nmarcetic,5,0.00058,142204,16.52033,860782
5658,nniehoff,5,0.00058,142209,16.52091,860782
5659,noambenami,5,0.00058,142214,16.52149,860782
5660,nokia-t1zhou,5,0.00058,142219,16.52207,860782
5661,Noremac201,5,0.00058,142224,16.52265,860782
5662,norswap,5,0.00058,142229,16.52323,860782
5663,nosteine,5,0.00058,142234,16.52381,860782
5664,notariuss,5,0.00058,142239,16.52439,860782
5665,npajkovsky,5,0.00058,142244,16.52497,860782
5666,npehrsson,5,0.00058,142249,16.52555,860782
5667,nrusinko,5,0.00058,142254,16.52614,860782
5668,nullzone,5,0.00058,142259,16.52672,860782
5669,numerology,5,0.00058,142264,16.52730,860782
5670,nurekage,5,0.00058,142269,16.52788,860782
5671,nyetsche,5,0.00058,142274,16.52846,860782
5672,nykma,5,0.00058,142279,16.52904,860782
5673,nynymike,5,0.00058,142284,16.52962,860782
5674,obeyda,5,0.00058,142289,16.53020,860782
5675,obiwanjacobi,5,0.00058,142294,16.53078,860782
5676,Obleskar,5,0.00058,142299,16.53136,860782
5677,odsod,5,0.00058,142304,16.53194,860782
5678,ogauthier,5,0.00058,142309,16.53253,860782
5679,OheyThere,5,0.00058,142314,16.53311,860782
5680,olivegak971,5,0.00058,142319,16.53369,860782
5681,OliverEvans96,5,0.00058,142324,16.53427,860782
5682,omicron-b,5,0.00058,142329,16.53485,860782
5683,omitrowski,5,0.00058,142334,16.53543,860782
5684,on4tux,5,0.00058,142339,16.53601,860782
5685,onsd,5,0.00058,142344,16.53659,860782
5686,oranje42,5,0.00058,142349,16.53717,860782
5687,orcaman,5,0.00058,142354,16.53775,860782
5688,OrlinVasilev,5,0.00058,142359,16.53833,860782
5689,Orobas-D,5,0.00058,142364,16.53891,860782
5690,osela,5,0.00058,142369,16.53950,860782
5691,os-virtualretail,5,0.00058,142374,16.54008,860782
5692,pabloxio,5,0.00058,142379,16.54066,860782
5693,pacu,5,0.00058,142384,16.54124,860782
5694,palsivertsen,5,0.00058,142389,16.54182,860782
5695,pambrose,5,0.00058,142394,16.54240,860782
5696,pancudaniel7,5,0.00058,142399,16.54298,860782
5697,pantelis-karamolegkos,5,0.00058,142404,16.54356,860782
5698,pardhasm,5,0.00058,142409,16.54414,860782
5699,pathikritmodak,5,0.00058,142414,16.54472,860782
5700,patricekrakow,5,0.00058,142419,16.54530,860782
5701,patrickdevivo,5,0.00058,142424,16.54589,860782
5702,paul42,5,0.00058,142429,16.54647,860782
5703,paulobezerr,5,0.00058,142434,16.54705,860782
5704,paulsinai,5,0.00058,142439,16.54763,860782
5705,pawelpetruch,5,0.00058,142444,16.54821,860782
5706,pbatg,5,0.00058,142449,16.54879,860782
5707,pbudds,5,0.00058,142454,16.54937,860782
5708,pcarranza,5,0.00058,142459,16.54995,860782
5709,pcfens,5,0.00058,142464,16.55053,860782
5710,pchychi-blox,5,0.00058,142469,16.55111,860782
5711,pdmars,5,0.00058,142474,16.55169,860782
5712,pdxkzeerkti,5,0.00058,142479,16.55227,860782
5713,peacocktrain,5,0.00058,142484,16.55286,860782
5714,PeiyuanQi,5,0.00058,142489,16.55344,860782
5715,pengfeiwang-cn,5,0.00058,142494,16.55402,860782
5716,penland365,5,0.00058,142499,16.55460,860782
5717,peopleone,5,0.00058,142504,16.55518,860782
5718,perty,5,0.00058,142509,16.55576,860782
5719,pete-thecat,5,0.00058,142514,16.55634,860782
5720,pgonin,5,0.00058,142519,16.55692,860782
5721,pierreprinetti,5,0.00058,142524,16.55750,860782
5722,pikot,5,0.00058,142529,16.55808,860782
5723,pikrzysztof,5,0.00058,142534,16.55866,860782
5724,pir8g33k,5,0.00058,142539,16.55924,860782
5725,PlatanoBailando,5,0.00058,142544,16.55983,860782
5726,pleonex,5,0.00058,142549,16.56041,860782
5727,plsnotracking,5,0.00058,142554,16.56099,860782
5728,pnnlrck8sstatus,5,0.00058,142559,16.56157,860782
5729,podothecat,5,0.00058,142564,16.56215,860782
5730,Portshift-Admin,5,0.00058,142569,16.56273,860782
5731,posteingang,5,0.00058,142574,16.56331,860782
5732,Prajwal-Koirala,5,0.00058,142579,16.56389,860782
5733,prakasa-tkpd,5,0.00058,142584,16.56447,860782
5734,praveenthuwat,5,0.00058,142589,16.56505,860782
5735,prince2208,5,0.00058,142594,16.56563,860782
5736,prithvi1307,5,0.00058,142599,16.56622,860782
5737,ps-feng,5,0.00058,142604,16.56680,860782
5738,pshanoop,5,0.00058,142609,16.56738,860782
5739,ptramsey,5,0.00058,142614,16.56796,860782
5740,pujumuslimah,5,0.00058,142619,16.56854,860782
5741,puneetloya,5,0.00058,142624,16.56912,860782
5742,Pycorax,5,0.00058,142629,16.56970,860782
5743,qingcai594,5,0.00058,142634,16.57028,860782
5744,qinshaoxuan,5,0.00058,142639,16.57086,860782
5745,quiye,5,0.00058,142644,16.57144,860782
5746,qw4990,5,0.00058,142649,16.57202,860782
5747,qzwlinux,5,0.00058,142654,16.57260,860782
5748,R4scal,5,0.00058,142659,16.57319,860782
5749,radicand,5,0.00058,142664,16.57377,860782
5750,radut,5,0.00058,142669,16.57435,860782
5751,RagingPuppies,5,0.00058,142674,16.57493,860782
5752,RainorshineGW,5,0.00058,142679,16.57551,860782
5753,rajeshwrn,5,0.00058,142684,16.57609,860782
5754,rajivmucheli,5,0.00058,142689,16.57667,860782
5755,rajputvishwas,5,0.00058,142694,16.57725,860782
5756,rakesh-007,5,0.00058,142699,16.57783,860782
5757,rakkum,5,0.00058,142704,16.57841,860782
5758,RandyLevensalor,5,0.00058,142709,16.57899,860782
5759,Ranguo01,5,0.00058,142714,16.57958,860782
5760,Rantanen,5,0.00058,142719,16.58016,860782
5761,Ratiborec,5,0.00058,142724,16.58074,860782
5762,rayanebel,5,0.00058,142729,16.58132,860782
5763,raz08,5,0.00058,142734,16.58190,860782
5764,raz3k,5,0.00058,142739,16.58248,860782
5765,rcastagnet,5,0.00058,142744,16.58306,860782
5766,rdgacarvalho,5,0.00058,142749,16.58364,860782
5767,rdxilano,5,0.00058,142754,16.58422,860782
5768,realmjian,5,0.00058,142759,16.58480,860782
5769,rebrendov,5,0.00058,142764,16.58538,860782
5770,reggie-k,5,0.00058,142769,16.58596,860782
5771,regulskimichal,5,0.00058,142774,16.58655,860782
5772,reicheltp,5,0.00058,142779,16.58713,860782
5773,remilapeyre,5,0.00058,142784,16.58771,860782
5774,remkolems,5,0.00058,142789,16.58829,860782
5775,renjithkm86,5,0.00058,142794,16.58887,860782
5776,Renz2018,5,0.00058,142799,16.58945,860782
5777,reta,5,0.00058,142804,16.59003,860782
5778,return02,5,0.00058,142809,16.59061,860782
5779,rhummelmose,5,0.00058,142814,16.59119,860782
5780,riquemon,5,0.00058,142819,16.59177,860782
5781,RJrocks,5,0.00058,142824,16.59235,860782
5782,rkbalgi,5,0.00058,142829,16.59294,860782
5783,rleekin,5,0.00058,142834,16.59352,860782
5784,rmazzine,5,0.00058,142839,16.59410,860782
5785,rnkhouse,5,0.00058,142844,16.59468,860782
5786,RobertoHuang,5,0.00058,142849,16.59526,860782
5787,robincw-gr,5,0.00058,142854,16.59584,860782
5788,robinp-tw,5,0.00058,142859,16.59642,860782
5789,robrys,5,0.00058,142864,16.59700,860782
5790,rodnymolina,5,0.00058,142869,16.59758,860782
5791,rofafor,5,0.00058,142874,16.59816,860782
5792,roman-ferstl,5,0.00058,142879,16.59874,860782
5793,romankor,5,0.00058,142884,16.59932,860782
5794,romejoe,5,0.00058,142889,16.59991,860782
5795,Romiko,5,0.00058,142894,16.60049,860782
5796,R-omk,5,0.00058,142899,16.60107,860782
5797,RonnyMaas,5,0.00058,142904,16.60165,860782
5798,RoSk0,5,0.00058,142909,16.60223,860782
5799,roy-work,5,0.00058,142914,16.60281,860782
5800,rpahli,5,0.00058,142919,16.60339,860782
5801,rr0hit,5,0.00058,142924,16.60397,860782
5802,rramanan15,5,0.00058,142929,16.60455,860782
5803,rudeigerc,5,0.00058,142934,16.60513,860782
5804,rueyaa332266,5,0.00058,142939,16.60571,860782
5805,runzhiwang,5,0.00058,142944,16.60630,860782
5806,rur0,5,0.00058,142949,16.60688,860782
5807,rushi47,5,0.00058,142954,16.60746,860782
5808,russoj88,5,0.00058,142959,16.60804,860782
5809,rvennam-lbg,5,0.00058,142964,16.60862,860782
5810,rvgud,5,0.00058,142969,16.60920,860782
5811,rvolykh,5,0.00058,142974,16.60978,860782
5812,ryaneorth,5,0.00058,142979,16.61036,860782
5813,ryanlyy,5,0.00058,142984,16.61094,860782
5814,ryanmt,5,0.00058,142989,16.61152,860782
5815,RyanSquared,5,0.00058,142994,16.61210,860782
5816,RyPeck,5,0.00058,142999,16.61268,860782
5817,Saberos,5,0.00058,143004,16.61327,860782
5818,sagarkal,5,0.00058,143009,16.61385,860782
5819,sagar-kolli,5,0.00058,143014,16.61443,860782
5820,saimanoj01,5,0.00058,143019,16.61501,860782
5821,saintnoah,5,0.00058,143024,16.61559,860782
5822,saiteja313,5,0.00058,143029,16.61617,860782
5823,sambr7,5,0.00058,143034,16.61675,860782
5824,samirmajen,5,0.00058,143039,16.61733,860782
5825,samrose,5,0.00058,143044,16.61791,860782
5826,samschlegel,5,0.00058,143049,16.61849,860782
5827,sanderma,5,0.00058,143054,16.61907,860782
5828,sangeethdba,5,0.00058,143059,16.61966,860782
5829,Sanghshree,5,0.00058,143064,16.62024,860782
5830,sarveshtamba,5,0.00058,143069,16.62082,860782
5831,sashiakula,5,0.00058,143074,16.62140,860782
5832,sateesh3550,5,0.00058,143079,16.62198,860782
5833,schlueter,5,0.00058,143084,16.62256,860782
5834,schnatterer,5,0.00058,143089,16.62314,860782
5835,schwichtgit,5,0.00058,143094,16.62372,860782
5836,scr-oath,5,0.00058,143099,16.62430,860782
5837,SebStrug,5,0.00058,143104,16.62488,860782
5838,sergey-safarov,5,0.00058,143109,16.62546,860782
5839,sethbergman,5,0.00058,143114,16.62604,860782
5840,sfnihilworlks,5,0.00058,143119,16.62663,860782
5841,sgaruda,5,0.00058,143124,16.62721,860782
5842,shachardevops,5,0.00058,143129,16.62779,860782
5843,shahamit2,5,0.00058,143134,16.62837,860782
5844,Shahard2,5,0.00058,143139,16.62895,860782
5845,shanleyHe,5,0.00058,143144,16.62953,860782
5846,shashankkoppar,5,0.00058,143149,16.63011,860782
5847,Shawn5141,5,0.00058,143154,16.63069,860782
5848,shawnU96,5,0.00058,143159,16.63127,860782
5849,sheeeng,5,0.00058,143164,16.63185,860782
5850,shikhar7,5,0.00058,143169,16.63243,860782
5851,shimajiro1111,5,0.00058,143174,16.63302,860782
5852,shivoham77,5,0.00058,143179,16.63360,860782
5853,shohidulhaque,5,0.00058,143184,16.63418,860782
5854,Shuanglu,5,0.00058,143189,16.63476,860782
5855,ShubhamB99,5,0.00058,143194,16.63534,860782
5856,shubhamranjan,5,0.00058,143199,16.63592,860782
5857,shunyy,5,0.00058,143204,16.63650,860782
5858,shyimo,5,0.00058,143209,16.63708,860782
5859,SidGrundfos,5,0.00058,143214,16.63766,860782
5860,sigtrap,5,0.00058,143219,16.63824,860782
5861,silencej,5,0.00058,143224,16.63882,860782
5862,Simeda,5,0.00058,143229,16.63940,860782
5863,simonc-613,5,0.00058,143234,16.63999,860782
5864,simone02f,5,0.00058,143239,16.64057,860782
5865,simonmacklin,5,0.00058,143244,16.64115,860782
5866,SimSmith,5,0.00058,143249,16.64173,860782
5867,Sindica,5,0.00058,143254,16.64231,860782
5868,skamboj,5,0.00058,143259,16.64289,860782
5869,slashmo,5,0.00058,143264,16.64347,860782
5870,SleepyBrett,5,0.00058,143269,16.64405,860782
5871,smnbbrv,5,0.00058,143274,16.64463,860782
5872,smueller18,5,0.00058,143279,16.64521,860782
5873,snehachhabria,5,0.00058,143284,16.64579,860782
5874,snehakpersistent,5,0.00058,143289,16.64638,860782
5875,snowmansora,5,0.00058,143294,16.64696,860782
5876,solarkennedy,5,0.00058,143299,16.64754,860782
5877,solomonhume,5,0.00058,143304,16.64812,860782
5878,sooron,5,0.00058,143309,16.64870,860782
5879,soulawaker,5,0.00058,143314,16.64928,860782
5880,sourcedelica,5,0.00058,143319,16.64986,860782
5881,sprotznock85,5,0.00058,143324,16.65044,860782
5882,srados,5,0.00058,143329,16.65102,860782
5883,ssdowdavalon,5,0.00058,143334,16.65160,860782
5884,sshoster,5,0.00058,143339,16.65218,860782
5885,steerben,5,0.00058,143344,16.65276,860782
5886,stefanbucur,5,0.00058,143349,16.65335,860782
5887,stefan-kolb,5,0.00058,143354,16.65393,860782
5888,stefanm8,5,0.00058,143359,16.65451,860782
5889,stephen-dexda,5,0.00058,143364,16.65509,860782
5890,stephenliang,5,0.00058,143369,16.65567,860782
5891,steve-fraser,5,0.00058,143374,16.65625,860782
5892,strangeminds,5,0.00058,143379,16.65683,860782
5893,stringang,5,0.00058,143384,16.65741,860782
5894,strobil,5,0.00058,143389,16.65799,860782
5895,stujb,5,0.00058,143394,16.65857,860782
5896,subnova-etsy,5,0.00058,143399,16.65915,860782
5897,subrnath,5,0.00058,143404,16.65973,860782
5898,sukhong,5,0.00058,143409,16.66032,860782
5899,sumitKash,5,0.00058,143414,16.66090,860782
5900,sungchun12,5,0.00058,143419,16.66148,860782
5901,sunlianqiang,5,0.00058,143424,16.66206,860782
5902,sunmou99,5,0.00058,143429,16.66264,860782
5903,sunnoy,5,0.00058,143434,16.66322,860782
5904,superbeer,5,0.00058,143439,16.66380,860782
5905,sushilsuresh,5,0.00058,143444,16.66438,860782
5906,sutaakar,5,0.00058,143449,16.66496,860782
5907,svenwiltink,5,0.00058,143454,16.66554,860782
5908,SwEngin,5,0.00058,143459,16.66612,860782
5909,syepes,5,0.00058,143464,16.66671,860782
5910,t83714,5,0.00058,143469,16.66729,860782
5911,tafkam,5,0.00058,143474,16.66787,860782
5912,talal,5,0.00058,143479,16.66845,860782
5913,tamilmani1989,5,0.00058,143484,16.66903,860782
5914,tanejar,5,0.00058,143489,16.66961,860782
5915,tanelso2,5,0.00058,143494,16.67019,860782
5916,tanweernoor,5,0.00058,143499,16.67077,860782
5917,tarjintor,5,0.00058,143504,16.67135,860782
5918,taru-svg,5,0.00058,143509,16.67193,860782
5919,Taurino3,5,0.00058,143514,16.67251,860782
5920,tboerger,5,0.00058,143519,16.67309,860782
5921,tbsoares,5,0.00058,143524,16.67368,860782
5922,tctovsli,5,0.00058,143529,16.67426,860782
5923,tculp,5,0.00058,143534,16.67484,860782
5924,TeAmP0is0N,5,0.00058,143539,16.67542,860782
5925,Techinica,5,0.00058,143544,16.67600,860782
5926,tedbrunelle,5,0.00058,143549,16.67658,860782
5927,tehho,5,0.00058,143554,16.67716,860782
5928,terrych0u,5,0.00058,143559,16.67774,860782
5929,TFTomSun,5,0.00058,143564,16.67832,860782
5930,thatdevsherry,5,0.00058,143569,16.67890,860782
5931,theanotherwise,5,0.00058,143574,16.67948,860782
5932,TheComice,5,0.00058,143579,16.68007,860782
5933,thedevelopnik,5,0.00058,143584,16.68065,860782
5934,thelinuxlich,5,0.00058,143589,16.68123,860782
5935,ThelonKarrde,5,0.00058,143594,16.68181,860782
5936,theStrayPointer,5,0.00058,143599,16.68239,860782
5937,thetruechar,5,0.00058,143604,16.68297,860782
5938,thiagoyeds,5,0.00058,143609,16.68355,860782
5939,tiffanyjachja,5,0.00058,143614,16.68413,860782
5940,tim-elliott,5,0.00058,143619,16.68471,860782
5941,timyl,5,0.00058,143624,16.68529,860782
5942,todd-davenport,5,0.00058,143629,16.68587,860782
5943,tolgatanriverdi,5,0.00058,143634,16.68645,860782
5944,TomatoAres,5,0.00058,143639,16.68704,860782
5945,tom-dudley,5,0.00058,143644,16.68762,860782
5946,tommazzo89,5,0.00058,143649,16.68820,860782
5947,toninis,5,0.00058,143654,16.68878,860782
5948,tonymmm1,5,0.00058,143659,16.68936,860782
5949,trashhalo,5,0.00058,143664,16.68994,860782
5950,trinadsz,5,0.00058,143669,16.69052,860782
5951,TroubleConsultant,5,0.00058,143674,16.69110,860782
5952,tsraza,5,0.00058,143679,16.69168,860782
5953,tstraley,5,0.00058,143684,16.69226,860782
5954,ttalal,5,0.00058,143689,16.69284,860782
5955,tuckerconnelly,5,0.00058,143694,16.69343,860782
5956,tweej,5,0.00058,143699,16.69401,860782
5957,tyler-at-fast,5,0.00058,143704,16.69459,860782
5958,tzuryby,5,0.00058,143709,16.69517,860782
5959,uchi-mata,5,0.00058,143714,16.69575,860782
5960,uecasm,5,0.00058,143719,16.69633,860782
5961,uhthomas,5,0.00058,143724,16.69691,860782
5962,ulucinar,5,0.00058,143729,16.69749,860782
5963,unbyte,5,0.00058,143734,16.69807,860782
5964,unclepieman,5,0.00058,143739,16.69865,860782
5965,unixzen,5,0.00058,143744,16.69923,860782
5966,ustuzhanin,5,0.00058,143749,16.69981,860782
5967,uzxmx,5,0.00058,143754,16.70040,860782
5968,v1b1,5,0.00058,143759,16.70098,860782
5969,vadim-egt,5,0.00058,143764,16.70156,860782
5970,vaibhavk,5,0.00058,143769,16.70214,860782
5971,vaporpin,5,0.00058,143774,16.70272,860782
5972,vardans6,5,0.00058,143779,16.70330,860782
5973,varungur,5,0.00058,143784,16.70388,860782
5974,vasanth29797,5,0.00058,143789,16.70446,860782
5975,vashish1,5,0.00058,143794,16.70504,860782
5976,vbohinc,5,0.00058,143799,16.70562,860782
5977,veeramalla-f5,5,0.00058,143804,16.70620,860782
5978,Velektron,5,0.00058,143809,16.70679,860782
5979,velvetkeyboard,5,0.00058,143814,16.70737,860782
5980,Vickey-Wu,5,0.00058,143819,16.70795,860782
5981,vijaygharge,5,0.00058,143824,16.70853,860782
5982,vijaygos,5,0.00058,143829,16.70911,860782
5983,VinothChinnadurai,5,0.00058,143834,16.70969,860782
5984,vinsguru,5,0.00058,143839,16.71027,860782
5985,viorelcanja,5,0.00058,143844,16.71085,860782
5986,vip30,5,0.00058,143849,16.71143,860782
5987,virusdave,5,0.00058,143854,16.71201,860782
5988,vishjain,5,0.00058,143859,16.71259,860782
5989,vishnuravi3186,5,0.00058,143864,16.71317,860782
5990,vishwa306,5,0.00058,143869,16.71376,860782
5991,vistamin,5,0.00058,143874,16.71434,860782
5992,vjda,5,0.00058,143879,16.71492,860782
5993,vladut2403,5,0.00058,143884,16.71550,860782
5994,vlad-vinogradov,5,0.00058,143889,16.71608,860782
5995,vmarkovtsev,5,0.00058,143894,16.71666,860782
5996,vmorris,5,0.00058,143899,16.71724,860782
5997,vyom-soft,5,0.00058,143904,16.71782,860782
5998,waelmas,5,0.00058,143909,16.71840,860782
5999,wagnst,5,0.00058,143914,16.71898,860782
6000,wallabyies,5,0.00058,143919,16.71956,860782
6001,walls00000,5,0.00058,143924,16.72015,860782
6002,wanfuuyu,5,0.00058,143929,16.72073,860782
6003,wangfakang,5,0.00058,143934,16.72131,860782
6004,wangzh21,5,0.00058,143939,16.72189,860782
6005,warent,5,0.00058,143944,16.72247,860782
6006,warrentmills,5,0.00058,143949,16.72305,860782
6007,WebDmitryPetrov,5,0.00058,143954,16.72363,860782
6008,web-refinery,5,0.00058,143959,16.72421,860782
6009,weizhouBlue,5,0.00058,143964,16.72479,860782
6010,wellbastos,5,0.00058,143969,16.72537,860782
6011,WenwuPeng,5,0.00058,143974,16.72595,860782
6012,wesleywh,5,0.00058,143979,16.72653,860782
6013,whenhellfreezes,5,0.00058,143984,16.72712,860782
6014,whymatter,5,0.00058,143989,16.72770,860782
6015,wilbry,5,0.00058,143994,16.72828,860782
6016,wildermesser,5,0.00058,143999,16.72886,860782
6017,willdeuschle,5,0.00058,144004,16.72944,860782
6018,williamaronli,5,0.00058,144009,16.73002,860782
6019,windegao,5,0.00058,144014,16.73060,860782
6020,wisre,5,0.00058,144019,16.73118,860782
6021,withqingshao,5,0.00058,144024,16.73176,860782
6022,wolf99,5,0.00058,144029,16.73234,860782
6023,wooviet,5,0.00058,144034,16.73292,860782
6024,wpwoodjr,5,0.00058,144039,16.73351,860782
6025,wrdls,5,0.00058,144044,16.73409,860782
6026,wuestkamp,5,0.00058,144049,16.73467,860782
6027,wwillsey,5,0.00058,144054,16.73525,860782
6028,XanderStrike,5,0.00058,144059,16.73583,860782
6029,x-bytes,5,0.00058,144064,16.73641,860782
6030,xiangyu123,5,0.00058,144069,16.73699,860782
6031,xiaohuanxj,5,0.00058,144074,16.73757,860782
6032,xmcqueen,5,0.00058,144079,16.73815,860782
6033,xtreme-nitin-ravindran,5,0.00058,144084,16.73873,860782
6034,xujyan,5,0.00058,144089,16.73931,860782
6035,xwu2git,5,0.00058,144094,16.73989,860782
6036,xxpniu,5,0.00058,144099,16.74048,860782
6037,yallie,5,0.00058,144104,16.74106,860782
6038,yaminisridaran,5,0.00058,144109,16.74164,860782
6039,YanChii,5,0.00058,144114,16.74222,860782
6040,yangchuan37326,5,0.00058,144119,16.74280,860782
6041,yanosh1982,5,0.00058,144124,16.74338,860782
6042,yanush51,5,0.00058,144129,16.74396,860782
6043,yashghia,5,0.00058,144134,16.74454,860782
6044,yehudamakarov,5,0.00058,144139,16.74512,860782
6045,Yepez1997,5,0.00058,144144,16.74570,860782
6046,yiyigit,5,0.00058,144149,16.74628,860782
6047,yiyouguisu,5,0.00058,144154,16.74687,860782
6048,yizhishang,5,0.00058,144159,16.74745,860782
6049,ymolists,5,0.00058,144164,16.74803,860782
6050,yoms,5,0.00058,144169,16.74861,860782
6051,yonirab,5,0.00058,144174,16.74919,860782
6052,youjiahe,5,0.00058,144179,16.74977,860782
6053,yteraoka,5,0.00058,144184,16.75035,860782
6054,yujingz,5,0.00058,144189,16.75093,860782
6055,yul14nrc,5,0.00058,144194,16.75151,860782
6056,YuvalAvra,5,0.00058,144199,16.75209,860782
6057,yuwtennis,5,0.00058,144204,16.75267,860782
6058,yuyulei,5,0.00058,144209,16.75325,860782
6059,yvanin,5,0.00058,144214,16.75384,860782
6060,yves-vogl,5,0.00058,144219,16.75442,860782
6061,zachomedia,5,0.00058,144224,16.75500,860782
6062,zak905,5,0.00058,144229,16.75558,860782
6063,zaro,5,0.00058,144234,16.75616,860782
6064,zawachte-msft,5,0.00058,144239,16.75674,860782
6065,zbigniew-mandziejewicz-3r,5,0.00058,144244,16.75732,860782
6066,zenman94,5,0.00058,144249,16.75790,860782
6067,zen-xu,5,0.00058,144254,16.75848,860782
6068,Zerotask,5,0.00058,144259,16.75906,860782
6069,zettaittenani,5,0.00058,144264,16.75964,860782
6070,zhiyanliu,5,0.00058,144269,16.76023,860782
6071,zhiyu0729,5,0.00058,144274,16.76081,860782
6072,ZhizhouTian,5,0.00058,144279,16.76139,860782
6073,zhujiangyou,5,0.00058,144284,16.76197,860782
6074,zimmski,5,0.00058,144289,16.76255,860782
6075,zjkmxy,5,0.00058,144294,16.76313,860782
6076,zlymeda,5,0.00058,144299,16.76371,860782
6077,zoetrope,5,0.00058,144304,16.76429,860782
6078,zouchengli,5,0.00058,144309,16.76487,860782
6079,zvolchak,5,0.00058,144314,16.76545,860782
6080,zxkane,5,0.00058,144319,16.76603,860782
6081,zyc801208,5,0.00058,144324,16.76661,860782
6082,0gajun,4,0.00046,144328,16.76708,860782
6083,1d2u3c,4,0.00046,144332,16.76754,860782
6084,1wpro2,4,0.00046,144336,16.76801,860782
6085,273539918,4,0.00046,144340,16.76847,860782
6086,3d0it,4,0.00046,144344,16.76894,860782
6087,70data,4,0.00046,144348,16.76940,860782
6088,aagarwalincontact,4,0.00046,144352,16.76987,860782
6089,aalcaraz97,4,0.00046,144356,16.77033,860782
6090,Aamir-raza-1,4,0.00046,144360,16.77080,860782
6091,aaomidi,4,0.00046,144364,16.77126,860782
6092,Aaron-23,4,0.00046,144368,16.77173,860782
6093,aaron-dsouza,4,0.00046,144372,16.77219,860782
6094,aaronj314,4,0.00046,144376,16.77266,860782
6095,aarontami,4,0.00046,144380,16.77312,860782
6096,aartinagdev,4,0.00046,144384,16.77358,860782
6097,aashish-chaubey,4,0.00046,144388,16.77405,860782
6098,aayush-rangwala,4,0.00046,144392,16.77451,860782
6099,abatilo,4,0.00046,144396,16.77498,860782
6100,AbelHu,4,0.00046,144400,16.77544,860782
6101,abezard,4,0.00046,144404,16.77591,860782
6102,abhaysi,4,0.00046,144408,16.77637,860782
6103,abhiniveshjain,4,0.00046,144412,16.77684,860782
6104,Abonazir,4,0.00046,144416,16.77730,860782
6105,achandras,4,0.00046,144420,16.77777,860782
6106,adamgoose,4,0.00046,144424,16.77823,860782
6107,adasari,4,0.00046,144428,16.77870,860782
6108,adiov,4,0.00046,144432,16.77916,860782
6109,AdityaBhansali1,4,0.00046,144436,16.77963,860782
6110,adnan-kamili,4,0.00046,144440,16.78009,860782
6111,adrian-thurston,4,0.00046,144444,16.78056,860782
6112,adriendelsalle,4,0.00046,144448,16.78102,860782
6113,adrienkohlbecker,4,0.00046,144452,16.78148,860782
6114,adw1n,4,0.00046,144456,16.78195,860782
6115,ae-ou,4,0.00046,144460,16.78241,860782
6116,after-the-sunrise,4,0.00046,144464,16.78288,860782
6117,AgentK20,4,0.00046,144468,16.78334,860782
6118,AGloberman,4,0.00046,144472,16.78381,860782
6119,agranado2k,4,0.00046,144476,16.78427,860782
6120,ahmed1smael,4,0.00046,144480,16.78474,860782
6121,ahuffman,4,0.00046,144484,16.78520,860782
6122,ajouve,4,0.00046,144488,16.78567,860782
6123,akamenev,4,0.00046,144492,16.78613,860782
6124,akhenakh,4,0.00046,144496,16.78660,860782
6125,akoumjian,4,0.00046,144500,16.78706,860782
6126,alanbchristie,4,0.00046,144504,16.78753,860782
6127,alastor-erinyes,4,0.00046,144508,16.78799,860782
6128,albertollamaso,4,0.00046,144512,16.78846,860782
6129,albertschwarzkopf,4,0.00046,144516,16.78892,860782
6130,aldelucca1,4,0.00046,144520,16.78938,860782
6131,aleb,4,0.00046,144524,16.78985,860782
6132,AleksanderGondek,4,0.00046,144528,16.79031,860782
6133,aleksmark,4,0.00046,144532,16.79078,860782
6134,alevchuk,4,0.00046,144536,16.79124,860782
6135,alexandrubordei,4,0.00046,144540,16.79171,860782
6136,AlexeiScherbakov,4,0.00046,144544,16.79217,860782
6137,alexeykaplin,4,0.00046,144548,16.79264,860782
6138,alexhcheng,4,0.00046,144552,16.79310,860782
6139,alexia19apl,4,0.00046,144556,16.79357,860782
6140,alexjh,4,0.00046,144560,16.79403,860782
6141,alexjuchina,4,0.00046,144564,16.79450,860782
6142,alexjurkiewicz,4,0.00046,144568,16.79496,860782
6143,alexmirkhaydarov,4,0.00046,144572,16.79543,860782
6144,alex-netris,4,0.00046,144576,16.79589,860782
6145,alex-tsbk,4,0.00046,144580,16.79635,860782
6146,alexwo,4,0.00046,144584,16.79682,860782
6147,algattik,4,0.00046,144588,16.79728,860782
6148,alhidalg,4,0.00046,144592,16.79775,860782
6149,alidadar7676,4,0.00046,144596,16.79821,860782
6150,alikhil,4,0.00046,144600,16.79868,860782
6151,AlivedDe,4,0.00046,144604,16.79914,860782
6152,alkanen,4,0.00046,144608,16.79961,860782
6153,allout58,4,0.00046,144612,16.80007,860782
6154,AloofJr,4,0.00046,144616,16.80054,860782
6155,alpozcan,4,0.00046,144620,16.80100,860782
6156,Alwyn-Teh,4,0.00046,144624,16.80147,860782
6157,amanda-tarafa,4,0.00046,144628,16.80193,860782
6158,amargherio,4,0.00046,144632,16.80240,860782
6159,amirkCA,4,0.00046,144636,16.80286,860782
6160,Amosss,4,0.00046,144640,16.80333,860782
6161,ananclub,4,0.00046,144644,16.80379,860782
6162,anandr781,4,0.00046,144648,16.80425,860782
6163,andreicroitoriu,4,0.00046,144652,16.80472,860782
6164,andrei-dascalu,4,0.00046,144656,16.80518,860782
6165,AndrewBedscastle,4,0.00046,144660,16.80565,860782
6166,andrewm41,4,0.00046,144664,16.80611,860782
6167,AndTheDaysGoBy,4,0.00046,144668,16.80658,860782
6168,AndyPook,4,0.00046,144672,16.80704,860782
6169,angrosz,4,0.00046,144676,16.80751,860782
6170,angyvolin,4,0.00046,144680,16.80797,860782
6171,aniekgul,4,0.00046,144684,16.80844,860782
6172,anilsakr,4,0.00046,144688,16.80890,860782
6173,ankane,4,0.00046,144692,16.80937,860782
6174,AnnatarHe,4,0.00046,144696,16.80983,860782
6175,anne-nelson,4,0.00046,144700,16.81030,860782
6176,anragen,4,0.00046,144704,16.81076,860782
6177,AnthonyWharton,4,0.00046,144708,16.81123,860782
6178,anthraxn8b,4,0.00046,144712,16.81169,860782
6179,Anticom,4,0.00046,144716,16.81215,860782
6180,antmoveh,4,0.00046,144720,16.81262,860782
6181,AntonKueltz,4,0.00046,144724,16.81308,860782
6182,AntonQubecinema,4,0.00046,144728,16.81355,860782
6183,anubhabMajumdar,4,0.00046,144732,16.81401,860782
6184,Aorjoa,4,0.00046,144736,16.81448,860782
6185,APAC-DevOps,4,0.00046,144740,16.81494,860782
6186,apatora,4,0.00046,144744,16.81541,860782
6187,apemost,4,0.00046,144748,16.81587,860782
6188,aphuang2013,4,0.00046,144752,16.81634,860782
6189,aramarao27,4,0.00046,144756,16.81680,860782
6190,AramshamFedaykin,4,0.00046,144760,16.81727,860782
6191,Aravin,4,0.00046,144764,16.81773,860782
6192,Archer-Hidden,4,0.00046,144768,16.81820,860782
6193,arctdav,4,0.00046,144772,16.81866,860782
6194,ariksa,4,0.00046,144776,16.81912,860782
6195,arjunrv88,4,0.00046,144780,16.81959,860782
6196,arkanmgerges,4,0.00046,144784,16.82005,860782
6197,arkoc,4,0.00046,144788,16.82052,860782
6198,Arnuphap-Yupuech,4,0.00046,144792,16.82098,860782
6199,arsulesandy,4,0.00046,144796,16.82145,860782
6200,Ashnam1100,4,0.00046,144800,16.82191,860782
6201,ashoksekar07,4,0.00046,144804,16.82238,860782
6202,ashtw,4,0.00046,144808,16.82284,860782
6203,asnkh,4,0.00046,144812,16.82331,860782
6204,assafisr,4,0.00046,144816,16.82377,860782
6205,AssafKatz3,4,0.00046,144820,16.82424,860782
6206,asteven,4,0.00046,144824,16.82470,860782
6207,astorath,4,0.00046,144828,16.82517,860782
6208,augustkang,4,0.00046,144832,16.82563,860782
6209,aurelienrb,4,0.00046,144836,16.82610,860782
6210,auxten,4,0.00046,144840,16.82656,860782
6211,AvihuHenya,4,0.00046,144844,16.82702,860782
6212,AvvariSaiBharadwaj,4,0.00046,144848,16.82749,860782
6213,AVVS,4,0.00046,144852,16.82795,860782
6214,Azim-Palmer,4,0.00046,144856,16.82842,860782
6215,b0rski,4,0.00046,144860,16.82888,860782
6216,b10s,4,0.00046,144864,16.82935,860782
6217,baens,4,0.00046,144868,16.82981,860782
6218,ballj,4,0.00046,144872,16.83028,860782
6219,barrydobson,4,0.00046,144876,16.83074,860782
6220,bartebor,4,0.00046,144880,16.83121,860782
6221,bastianeicher,4,0.00046,144884,16.83167,860782
6222,bavedarnow,4,0.00046,144888,16.83214,860782
6223,bcba25,4,0.00046,144892,16.83260,860782
6224,bcbrockway,4,0.00046,144896,16.83307,860782
6225,bcollard,4,0.00046,144900,16.83353,860782
6226,beanhacker,4,0.00046,144904,16.83400,860782
6227,beef9999,4,0.00046,144908,16.83446,860782
6228,beikov,4,0.00046,144912,16.83492,860782
6229,belegent,4,0.00046,144916,16.83539,860782
6230,benagricola,4,0.00046,144920,16.83585,860782
6231,benburry,4,0.00046,144924,16.83632,860782
6232,bendavis78,4,0.00046,144928,16.83678,860782
6233,benpettman,4,0.00046,144932,16.83725,860782
6234,beorn-,4,0.00046,144936,16.83771,860782
6235,berndruecker,4,0.00046,144940,16.83818,860782
6236,betabandido,4,0.00046,144944,16.83864,860782
6237,bezgubov,4,0.00046,144948,16.83911,860782
6238,bigornoo,4,0.00046,144952,16.83957,860782
6239,bilal-jafri,4,0.00046,144956,16.84004,860782
6240,Bingjian-Zhu,4,0.00046,144960,16.84050,860782
6241,biox,4,0.00046,144964,16.84097,860782
6242,bjoernrost,4,0.00046,144968,16.84143,860782
6243,bjorn-ali-goransson,4,0.00046,144972,16.84189,860782
6244,bjxutj,4,0.00046,144976,16.84236,860782
6245,bk201,4,0.00046,144980,16.84282,860782
6246,bkannadassan,4,0.00046,144984,16.84329,860782
6247,BlackCrowned,4,0.00046,144988,16.84375,860782
6248,blairboy362,4,0.00046,144992,16.84422,860782
6249,blake,4,0.00046,144996,16.84468,860782
6250,bluechips23,4,0.00046,145000,16.84515,860782
6251,bluehtt,4,0.00046,145004,16.84561,860782
6252,bluestealth,4,0.00046,145008,16.84608,860782
6253,blueviggen,4,0.00046,145012,16.84654,860782
6254,bmv126,4,0.00046,145016,16.84701,860782
6255,bnjjj,4,0.00046,145020,16.84747,860782
6256,bobheadxi,4,0.00046,145024,16.84794,860782
6257,bobmayuze,4,0.00046,145028,16.84840,860782
6258,bobotu,4,0.00046,145032,16.84887,860782
6259,bohdantverdyi,4,0.00046,145036,16.84933,860782
6260,BojanPantovic1989,4,0.00046,145040,16.84979,860782
6261,BokyLiu,4,0.00046,145044,16.85026,860782
6262,bonedaddy,4,0.00046,145048,16.85072,860782
6263,boniek83,4,0.00046,145052,16.85119,860782
6264,booboothefool,4,0.00046,145056,16.85165,860782
6265,boris-lapouga,4,0.00046,145060,16.85212,860782
6266,BowenXiao1999,4,0.00046,145064,16.85258,860782
6267,bradleyd,4,0.00046,145068,16.85305,860782
6268,BretFisher,4,0.00046,145072,16.85351,860782
6269,briankmatheson,4,0.00046,145076,16.85398,860782
6270,BruceWayneVsSuperMan,4,0.00046,145080,16.85444,860782
6271,BrukT,4,0.00046,145084,16.85491,860782
6272,brunomptorres,4,0.00046,145088,16.85537,860782
6273,BryanEllington,4,0.00046,145092,16.85584,860782
6274,bsundsrud,4,0.00046,145096,16.85630,860782
6275,btoonk,4,0.00046,145100,16.85677,860782
6276,bullrox,4,0.00046,145104,16.85723,860782
6277,BumwooPark,4,0.00046,145108,16.85769,860782
6278,bushraKhan23,4,0.00046,145112,16.85816,860782
6279,butterfly2sea,4,0.00046,145116,16.85862,860782
6280,buxizhizhoum,4,0.00046,145120,16.85909,860782
6281,bw512,4,0.00046,145124,16.85955,860782
6282,C01DER,4,0.00046,145128,16.86002,860782
6283,c089,4,0.00046,145132,16.86048,860782
6284,c10b10,4,0.00046,145136,16.86095,860782
6285,cachila,4,0.00046,145140,16.86141,860782
6286,CadenOf,4,0.00046,145144,16.86188,860782
6287,camelx1,4,0.00046,145148,16.86234,860782
6288,cann0nf0dder,4,0.00046,145152,16.86281,860782
6289,capitangolo,4,0.00046,145156,16.86327,860782
6290,cappelaere,4,0.00046,145160,16.86374,860782
6291,captain-kark,4,0.00046,145164,16.86420,860782
6292,carlbalmer,4,0.00046,145168,16.86466,860782
6293,carlosbustillordguez,4,0.00046,145172,16.86513,860782
6294,carlosrmendes,4,0.00046,145176,16.86559,860782
6295,carlosrodf,4,0.00046,145180,16.86606,860782
6296,casey-robertson,4,0.00046,145184,16.86652,860782
6297,cawamata,4,0.00046,145188,16.86699,860782
6298,ccbrown,4,0.00046,145192,16.86745,860782
6299,cede87,4,0.00046,145196,16.86792,860782
6300,cedi,4,0.00046,145200,16.86838,860782
6301,Cenness,4,0.00046,145204,16.86885,860782
6302,cesarpino,4,0.00046,145208,16.86931,860782
6303,cforce,4,0.00046,145212,16.86978,860782
6304,cf-sewe,4,0.00046,145216,16.87024,860782
6305,cglacet,4,0.00046,145220,16.87071,860782
6306,cgzchen,4,0.00046,145224,16.87117,860782
6307,CH3CHO,4,0.00046,145228,16.87164,860782
6308,chabater,4,0.00046,145232,16.87210,860782
6309,chakatz,4,0.00046,145236,16.87256,860782
6310,char1st,4,0.00046,145240,16.87303,860782
6311,charles2j,4,0.00046,145244,16.87349,860782
6312,charlesguo404,4,0.00046,145248,16.87396,860782
6313,chenxuc,4,0.00046,145252,16.87442,860782
6314,chenyg0911,4,0.00046,145256,16.87489,860782
6315,chetnuy,4,0.00046,145260,16.87535,860782
6316,chihaiaalex,4,0.00046,145264,16.87582,860782
6317,chintanrp,4,0.00046,145268,16.87628,860782
6318,ChloeAcheampong,4,0.00046,145272,16.87675,860782
6319,choffmeister,4,0.00046,145276,16.87721,860782
6320,chout0000,4,0.00046,145280,16.87768,860782
6321,chpq95,4,0.00046,145284,16.87814,860782
6322,chris13524,4,0.00046,145288,16.87861,860782
6323,chriskobpin,4,0.00046,145292,16.87907,860782
6324,chris-ng-scmp,4,0.00046,145296,16.87954,860782
6325,chrisUsick,4,0.00046,145300,16.88000,860782
6326,cifc,4,0.00046,145304,16.88046,860782
6327,clarkds14,4,0.00046,145308,16.88093,860782
6328,classickar,4,0.00046,145312,16.88139,860782
6329,clcollins,4,0.00046,145316,16.88186,860782
6330,cleman95,4,0.00046,145320,16.88232,860782
6331,clementDele,4,0.00046,145324,16.88279,860782
6332,clementlesne,4,0.00046,145328,16.88325,860782
6333,clhuang,4,0.00046,145332,16.88372,860782
6334,ClickSimply,4,0.00046,145336,16.88418,860782
6335,cliles,4,0.00046,145340,16.88465,860782
6336,cloudtrends,4,0.00046,145344,16.88511,860782
6337,c-mcdonnell,4,0.00046,145348,16.88558,860782
6338,cmpmohan,4,0.00046,145352,16.88604,860782
6339,cnnaik,4,0.00046,145356,16.88651,860782
6340,cobexer,4,0.00046,145360,16.88697,860782
6341,code-chris,4,0.00046,145364,16.88743,860782
6342,codehimanshu,4,0.00046,145368,16.88790,860782
6343,coderwangke,4,0.00046,145372,16.88836,860782
6344,codykaup,4,0.00046,145376,16.88883,860782
6345,coelho,4,0.00046,145380,16.88929,860782
6346,collinarnett,4,0.00046,145384,16.88976,860782
6347,collivier,4,0.00046,145388,16.89022,860782
6348,colotiline,4,0.00046,145392,16.89069,860782
6349,combinatorial,4,0.00046,145396,16.89115,860782
6350,confiq,4,0.00046,145400,16.89162,860782
6351,connorgorman,4,0.00046,145404,16.89208,860782
6352,ConnorGraham,4,0.00046,145408,16.89255,860782
6353,ConscriptMR,4,0.00046,145412,16.89301,860782
6354,consoleKEC,4,0.00046,145416,16.89348,860782
6355,corbathegeek,4,0.00046,145420,16.89394,860782
6356,cosmonawt,4,0.00046,145424,16.89441,860782
6357,cprogrammer1994,4,0.00046,145428,16.89487,860782
6358,cr1st1p,4,0.00046,145432,16.89533,860782
6359,crawshaw,4,0.00046,145436,16.89580,860782
6360,CrazyMushu,4,0.00046,145440,16.89626,860782
6361,creativie,4,0.00046,145444,16.89673,860782
6362,cridam,4,0.00046,145448,16.89719,860782
6363,croensch,4,0.00046,145452,16.89766,860782
6364,crsandeep,4,0.00046,145456,16.89812,860782
6365,crutonjohn,4,0.00046,145460,16.89859,860782
6366,cseader,4,0.00046,145464,16.89905,860782
6367,csiemantel,4,0.00046,145468,16.89952,860782
6368,csuzhangxc,4,0.00046,145472,16.89998,860782
6369,ctext,4,0.00046,145476,16.90045,860782
6370,cugykw,4,0.00046,145480,16.90091,860782
6371,cuiyuancao,4,0.00046,145484,16.90138,860782
6372,cure,4,0.00046,145488,16.90184,860782
6373,cw75,4,0.00046,145492,16.90231,860782
6374,cwurm,4,0.00046,145496,16.90277,860782
6375,cxhiano,4,0.00046,145500,16.90323,860782
6376,cyberpwnn,4,0.00046,145504,16.90370,860782
6377,cyx,4,0.00046,145508,16.90416,860782
6378,czardien,4,0.00046,145512,16.90463,860782
6379,CzarMich,4,0.00046,145516,16.90509,860782
6380,czert,4,0.00046,145520,16.90556,860782
6381,czhfe,4,0.00046,145524,16.90602,860782
6382,D3N14L,4,0.00046,145528,16.90649,860782
6383,Da5-Id,4,0.00046,145532,16.90695,860782
6384,dabljues,4,0.00046,145536,16.90742,860782
6385,daghaian,4,0.00046,145540,16.90788,860782
6386,dajose,4,0.00046,145544,16.90835,860782
6387,daltonj,4,0.00046,145548,16.90881,860782
6388,damdo,4,0.00046,145552,16.90928,860782
6389,damerakd,4,0.00046,145556,16.90974,860782
6390,DamonQu,4,0.00046,145560,16.91020,860782
6391,daneshk,4,0.00046,145564,16.91067,860782
6392,Daniel42VTS,4,0.00046,145568,16.91113,860782
6393,danielcgithub,4,0.00046,145572,16.91160,860782
6394,daniel-hutao,4,0.00046,145576,16.91206,860782
6395,dan-leanix,4,0.00046,145580,16.91253,860782
6396,danmux,4,0.00046,145584,16.91299,860782
6397,dany74q,4,0.00046,145588,16.91346,860782
6398,DapengLan,4,0.00046,145592,16.91392,860782
6399,dardanos,4,0.00046,145596,16.91439,860782
6400,dariuszkuc,4,0.00046,145600,16.91485,860782
6401,darkdragn,4,0.00046,145604,16.91532,860782
6402,davefinger,4,0.00046,145608,16.91578,860782
6403,davew44c,4,0.00046,145612,16.91625,860782
6404,davidair,4,0.00046,145616,16.91671,860782
6405,davidclin,4,0.00046,145620,16.91718,860782
6406,davidgibbons,4,0.00046,145624,16.91764,860782
6407,Davidrjx,4,0.00046,145628,16.91810,860782
6408,davorceman,4,0.00046,145632,16.91857,860782
6409,davrodpin,4,0.00046,145636,16.91903,860782
6410,dba-git,4,0.00046,145640,16.91950,860782
6411,dbenduga,4,0.00046,145644,16.91996,860782
6412,Dchoksi-brierley,4,0.00046,145648,16.92043,860782
6413,ddesjardins-splunk,4,0.00046,145652,16.92089,860782
6414,deamwork,4,0.00046,145656,16.92136,860782
6415,debasisc-opa,4,0.00046,145660,16.92182,860782
6416,decause,4,0.00046,145664,16.92229,860782
6417,degilq,4,0.00046,145668,16.92275,860782
6418,degiple,4,0.00046,145672,16.92322,860782
6419,deltawi,4,0.00046,145676,16.92368,860782
6420,demilyc,4,0.00046,145680,16.92415,860782
6421,denisok,4,0.00046,145684,16.92461,860782
6422,Denissa89,4,0.00046,145688,16.92508,860782
6423,denisSurkov,4,0.00046,145692,16.92554,860782
6424,dennybritz,4,0.00046,145696,16.92600,860782
6425,denwork,4,0.00046,145700,16.92647,860782
6426,depeele,4,0.00046,145704,16.92693,860782
6427,derekm,4,0.00046,145708,16.92740,860782
6428,destanyinside,4,0.00046,145712,16.92786,860782
6429,devika-28,4,0.00046,145716,16.92833,860782
6430,dguyhasnoname,4,0.00046,145720,16.92879,860782
6431,Diggsey,4,0.00046,145724,16.92926,860782
6432,directionless,4,0.00046,145728,16.92972,860782
6433,Disgruntled,4,0.00046,145732,16.93019,860782
6434,dit-kmd,4,0.00046,145736,16.93065,860782
6435,djain13,4,0.00046,145740,16.93112,860782
6436,djajcevic,4,0.00046,145744,16.93158,860782
6437,djamaile,4,0.00046,145748,16.93205,860782
6438,djrollins,4,0.00046,145752,16.93251,860782
6439,djs28,4,0.00046,145756,16.93297,860782
6440,dlouks,4,0.00046,145760,16.93344,860782
6441,dmitrievav,4,0.00046,145764,16.93390,860782
6442,dmitrybakaev,4,0.00046,145768,16.93437,860782
6443,dmitry-saprykin,4,0.00046,145772,16.93483,860782
6444,DNCoelho,4,0.00046,145776,16.93530,860782
6445,doctori,4,0.00046,145780,16.93576,860782
6446,doczico,4,0.00046,145784,16.93623,860782
6447,dogzzdogzz,4,0.00046,145788,16.93669,860782
6448,dolv,4,0.00046,145792,16.93716,860782
6449,donovanmuller,4,0.00046,145796,16.93762,860782
6450,dontdieych,4,0.00046,145800,16.93809,860782
6451,doribd,4,0.00046,145804,16.93855,860782
6452,dotanrs,4,0.00046,145808,16.93902,860782
6453,doubletao318,4,0.00046,145812,16.93948,860782
6454,douzt,4,0.00046,145816,16.93995,860782
6455,doviche,4,0.00046,145820,16.94041,860782
6456,dragan-vucanovic-devtech,4,0.00046,145824,16.94087,860782
6457,Drewster727,4,0.00046,145828,16.94134,860782
6458,DrMcTaco,4,0.00046,145832,16.94180,860782
6459,drweber,4,0.00046,145836,16.94227,860782
6460,dsmith73,4,0.00046,145840,16.94273,860782
6461,dstuart,4,0.00046,145844,16.94320,860782
6462,dtornow,4,0.00046,145848,16.94366,860782
6463,duanjiong,4,0.00046,145852,16.94413,860782
6464,dulek,4,0.00046,145856,16.94459,860782
6465,dumez-k,4,0.00046,145860,16.94506,860782
6466,DuncanvR,4,0.00046,145864,16.94552,860782
6467,dunkelbunt1,4,0.00046,145868,16.94599,860782
6468,dunmorogh1993,4,0.00046,145872,16.94645,860782
6469,dunxiii,4,0.00046,145876,16.94692,860782
6470,Duologic,4,0.00046,145880,16.94738,860782
6471,dverdonschot,4,0.00046,145884,16.94785,860782
6472,dwbrown2,4,0.00046,145888,16.94831,860782
6473,DylanLange,4,0.00046,145892,16.94877,860782
6474,DymentJen,4,0.00046,145896,16.94924,860782
6475,dymq,4,0.00046,145900,16.94970,860782
6476,dzlab,4,0.00046,145904,16.95017,860782
6477,dzou,4,0.00046,145908,16.95063,860782
6478,EagleIJoe,4,0.00046,145912,16.95110,860782
6479,easonjim,4,0.00046,145916,16.95156,860782
6480,EBCEEB,4,0.00046,145920,16.95203,860782
6481,eddiewang,4,0.00046,145924,16.95249,860782
6482,edeca,4,0.00046,145928,16.95296,860782
6483,edify42,4,0.00046,145932,16.95342,860782
6484,EdwinEngelen,4,0.00046,145936,16.95389,860782
6485,eenchev,4,0.00046,145940,16.95435,860782
6486,Ehekatl,4,0.00046,145944,16.95482,860782
6487,eightnoteight,4,0.00046,145948,16.95528,860782
6488,ekarademir,4,0.00046,145952,16.95574,860782
6489,elioengcomp,4,0.00046,145956,16.95621,860782
6490,elliotpeele,4,0.00046,145960,16.95667,860782
6491,elmariofredo,4,0.00046,145964,16.95714,860782
6492,elocke,4,0.00046,145968,16.95760,860782
6493,elonzh,4,0.00046,145972,16.95807,860782
6494,ElvenSpellmaker,4,0.00046,145976,16.95853,860782
6495,Elynzis,4,0.00046,145980,16.95900,860782
6496,eMGabriel,4,0.00046,145984,16.95946,860782
6497,emil14,4,0.00046,145988,16.95993,860782
6498,EmileMaras,4,0.00046,145992,16.96039,860782
6499,eminaktas,4,0.00046,145996,16.96086,860782
6500,emlynmac,4,0.00046,146000,16.96132,860782
6501,EmPRio93,4,0.00046,146004,16.96179,860782
6502,emrocha,4,0.00046,146008,16.96225,860782
6503,ENikS,4,0.00046,146012,16.96272,860782
6504,eosantigen,4,0.00046,146016,16.96318,860782
6505,epeay,4,0.00046,146020,16.96364,860782
6506,eric4321,4,0.00046,146024,16.96411,860782
6507,erosb,4,0.00046,146028,16.96457,860782
6508,esakat,4,0.00046,146032,16.96504,860782
6509,esg-dlelis,4,0.00046,146036,16.96550,860782
6510,ethrbunny,4,0.00046,146040,16.96597,860782
6511,EugeneAikashev,4,0.00046,146044,16.96643,860782
6512,eugenekainara,4,0.00046,146048,16.96690,860782
6513,EvertonFreire,4,0.00046,146052,16.96736,860782
6514,extrawurst,4,0.00046,146056,16.96783,860782
6515,fabianfett,4,0.00046,146060,16.96829,860782
6516,fach,4,0.00046,146064,16.96876,860782
6517,fangwei18,4,0.00046,146068,16.96922,860782
6518,fantapsody,4,0.00046,146072,16.96969,860782
6519,fayak,4,0.00046,146076,16.97015,860782
6520,fayepal,4,0.00046,146080,16.97062,860782
6521,fbarotov,4,0.00046,146084,16.97108,860782
6522,fclairamb,4,0.00046,146088,16.97154,860782
6523,fduyangchao,4,0.00046,146092,16.97201,860782
6524,felixPG,4,0.00046,146096,16.97247,860782
6525,fengsi,4,0.00046,146100,16.97294,860782
6526,feniix,4,0.00046,146104,16.97340,860782
6527,Ferenc-,4,0.00046,146108,16.97387,860782
6528,FessAectan,4,0.00046,146112,16.97433,860782
6529,ffassler,4,0.00046,146116,16.97480,860782
6530,Fillo22,4,0.00046,146120,16.97526,860782
6531,finaldzn,4,0.00046,146124,16.97573,860782
6532,fleeteo,4,0.00046,146128,16.97619,860782
6533,Fly-Coder,4,0.00046,146132,16.97666,860782
6534,flytux,4,0.00046,146136,16.97712,860782
6535,fOO223Fr,4,0.00046,146140,16.97759,860782
6536,foreversor,4,0.00046,146144,16.97805,860782
6537,fortanu82,4,0.00046,146148,16.97851,860782
6538,FOTempel,4,0.00046,146152,16.97898,860782
6539,Fox32,4,0.00046,146156,16.97944,860782
6540,FPAX,4,0.00046,146160,16.97991,860782
6541,fpmchu,4,0.00046,146164,16.98037,860782
6542,fr3aker,4,0.00046,146168,16.98084,860782
6543,FrakasTeam,4,0.00046,146172,16.98130,860782
6544,franklevering,4,0.00046,146176,16.98177,860782
6545,Frederik-Baetens,4,0.00046,146180,16.98223,860782
6546,freeseacher,4,0.00046,146184,16.98270,860782
6547,frenkye,4,0.00046,146188,16.98316,860782
6548,from88,4,0.00046,146192,16.98363,860782
6549,fsniper,4,0.00046,146196,16.98409,860782
6550,fsperling,4,0.00046,146200,16.98456,860782
6551,fulii,4,0.00046,146204,16.98502,860782
6552,fungiboletus,4,0.00046,146208,16.98549,860782
6553,Funzinator,4,0.00046,146212,16.98595,860782
6554,fwilhelm92,4,0.00046,146216,16.98641,860782
6555,g574,4,0.00046,146220,16.98688,860782
6556,GabrielCastro,4,0.00046,146224,16.98734,860782
6557,gabriel-milan,4,0.00046,146228,16.98781,860782
6558,gangganghong,4,0.00046,146232,16.98827,860782
6559,gaohoward,4,0.00046,146236,16.98874,860782
6560,gapro20022,4,0.00046,146240,16.98920,860782
6561,GaramNick,4,0.00046,146244,16.98967,860782
6562,garimagupta779,4,0.00046,146248,16.99013,860782
6563,gashirar,4,0.00046,146252,16.99060,860782
6564,gaveezy,4,0.00046,146256,16.99106,860782
6565,gazzyt,4,0.00046,146260,16.99153,860782
6566,gdoyer-oxv,4,0.00046,146264,16.99199,860782
6567,gebn,4,0.00046,146268,16.99246,860782
6568,gee4vee,4,0.00046,146272,16.99292,860782
6569,generatives,4,0.00046,146276,16.99339,860782
6570,georgedelacruz213,4,0.00046,146280,16.99385,860782
6571,georgr,4,0.00046,146284,16.99431,860782
6572,gerardo8a,4,0.00046,146288,16.99478,860782
6573,Gerhut,4,0.00046,146292,16.99524,860782
6574,gerrnot,4,0.00046,146296,16.99571,860782
6575,GFLEMING133,4,0.00046,146300,16.99617,860782
6576,ghudiczius,4,0.00046,146304,16.99664,860782
6577,GianOrtiz,4,0.00046,146308,16.99710,860782
6578,gil-excelero,4,0.00046,146312,16.99757,860782
6579,giri-jeedigunta,4,0.00046,146316,16.99803,860782
6580,gitaferber2,4,0.00046,146320,16.99850,860782
6581,giteshk,4,0.00046,146324,16.99896,860782
6582,github-edu,4,0.00046,146328,16.99943,860782
6583,gitmko0,4,0.00046,146332,16.99989,860782
6584,gittadesushil,4,0.00046,146336,17.00036,860782
6585,gizmotronic,4,0.00046,146340,17.00082,860782
6586,Gl4di4torRr,4,0.00046,146344,17.00128,860782
6587,glueric,4,0.00046,146348,17.00175,860782
6588,gmolkvk,4,0.00046,146352,17.00221,860782
6589,gonzalobarbitta,4,0.00046,146356,17.00268,860782
6590,GopiPacha1996,4,0.00046,146360,17.00314,860782
6591,gorakhargosh,4,0.00046,146364,17.00361,860782
6592,gp42,4,0.00046,146368,17.00407,860782
6593,Graham42,4,0.00046,146372,17.00454,860782
6594,grantmiller,4,0.00046,146376,17.00500,860782
6595,greenboxal,4,0.00046,146380,17.00547,860782
6596,greenu,4,0.00046,146384,17.00593,860782
6597,GregoireW,4,0.00046,146388,17.00640,860782
6598,grey-droid,4,0.00046,146392,17.00686,860782
6599,grig-tar,4,0.00046,146396,17.00733,860782
6600,grv231,4,0.00046,146400,17.00779,860782
6601,grzegorzgr,4,0.00046,146404,17.00826,860782
6602,guanxingfeng,4,0.00046,146408,17.00872,860782
6603,guidodobboletta,4,0.00046,146412,17.00918,860782
6604,guikcd,4,0.00046,146416,17.00965,860782
6605,gupf0719,4,0.00046,146420,17.01011,860782
6606,gurleensethi,4,0.00046,146424,17.01058,860782
6607,gw0,4,0.00046,146428,17.01104,860782
6608,gwnet,4,0.00046,146432,17.01151,860782
6609,hackacharya,4,0.00046,146436,17.01197,860782
6610,haleyw,4,0.00046,146440,17.01244,860782
6611,halfmatthalfcat,4,0.00046,146444,17.01290,860782
6612,halradaideh,4,0.00046,146448,17.01337,860782
6613,hammer2j2,4,0.00046,146452,17.01383,860782
6614,hamzakilic,4,0.00046,146456,17.01430,860782
6615,HaoLiuHust,4,0.00046,146460,17.01476,860782
6616,harshitagupta6,4,0.00046,146464,17.01523,860782
6617,hasakura12,4,0.00046,146468,17.01569,860782
6618,hatamiarash7,4,0.00046,146472,17.01616,860782
6619,Hats-Wang,4,0.00046,146476,17.01662,860782
6620,hazurd,4,0.00046,146480,17.01708,860782
6621,heavytail,4,0.00046,146484,17.01755,860782
6622,hedgepigdaniel,4,0.00046,146488,17.01801,860782
6623,heimweh,4,0.00046,146492,17.01848,860782
6624,heldergregorio,4,0.00046,146496,17.01894,860782
6625,hellxz,4,0.00046,146500,17.01941,860782
6626,helpfulBadger,4,0.00046,146504,17.01987,860782
6627,hendra-2020,4,0.00046,146508,17.02034,860782
6628,henri9813,4,0.00046,146512,17.02080,860782
6629,Henry-Asante,4,0.00046,146516,17.02127,860782
6630,hexsel,4,0.00046,146520,17.02173,860782
6631,hgye,4,0.00046,146524,17.02220,860782
6632,hiectai,4,0.00046,146528,17.02266,860782
6633,hijamoya,4,0.00046,146532,17.02313,860782
6634,himanshusharma-git,4,0.00046,146536,17.02359,860782
6635,HimaVarsha94,4,0.00046,146540,17.02405,860782
6636,hirosat,4,0.00046,146544,17.02452,860782
6637,hjkatz,4,0.00046,146548,17.02498,860782
6638,hjlp20150803,4,0.00046,146552,17.02545,860782
6639,hjpotter92,4,0.00046,146556,17.02591,860782
6640,hkparker,4,0.00046,146560,17.02638,860782
6641,hmeerlo,4,0.00046,146564,17.02684,860782
6642,hnasr,4,0.00046,146568,17.02731,860782
6643,hnicke,4,0.00046,146572,17.02777,860782
6644,hohteri,4,0.00046,146576,17.02824,860782
6645,hoodbsa,4,0.00046,146580,17.02870,860782
6646,houfangdong,4,0.00046,146584,17.02917,860782
6647,HoussemDellai,4,0.00046,146588,17.02963,860782
6648,hpamukcu,4,0.00046,146592,17.03010,860782
6649,hpapaxen,4,0.00046,146596,17.03056,860782
6650,hrishikesh77,4,0.00046,146600,17.03103,860782
6651,hroyrh,4,0.00046,146604,17.03149,860782
6652,hsychla,4,0.00046,146608,17.03195,860782
6653,htdvisser,4,0.00046,146612,17.03242,860782
6654,huangxuxin233,4,0.00046,146616,17.03288,860782
6655,HubbeKing,4,0.00046,146620,17.03335,860782
6656,hudannag,4,0.00046,146624,17.03381,860782
6657,huide9,4,0.00046,146628,17.03428,860782
6658,humphrieslk,4,0.00046,146632,17.03474,860782
6659,hungrymike,4,0.00046,146636,17.03521,860782
6660,huseyinyilmaz,4,0.00046,146640,17.03567,860782
6661,huww98,4,0.00046,146644,17.03614,860782
6662,huzefa51,4,0.00046,146648,17.03660,860782
6663,HW13,4,0.00046,146652,17.03707,860782
6664,hxbaishikele,4,0.00046,146656,17.03753,860782
6665,hydeenoble,4,0.00046,146660,17.03800,860782
6666,i5Js,4,0.00046,146664,17.03846,860782
6667,ianic,4,0.00046,146668,17.03893,860782
6668,iasniv,4,0.00046,146672,17.03939,860782
6669,iAziz786,4,0.00046,146676,17.03985,860782
6670,ibantoo,4,0.00046,146680,17.04032,860782
6671,ibnipun10,4,0.00046,146684,17.04078,860782
6672,IceeMC,4,0.00046,146688,17.04125,860782
6673,IdanAdar,4,0.00046,146692,17.04171,860782
6674,iffyio,4,0.00046,146696,17.04218,860782
6675,Ifriqiya,4,0.00046,146700,17.04264,860782
6676,ihostage,4,0.00046,146704,17.04311,860782
6677,ijmitch,4,0.00046,146708,17.04357,860782
6678,ik9999,4,0.00046,146712,17.04404,860782
6679,ilyaigpetrov,4,0.00046,146716,17.04450,860782
6680,imabelli,4,0.00046,146720,17.04497,860782
6681,imdhruva,4,0.00046,146724,17.04543,860782
6682,immesys,4,0.00046,146728,17.04590,860782
6683,inanna-malick,4,0.00046,146732,17.04636,860782
6684,InfluencerNGZK,4,0.00046,146736,17.04682,860782
6685,IngussNeilands,4,0.00046,146740,17.04729,860782
6686,internetionals,4,0.00046,146744,17.04775,860782
6687,intlabs,4,0.00046,146748,17.04822,860782
6688,inzamam-iqbal,4,0.00046,146752,17.04868,860782
6689,iotty,4,0.00046,146756,17.04915,860782
6690,iputra,4,0.00046,146760,17.04961,860782
6691,irivera007,4,0.00046,146764,17.05008,860782
6692,ironhalo,4,0.00046,146768,17.05054,860782
6693,ironknight78,4,0.00046,146772,17.05101,860782
6694,isabelgk,4,0.00046,146776,17.05147,860782
6695,isantospardo,4,0.00046,146780,17.05194,860782
6696,isehgu,4,0.00046,146784,17.05240,860782
6697,ish-xyz,4,0.00046,146788,17.05287,860782
6698,ITBOX-ITBOY,4,0.00046,146792,17.05333,860782
6699,itchyny,4,0.00046,146796,17.05380,860782
6700,itdove,4,0.00046,146800,17.05426,860782
6701,ItsLeeOwen,4,0.00046,146804,17.05472,860782
6702,izone-airstream,4,0.00046,146808,17.05519,860782
6703,j0sh3rs,4,0.00046,146812,17.05565,860782
6704,J0WI,4,0.00046,146816,17.05612,860782
6705,j2gg0s,4,0.00046,146820,17.05658,860782
6706,j75,4,0.00046,146824,17.05705,860782
6707,Jack881,4,0.00046,146828,17.05751,860782
6708,jacknagel,4,0.00046,146832,17.05798,860782
6709,jackyng88,4,0.00046,146836,17.05844,860782
6710,JacobHenner,4,0.00046,146840,17.05891,860782
6711,Jaggle,4,0.00046,146844,17.05937,860782
6712,Jake-Smullin,4,0.00046,146848,17.05984,860782
6713,jakesyl,4,0.00046,146852,17.06030,860782
6714,JakubJecminek,4,0.00046,146856,17.06077,860782
6715,jamesbeedy,4,0.00046,146860,17.06123,860782
6716,JamesMurkin,4,0.00046,146864,17.06170,860782
6717,jamesonatdell,4,0.00046,146868,17.06216,860782
6718,jamesstow,4,0.00046,146872,17.06262,860782
6719,jamesxuhaozhe,4,0.00046,146876,17.06309,860782
6720,jameszh,4,0.00046,146880,17.06355,860782
6721,jamietre,4,0.00046,146884,17.06402,860782
6722,jananzhu,4,0.00046,146888,17.06448,860782
6723,janboll,4,0.00046,146892,17.06495,860782
6724,jangolano,4,0.00046,146896,17.06541,860782
6725,jan-hudec,4,0.00046,146900,17.06588,860782
6726,janlud,4,0.00046,146904,17.06634,860782
6727,janludvikd3,4,0.00046,146908,17.06681,860782
6728,JanMkl,4,0.00046,146912,17.06727,860782
6729,jaredhancock31,4,0.00046,146916,17.06774,860782
6730,jaredkhan,4,0.00046,146920,17.06820,860782
6731,jarkt,4,0.00046,146924,17.06867,860782
6732,jarrettprosser,4,0.00046,146928,17.06913,860782
6733,jasmdk,4,0.00046,146932,17.06959,860782
6734,JasonEverling,4,0.00046,146936,17.07006,860782
6735,JasonMorgan,4,0.00046,146940,17.07052,860782
6736,jasonstitt,4,0.00046,146944,17.07099,860782
6737,jaumard,4,0.00046,146948,17.07145,860782
6738,javaDer,4,0.00046,146952,17.07192,860782
6739,javiertoledos,4,0.00046,146956,17.07238,860782
6740,JayjeetAtGithub,4,0.00046,146960,17.07285,860782
6741,jbdelpech,4,0.00046,146964,17.07331,860782
6742,jbielick,4,0.00046,146968,17.07378,860782
6743,jbmcfarlin31,4,0.00046,146972,17.07424,860782
6744,jcgonlop,4,0.00046,146976,17.07471,860782
6745,jdunhamvrtx,4,0.00046,146980,17.07517,860782
6746,jehutyy,4,0.00046,146984,17.07564,860782
6747,jemisonf,4,0.00046,146988,17.07610,860782
6748,jennynilsen,4,0.00046,146992,17.07657,860782
6749,jensenity,4,0.00046,146996,17.07703,860782
6750,jeremy-sigma,4,0.00046,147000,17.07749,860782
6751,Jeskz0rd,4,0.00046,147004,17.07796,860782
6752,Jetman80,4,0.00046,147008,17.07842,860782
6753,jewar,4,0.00046,147012,17.07889,860782
6754,Jeyakumardevarajulu,4,0.00046,147016,17.07935,860782
6755,jgzurano,4,0.00046,147020,17.07982,860782
6756,jhalebot,4,0.00046,147024,17.08028,860782
6757,jiahaog,4,0.00046,147028,17.08075,860782
6758,jiajiayang,4,0.00046,147032,17.08121,860782
6759,Jiajing-Hu,4,0.00046,147036,17.08168,860782
6760,jimsheldon,4,0.00046,147040,17.08214,860782
6761,jingzhang36,4,0.00046,147044,17.08261,860782
6762,jinxingwang,4,0.00046,147048,17.08307,860782
6763,jisnardo,4,0.00046,147052,17.08354,860782
6764,jjfmarket,4,0.00046,147056,17.08400,860782
6765,JJJJJones,4,0.00046,147060,17.08447,860782
6766,jkimixl,4,0.00046,147064,17.08493,860782
6767,jkornata,4,0.00046,147068,17.08539,860782
6768,jmf0526,4,0.00046,147072,17.08586,860782
6769,jmgilman,4,0.00046,147076,17.08632,860782
6770,jmriebold,4,0.00046,147080,17.08679,860782
6771,jmzwcn,4,0.00046,147084,17.08725,860782
6772,jnach,4,0.00046,147088,17.08772,860782
6773,jnewbigin,4,0.00046,147092,17.08818,860782
6774,joekendal,4,0.00046,147096,17.08865,860782
6775,joelrbrandt,4,0.00046,147100,17.08911,860782
6776,jofia,4,0.00046,147104,17.08958,860782
6777,johanfleury,4,0.00046,147108,17.09004,860782
6778,johannes-darms,4,0.00046,147112,17.09051,860782
6779,johnjjung,4,0.00046,147116,17.09097,860782
6780,johnlam90,4,0.00046,147120,17.09144,860782
6781,johnpemberton,4,0.00046,147124,17.09190,860782
6782,JohnStarich,4,0.00046,147128,17.09236,860782
6783,johntron,4,0.00046,147132,17.09283,860782
6784,JohnWillker,4,0.00046,147136,17.09329,860782
6785,johnwmstevens,4,0.00046,147140,17.09376,860782
6786,JollyZeus,4,0.00046,147144,17.09422,860782
6787,jonashartwig,4,0.00046,147148,17.09469,860782
6788,jonay2000,4,0.00046,147152,17.09515,860782
6789,jonbesga,4,0.00046,147156,17.09562,860782
6790,jond3k,4,0.00046,147160,17.09608,860782
6791,jonny-wg2,4,0.00046,147164,17.09655,860782
6792,jontro,4,0.00046,147168,17.09701,860782
6793,jordanabderrachid,4,0.00046,147172,17.09748,860782
6794,josefschabasser,4,0.00046,147176,17.09794,860782
6795,joshimhoff,4,0.00046,147180,17.09841,860782
6796,joshuafc,4,0.00046,147184,17.09887,860782
6797,JoshVanL,4,0.00046,147188,17.09934,860782
6798,josnidhin,4,0.00046,147192,17.09980,860782
6799,jotaoncode,4,0.00046,147196,17.10026,860782
6800,jpantsjoha,4,0.00046,147200,17.10073,860782
6801,jpatokal,4,0.00046,147204,17.10119,860782
6802,jpresky,4,0.00046,147208,17.10166,860782
6803,jrconlin,4,0.00046,147212,17.10212,860782
6804,jrmyr,4,0.00046,147216,17.10259,860782
6805,jrubenc,4,0.00046,147220,17.10305,860782
6806,JScrivanich,4,0.00046,147224,17.10352,860782
6807,jsedy7,4,0.00046,147228,17.10398,860782
6808,JS-Jake,4,0.00046,147232,17.10445,860782
6809,jsloan117,4,0.00046,147236,17.10491,860782
6810,jsm84,4,0.00046,147240,17.10538,860782
6811,jsmouret,4,0.00046,147244,17.10584,860782
6812,jsubirat,4,0.00046,147248,17.10631,860782
6813,jswidler,4,0.00046,147252,17.10677,860782
6814,jtherin,4,0.00046,147256,17.10724,860782
6815,jtudelag,4,0.00046,147260,17.10770,860782
6816,jtyers,4,0.00046,147264,17.10816,860782
6817,JulienBreux,4,0.00046,147268,17.10863,860782
6818,juliogreff,4,0.00046,147272,17.10909,860782
6819,just1689,4,0.00046,147276,17.10956,860782
6820,jvassev,4,0.00046,147280,17.11002,860782
6821,jvdgeest,4,0.00046,147284,17.11049,860782
6822,jwietelmann,4,0.00046,147288,17.11095,860782
6823,jxadro,4,0.00046,147292,17.11142,860782
6824,jyotima,4,0.00046,147296,17.11188,860782
6825,Kaali,4,0.00046,147300,17.11235,860782
6826,kabaliwths,4,0.00046,147304,17.11281,860782
6827,kagkarlsson,4,0.00046,147308,17.11328,860782
6828,kaleo211,4,0.00046,147312,17.11374,860782
6829,KamranAzeem,4,0.00046,147316,17.11421,860782
6830,kapekost,4,0.00046,147320,17.11467,860782
6831,kapilbalwani,4,0.00046,147324,17.11513,860782
6832,kapil-rn,4,0.00046,147328,17.11560,860782
6833,kaplandani,4,0.00046,147332,17.11606,860782
6834,karadia10,4,0.00046,147336,17.11653,860782
6835,karim-manaouil,4,0.00046,147340,17.11699,860782
6836,karllhughes,4,0.00046,147344,17.11746,860782
6837,karok2m,4,0.00046,147348,17.11792,860782
6838,karthikeayan,4,0.00046,147352,17.11839,860782
6839,KarthikNedunchezhiyan,4,0.00046,147356,17.11885,860782
6840,kellyhyomin,4,0.00046,147360,17.11932,860782
6841,kelvinsand,4,0.00046,147364,17.11978,860782
6842,kenichi-shibata,4,0.00046,147368,17.12025,860782
6843,kerbyhughes,4,0.00046,147372,17.12071,860782
6844,kevza,4,0.00046,147376,17.12118,860782
6845,kfirfer,4,0.00046,147380,17.12164,860782
6846,kgumbs,4,0.00046,147384,17.12211,860782
6847,kingdonb,4,0.00046,147388,17.12257,860782
6848,kissingleman,4,0.00046,147392,17.12303,860782
6849,kiwiz,4,0.00046,147396,17.12350,860782
6850,kjozsa,4,0.00046,147400,17.12396,860782
6851,kkc,4,0.00046,147404,17.12443,860782
6852,kkruk-sumo,4,0.00046,147408,17.12489,860782
6853,kle622,4,0.00046,147412,17.12536,860782
6854,Knappek,4,0.00046,147416,17.12582,860782
6855,konfortes,4,0.00046,147420,17.12629,860782
6856,konvergence,4,0.00046,147424,17.12675,860782
6857,kopwei,4,0.00046,147428,17.12722,860782
6858,koraktor,4,0.00046,147432,17.12768,860782
6859,krangerich,4,0.00046,147436,17.12815,860782
6860,krbcmt,4,0.00046,147440,17.12861,860782
6861,krichardson-apexclearing,4,0.00046,147444,17.12908,860782
6862,kriefsacha,4,0.00046,147448,17.12954,860782
6863,kris-g,4,0.00046,147452,17.13001,860782
6864,krishnatejap,4,0.00046,147456,17.13047,860782
6865,kristapsm,4,0.00046,147460,17.13093,860782
6866,kritisingh,4,0.00046,147464,17.13140,860782
6867,krrypto,4,0.00046,147468,17.13186,860782
6868,ksiadz,4,0.00046,147472,17.13233,860782
6869,kthoms,4,0.00046,147476,17.13279,860782
6870,kunal-kushwaha,4,0.00046,147480,17.13326,860782
6871,kunalpuriii,4,0.00046,147484,17.13372,860782
6872,kungfu71186,4,0.00046,147488,17.13419,860782
6873,kunmin-db,4,0.00046,147492,17.13465,860782
6874,kunrad,4,0.00046,147496,17.13512,860782
6875,kurtisvg,4,0.00046,147500,17.13558,860782
6876,Kvasscn,4,0.00046,147504,17.13605,860782
6877,kylezh,4,0.00046,147508,17.13651,860782
6878,kyounger,4,0.00046,147512,17.13698,860782
6879,l0n3star,4,0.00046,147516,17.13744,860782
6880,Laakso,4,0.00046,147520,17.13790,860782
6881,lacebal,4,0.00046,147524,17.13837,860782
6882,Lagicrus,4,0.00046,147528,17.13883,860782
6883,langseb,4,0.00046,147532,17.13930,860782
6884,lapolonio,4,0.00046,147536,17.13976,860782
6885,larytet,4,0.00046,147540,17.14023,860782
6886,LaughingBubba,4,0.00046,147544,17.14069,860782
6887,laur89,4,0.00046,147548,17.14116,860782
6888,laxmikantbpandhare,4,0.00046,147552,17.14162,860782
6889,LazyBrush,4,0.00046,147556,17.14209,860782
6890,LCaparelli,4,0.00046,147560,17.14255,860782
6891,lcldragon,4,0.00046,147564,17.14302,860782
6892,lddhappy,4,0.00046,147568,17.14348,860782
6893,lebaptiste,4,0.00046,147572,17.14395,860782
6894,lechen26,4,0.00046,147576,17.14441,860782
6895,Leen15,4,0.00046,147580,17.14488,860782
6896,Lellansin,4,0.00046,147584,17.14534,860782
6897,lelvisl,4,0.00046,147588,17.14580,860782
6898,leoluz,4,0.00046,147592,17.14627,860782
6899,leolzbing521,4,0.00046,147596,17.14673,860782
6900,leonsp-ai,4,0.00046,147600,17.14720,860782
6901,lewiscowper,4,0.00046,147604,17.14766,860782
6902,lgarron,4,0.00046,147608,17.14813,860782
6903,lgmkr,4,0.00046,147612,17.14859,860782
6904,lgnashold,4,0.00046,147616,17.14906,860782
6905,Lhfxxqx510,4,0.00046,147620,17.14952,860782
6906,lhluo,4,0.00046,147624,17.14999,860782
6907,liamstask,4,0.00046,147628,17.15045,860782
6908,liangjfblue,4,0.00046,147632,17.15092,860782
6909,lighteness,4,0.00046,147636,17.15138,860782
6910,liguangcheng,4,0.00046,147640,17.15185,860782
6911,lilida,4,0.00046,147644,17.15231,860782
6912,LinShuicheng,4,0.00046,147648,17.15278,860782
6913,linuxman1000,4,0.00046,147652,17.15324,860782
6914,linyuan0,4,0.00046,147656,17.15370,860782
6915,lioriz,4,0.00046,147660,17.15417,860782
6916,LittleFox94,4,0.00046,147664,17.15463,860782
6917,liuchong,4,0.00046,147668,17.15510,860782
6918,liujinpengtommy,4,0.00046,147672,17.15556,860782
6919,liupeidong0620,4,0.00046,147676,17.15603,860782
6920,liusy182,4,0.00046,147680,17.15649,860782
6921,liuxiaoli007,4,0.00046,147684,17.15696,860782
6922,lixy529,4,0.00046,147688,17.15742,860782
6923,liy516,4,0.00046,147692,17.15789,860782
6924,lkeijser,4,0.00046,147696,17.15835,860782
6925,lkolchin,4,0.00046,147700,17.15882,860782
6926,llapx,4,0.00046,147704,17.15928,860782
6927,lnregalias,4,0.00046,147708,17.15975,860782
6928,LO3N,4,0.00046,147712,17.16021,860782
6929,lojurn,4,0.00046,147716,17.16067,860782
6930,lokoArt,4,0.00046,147720,17.16114,860782
6931,Lola150716,4,0.00046,147724,17.16160,860782
6932,lonegunmanb,4,0.00046,147728,17.16207,860782
6933,longit644,4,0.00046,147732,17.16253,860782
6934,loranmutafov,4,0.00046,147736,17.16300,860782
6935,LordNoteworthy,4,0.00046,147740,17.16346,860782
6936,lostmimic,4,0.00046,147744,17.16393,860782
6937,lsa5521,4,0.00046,147748,17.16439,860782
6938,ltamasi,4,0.00046,147752,17.16486,860782
6939,lubocheng,4,0.00046,147756,17.16532,860782
6940,lukasberger,4,0.00046,147760,17.16579,860782
6941,lukewendling,4,0.00046,147764,17.16625,860782
6942,luotian-github,4,0.00046,147768,17.16672,860782
6943,luppie,4,0.00046,147772,17.16718,860782
6944,luxuze,4,0.00046,147776,17.16765,860782
6945,lxiaozhic,4,0.00046,147780,17.16811,860782
6946,LyleLee,4,0.00046,147784,17.16857,860782
6947,lzha106,4,0.00046,147788,17.16904,860782
6948,lzhfromustc,4,0.00046,147792,17.16950,860782
6949,M0NsTeRRR,4,0.00046,147796,17.16997,860782
6950,madewithkode,4,0.00046,147800,17.17043,860782
6951,MadRabbit,4,0.00046,147804,17.17090,860782
6952,magnusja,4,0.00046,147808,17.17136,860782
6953,Maher4Ever,4,0.00046,147812,17.17183,860782
6954,mahmud2011,4,0.00046,147816,17.17229,860782
6955,maiamcc,4,0.00046,147820,17.17276,860782
6956,mainred,4,0.00046,147824,17.17322,860782
6957,makotow,4,0.00046,147828,17.17369,860782
6958,malingaraj,4,0.00046,147832,17.17415,860782
6959,malli31,4,0.00046,147836,17.17462,860782
6960,manderson23,4,0.00046,147840,17.17508,860782
6961,mangareader,4,0.00046,147844,17.17555,860782
6962,manhhailua,4,0.00046,147848,17.17601,860782
6963,manishdangi98,4,0.00046,147852,17.17647,860782
6964,manojchandrabss,4,0.00046,147856,17.17694,860782
6965,mantuliu,4,0.00046,147860,17.17740,860782
6966,manuNCL,4,0.00046,147864,17.17787,860782
6967,manusa,4,0.00046,147868,17.17833,860782
6968,maoueh,4,0.00046,147872,17.17880,860782
6969,marcdel,4,0.00046,147876,17.17926,860782
6970,marcosmarxm,4,0.00046,147880,17.17973,860782
6971,marcusm,4,0.00046,147884,17.18019,860782
6972,marcusteixeira,4,0.00046,147888,17.18066,860782
6973,marga-kinvolk,4,0.00046,147892,17.18112,860782
6974,mariolamacchia,4,0.00046,147896,17.18159,860782
6975,marizmendi,4,0.00046,147900,17.18205,860782
6976,markbenschop,4,0.00046,147904,17.18252,860782
6977,MarkDana,4,0.00046,147908,17.18298,860782
6978,marojor,4,0.00046,147912,17.18344,860782
6979,Martinho0330,4,0.00046,147916,17.18391,860782
6980,MartinLeedotOrg,4,0.00046,147920,17.18437,860782
6981,Mastergalen,4,0.00046,147924,17.18484,860782
6982,matheusjericoo,4,0.00046,147928,17.18530,860782
6983,Matiasmct,4,0.00046,147932,17.18577,860782
6984,MatonAnthony,4,0.00046,147936,17.18623,860782
6985,matthew-mcdermott,4,0.00046,147940,17.18670,860782
6986,matthewpwilson,4,0.00046,147944,17.18716,860782
6987,MatthewShotton,4,0.00046,147948,17.18763,860782
6988,matthew-walters,4,0.00046,147952,17.18809,860782
6989,mattKaczorowski,4,0.00046,147956,17.18856,860782
6990,mattmattox,4,0.00046,147960,17.18902,860782
6991,mauritsvdvijgh,4,0.00046,147964,17.18949,860782
6992,maushah,4,0.00046,147968,17.18995,860782
6993,max-neverov,4,0.00046,147972,17.19042,860782
6994,maxstr,4,0.00046,147976,17.19088,860782
6995,MBarendregt,4,0.00046,147980,17.19134,860782
6996,mberwanger,4,0.00046,147984,17.19181,860782
6997,mbrodala,4,0.00046,147988,17.19227,860782
6998,meabed,4,0.00046,147992,17.19274,860782
6999,megaredfan,4,0.00046,147996,17.19320,860782
7000,mekstrem,4,0.00046,148000,17.19367,860782
7001,mercantiandrea,4,0.00046,148004,17.19413,860782
7002,METAJIJI,4,0.00046,148008,17.19460,860782
7003,MeYururi,4,0.00046,148012,17.19506,860782
7004,mghildiy,4,0.00046,148016,17.19553,860782
7005,mgoltzsche,4,0.00046,148020,17.19599,860782
7006,Mhs-220,4,0.00046,148024,17.19646,860782
7007,mhwasil,4,0.00046,148028,17.19692,860782
7008,MichaelWMerritt,4,0.00046,148032,17.19739,860782
7009,micheam,4,0.00046,148036,17.19785,860782
7010,michielswaanen,4,0.00046,148040,17.19832,860782
7011,mickdekkers,4,0.00046,148044,17.19878,860782
7012,middlestone,4,0.00046,148048,17.19924,860782
7013,MidnightJava,4,0.00046,148052,17.19971,860782
7014,midokura-agustin,4,0.00046,148056,17.20017,860782
7015,mig4,4,0.00046,148060,17.20064,860782
7016,migueloller,4,0.00046,148064,17.20110,860782
7017,MikaelElkiaer,4,0.00046,148068,17.20157,860782
7018,mikelo,4,0.00046,148072,17.20203,860782
7019,mikemountjoy,4,0.00046,148076,17.20250,860782
7020,miklosn,4,0.00046,148080,17.20296,860782
7021,mimizone,4,0.00046,148084,17.20343,860782
7022,mimuret,4,0.00046,148088,17.20389,860782
7023,minelminel,4,0.00046,148092,17.20436,860782
7024,mingfang,4,0.00046,148096,17.20482,860782
7025,mipearlska,4,0.00046,148100,17.20529,860782
7026,mirusky,4,0.00046,148104,17.20575,860782
7027,Miss-you,4,0.00046,148108,17.20621,860782
7028,Mister101,4,0.00046,148112,17.20668,860782
7029,misterngng,4,0.00046,148116,17.20714,860782
7030,Mistic92,4,0.00046,148120,17.20761,860782
7031,mjgallag,4,0.00046,148124,17.20807,860782
7032,mjrepo2,4,0.00046,148128,17.20854,860782
7033,mkaroshi,4,0.00046,148132,17.20900,860782
7034,mknyszek,4,0.00046,148136,17.20947,860782
7035,mleklund,4,0.00046,148140,17.20993,860782
7036,mmack,4,0.00046,148144,17.21040,860782
7037,mmanciop,4,0.00046,148148,17.21086,860782
7038,mmlb,4,0.00046,148152,17.21133,860782
7039,mmojica53,4,0.00046,148156,17.21179,860782
7040,mmpetarpeshev,4,0.00046,148160,17.21226,860782
7041,mo254,4,0.00046,148164,17.21272,860782
7042,moadqassem,4,0.00046,148168,17.21319,860782
7043,MoeHamdan,4,0.00046,148172,17.21365,860782
7044,mogwai,4,0.00046,148176,17.21411,860782
7045,mohsensamiei,4,0.00046,148180,17.21458,860782
7046,monfardineL,4,0.00046,148184,17.21504,860782
7047,monsterrev,4,0.00046,148188,17.21551,860782
7048,morfj,4,0.00046,148192,17.21597,860782
7049,morganatwishpond,4,0.00046,148196,17.21644,860782
7050,Moshem123,4,0.00046,148200,17.21690,860782
7051,moyasu,4,0.00046,148204,17.21737,860782
7052,MParvin,4,0.00046,148208,17.21783,860782
7053,mper0003,4,0.00046,148212,17.21830,860782
7054,mpiexec,4,0.00046,148216,17.21876,860782
7055,mpryc,4,0.00046,148220,17.21923,860782
7056,mrcdb,4,0.00046,148224,17.21969,860782
7057,Mr-Howard-Roark,4,0.00046,148228,17.22016,860782
7058,mrnold,4,0.00046,148232,17.22062,860782
7059,mrtristan,4,0.00046,148236,17.22109,860782
7060,mtnbikenc,4,0.00046,148240,17.22155,860782
7061,muirdm,4,0.00046,148244,17.22201,860782
7062,mujx,4,0.00046,148248,17.22248,860782
7063,MuralidharB,4,0.00046,148252,17.22294,860782
7064,mvrhov,4,0.00046,148256,17.22341,860782
7065,mvukadinoff,4,0.00046,148260,17.22387,860782
7066,mwarzynski,4,0.00046,148264,17.22434,860782
7067,mxey,4,0.00046,148268,17.22480,860782
7068,mydevice,4,0.00046,148272,17.22527,860782
7069,myugan,4,0.00046,148276,17.22573,860782
7070,n0vad3v,4,0.00046,148280,17.22620,860782
7071,n27051538,4,0.00046,148284,17.22666,860782
7072,nadendlaprasad,4,0.00046,148288,17.22713,860782
7073,Nadine2016,4,0.00046,148292,17.22759,860782
7074,naioja,4,0.00046,148296,17.22806,860782
7075,nakkoh,4,0.00046,148300,17.22852,860782
7076,namutaka,4,0.00046,148304,17.22898,860782
7077,naotospace,4,0.00046,148308,17.22945,860782
7078,NArnott,4,0.00046,148312,17.22991,860782
7079,natalefalco,4,0.00046,148316,17.23038,860782
7080,natchaphon-r,4,0.00046,148320,17.23084,860782
7081,natealcedo,4,0.00046,148324,17.23131,860782
7082,nathanstilwell,4,0.00046,148328,17.23177,860782
7083,Naveenlbg,4,0.00046,148332,17.23224,860782
7084,nawa,4,0.00046,148336,17.23270,860782
7085,nawazdhandala,4,0.00046,148340,17.23317,860782
7086,NeckBeardPrince,4,0.00046,148344,17.23363,860782
7087,nengbowan,4,0.00046,148348,17.23410,860782
7088,Neraud,4,0.00046,148352,17.23456,860782
7089,nesc58,4,0.00046,148356,17.23503,860782
7090,netdata-be,4,0.00046,148360,17.23549,860782
7091,NewbMiao,4,0.00046,148364,17.23596,860782
7092,newman0089,4,0.00046,148368,17.23642,860782
7093,next-joaquinfernandezcampo,4,0.00046,148372,17.23688,860782
7094,ngc104,4,0.00046,148376,17.23735,860782
7095,niall-weedon,4,0.00046,148380,17.23781,860782
7096,nicholasxuu,4,0.00046,148384,17.23828,860782
7097,nickdgriffin,4,0.00046,148388,17.23874,860782
7098,nickma82,4,0.00046,148392,17.23921,860782
7099,NicoChenyt,4,0.00046,148396,17.23967,860782
7100,nicogon,4,0.00046,148400,17.24014,860782
7101,NidhalRouissi,4,0.00046,148404,17.24060,860782
7102,nielsslot,4,0.00046,148408,17.24107,860782
7103,NikolaeVarius,4,0.00046,148412,17.24153,860782
7104,nikoskip,4,0.00046,148416,17.24200,860782
7105,nilogarcia,4,0.00046,148420,17.24246,860782
7106,nipponilyal,4,0.00046,148424,17.24293,860782
7107,nirav-chotai,4,0.00046,148428,17.24339,860782
7108,nishchit,4,0.00046,148432,17.24386,860782
7109,NKcqx,4,0.00046,148436,17.24432,860782
7110,nliao,4,0.00046,148440,17.24478,860782
7111,nmpacheco,4,0.00046,148444,17.24525,860782
7112,noorulhud,4,0.00046,148448,17.24571,860782
7113,novalagung,4,0.00046,148452,17.24618,860782
7114,nporsche,4,0.00046,148456,17.24664,860782
7115,nrapopor,4,0.00046,148460,17.24711,860782
7116,nrjohnstone,4,0.00046,148464,17.24757,860782
7117,nrvmodi,4,0.00046,148468,17.24804,860782
7118,ntkjer,4,0.00046,148472,17.24850,860782
7119,nurgasemetey,4,0.00046,148476,17.24897,860782
7120,Nwhouse,4,0.00046,148480,17.24943,860782
7121,nxf5025,4,0.00046,148484,17.24990,860782
7122,nyechiel,4,0.00046,148488,17.25036,860782
7123,nyvanga,4,0.00046,148492,17.25083,860782
7124,ochotinun,4,0.00046,148496,17.25129,860782
7125,oCroso,4,0.00046,148500,17.25175,860782
7126,ofirshtrull,4,0.00046,148504,17.25222,860782
7127,ogre0403,4,0.00046,148508,17.25268,860782
7128,oguzssahin,4,0.00046,148512,17.25315,860782
7129,okravets,4,0.00046,148516,17.25361,860782
7130,olegsidokhmetov,4,0.00046,148520,17.25408,860782
7131,oliviermichaelis,4,0.00046,148524,17.25454,860782
7132,OlleLarsson,4,0.00046,148528,17.25501,860782
7133,olsw,4,0.00046,148532,17.25547,860782
7134,Olympuus,4,0.00046,148536,17.25594,860782
7135,omaristalis,4,0.00046,148540,17.25640,860782
7136,omegas27,4,0.00046,148544,17.25687,860782
7137,omeryounus,4,0.00046,148548,17.25733,860782
7138,OmriHarary,4,0.00046,148552,17.25780,860782
7139,onepiers,4,0.00046,148556,17.25826,860782
7140,onepos-zaika,4,0.00046,148560,17.25873,860782
7141,onichandame,4,0.00046,148564,17.25919,860782
7142,Opalo,4,0.00046,148568,17.25965,860782
7143,opeco17,4,0.00046,148572,17.26012,860782
7144,orange64,4,0.00046,148576,17.26058,860782
7145,OriHoch,4,0.00046,148580,17.26105,860782
7146,osaffer,4,0.00046,148584,17.26151,860782
7147,oscar60310,4,0.00046,148588,17.26198,860782
7148,osoykan,4,0.00046,148592,17.26244,860782
7149,otan,4,0.00046,148596,17.26291,860782
7150,Ottovsky,4,0.00046,148600,17.26337,860782
7151,OuFinx,4,0.00046,148604,17.26384,860782
7152,ozooxo,4,0.00046,148608,17.26430,860782
7153,pacospace,4,0.00046,148612,17.26477,860782
7154,painhardcore,4,0.00046,148616,17.26523,860782
7155,palrabt,4,0.00046,148620,17.26570,860782
7156,panho66,4,0.00046,148624,17.26616,860782
7157,papirosko,4,0.00046,148628,17.26662,860782
7158,paravatha,4,0.00046,148632,17.26709,860782
7159,ParthSareen,4,0.00046,148636,17.26755,860782
7160,pashtet04,4,0.00046,148640,17.26802,860782
7161,patrick0057,4,0.00046,148644,17.26848,860782
7162,PatrickXYS,4,0.00046,148648,17.26895,860782
7163,patuck,4,0.00046,148652,17.26941,860782
7164,paul1956,4,0.00046,148656,17.26988,860782
7165,paulfairless,4,0.00046,148660,17.27034,860782
7166,paulm-jones,4,0.00046,148664,17.27081,860782
7167,paulpuvi06,4,0.00046,148668,17.27127,860782
7168,paultung,4,0.00046,148672,17.27174,860782
7169,pbudner,4,0.00046,148676,17.27220,860782
7170,pcaifi,4,0.00046,148680,17.27267,860782
7171,pckhoi,4,0.00046,148684,17.27313,860782
7172,pc-rnukala1,4,0.00046,148688,17.27360,860782
7173,PearceDuan,4,0.00046,148692,17.27406,860782
7174,pelov,4,0.00046,148696,17.27452,860782
7175,peng-isi,4,0.00046,148700,17.27499,860782
7176,PengJi,4,0.00046,148704,17.27545,860782
7177,Perfect-Web,4,0.00046,148708,17.27592,860782
7178,perriea,4,0.00046,148712,17.27638,860782
7179,peterbueschel,4,0.00046,148716,17.27685,860782
7180,peterloron,4,0.00046,148720,17.27731,860782
7181,PeterMaco,4,0.00046,148724,17.27778,860782
7182,peterstyra,4,0.00046,148728,17.27824,860782
7183,pfraedrichmss,4,0.00046,148732,17.27871,860782
7184,pgherveou,4,0.00046,148736,17.27917,860782
7185,pgkulk,4,0.00046,148740,17.27964,860782
7186,pgp,4,0.00046,148744,17.28010,860782
7187,Phantomias3782,4,0.00046,148748,17.28057,860782
7188,p-hash,4,0.00046,148752,17.28103,860782
7189,PhilRW,4,0.00046,148756,17.28150,860782
7190,phin1x,4,0.00046,148760,17.28196,860782
7191,phpsxg,4,0.00046,148764,17.28242,860782
7192,PierreZ,4,0.00046,148768,17.28289,860782
7193,ping2alexander,4,0.00046,148772,17.28335,860782
7194,pingdink,4,0.00046,148776,17.28382,860782
7195,pinkavaj,4,0.00046,148780,17.28428,860782
7196,pjastrzabek,4,0.00046,148784,17.28475,860782
7197,pjz,4,0.00046,148788,17.28521,860782
7198,pkavajin,4,0.00046,148792,17.28568,860782
7199,Placidina,4,0.00046,148796,17.28614,860782
7200,plasticine,4,0.00046,148800,17.28661,860782
7201,plod,4,0.00046,148804,17.28707,860782
7202,plynch76,4,0.00046,148808,17.28754,860782
7203,pmalic,4,0.00046,148812,17.28800,860782
7204,pmansour,4,0.00046,148816,17.28847,860782
7205,pmyjavec,4,0.00046,148820,17.28893,860782
7206,PocketMobsters,4,0.00046,148824,17.28939,860782
7207,poladiaraj,4,0.00046,148828,17.28986,860782
7208,pollier,4,0.00046,148832,17.29032,860782
7209,ppetit,4,0.00046,148836,17.29079,860782
7210,prabhu-r-ramasamy,4,0.00046,148840,17.29125,860782
7211,Pradeepadtricon,4,0.00046,148844,17.29172,860782
7212,prakash1097,4,0.00046,148848,17.29218,860782
7213,prakashid2,4,0.00046,148852,17.29265,860782
7214,prasanth12344,4,0.00046,148856,17.29311,860782
7215,pratapagiri,4,0.00046,148860,17.29358,860782
7216,PremSubudhi,4,0.00046,148864,17.29404,860782
7217,pretzelmaker,4,0.00046,148868,17.29451,860782
7218,problame,4,0.00046,148872,17.29497,860782
7219,protheusfr,4,0.00046,148876,17.29544,860782
7220,prrichard,4,0.00046,148880,17.29590,860782
7221,pryan-branch,4,0.00046,148884,17.29637,860782
7222,psalaberria002,4,0.00046,148888,17.29683,860782
7223,pschulten,4,0.00046,148892,17.29729,860782
7224,ptitpoulpe,4,0.00046,148896,17.29776,860782
7225,ptravers,4,0.00046,148900,17.29822,860782
7226,PuneeshMotwani,4,0.00046,148904,17.29869,860782
7227,PurnimaChawla,4,0.00046,148908,17.29915,860782
7228,pvwebb,4,0.00046,148912,17.29962,860782
7229,qaisarhayat12,4,0.00046,148916,17.30008,860782
7230,Qard,4,0.00046,148920,17.30055,860782
7231,qianying-99,4,0.00046,148924,17.30101,860782
7232,qi-min,4,0.00046,148928,17.30148,860782
7233,qnapnickchang,4,0.00046,148932,17.30194,860782
7234,QuentinLeloire,4,0.00046,148936,17.30241,860782
7235,quickflash10,4,0.00046,148940,17.30287,860782
7236,QuRa,4,0.00046,148944,17.30334,860782
7237,qvmedvedev,4,0.00046,148948,17.30380,860782
7238,qw2208,4,0.00046,148952,17.30427,860782
7239,qwertyMUC,4,0.00046,148956,17.30473,860782
7240,rachgupt,4,0.00046,148960,17.30519,860782
7241,rachit3003,4,0.00046,148964,17.30566,860782
7242,radunicolae,4,0.00046,148968,17.30612,860782
7243,rafalAtAdscale,4,0.00046,148972,17.30659,860782
7244,RafalSkolasinski,4,0.00046,148976,17.30705,860782
7245,rafal-szypulka,4,0.00046,148980,17.30752,860782
7246,rafe-delphix,4,0.00046,148984,17.30798,860782
7247,raghuchahar007,4,0.00046,148988,17.30845,860782
7248,rahmanme,4,0.00046,148992,17.30891,860782
7249,rahul342,4,0.00046,148996,17.30938,860782
7250,rahulchandravanshi,4,0.00046,149000,17.30984,860782
7251,raine,4,0.00046,149004,17.31031,860782
7252,rajasaur,4,0.00046,149008,17.31077,860782
7253,rajeshkodali,4,0.00046,149012,17.31124,860782
7254,rallen090,4,0.00046,149016,17.31170,860782
7255,ramachaitanyak,4,0.00046,149020,17.31216,860782
7256,rami-abu,4,0.00046,149024,17.31263,860782
7257,ramilexe,4,0.00046,149028,17.31309,860782
7258,ramonck,4,0.00046,149032,17.31356,860782
7259,ramran-r,4,0.00046,149036,17.31402,860782
7260,RaSla,4,0.00046,149040,17.31449,860782
7261,Rathil,4,0.00046,149044,17.31495,860782
7262,ravilach,4,0.00046,149048,17.31542,860782
7263,rblock-aw,4,0.00046,149052,17.31588,860782
7264,rcampbel,4,0.00046,149056,17.31635,860782
7265,rcdmoreno,4,0.00046,149060,17.31681,860782
7266,redondoxx,4,0.00046,149064,17.31728,860782
7267,reintroducing,4,0.00046,149068,17.31774,860782
7268,rektide,4,0.00046,149072,17.31821,860782
7269,renezoller,4,0.00046,149076,17.31867,860782
7270,rennokki,4,0.00046,149080,17.31914,860782
7271,Retenodus,4,0.00046,149084,17.31960,860782
7272,Reuuke,4,0.00046,149088,17.32006,860782
7273,rewenset,4,0.00046,149092,17.32053,860782
7274,ricardojdsilva87,4,0.00046,149096,17.32099,860782
7275,richard-fairthorne,4,0.00046,149100,17.32146,860782
7276,richardse,4,0.00046,149104,17.32192,860782
7277,riffling,4,0.00046,149108,17.32239,860782
7278,RinChanNOWWW,4,0.00046,149112,17.32285,860782
7279,rishabh625,4,0.00046,149116,17.32332,860782
7280,rishi7c,4,0.00046,149120,17.32378,860782
7281,RizwanDG,4,0.00046,149124,17.32425,860782
7282,RMcD,4,0.00046,149128,17.32471,860782
7283,roastiek,4,0.00046,149132,17.32518,860782
7284,robbertvdg,4,0.00046,149136,17.32564,860782
7285,robermar23,4,0.00046,149140,17.32611,860782
7286,robertdavidsmith,4,0.00046,149144,17.32657,860782
7287,roberthstrand,4,0.00046,149148,17.32704,860782
7288,robherley,4,0.00046,149152,17.32750,860782
7289,Roguelazer,4,0.00046,149156,17.32796,860782
7290,rohrit,4,0.00046,149160,17.32843,860782
7291,rolfik,4,0.00046,149164,17.32889,860782
7292,romilpunetha,4,0.00046,149168,17.32936,860782
7293,romuald,4,0.00046,149172,17.32982,860782
7294,Roninchen,4,0.00046,149176,17.33029,860782
7295,rossmckelvie,4,0.00046,149180,17.33075,860782
7296,RotBolt,4,0.00046,149184,17.33122,860782
7297,RothAndrew,4,0.00046,149188,17.33168,860782
7298,rozcietrzewiacz,4,0.00046,149192,17.33215,860782
7299,rparth,4,0.00046,149196,17.33261,860782
7300,rroberts59110,4,0.00046,149200,17.33308,860782
7301,rsparulek,4,0.00046,149204,17.33354,860782
7302,ruiwen-zhao,4,0.00046,149208,17.33401,860782
7303,rupinder10,4,0.00046,149212,17.33447,860782
7304,rushikeshjadhav,4,0.00046,149216,17.33493,860782
7305,rushyrush,4,0.00046,149220,17.33540,860782
7306,RussianNeuroMancer,4,0.00046,149224,17.33586,860782
7307,rustyx,4,0.00046,149228,17.33633,860782
7308,rvolosatovs,4,0.00046,149232,17.33679,860782
7309,s50600822,4,0.00046,149236,17.33726,860782
7310,s977120,4,0.00046,149240,17.33772,860782
7311,SAbdulRahuman,4,0.00046,149244,17.33819,860782
7312,sachinphogat,4,0.00046,149248,17.33865,860782
7313,sadhugit,4,0.00046,149252,17.33912,860782
7314,sadjunky,4,0.00046,149256,17.33958,860782
7315,sagarraob4u,4,0.00046,149260,17.34005,860782
7316,saimakin,4,0.00046,149264,17.34051,860782
7317,sairam546,4,0.00046,149268,17.34098,860782
7318,saiyidi,4,0.00046,149272,17.34144,860782
7319,sajanjswl,4,0.00046,149276,17.34191,860782
7320,salasrod,4,0.00046,149280,17.34237,860782
7321,salimd,4,0.00046,149284,17.34283,860782
7322,Sam123ben,4,0.00046,149288,17.34330,860782
7323,SamarSidharth,4,0.00046,149292,17.34376,860782
7324,samof76,4,0.00046,149296,17.34423,860782
7325,samuelb,4,0.00046,149300,17.34469,860782
7326,SamuelBagattin,4,0.00046,149304,17.34516,860782
7327,samwhite-gl,4,0.00046,149308,17.34562,860782
7328,sandhya816,4,0.00046,149312,17.34609,860782
7329,sandoichi,4,0.00046,149316,17.34655,860782
7330,sangcom15,4,0.00046,149320,17.34702,860782
7331,sangnguyen7,4,0.00046,149324,17.34748,860782
7332,sanmai-NL,4,0.00046,149328,17.34795,860782
7333,santi69,4,0.00046,149332,17.34841,860782
7334,santigl,4,0.00046,149336,17.34888,860782
7335,saparaj,4,0.00046,149340,17.34934,860782
7336,sarat1669,4,0.00046,149344,17.34981,860782
7337,sarialem,4,0.00046,149348,17.35027,860782
7338,Sathishkunisai,4,0.00046,149352,17.35073,860782
7339,satyamuralidhar,4,0.00046,149356,17.35120,860782
7340,saurabh1git,4,0.00046,149360,17.35166,860782
7341,saurabhanetskope,4,0.00046,149364,17.35213,860782
7342,sbalinen,4,0.00046,149368,17.35259,860782
7343,sbhmnaik,4,0.00046,149372,17.35306,860782
7344,sbulage,4,0.00046,149376,17.35352,860782
7345,sbuzonas,4,0.00046,149380,17.35399,860782
7346,schaze,4,0.00046,149384,17.35445,860782
7347,schizoid90,4,0.00046,149388,17.35492,860782
7348,SCLogo,4,0.00046,149392,17.35538,860782
7349,scoopex,4,0.00046,149396,17.35585,860782
7350,scott-grimes,4,0.00046,149400,17.35631,860782
7351,ScottGuymer,4,0.00046,149404,17.35678,860782
7352,scriptnull,4,0.00046,149408,17.35724,860782
7353,sdickhoven,4,0.00046,149412,17.35770,860782
7354,Sebadst,4,0.00046,149416,17.35817,860782
7355,sebastianblunt,4,0.00046,149420,17.35863,860782
7356,SebastianGoeb,4,0.00046,149424,17.35910,860782
7357,sebastien-coavoux,4,0.00046,149428,17.35956,860782
7358,sebschlue,4,0.00046,149432,17.36003,860782
7359,sedooe,4,0.00046,149436,17.36049,860782
7360,seetaramrao,4,0.00046,149440,17.36096,860782
7361,seifghazi,4,0.00046,149444,17.36142,860782
7362,selslack,4,0.00046,149448,17.36189,860782
7363,senlog,4,0.00046,149452,17.36235,860782
7364,senthil13,4,0.00046,149456,17.36282,860782
7365,senthilnathan,4,0.00046,149460,17.36328,860782
7366,serain,4,0.00046,149464,17.36375,860782
7367,SergeyMuha,4,0.00046,149468,17.36421,860782
7368,sergioarmgpl,4,0.00046,149472,17.36468,860782
7369,sergiocharpineljr,4,0.00046,149476,17.36514,860782
7370,seuf,4,0.00046,149480,17.36560,860782
7371,sfm1977,4,0.00046,149484,17.36607,860782
7372,sfowl,4,0.00046,149488,17.36653,860782
7373,sgrzebieta,4,0.00046,149492,17.36700,860782
7374,shachar-ash,4,0.00046,149496,17.36746,860782
7375,Shagon94,4,0.00046,149500,17.36793,860782
7376,shaktsin,4,0.00046,149504,17.36839,860782
7377,shanekcodes,4,0.00046,149508,17.36886,860782
7378,shanesveller,4,0.00046,149512,17.36932,860782
7379,shaobo322,4,0.00046,149516,17.36979,860782
7380,shawndodo,4,0.00046,149520,17.37025,860782
7381,Sheldonwl,4,0.00046,149524,17.37072,860782
7382,sherifkayad,4,0.00046,149528,17.37118,860782
7383,shezroy1,4,0.00046,149532,17.37165,860782
7384,shikam,4,0.00046,149536,17.37211,860782
7385,shivam009,4,0.00046,149540,17.37258,860782
7386,shonpaz123,4,0.00046,149544,17.37304,860782
7387,shouldnotappearcalm,4,0.00046,149548,17.37350,860782
7388,shramikawale,4,0.00046,149552,17.37397,860782
7389,shrivastavshubham34,4,0.00046,149556,17.37443,860782
7390,shubham1172,4,0.00046,149560,17.37490,860782
7391,SHUFIL,4,0.00046,149564,17.37536,860782
7392,shuke987,4,0.00046,149568,17.37583,860782
7393,shuvankar0907,4,0.00046,149572,17.37629,860782
7394,shyamjos,4,0.00046,149576,17.37676,860782
7395,sibendu,4,0.00046,149580,17.37722,860782
7396,sibidass,4,0.00046,149584,17.37769,860782
7397,siddhuthota,4,0.00046,149588,17.37815,860782
7398,silborynirmata,4,0.00046,149592,17.37862,860782
7399,silvairsoares,4,0.00046,149596,17.37908,860782
7400,SilverTux,4,0.00046,149600,17.37955,860782
7401,simhnna,4,0.00046,149604,17.38001,860782
7402,simonstumpf,4,0.00046,149608,17.38047,860782
7403,sincerywaing,4,0.00046,149612,17.38094,860782
7404,siqusoft,4,0.00046,149616,17.38140,860782
7405,sirdarckcat,4,0.00046,149620,17.38187,860782
7406,sishbi,4,0.00046,149624,17.38233,860782
7407,sivaramsk,4,0.00046,149628,17.38280,860782
7408,siying,4,0.00046,149632,17.38326,860782
7409,sjammy6,4,0.00046,149636,17.38373,860782
7410,sjdweb,4,0.00046,149640,17.38419,860782
7411,sjkummer,4,0.00046,149644,17.38466,860782
7412,skadem07,4,0.00046,149648,17.38512,860782
7413,skibum55,4,0.00046,149652,17.38559,860782
7414,skuffe,4,0.00046,149656,17.38605,860782
7415,skuo,4,0.00046,149660,17.38652,860782
7416,skylonwolf,4,0.00046,149664,17.38698,860782
7417,skymeyer,4,0.00046,149668,17.38745,860782
7418,Skymirrh,4,0.00046,149672,17.38791,860782
7419,slamdev,4,0.00046,149676,17.38837,860782
7420,sleshchenko,4,0.00046,149680,17.38884,860782
7421,smaillns,4,0.00046,149684,17.38930,860782
7422,smcavallo,4,0.00046,149688,17.38977,860782
7423,smekkley,4,0.00046,149692,17.39023,860782
7424,SmithSgq,4,0.00046,149696,17.39070,860782
7425,snir911,4,0.00046,149700,17.39116,860782
7426,snowjunkie,4,0.00046,149704,17.39163,860782
7427,sojo101,4,0.00046,149708,17.39209,860782
7428,sokourg,4,0.00046,149712,17.39256,860782
7429,solid210,4,0.00046,149716,17.39302,860782
7430,solongtony,4,0.00046,149720,17.39349,860782
7431,SongJiyeon,4,0.00046,149724,17.39395,860782
7432,soumyax1das,4,0.00046,149728,17.39442,860782
7433,sowhatim,4,0.00046,149732,17.39488,860782
7434,spartucus,4,0.00046,149736,17.39535,860782
7435,SpiderYang,4,0.00046,149740,17.39581,860782
7436,sporkmonger,4,0.00046,149744,17.39627,860782
7437,Spritekin,4,0.00046,149748,17.39674,860782
7438,srajmane,4,0.00046,149752,17.39720,860782
7439,SrikanthSrinivasamurthy,4,0.00046,149756,17.39767,860782
7440,srspnda,4,0.00046,149760,17.39813,860782
7441,srteam2020,4,0.00046,149764,17.39860,860782
7442,sshanks-kx,4,0.00046,149768,17.39906,860782
7443,stainboy,4,0.00046,149772,17.39953,860782
7444,stannum-l,4,0.00046,149776,17.39999,860782
7445,Starblade42,4,0.00046,149780,17.40046,860782
7446,stawii,4,0.00046,149784,17.40092,860782
7447,stefanhenseler,4,0.00046,149788,17.40139,860782
7448,stephen00001,4,0.00046,149792,17.40185,860782
7449,stephengrice,4,0.00046,149796,17.40232,860782
7450,StephenWeber,4,0.00046,149800,17.40278,860782
7451,steveazz,4,0.00046,149804,17.40324,860782
7452,steven-supersolid,4,0.00046,149808,17.40371,860782
7453,steveoh,4,0.00046,149812,17.40417,860782
7454,Stogrammus,4,0.00046,149816,17.40464,860782
7455,Subhadeep2707,4,0.00046,149820,17.40510,860782
7456,subhendukundu,4,0.00046,149824,17.40557,860782
7457,suhyunjeon,4,0.00046,149828,17.40603,860782
7458,sukhil-suresh,4,0.00046,149832,17.40650,860782
7459,sunix,4,0.00046,149836,17.40696,860782
7460,sunliusi,4,0.00046,149840,17.40743,860782
7461,sunnypatel2141,4,0.00046,149844,17.40789,860782
7462,superlzs0476,4,0.00046,149848,17.40836,860782
7463,sureshappana,4,0.00046,149852,17.40882,860782
7464,Susie-Hu,4,0.00046,149856,17.40929,860782
7465,SuvratAgrawal,4,0.00046,149860,17.40975,860782
7466,sventschui,4,0.00046,149864,17.41022,860782
7467,swq499809608,4,0.00046,149868,17.41068,860782
7468,syed-awais-ali,4,0.00046,149872,17.41114,860782
7469,sysadm1989,4,0.00046,149876,17.41161,860782
7470,szucsitg,4,0.00046,149880,17.41207,860782
7471,t1bb4r,4,0.00046,149884,17.41254,860782
7472,t3-aoki,4,0.00046,149888,17.41300,860782
7473,t57root,4,0.00046,149892,17.41347,860782
7474,tabishathar,4,0.00046,149896,17.41393,860782
7475,taggelos,4,0.00046,149900,17.41440,860782
7476,tailorvj,4,0.00046,149904,17.41486,860782
7477,tangjiaxing669,4,0.00046,149908,17.41533,860782
7478,Tanmay17,4,0.00046,149912,17.41579,860782
7479,taoyouh,4,0.00046,149916,17.41626,860782
7480,tariqajyusuf,4,0.00046,149920,17.41672,860782
7481,Tarjei400,4,0.00046,149924,17.41719,860782
7482,tarunaroraonline,4,0.00046,149928,17.41765,860782
7483,TatsukiMinami,4,0.00046,149932,17.41812,860782
7484,tavin,4,0.00046,149936,17.41858,860782
7485,te4336,4,0.00046,149940,17.41904,860782
7486,teachermanalex,4,0.00046,149944,17.41951,860782
7487,techknowlogick,4,0.00046,149948,17.41997,860782
7488,techmaniack,4,0.00046,149952,17.42044,860782
7489,Tehacz,4,0.00046,149956,17.42090,860782
7490,tejendrab,4,0.00046,149960,17.42137,860782
7491,Telzeng,4,0.00046,149964,17.42183,860782
7492,TemaSM,4,0.00046,149968,17.42230,860782
7493,terrytibbles,4,0.00046,149972,17.42276,860782
7494,tetsuya28,4,0.00046,149976,17.42323,860782
7495,thanhlong9x,4,0.00046,149980,17.42369,860782
7496,thatguyjono94,4,0.00046,149984,17.42416,860782
7497,thbtcllt,4,0.00046,149988,17.42462,860782
7498,thefuckingcode,4,0.00046,149992,17.42509,860782
7499,thefuyang,4,0.00046,149996,17.42555,860782
7500,thejasbabu-hotstar,4,0.00046,150000,17.42601,860782
7501,theJaxon,4,0.00046,150004,17.42648,860782
7502,thekalpesh7,4,0.00046,150008,17.42694,860782
7503,TheNotary,4,0.00046,150012,17.42741,860782
7504,ThePants999,4,0.00046,150016,17.42787,860782
7505,thesayyn,4,0.00046,150020,17.42834,860782
7506,thewilli,4,0.00046,150024,17.42880,860782
7507,TheYoungester,4,0.00046,150028,17.42927,860782
7508,thodquach,4,0.00046,150032,17.42973,860782
7509,ThoTischner,4,0.00046,150036,17.43020,860782
7510,thunder-spb,4,0.00046,150040,17.43066,860782
7511,ThWoywod,4,0.00046,150044,17.43113,860782
7512,tiagosimao,4,0.00046,150048,17.43159,860782
7513,Ticiano-mw,4,0.00046,150052,17.43206,860782
7514,ticpu,4,0.00046,150056,17.43252,860782
7515,tik-stbuehler,4,0.00046,150060,17.43299,860782
7516,timonegk,4,0.00046,150064,17.43345,860782
7517,timown,4,0.00046,150068,17.43391,860782
7518,timsamart,4,0.00046,150072,17.43438,860782
7519,timtorChen,4,0.00046,150076,17.43484,860782
7520,tingeltangelthomas,4,0.00046,150080,17.43531,860782
7521,tipok,4,0.00046,150084,17.43577,860782
7522,Titof974,4,0.00046,150088,17.43624,860782
7523,tkukushkin,4,0.00046,150092,17.43670,860782
7524,tlatkin,4,0.00046,150096,17.43717,860782
7525,tmaxanc-cloudofficial,4,0.00046,150100,17.43763,860782
7526,tniita,4,0.00046,150104,17.43810,860782
7527,toan-hf,4,0.00046,150108,17.43856,860782
7528,tobiasgies,4,0.00046,150112,17.43903,860782
7529,toffentoffen,4,0.00046,150116,17.43949,860782
7530,tomaszpiekarczyk,4,0.00046,150120,17.43996,860782
7531,tomlankhorst,4,0.00046,150124,17.44042,860782
7532,tomlu,4,0.00046,150128,17.44089,860782
7533,tom-r-o,4,0.00046,150132,17.44135,860782
7534,TomyLobo,4,0.00046,150136,17.44181,860782
7535,tongying123456,4,0.00046,150140,17.44228,860782
7536,tonyaw,4,0.00046,150144,17.44274,860782
7537,tonychoe,4,0.00046,150148,17.44321,860782
7538,TonyLovesDevOps,4,0.00046,150152,17.44367,860782
7539,topliceanu,4,0.00046,150156,17.44414,860782
7540,tpetkov-VMW,4,0.00046,150160,17.44460,860782
7541,travikk,4,0.00046,150164,17.44507,860782
7542,treytabner,4,0.00046,150168,17.44553,860782
7543,troytop,4,0.00046,150172,17.44600,860782
7544,tshak,4,0.00046,150176,17.44646,860782
7545,ttsrg,4,0.00046,150180,17.44693,860782
7546,tumusudheer,4,0.00046,150184,17.44739,860782
7547,tusharRepo,4,0.00046,150188,17.44786,860782
7548,twadrianlis,4,0.00046,150192,17.44832,860782
7549,twocs,4,0.00046,150196,17.44878,860782
7550,txr150430,4,0.00046,150200,17.44925,860782
7551,Tylertron1998,4,0.00046,150204,17.44971,860782
7552,TyurinAS,4,0.00046,150208,17.45018,860782
7553,udaymadu,4,0.00046,150212,17.45064,860782
7554,ujihisa,4,0.00046,150216,17.45111,860782
7555,ulfjack,4,0.00046,150220,17.45157,860782
7556,umi0410,4,0.00046,150224,17.45204,860782
7557,umrikar,4,0.00046,150228,17.45250,860782
7558,uninvited,4,0.00046,150232,17.45297,860782
7559,Uni-wv,4,0.00046,150236,17.45343,860782
7560,unludo,4,0.00046,150240,17.45390,860782
7561,upday7,4,0.00046,150244,17.45436,860782
7562,uraniumsteel,4,0.00046,150248,17.45483,860782
7563,urmet,4,0.00046,150252,17.45529,860782
7564,Urvik08,4,0.00046,150256,17.45576,860782
7565,uselessidbr,4,0.00046,150260,17.45622,860782
7566,usernkey,4,0.00046,150264,17.45668,860782
7567,utkarsh-pandey-ext,4,0.00046,150268,17.45715,860782
7568,uwemaurer,4,0.00046,150272,17.45761,860782
7569,vadbluedata,4,0.00046,150276,17.45808,860782
7570,ValdasK,4,0.00046,150280,17.45854,860782
7571,valery-zhurbenko,4,0.00046,150284,17.45901,860782
7572,vanugrah,4,0.00046,150288,17.45947,860782
7573,vatine,4,0.00046,150292,17.45994,860782
7574,vbottu,4,0.00046,150296,17.46040,860782
7575,vdinovi,4,0.00046,150300,17.46087,860782
7576,velann21,4,0.00046,150304,17.46133,860782
7577,velvia,4,0.00046,150308,17.46180,860782
7578,venkatji,4,0.00046,150312,17.46226,860782
7579,verbunk,4,0.00046,150316,17.46273,860782
7580,verysonglaa,4,0.00046,150320,17.46319,860782
7581,vflong,4,0.00046,150324,17.46366,860782
7582,vignesh-v-nutanix,4,0.00046,150328,17.46412,860782
7583,VikasBains,4,0.00046,150332,17.46458,860782
7584,vinnyzhaowenyu,4,0.00046,150336,17.46505,860782
7585,virtualdxs,4,0.00046,150340,17.46551,860782
7586,virus2016,4,0.00046,150344,17.46598,860782
7587,vishnugs,4,0.00046,150348,17.46644,860782
7588,vivekpatani,4,0.00046,150352,17.46691,860782
7589,viveksatasiya,4,0.00046,150356,17.46737,860782
7590,vkhater,4,0.00046,150360,17.46784,860782
7591,vlganev,4,0.00046,150364,17.46830,860782
7592,vmdude,4,0.00046,150368,17.46877,860782
7593,vmvmpvm,4,0.00046,150372,17.46923,860782
7594,vofish,4,0.00046,150376,17.46970,860782
7595,vosdev,4,0.00046,150380,17.47016,860782
7596,Voziv,4,0.00046,150384,17.47063,860782
7597,vsai9594,4,0.00046,150388,17.47109,860782
7598,vsirimalla,4,0.00046,150392,17.47155,860782
7599,vtdat,4,0.00046,150396,17.47202,860782
7600,vvavepacket,4,0.00046,150400,17.47248,860782
7601,wahabmk,4,0.00046,150404,17.47295,860782
7602,wakeupcolumn,4,0.00046,150408,17.47341,860782
7603,walidshaari,4,0.00046,150412,17.47388,860782
7604,wangyanzhao,4,0.00046,150416,17.47434,860782
7605,wataruian,4,0.00046,150420,17.47481,860782
7606,Waterdrips,4,0.00046,150424,17.47527,860782
7607,wayne-li2,4,0.00046,150428,17.47574,860782
7608,wayne-o,4,0.00046,150432,17.47620,860782
7609,waynexia,4,0.00046,150436,17.47667,860782
7610,wbe7,4,0.00046,150440,17.47713,860782
7611,wcollin,4,0.00046,150444,17.47760,860782
7612,wecger,4,0.00046,150448,17.47806,860782
7613,wenxuwan,4,0.00046,150452,17.47853,860782
7614,wesleyParriott,4,0.00046,150456,17.47899,860782
7615,weslleycamilo,4,0.00046,150460,17.47945,860782
7616,wglambert,4,0.00046,150464,17.47992,860782
7617,whatthefrog,4,0.00046,150468,17.48038,860782
7618,whitehack2512,4,0.00046,150472,17.48085,860782
7619,whlcmhh,4,0.00046,150476,17.48131,860782
7620,Whoweez,4,0.00046,150480,17.48178,860782
7621,whyvez,4,0.00046,150484,17.48224,860782
7622,wiljay,4,0.00046,150488,17.48271,860782
7623,Wilm0r,4,0.00046,150492,17.48317,860782
7624,windmgc,4,0.00046,150496,17.48364,860782
7625,wingman-chakra,4,0.00046,150500,17.48410,860782
7626,WithoutCaps,4,0.00046,150504,17.48457,860782
7627,wkchee,4,0.00046,150508,17.48503,860782
7628,wodedipanr,4,0.00046,150512,17.48550,860782
7629,Woile,4,0.00046,150516,17.48596,860782
7630,woodliu,4,0.00046,150520,17.48643,860782
7631,wookietreiber,4,0.00046,150524,17.48689,860782
7632,WorldIsM,4,0.00046,150528,17.48735,860782
7633,wpfnihao,4,0.00046,150532,17.48782,860782
7634,wrossmann,4,0.00046,150536,17.48828,860782
7635,wtayyeb,4,0.00046,150540,17.48875,860782
7636,wuchao1111,4,0.00046,150544,17.48921,860782
7637,wwaayyaa,4,0.00046,150548,17.48968,860782
7638,wwitzel3,4,0.00046,150552,17.49014,860782
7639,wzshiming,4,0.00046,150556,17.49061,860782
7640,x1wins,4,0.00046,150560,17.49107,860782
7641,Xartos,4,0.00046,150564,17.49154,860782
7642,xdire,4,0.00046,150568,17.49200,860782
7643,xh3b4sd,4,0.00046,150572,17.49247,860782
7644,xi4oc4i,4,0.00046,150576,17.49293,860782
7645,xiaochonghao,4,0.00046,150580,17.49340,860782
7646,xiaodongw,4,0.00046,150584,17.49386,860782
7647,xiegang1,4,0.00046,150588,17.49432,860782
7648,xie-qianyue,4,0.00046,150592,17.49479,860782
7649,ximbal,4,0.00046,150596,17.49525,860782
7650,ximply,4,0.00046,150600,17.49572,860782
7651,xin053,4,0.00046,150604,17.49618,860782
7652,xinxindu,4,0.00046,150608,17.49665,860782
7653,xJoeWoo,4,0.00046,150612,17.49711,860782
7654,xjtian,4,0.00046,150616,17.49758,860782
7655,xkszltl,4,0.00046,150620,17.49804,860782
7656,xmichele,4,0.00046,150624,17.49851,860782
7657,xoanmi,4,0.00046,150628,17.49897,860782
7658,Xorima,4,0.00046,150632,17.49944,860782
7659,xs233,4,0.00046,150636,17.49990,860782
7660,xsqian,4,0.00046,150640,17.50037,860782
7661,xuejipeng,4,0.00046,150644,17.50083,860782
7662,xuyinhao,4,0.00046,150648,17.50130,860782
7663,xylix,4,0.00046,150652,17.50176,860782
7664,y805939188,4,0.00046,150656,17.50222,860782
7665,yahaa,4,0.00046,150660,17.50269,860782
7666,yangvipguang,4,0.00046,150664,17.50315,860782
7667,yangxikun,4,0.00046,150668,17.50362,860782
7668,yaoice,4,0.00046,150672,17.50408,860782
7669,yardensachs,4,0.00046,150676,17.50455,860782
7670,yasharne,4,0.00046,150680,17.50501,860782
7671,yassan,4,0.00046,150684,17.50548,860782
7672,Yaxian,4,0.00046,150688,17.50594,860782
7673,ycjessyhuang,4,0.00046,150692,17.50641,860782
7674,yeqown,4,0.00046,150696,17.50687,860782
7675,ye-will,4,0.00046,150700,17.50734,860782
7676,yinjingjiu,4,0.00046,150704,17.50780,860782
7677,yinynick,4,0.00046,150708,17.50827,860782
7678,yks0000,4,0.00046,150712,17.50873,860782
7679,yl-yue,4,0.00046,150716,17.50920,860782
7680,ylz-at,4,0.00046,150720,17.50966,860782
7681,yoan-adfinis,4,0.00046,150724,17.51012,860782
7682,yoavAqua,4,0.00046,150728,17.51059,860782
7683,yongxiu,4,0.00046,150732,17.51105,860782
7684,yordis,4,0.00046,150736,17.51152,860782
7685,youngjoonso1,4,0.00046,150740,17.51198,860782
7686,youngsofun,4,0.00046,150744,17.51245,860782
7687,younseunghyun,4,0.00046,150748,17.51291,860782
7688,ysennoun,4,0.00046,150752,17.51338,860782
7689,YSZhuoyang,4,0.00046,150756,17.51384,860782
7690,yuanyiran,4,0.00046,150760,17.51431,860782
7691,yufuluo,4,0.00046,150764,17.51477,860782
7692,yukunlin,4,0.00046,150768,17.51524,860782
7693,yuliyantsvetkov,4,0.00046,150772,17.51570,860782
7694,yunnysunny,4,0.00046,150776,17.51617,860782
7695,YunWang,4,0.00046,150780,17.51663,860782
7696,yurividal,4,0.00046,150784,17.51709,860782
7697,yuzisun,4,0.00046,150788,17.51756,860782
7698,yxzking,4,0.00046,150792,17.51802,860782
7699,yyf1986,4,0.00046,150796,17.51849,860782
7700,yyyogev,4,0.00046,150800,17.51895,860782
7701,yz8654773,4,0.00046,150804,17.51942,860782
7702,Yzerost,4,0.00046,150808,17.51988,860782
7703,zbing0203,4,0.00046,150812,17.52035,860782
7704,zcain117,4,0.00046,150816,17.52081,860782
7705,ZCube,4,0.00046,150820,17.52128,860782
7706,zhamdoctor,4,0.00046,150824,17.52174,860782
7707,zhangchangwei,4,0.00046,150828,17.52221,860782
7708,ZhangDewei,4,0.00046,150832,17.52267,860782
7709,zhanghepeng,4,0.00046,150836,17.52314,860782
7710,zhangyyun,4,0.00046,150840,17.52360,860782
7711,zhangzhenyu2,4,0.00046,150844,17.52407,860782
7712,zhaoguangqiang,4,0.00046,150848,17.52453,860782
7713,zhengcanbin,4,0.00046,150852,17.52499,860782
7714,zhouyp520,4,0.00046,150856,17.52546,860782
7715,zhu20200720,4,0.00046,150860,17.52592,860782
7716,zhuyanxi,4,0.00046,150864,17.52639,860782
7717,zhxqgithub,4,0.00046,150868,17.52685,860782
7718,zihengCat,4,0.00046,150872,17.52732,860782
7719,zjgoodman,4,0.00046,150876,17.52778,860782
7720,zmapleshine,4,0.00046,150880,17.52825,860782
7721,zonggen,4,0.00046,150884,17.52871,860782
7722,ZPerling,4,0.00046,150888,17.52918,860782
7723,zpittmansf,4,0.00046,150892,17.52964,860782
7724,zqdlove,4,0.00046,150896,17.53011,860782
7725,zxh326,4,0.00046,150900,17.53057,860782
7726,zxiaozhou,4,0.00046,150904,17.53104,860782
7727,zyguan,4,0.00046,150908,17.53150,860782
7728,zzq900503,4,0.00046,150912,17.53197,860782
7729,007g3m1n1,3,0.00035,150915,17.53231,860782
7730,012345678987654321,3,0.00035,150918,17.53266,860782
7731,0xF4D3C0D3,3,0.00035,150921,17.53301,860782
7732,1150310621,3,0.00035,150924,17.53336,860782
7733,11jwolfe2,3,0.00035,150927,17.53371,860782
7734,11matt556,3,0.00035,150930,17.53406,860782
7735,12Dong,3,0.00035,150933,17.53440,860782
7736,13217amasia,3,0.00035,150936,17.53475,860782
7737,404-geek,3,0.00035,150939,17.53510,860782
7738,496268931,3,0.00035,150942,17.53545,860782
7739,4c74356b41,3,0.00035,150945,17.53580,860782
7740,4n4nd,3,0.00035,150948,17.53615,860782
7741,7tabish,3,0.00035,150951,17.53650,860782
7742,871690991,3,0.00035,150954,17.53684,860782
7743,94d90b08-c4ef-416c-bf7b-b6c5b7275e6a,3,0.00035,150957,17.53719,860782
7744,9ee1,3,0.00035,150960,17.53754,860782
7745,a0145,3,0.00035,150963,17.53789,860782
7746,a36233,3,0.00035,150966,17.53824,860782
7747,a60814billy,3,0.00035,150969,17.53859,860782
7748,aaahrens,3,0.00035,150972,17.53894,860782
7749,aajain-com,3,0.00035,150975,17.53928,860782
7750,aapeliv,3,0.00035,150978,17.53963,860782
7751,aaronjheng,3,0.00035,150981,17.53998,860782
7752,aaronlindsey,3,0.00035,150984,17.54033,860782
7753,aashishgoyal246,3,0.00035,150987,17.54068,860782
7754,abhaybhargav,3,0.00035,150990,17.54103,860782
7755,Abhilash-sandupatla,3,0.00035,150993,17.54138,860782
7756,abhinav-goyall,3,0.00035,150996,17.54172,860782
7757,Abirdcfly,3,0.00035,150999,17.54207,860782
7758,aburluka,3,0.00035,151002,17.54242,860782
7759,AChaoZJU,3,0.00035,151005,17.54277,860782
7760,achevuru,3,0.00035,151008,17.54312,860782
7761,ackerr01,3,0.00035,151011,17.54347,860782
7762,acrigney,3,0.00035,151014,17.54381,860782
7763,act28,3,0.00035,151017,17.54416,860782
7764,adamj-codethink,3,0.00035,151020,17.54451,860782
7765,AdamSharif-MSFT,3,0.00035,151023,17.54486,860782
7766,adamulrich,3,0.00035,151026,17.54521,860782
7767,AdamWyzgol,3,0.00035,151029,17.54556,860782
7768,ada-u,3,0.00035,151032,17.54591,860782
7769,adberger,3,0.00035,151035,17.54625,860782
7770,addreas,3,0.00035,151038,17.54660,860782
7771,Adhders,3,0.00035,151041,17.54695,860782
7772,ADI10HERO,3,0.00035,151044,17.54730,860782
7773,adiezg,3,0.00035,151047,17.54765,860782
7774,adityamukho,3,0.00035,151050,17.54800,860782
7775,adk9,3,0.00035,151053,17.54835,860782
7776,admantium-sg,3,0.00035,151056,17.54869,860782
7777,admiral0,3,0.00035,151059,17.54904,860782
7778,admirito,3,0.00035,151062,17.54939,860782
7779,adreeana,3,0.00035,151065,17.54974,860782
7780,adrianimboden,3,0.00035,151068,17.55009,860782
7781,adrian-skybaker,3,0.00035,151071,17.55044,860782
7782,AdrieVanDijk,3,0.00035,151074,17.55079,860782
7783,ADustyOldMuffin,3,0.00035,151077,17.55113,860782
7784,AFMiziara,3,0.00035,151080,17.55148,860782
7785,agatakrajewska,3,0.00035,151083,17.55183,860782
7786,agehrke,3,0.00035,151086,17.55218,860782
7787,A-Gordon,3,0.00035,151089,17.55253,860782
7788,agrenott,3,0.00035,151092,17.55288,860782
7789,ahaeber,3,0.00035,151095,17.55322,860782
7790,ahilsend,3,0.00035,151098,17.55357,860782
7791,ahmedawais,3,0.00035,151101,17.55392,860782
7792,ahtohio,3,0.00035,151104,17.55427,860782
7793,aidan-melen,3,0.00035,151107,17.55462,860782
7794,aijamalnk,3,0.00035,151110,17.55497,860782
7795,AirbornePorcine,3,0.00035,151113,17.55532,860782
7796,aiyengar2,3,0.00035,151116,17.55566,860782
7797,aiyijing,3,0.00035,151119,17.55601,860782
7798,ajayr5,3,0.00035,151122,17.55636,860782
7799,ajf,3,0.00035,151125,17.55671,860782
7800,ajs11174,3,0.00035,151128,17.55706,860782
7801,ak2766,3,0.00035,151131,17.55741,860782
7802,AKASH209BC,3,0.00035,151134,17.55776,860782
7803,akashmantry,3,0.00035,151137,17.55810,860782
7804,akashpatel2,3,0.00035,151140,17.55845,860782
7805,AKBarcenas,3,0.00035,151143,17.55880,860782
7806,akhilkochuveedu,3,0.00035,151146,17.55915,860782
7807,akshaybhatt14495,3,0.00035,151149,17.55950,860782
7808,akshayyverma,3,0.00035,151152,17.55985,860782
7809,akulakhan,3,0.00035,151155,17.56020,860782
7810,akumacxd,3,0.00035,151158,17.56054,860782
7811,Alabate,3,0.00035,151161,17.56089,860782
7812,aland-zhang,3,0.00035,151164,17.56124,860782
7813,alanmeadows,3,0.00035,151167,17.56159,860782
7814,alanmoment,3,0.00035,151170,17.56194,860782
7815,albanm,3,0.00035,151173,17.56229,860782
7816,albertobeas20,3,0.00035,151176,17.56263,860782
7817,albertomilan,3,0.00035,151179,17.56298,860782
7818,aleeminati,3,0.00035,151182,17.56333,860782
7819,AleF83,3,0.00035,151185,17.56368,860782
7820,AleksandrNull,3,0.00035,151188,17.56403,860782
7821,aLekSer,3,0.00035,151191,17.56438,860782
7822,aleofreddi,3,0.00035,151194,17.56473,860782
7823,alesabater,3,0.00035,151197,17.56507,860782
7824,alesanmed,3,0.00035,151200,17.56542,860782
7825,Alex69rus,3,0.00035,151203,17.56577,860782
7826,AlexanderBinkovsky,3,0.00035,151206,17.56612,860782
7827,alexanderkyte,3,0.00035,151209,17.56647,860782
7828,alexanderturner,3,0.00035,151212,17.56682,860782
7829,alexandrevicenzi,3,0.00035,151215,17.56717,860782
7830,alexclarkofficial,3,0.00035,151218,17.56751,860782
7831,AlexDaSoul,3,0.00035,151221,17.56786,860782
7832,AlexDHoffer,3,0.00035,151224,17.56821,860782
7833,AlexeyRaga,3,0.00035,151227,17.56856,860782
7834,AlexHerman2,3,0.00035,151230,17.56891,860782
7835,alexkarpitski,3,0.00035,151233,17.56926,860782
7836,alexkhimich,3,0.00035,151236,17.56961,860782
7837,alexsmith15,3,0.00035,151239,17.56995,860782
7838,alextodicescu,3,0.00035,151242,17.57030,860782
7839,alexvanboxel,3,0.00035,151245,17.57065,860782
7840,alf009,3,0.00035,151248,17.57100,860782
7841,Aliabbask08,3,0.00035,151251,17.57135,860782
7842,alihalabyah,3,0.00035,151254,17.57170,860782
7843,AlKult,3,0.00035,151257,17.57204,860782
7844,Allex1,3,0.00035,151260,17.57239,860782
7845,almato-mdm-support,3,0.00035,151263,17.57274,860782
7846,alombardo4,3,0.00035,151266,17.57309,860782
7847,alukyan,3,0.00035,151269,17.57344,860782
7848,AmaliMatharaarachchi,3,0.00035,151272,17.57379,860782
7849,amariampolskiy,3,0.00035,151275,17.57414,860782
7850,amarsgithub,3,0.00035,151278,17.57448,860782
7851,amatestuser124,3,0.00035,151281,17.57483,860782
7852,amatosg,3,0.00035,151284,17.57518,860782
7853,amazingandyyy,3,0.00035,151287,17.57553,860782
7854,a-melnyk,3,0.00035,151290,17.57588,860782
7855,amgads,3,0.00035,151293,17.57623,860782
7856,amio,3,0.00035,151296,17.57658,860782
7857,amirdamirov,3,0.00035,151299,17.57692,860782
7858,amit17133129,3,0.00035,151302,17.57727,860782
7859,amitbhatia1987,3,0.00035,151305,17.57762,860782
7860,ammeil,3,0.00035,151308,17.57797,860782
7861,anaisbetts,3,0.00035,151311,17.57832,860782
7862,anasalloush,3,0.00035,151314,17.57867,860782
7863,andpozo,3,0.00035,151317,17.57902,860782
7864,andredxc,3,0.00035,151320,17.57936,860782
7865,andrejguran,3,0.00035,151323,17.57971,860782
7866,andrevegas,3,0.00035,151326,17.58006,860782
7867,andrew-lozoya,3,0.00035,151329,17.58041,860782
7868,andrewshaoyu,3,0.00035,151332,17.58076,860782
7869,andrzejwaw,3,0.00035,151335,17.58111,860782
7870,andtra,3,0.00035,151338,17.58146,860782
7871,andu1c,3,0.00035,151341,17.58180,860782
7872,andynx90,3,0.00035,151344,17.58215,860782
7873,andytsnowden,3,0.00035,151347,17.58250,860782
7874,andy-v-h,3,0.00035,151350,17.58285,860782
7875,andyyaldoo,3,0.00035,151353,17.58320,860782
7876,aneelysis,3,0.00035,151356,17.58355,860782
7877,AngelaNing97,3,0.00035,151359,17.58389,860782
7878,anitabee,3,0.00035,151362,17.58424,860782
7879,ankitjain87,3,0.00035,151365,17.58459,860782
7880,ankur-anand,3,0.00035,151368,17.58494,860782
7881,ankycooper,3,0.00035,151371,17.58529,860782
7882,anmolbabu,3,0.00035,151374,17.58564,860782
7883,annakosek,3,0.00035,151377,17.58599,860782
7884,annder,3,0.00035,151380,17.58633,860782
7885,anotherwriter,3,0.00035,151383,17.58668,860782
7886,AnshulPatni,3,0.00035,151386,17.58703,860782
7887,anshurajendra,3,0.00035,151389,17.58738,860782
7888,anson627,3,0.00035,151392,17.58773,860782
7889,anthonymq,3,0.00035,151395,17.58808,860782
7890,anthony-pastor,3,0.00035,151398,17.58843,860782
7891,AntonDzyk,3,0.00035,151401,17.58877,860782
7892,antoniotamer,3,0.00035,151404,17.58912,860782
7893,Antti-Paladin,3,0.00035,151407,17.58947,860782
7894,anujga,3,0.00035,151410,17.58982,860782
7895,anujgeek,3,0.00035,151413,17.59017,860782
7896,anuraagrijal3138,3,0.00035,151416,17.59052,860782
7897,apenen,3,0.00035,151419,17.59087,860782
7898,apigirl,3,0.00035,151422,17.59121,860782
7899,appleciderjack,3,0.00035,151425,17.59156,860782
7900,apr1809,3,0.00035,151428,17.59191,860782
7901,april4,3,0.00035,151431,17.59226,860782
7902,apurv15,3,0.00035,151434,17.59261,860782
7903,aqt01,3,0.00035,151437,17.59296,860782
7904,AquoDev,3,0.00035,151440,17.59330,860782
7905,aravindputrevu,3,0.00035,151443,17.59365,860782
7906,arbazkhan002,3,0.00035,151446,17.59400,860782
7907,ArcticB,3,0.00035,151449,17.59435,860782
7908,arctiqjacob,3,0.00035,151452,17.59470,860782
7909,ardymalihi,3,0.00035,151455,17.59505,860782
7910,arhea,3,0.00035,151458,17.59540,860782
7911,arielmoraes,3,0.00035,151461,17.59574,860782
7912,ArieScheurwater,3,0.00035,151464,17.59609,860782
7913,Aries-Lee1991,3,0.00035,151467,17.59644,860782
7914,arisettia,3,0.00035,151470,17.59679,860782
7915,aristosvo,3,0.00035,151473,17.59714,860782
7916,arjungoel,3,0.00035,151476,17.59749,860782
7917,armandgrillet,3,0.00035,151479,17.59784,860782
7918,armanos,3,0.00035,151482,17.59818,860782
7919,arminbuerkle,3,0.00035,151485,17.59853,860782
7920,Arnavion,3,0.00035,151488,17.59888,860782
7921,ArPharazon,3,0.00035,151491,17.59923,860782
7922,arpit1997,3,0.00035,151494,17.59958,860782
7923,arren-ru,3,0.00035,151497,17.59993,860782
7924,arsalan-vs,3,0.00035,151500,17.60028,860782
7925,artback,3,0.00035,151503,17.60062,860782
7926,ArtemKolichenkov,3,0.00035,151506,17.60097,860782
7927,artem-kosenko,3,0.00035,151509,17.60132,860782
7928,artemsablin,3,0.00035,151512,17.60167,860782
7929,arthurvaverko,3,0.00035,151515,17.60202,860782
7930,artooro,3,0.00035,151518,17.60237,860782
7931,arturenault,3,0.00035,151521,17.60271,860782
7932,artur-jablonski,3,0.00035,151524,17.60306,860782
7933,ArunaKumarik16,3,0.00035,151527,17.60341,860782
7934,Arun-KumarH,3,0.00035,151530,17.60376,860782
7935,ArvinSiChuan,3,0.00035,151533,17.60411,860782
7936,asaaki,3,0.00035,151536,17.60446,860782
7937,asdonation,3,0.00035,151539,17.60481,860782
7938,asenci,3,0.00035,151542,17.60515,860782
7939,ashikjm,3,0.00035,151545,17.60550,860782
7940,ashish1586,3,0.00035,151548,17.60585,860782
7941,ashishpatel1323,3,0.00035,151551,17.60620,860782
7942,ashispavan,3,0.00035,151554,17.60655,860782
7943,ashokwipro,3,0.00035,151557,17.60690,860782
7944,ashwiniramesha,3,0.00035,151560,17.60725,860782
7945,ashwini-vasanth,3,0.00035,151563,17.60759,860782
7946,asitaru,3,0.00035,151566,17.60794,860782
7947,AskAlexSharov,3,0.00035,151569,17.60829,860782
7948,astormnewrelic,3,0.00035,151572,17.60864,860782
7949,asubmani,3,0.00035,151575,17.60899,860782
7950,asyncee,3,0.00035,151578,17.60934,860782
7951,aThorp96,3,0.00035,151581,17.60969,860782
7952,Atlaster,3,0.00035,151584,17.61003,860782
7953,AtosNicoS,3,0.00035,151587,17.61038,860782
7954,atotala,3,0.00035,151590,17.61073,860782
7955,atpons,3,0.00035,151593,17.61108,860782
7956,aude,3,0.00035,151596,17.61143,860782
7957,audrey-brightloom,3,0.00035,151599,17.61178,860782
7958,augi,3,0.00035,151602,17.61212,860782
7959,augusten,3,0.00035,151605,17.61247,860782
7960,auras,3,0.00035,151608,17.61282,860782
7961,auswells,3,0.00035,151611,17.61317,860782
7962,automagic,3,0.00035,151614,17.61352,860782
7963,auvipy,3,0.00035,151617,17.61387,860782
7964,avdhoot,3,0.00035,151620,17.61422,860782
7965,aviorma,3,0.00035,151623,17.61456,860782
7966,avishnyakov,3,0.00035,151626,17.61491,860782
7967,AviVahl,3,0.00035,151629,17.61526,860782
7968,avnertzur,3,0.00035,151632,17.61561,860782
7969,awwx,3,0.00035,151635,17.61596,860782
7970,AyushG3112,3,0.00035,151638,17.61631,860782
7971,azeemzaidi,3,0.00035,151641,17.61666,860782
7972,azherullahkhan,3,0.00035,151644,17.61700,860782
7973,Azolo,3,0.00035,151647,17.61735,860782
7974,b23prodtm,3,0.00035,151650,17.61770,860782
7975,b675987273,3,0.00035,151653,17.61805,860782
7976,babiaastor,3,0.00035,151656,17.61840,860782
7977,Backbecher05,3,0.00035,151659,17.61875,860782
7978,badrulhussain,3,0.00035,151662,17.61910,860782
7979,Balador59,3,0.00035,151665,17.61944,860782
7980,balasenthil-d,3,0.00035,151668,17.61979,860782
7981,BaldStrong,3,0.00035,151671,17.62014,860782
7982,balpreet-telnyx,3,0.00035,151674,17.62049,860782
7983,balusarakesh,3,0.00035,151677,17.62084,860782
7984,bananetomate,3,0.00035,151680,17.62119,860782
7985,bankyadam,3,0.00035,151683,17.62153,860782
7986,banthaherder,3,0.00035,151686,17.62188,860782
7987,BaolongJia,3,0.00035,151689,17.62223,860782
7988,baptistemesta,3,0.00035,151692,17.62258,860782
7989,Barborica-Alexandru,3,0.00035,151695,17.62293,860782
7990,baremaximum,3,0.00035,151698,17.62328,860782
7991,barryz,3,0.00035,151701,17.62363,860782
7992,bartcode,3,0.00035,151704,17.62397,860782
7993,barthalion,3,0.00035,151707,17.62432,860782
7994,BartoszCki,3,0.00035,151710,17.62467,860782
7995,BartoszKaszewczuk,3,0.00035,151713,17.62502,860782
7996,bascht,3,0.00035,151716,17.62537,860782
7997,basheer12,3,0.00035,151719,17.62572,860782
7998,basvandenbrink,3,0.00035,151722,17.62607,860782
7999,bbl,3,0.00035,151725,17.62641,860782
8000,bcochofel,3,0.00035,151728,17.62676,860782
8001,bcressey,3,0.00035,151731,17.62711,860782
8002,bebyx,3,0.00035,151734,17.62746,860782
8003,behunin,3,0.00035,151737,17.62781,860782
8004,behzadm18,3,0.00035,151740,17.62816,860782
8005,beilber,3,0.00035,151743,17.62851,860782
8006,beirtipol,3,0.00035,151746,17.62885,860782
8007,beliot-atos,3,0.00035,151749,17.62920,860782
8008,benceszikora,3,0.00035,151752,17.62955,860782
8009,benjulios,3,0.00035,151755,17.62990,860782
8010,benp20,3,0.00035,151758,17.63025,860782
8011,benson-lin,3,0.00035,151761,17.63060,860782
8012,benwbooth,3,0.00035,151764,17.63094,860782
8013,Berbe,3,0.00035,151767,17.63129,860782
8014,BernardTsai,3,0.00035,151770,17.63164,860782
8015,berniechiu,3,0.00035,151773,17.63199,860782
8016,berthoug,3,0.00035,151776,17.63234,860782
8017,betonmoewe,3,0.00035,151779,17.63269,860782
8018,betterclever,3,0.00035,151782,17.63304,860782
8019,bgdnlp,3,0.00035,151785,17.63338,860782
8020,bgopalakrishnan1986,3,0.00035,151788,17.63373,860782
8021,bhabermaas,3,0.00035,151791,17.63408,860782
8022,bhargavim613,3,0.00035,151794,17.63443,860782
8023,bhavvu,3,0.00035,151797,17.63478,860782
8024,bhaweshintouch,3,0.00035,151800,17.63513,860782
8025,bhushankumarl,3,0.00035,151803,17.63548,860782
8026,bibinphilip,3,0.00035,151806,17.63582,860782
8027,BIGBALLON,3,0.00035,151809,17.63617,860782
8028,bigbohne,3,0.00035,151812,17.63652,860782
8029,bigpigeon,3,0.00035,151815,17.63687,860782
8030,bikashkumars,3,0.00035,151818,17.63722,860782
8031,billcchung,3,0.00035,151821,17.63757,860782
8032,BillDett,3,0.00035,151824,17.63792,860782
8033,billputer,3,0.00035,151827,17.63826,860782
8034,bitdancer,3,0.00035,151830,17.63861,860782
8035,bitomaxsp,3,0.00035,151833,17.63896,860782
8036,Bklyn,3,0.00035,151836,17.63931,860782
8037,blacksailer,3,0.00035,151839,17.63966,860782
8038,blankenshipz,3,0.00035,151842,17.64001,860782
8039,blee-wd,3,0.00035,151845,17.64035,860782
8040,bljusruk,3,0.00035,151848,17.64070,860782
8041,blodan,3,0.00035,151851,17.64105,860782
8042,bluca,3,0.00035,151854,17.64140,860782
8043,bmhm,3,0.00035,151857,17.64175,860782
8044,boarder981,3,0.00035,151860,17.64210,860782
8045,bohrasd,3,0.00035,151863,17.64245,860782
8046,bolipereira,3,0.00035,151866,17.64279,860782
8047,boocup,3,0.00035,151869,17.64314,860782
8048,Boran,3,0.00035,151872,17.64349,860782
8049,boskoop,3,0.00035,151875,17.64384,860782
8050,BostjanBozic,3,0.00035,151878,17.64419,860782
8051,bostonaqua,3,0.00035,151881,17.64454,860782
8052,boundless-thread,3,0.00035,151884,17.64489,860782
8053,BowlingX,3,0.00035,151887,17.64523,860782
8054,bpinter,3,0.00035,151890,17.64558,860782
8055,bqian20,3,0.00035,151893,17.64593,860782
8056,bradmat,3,0.00035,151896,17.64628,860782
8057,braedon,3,0.00035,151899,17.64663,860782
8058,bramvdbogaerde,3,0.00035,151902,17.64698,860782
8059,brasky,3,0.00035,151905,17.64733,860782
8060,brasseld,3,0.00035,151908,17.64767,860782
8061,brechtvhb,3,0.00035,151911,17.64802,860782
8062,brennancheung,3,0.00035,151914,17.64837,860782
8063,breun,3,0.00035,151917,17.64872,860782
8064,breunigs,3,0.00035,151920,17.64907,860782
8065,brewsteropsdev,3,0.00035,151923,17.64942,860782
8066,breyer,3,0.00035,151926,17.64976,860782
8067,brianashby-sfx,3,0.00035,151929,17.65011,860782
8068,brianmajor,3,0.00035,151932,17.65046,860782
8069,briansneddon,3,0.00035,151935,17.65081,860782
8070,BrijJhala,3,0.00035,151938,17.65116,860782
8071,bryanchang15,3,0.00035,151941,17.65151,860782
8072,bsherrod,3,0.00035,151944,17.65186,860782
8073,bt-jonathanchen,3,0.00035,151947,17.65220,860782
8074,bttger,3,0.00035,151950,17.65255,860782
8075,buanzo,3,0.00035,151953,17.65290,860782
8076,bugaolengdeyuxiaoer,3,0.00035,151956,17.65325,860782
8077,bugok,3,0.00035,151959,17.65360,860782
8078,bumbing,3,0.00035,151962,17.65395,860782
8079,buno047,3,0.00035,151965,17.65430,860782
8080,buzzers,3,0.00035,151968,17.65464,860782
8081,byakku,3,0.00035,151971,17.65499,860782
8082,C123R,3,0.00035,151974,17.65534,860782
8083,ca7erina,3,0.00035,151977,17.65569,860782
8084,caiges,3,0.00035,151980,17.65604,860782
8085,caihy05,3,0.00035,151983,17.65639,860782
8086,caiusb,3,0.00035,151986,17.65674,860782
8087,cakuros,3,0.00035,151989,17.65708,860782
8088,caleno,3,0.00035,151992,17.65743,860782
8089,cameronkerrnz,3,0.00035,151995,17.65778,860782
8090,camrossi,3,0.00035,151998,17.65813,860782
8091,Candy93j,3,0.00035,152001,17.65848,860782
8092,canidam,3,0.00035,152004,17.65883,860782
8093,cannium,3,0.00035,152007,17.65918,860782
8094,caoyukun0430,3,0.00035,152010,17.65952,860782
8095,capnajax,3,0.00035,152013,17.65987,860782
8096,CapoD,3,0.00035,152016,17.66022,860782
8097,cappyzawa,3,0.00035,152019,17.66057,860782
8098,CaramelMario,3,0.00035,152022,17.66092,860782
8099,carletes,3,0.00035,152025,17.66127,860782
8100,carlonoelle,3,0.00035,152028,17.66161,860782
8101,carlosafonso,3,0.00035,152031,17.66196,860782
8102,carnesen,3,0.00035,152034,17.66231,860782
8103,CarolineTeicher,3,0.00035,152037,17.66266,860782
8104,carpdm,3,0.00035,152040,17.66301,860782
8105,carsoni,3,0.00035,152043,17.66336,860782
8106,catherye,3,0.00035,152046,17.66371,860782
8107,caugustus-ezcater,3,0.00035,152049,17.66405,860782
8108,cawoodm,3,0.00035,152052,17.66440,860782
8109,cazorla19,3,0.00035,152055,17.66475,860782
8110,cbraynor,3,0.00035,152058,17.66510,860782
8111,cbui,3,0.00035,152061,17.66545,860782
8112,cbuto,3,0.00035,152064,17.66580,860782
8113,cc19931002,3,0.00035,152067,17.66615,860782
8114,ccqpein,3,0.00035,152070,17.66649,860782
8115,cdecker,3,0.00035,152073,17.66684,860782
8116,cdlcs,3,0.00035,152076,17.66719,860782
8117,cdunford,3,0.00035,152079,17.66754,860782
8118,ceastman-ibm,3,0.00035,152082,17.66789,860782
8119,cedef,3,0.00035,152085,17.66824,860782
8120,cedlerouge,3,0.00035,152088,17.66859,860782
8121,ceelian,3,0.00035,152091,17.66893,860782
8122,CentUser,3,0.00035,152094,17.66928,860782
8123,Centzilius,3,0.00035,152097,17.66963,860782
8124,cesar-rodriguez,3,0.00035,152100,17.66998,860782
8125,cezane,3,0.00035,152103,17.67033,860782
8126,cfiderer,3,0.00035,152106,17.67068,860782
8127,chadbitzer,3,0.00035,152109,17.67102,860782
8128,chadlwilson,3,0.00035,152112,17.67137,860782
8129,chaimcode,3,0.00035,152115,17.67172,860782
8130,chaishiqi,3,0.00035,152118,17.67207,860782
8131,chaitushiva,3,0.00035,152121,17.67242,860782
8132,chaliy,3,0.00035,152124,17.67277,860782
8133,chanseokoh,3,0.00035,152127,17.67312,860782
8134,chaochn47,3,0.00035,152130,17.67346,860782
8135,CharanBR,3,0.00035,152133,17.67381,860782
8136,charliecatney,3,0.00035,152136,17.67416,860782
8137,Chartreux0,3,0.00035,152139,17.67451,860782
8138,chemasan,3,0.00035,152142,17.67486,860782
8139,cheng0214,3,0.00035,152145,17.67521,860782
8140,chenhaiq,3,0.00035,152148,17.67556,860782
8141,chethanah,3,0.00035,152151,17.67590,860782
8142,chez-shanpu,3,0.00035,152154,17.67625,860782
8143,chiefzor,3,0.00035,152157,17.67660,860782
8144,chikinchoi,3,0.00035,152160,17.67695,860782
8145,Chinaxiang,3,0.00035,152163,17.67730,860782
8146,chinniehendrix,3,0.00035,152166,17.67765,860782
8147,chintan-mishra,3,0.00035,152169,17.67800,860782
8148,chiru6003,3,0.00035,152172,17.67834,860782
8149,CH-karthikprasad,3,0.00035,152175,17.67869,860782
8150,chmielas,3,0.00035,152178,17.67904,860782
8151,chrisahl,3,0.00035,152181,17.67939,860782
8152,chrisfw,3,0.00035,152184,17.67974,860782
8153,Chris-Lauer,3,0.00035,152187,17.68009,860782
8154,christbenhur,3,0.00035,152190,17.68043,860782
8155,christiaangoossens,3,0.00035,152193,17.68078,860782
8156,ChristosKa,3,0.00035,152196,17.68113,860782
8157,chriswilliams1977,3,0.00035,152199,17.68148,860782
8158,chriswwalz,3,0.00035,152202,17.68183,860782
8159,chrizel,3,0.00035,152205,17.68218,860782
8160,chroju,3,0.00035,152208,17.68253,860782
8161,chromy96,3,0.00035,152211,17.68287,860782
8162,ChuckHend,3,0.00035,152214,17.68322,860782
8163,chukynax,3,0.00035,152217,17.68357,860782
8164,chunqizhi,3,0.00035,152220,17.68392,860782
8165,chunyingli,3,0.00035,152223,17.68427,860782
8166,cinder-fish,3,0.00035,152226,17.68462,860782
8167,circum1,3,0.00035,152229,17.68497,860782
8168,cj-anthony,3,0.00035,152232,17.68531,860782
8169,cjbehm,3,0.00035,152235,17.68566,860782
8170,cjk,3,0.00035,152238,17.68601,860782
8171,cjmckenna,3,0.00035,152241,17.68636,860782
8172,cjohnstoniv,3,0.00035,152244,17.68671,860782
8173,Ckopitc,3,0.00035,152247,17.68706,860782
8174,ckyx,3,0.00035,152250,17.68741,860782
8175,clambin,3,0.00035,152253,17.68775,860782
8176,ClavinJune,3,0.00035,152256,17.68810,860782
8177,Clement-Jean,3,0.00035,152259,17.68845,860782
8178,ClemOzil,3,0.00035,152262,17.68880,860782
8179,cloud-egl,3,0.00035,152265,17.68915,860782
8180,cnaslain,3,0.00035,152268,17.68950,860782
8181,cneumaier,3,0.00035,152271,17.68984,860782
8182,codeactivist,3,0.00035,152274,17.69019,860782
8183,codecandy2015,3,0.00035,152277,17.69054,860782
8184,code-pug,3,0.00035,152280,17.69089,860782
8185,codingkapoor,3,0.00035,152283,17.69124,860782
8186,cohomology,3,0.00035,152286,17.69159,860782
8187,colangelo,3,0.00035,152289,17.69194,860782
8188,colearendt,3,0.00035,152292,17.69228,860782
8189,colinman,3,0.00035,152295,17.69263,860782
8190,columbus9963,3,0.00035,152298,17.69298,860782
8191,congim,3,0.00035,152301,17.69333,860782
8192,ConnorJC3,3,0.00035,152304,17.69368,860782
8193,connorworkman,3,0.00035,152307,17.69403,860782
8194,conradj87,3,0.00035,152310,17.69438,860782
8195,consokodev,3,0.00035,152313,17.69472,860782
8196,ConverJens,3,0.00035,152316,17.69507,860782
8197,cooclsee,3,0.00035,152319,17.69542,860782
8198,coolshilpi6,3,0.00035,152322,17.69577,860782
8199,copocaneta,3,0.00035,152325,17.69612,860782
8200,coreyperkins,3,0.00035,152328,17.69647,860782
8201,corneredrat,3,0.00035,152331,17.69682,860782
8202,CostelLupoaie,3,0.00035,152334,17.69716,860782
8203,cowlingj,3,0.00035,152337,17.69751,860782
8204,cpressland,3,0.00035,152340,17.69786,860782
8205,crackcomm,3,0.00035,152343,17.69821,860782
8206,cranzy,3,0.00035,152346,17.69856,860782
8207,crawforde,3,0.00035,152349,17.69891,860782
8208,crazyss,3,0.00035,152352,17.69925,860782
8209,creet0007,3,0.00035,152355,17.69960,860782
8210,crisfrusu,3,0.00035,152358,17.69995,860782
8211,cristobal,3,0.00035,152361,17.70030,860782
8212,cro,3,0.00035,152364,17.70065,860782
8213,crodjer,3,0.00035,152367,17.70100,860782
8214,croziere,3,0.00035,152370,17.70135,860782
8215,cruelwen,3,0.00035,152373,17.70169,860782
8216,cryptox31,3,0.00035,152376,17.70204,860782
8217,cshivashankar,3,0.00035,152379,17.70239,860782
8218,csolidum,3,0.00035,152382,17.70274,860782
8219,cstroe,3,0.00035,152385,17.70309,860782
8220,ctolon22,3,0.00035,152388,17.70344,860782
8221,ctrlshp,3,0.00035,152391,17.70379,860782
8222,cvalla,3,0.00035,152394,17.70413,860782
8223,cvanlabe,3,0.00035,152397,17.70448,860782
8224,CVVDN-S,3,0.00035,152400,17.70483,860782
8225,cvvz,3,0.00035,152403,17.70518,860782
8226,cwadley,3,0.00035,152406,17.70553,860782
8227,cwsolee,3,0.00035,152409,17.70588,860782
8228,cwt,3,0.00035,152412,17.70623,860782
8229,cyperplex,3,0.00035,152415,17.70657,860782
8230,czysl,3,0.00035,152418,17.70692,860782
8231,dabest1,3,0.00035,152421,17.70727,860782
8232,DaddyWesker,3,0.00035,152424,17.70762,860782
8233,dagvl,3,0.00035,152427,17.70797,860782
8234,dailyherold,3,0.00035,152430,17.70832,860782
8235,dalejrodriguez,3,0.00035,152433,17.70866,860782
8236,danche,3,0.00035,152436,17.70901,860782
8237,danfaer,3,0.00035,152439,17.70936,860782
8238,danhawkins,3,0.00035,152442,17.70971,860782
8239,danielhass,3,0.00035,152445,17.71006,860782
8240,daniellawrence,3,0.00035,152448,17.71041,860782
8241,danielleiszen,3,0.00035,152451,17.71076,860782
8242,danielmarbach,3,0.00035,152454,17.71110,860782
8243,danielmoore,3,0.00035,152457,17.71145,860782
8244,danielrataj,3,0.00035,152460,17.71180,860782
8245,danielschnetler,3,0.00035,152463,17.71215,860782
8246,danielthank,3,0.00035,152466,17.71250,860782
8247,Danish864,3,0.00035,152469,17.71285,860782
8248,danitfk,3,0.00035,152472,17.71320,860782
8249,dan-katz,3,0.00035,152475,17.71354,860782
8250,danlister,3,0.00035,152478,17.71389,860782
8251,danny2394,3,0.00035,152481,17.71424,860782
8252,danoh-recurly,3,0.00035,152484,17.71459,860782
8253,danquah,3,0.00035,152487,17.71494,860782
8254,dantman,3,0.00035,152490,17.71529,860782
8255,danylohetmantsev,3,0.00035,152493,17.71564,860782
8256,dariogriffo,3,0.00035,152496,17.71598,860782
8257,dark-shade,3,0.00035,152499,17.71633,860782
8258,datavisorerzuozhou,3,0.00035,152502,17.71668,860782
8259,datgeek,3,0.00035,152505,17.71703,860782
8260,davemac30,3,0.00035,152508,17.71738,860782
8261,daveram,3,0.00035,152511,17.71773,860782
8262,davesachin,3,0.00035,152514,17.71807,860782
8263,davidfm,3,0.00035,152517,17.71842,860782
8264,david-kirby,3,0.00035,152520,17.71877,860782
8265,davidlj95,3,0.00035,152523,17.71912,860782
8266,david-l-riley,3,0.00035,152526,17.71947,860782
8267,davidoceans,3,0.00035,152529,17.71982,860782
8268,davids91,3,0.00035,152532,17.72017,860782
8269,DavidWells,3,0.00035,152535,17.72051,860782
8270,davidwtf,3,0.00035,152538,17.72086,860782
8271,dawncold,3,0.00035,152541,17.72121,860782
8272,Daxtrose,3,0.00035,152544,17.72156,860782
8273,Daych,3,0.00035,152547,17.72191,860782
8274,dayeol,3,0.00035,152550,17.72226,860782
8275,dbabbitt,3,0.00035,152553,17.72261,860782
8276,dbafromthecold,3,0.00035,152556,17.72295,860782
8277,dbevan-kabam,3,0.00035,152559,17.72330,860782
8278,dboshardy,3,0.00035,152562,17.72365,860782
8279,dbrat43,3,0.00035,152565,17.72400,860782
8280,dcodix,3,0.00035,152568,17.72435,860782
8281,debankur1,3,0.00035,152571,17.72470,860782
8282,decanus,3,0.00035,152574,17.72505,860782
8283,deedrah,3,0.00035,152577,17.72539,860782
8284,deepaksrinath,3,0.00035,152580,17.72574,860782
8285,deepavk,3,0.00035,152583,17.72609,860782
8286,deep-blue,3,0.00035,152586,17.72644,860782
8287,deewhyweb,3,0.00035,152589,17.72679,860782
8288,delamart,3,0.00035,152592,17.72714,860782
8289,dellelce,3,0.00035,152595,17.72749,860782
8290,demikl,3,0.00035,152598,17.72783,860782
8291,Den3,3,0.00035,152601,17.72818,860782
8292,denniseffing,3,0.00035,152604,17.72853,860782
8293,derba,3,0.00035,152607,17.72888,860782
8294,DerekTBrown,3,0.00035,152610,17.72923,860782
8295,design365,3,0.00035,152613,17.72958,860782
8296,devdinu,3,0.00035,152616,17.72992,860782
8297,dev-e,3,0.00035,152619,17.73027,860782
8298,deveshbajpai19,3,0.00035,152622,17.73062,860782
8299,devlucasc,3,0.00035,152625,17.73097,860782
8300,devopsali7118,3,0.00035,152628,17.73132,860782
8301,dewe,3,0.00035,152631,17.73167,860782
8302,dfedorov-ciena,3,0.00035,152634,17.73202,860782
8303,dg-jwmera,3,0.00035,152637,17.73236,860782
8304,dhalperi,3,0.00035,152640,17.73271,860782
8305,dhananshan,3,0.00035,152643,17.73306,860782
8306,dhdersch,3,0.00035,152646,17.73341,860782
8307,dhirajsurve,3,0.00035,152649,17.73376,860782
8308,dhoppe,3,0.00035,152652,17.73411,860782
8309,DhruvM94,3,0.00035,152655,17.73446,860782
8310,DianaOlympos,3,0.00035,152658,17.73480,860782
8311,diego-lugones,3,0.00035,152661,17.73515,860782
8312,diemus,3,0.00035,152664,17.73550,860782
8313,diepes,3,0.00035,152667,17.73585,860782
8314,DifanZhang,3,0.00035,152670,17.73620,860782
8315,digitalsanctum,3,0.00035,152673,17.73655,860782
8316,dilshad18,3,0.00035,152676,17.73690,860782
8317,dimalbaby,3,0.00035,152679,17.73724,860782
8318,dimbleby,3,0.00035,152682,17.73759,860782
8319,DiogoMajela,3,0.00035,152685,17.73794,860782
8320,dipeshjoshi,3,0.00035,152688,17.73829,860782
8321,dipeti,3,0.00035,152691,17.73864,860782
8322,DirkTheDaring,3,0.00035,152694,17.73899,860782
8323,discodonut,3,0.00035,152697,17.73933,860782
8324,disconnect3d,3,0.00035,152700,17.73968,860782
8325,disparo13,3,0.00035,152703,17.74003,860782
8326,DivyaNayaka,3,0.00035,152706,17.74038,860782
8327,Djiit,3,0.00035,152709,17.74073,860782
8328,dkabracadabra,3,0.00035,152712,17.74108,860782
8329,dkulchinsky,3,0.00035,152715,17.74143,860782
8330,dlfoo,3,0.00035,152718,17.74177,860782
8331,dm0610,3,0.00035,152721,17.74212,860782
8332,dmarkwat,3,0.00035,152724,17.74247,860782
8333,dmcquiston8,3,0.00035,152727,17.74282,860782
8334,d-mo,3,0.00035,152730,17.74317,860782
8335,dmosruby,3,0.00035,152733,17.74352,860782
8336,dmsolr,3,0.00035,152736,17.74387,860782
8337,dmxlsj,3,0.00035,152739,17.74421,860782
8338,dmytroleonenko,3,0.00035,152742,17.74456,860782
8339,dmytroshokha,3,0.00035,152745,17.74491,860782
8340,dnishimura,3,0.00035,152748,17.74526,860782
8341,dnull88,3,0.00035,152751,17.74561,860782
8342,domgoodwin,3,0.00035,152754,17.74596,860782
8343,domhdp,3,0.00035,152757,17.74631,860782
8344,domingusj,3,0.00035,152760,17.74665,860782
8345,dominicqi,3,0.00035,152763,17.74700,860782
8346,dominik-bln,3,0.00035,152766,17.74735,860782
8347,dominikrose-leanix,3,0.00035,152769,17.74770,860782
8348,DonatasFe,3,0.00035,152772,17.74805,860782
8349,dongkaipo,3,0.00035,152775,17.74840,860782
8350,dongnt1612,3,0.00035,152778,17.74874,860782
8351,donmstewart,3,0.00035,152781,17.74909,860782
8352,dooleyb1,3,0.00035,152784,17.74944,860782
8353,DoomGerbil,3,0.00035,152787,17.74979,860782
8354,dopey,3,0.00035,152790,17.75014,860782
8355,Doqnach,3,0.00035,152793,17.75049,860782
8356,DotNetRockStar,3,0.00035,152796,17.75084,860782
8357,douglasduteil,3,0.00035,152799,17.75118,860782
8358,dp450,3,0.00035,152802,17.75153,860782
8359,dpaks,3,0.00035,152805,17.75188,860782
8360,dprittie,3,0.00035,152808,17.75223,860782
8361,DragonBanana,3,0.00035,152811,17.75258,860782
8362,Dragotic,3,0.00035,152814,17.75293,860782
8363,drewfisher314,3,0.00035,152817,17.75328,860782
8364,dricoco,3,0.00035,152820,17.75362,860782
8365,drumcircle,3,0.00035,152823,17.75397,860782
8366,drzdbd1,3,0.00035,152826,17.75432,860782
8367,dschaaff,3,0.00035,152829,17.75467,860782
8368,dschunack,3,0.00035,152832,17.75502,860782
8369,dsnet,3,0.00035,152835,17.75537,860782
8370,dspenard,3,0.00035,152838,17.75572,860782
8371,DTrejo,3,0.00035,152841,17.75606,860782
8372,duboc,3,0.00035,152844,17.75641,860782
8373,duckpuppy,3,0.00035,152847,17.75676,860782
8374,dukeng,3,0.00035,152850,17.75711,860782
8375,Dulanic,3,0.00035,152853,17.75746,860782
8376,dungnt081191,3,0.00035,152856,17.75781,860782
8377,dunnock,3,0.00035,152859,17.75815,860782
8378,Dunoyer,3,0.00035,152862,17.75850,860782
8379,dupengcheng,3,0.00035,152865,17.75885,860782
8380,Durbois,3,0.00035,152868,17.75920,860782
8381,duythien,3,0.00035,152871,17.75955,860782
8382,dykow,3,0.00035,152874,17.75990,860782
8383,Dzhan85,3,0.00035,152877,17.76025,860782
8384,eas5,3,0.00035,152880,17.76059,860782
8385,easel,3,0.00035,152883,17.76094,860782
8386,easimon,3,0.00035,152886,17.76129,860782
8387,EasonFeng5870,3,0.00035,152889,17.76164,860782
8388,eaterm,3,0.00035,152892,17.76199,860782
8389,ebcarty,3,0.00035,152895,17.76234,860782
8390,ebenezarisaac,3,0.00035,152898,17.76269,860782
8391,ebrudalkir,3,0.00035,152901,17.76303,860782
8392,ebucchianeri,3,0.00035,152904,17.76338,860782
8393,ecbrodie,3,0.00035,152907,17.76373,860782
8394,ecky-l,3,0.00035,152910,17.76408,860782
8395,ecmercado,3,0.00035,152913,17.76443,860782
8396,edgardang,3,0.00035,152916,17.76478,860782
8397,edgrz,3,0.00035,152919,17.76513,860782
8398,edmeister,3,0.00035,152922,17.76547,860782
8399,edxi,3,0.00035,152925,17.76582,860782
8400,eerichmond,3,0.00035,152928,17.76617,860782
8401,eesperi,3,0.00035,152931,17.76652,860782
8402,eez0,3,0.00035,152934,17.76687,860782
8403,efeller,3,0.00035,152937,17.76722,860782
8404,efotopoulou,3,0.00035,152940,17.76756,860782
8405,Efp95,3,0.00035,152943,17.76791,860782
8406,ehrktia,3,0.00035,152946,17.76826,860782
8407,einst44,3,0.00035,152949,17.76861,860782
8408,ejhayes,3,0.00035,152952,17.76896,860782
8409,ejiek,3,0.00035,152955,17.76931,860782
8410,ekanai,3,0.00035,152958,17.76966,860782
8411,eleaner,3,0.00035,152961,17.77000,860782
8412,ElectricRabbit,3,0.00035,152964,17.77035,860782
8413,eliasp,3,0.00035,152967,17.77070,860782
8414,elinesterov,3,0.00035,152970,17.77105,860782
8415,elvinasp,3,0.00035,152973,17.77140,860782
8416,emacdona,3,0.00035,152976,17.77175,860782
8417,emilwangaa,3,0.00035,152979,17.77210,860782
8418,emmanuelCarre,3,0.00035,152982,17.77244,860782
8419,emreberber,3,0.00035,152985,17.77279,860782
8420,eMurgaNd,3,0.00035,152988,17.77314,860782
8421,Encore222,3,0.00035,152991,17.77349,860782
8422,encryptblockr,3,0.00035,152994,17.77384,860782
8423,engnakagawa,3,0.00035,152997,17.77419,860782
8424,enguerrand,3,0.00035,153000,17.77454,860782
8425,engyishere,3,0.00035,153003,17.77488,860782
8426,enokawa,3,0.00035,153006,17.77523,860782
8427,enricovittorini,3,0.00035,153009,17.77558,860782
8428,enzian,3,0.00035,153012,17.77593,860782
8429,eplightning,3,0.00035,153015,17.77628,860782
8430,epuertat,3,0.00035,153018,17.77663,860782
8431,eraclitux,3,0.00035,153021,17.77697,860782
8432,ericgomes56,3,0.00035,153024,17.77732,860782
8433,ericharmeling,3,0.00035,153027,17.77767,860782
8434,ericleu,3,0.00035,153030,17.77802,860782
8435,ericychoi,3,0.00035,153033,17.77837,860782
8436,erikbryant,3,0.00035,153036,17.77872,860782
8437,erkannt,3,0.00035,153039,17.77907,860782
8438,ermakov-oleg,3,0.00035,153042,17.77941,860782
8439,ernaldobr,3,0.00035,153045,17.77976,860782
8440,errogaht,3,0.00035,153048,17.78011,860782
8441,ervindm,3,0.00035,153051,17.78046,860782
8442,eselkin,3,0.00035,153054,17.78081,860782
8443,estei,3,0.00035,153057,17.78116,860782
8444,ethinx,3,0.00035,153060,17.78151,860782
8445,EusebiusAditya,3,0.00035,153063,17.78185,860782
8446,everythings-gonna-be-alright,3,0.00035,153066,17.78220,860782
8447,evq,3,0.00035,153069,17.78255,860782
8448,ewassef,3,0.00035,153072,17.78290,860782
8449,ewezhai,3,0.00035,153075,17.78325,860782
8450,fafalafafa,3,0.00035,153078,17.78360,860782
8451,fai555,3,0.00035,153081,17.78395,860782
8452,faintdream,3,0.00035,153084,17.78429,860782
8453,fanglijun,3,0.00035,153087,17.78464,860782
8454,fbongiovanni29,3,0.00035,153090,17.78499,860782
8455,fcantournet,3,0.00035,153093,17.78534,860782
8456,fcioffi,3,0.00035,153096,17.78569,860782
8457,Fedomn,3,0.00035,153099,17.78604,860782
8458,feige0304,3,0.00035,153102,17.78638,860782
8459,felixfriedrich,3,0.00035,153105,17.78673,860782
8460,FelixRodriguezJara,3,0.00035,153108,17.78708,860782
8461,felixtran39,3,0.00035,153111,17.78743,860782
8462,fella752,3,0.00035,153114,17.78778,860782
8463,fenggolang,3,0.00035,153117,17.78813,860782
8464,FengXingYuXin,3,0.00035,153120,17.78848,860782
8465,fenngwd,3,0.00035,153123,17.78882,860782
8466,ferried,3,0.00035,153126,17.78917,860782
8467,fhofherr,3,0.00035,153129,17.78952,860782
8468,ficcaglia,3,0.00035,153132,17.78987,860782
8469,fidato13,3,0.00035,153135,17.79022,860782
8470,filipepinheiro,3,0.00035,153138,17.79057,860782
8471,filip-havlicek,3,0.00035,153141,17.79092,860782
8472,firecat53,3,0.00035,153144,17.79126,860782
8473,fischer-ti,3,0.00035,153147,17.79161,860782
8474,fishioon,3,0.00035,153150,17.79196,860782
8475,fishzle,3,0.00035,153153,17.79231,860782
8476,fkaleo,3,0.00035,153156,17.79266,860782
8477,fknipp,3,0.00035,153159,17.79301,860782
8478,FlexibleToast,3,0.00035,153162,17.79336,860782
8479,fliphess,3,0.00035,153165,17.79370,860782
8480,flolu,3,0.00035,153168,17.79405,860782
8481,florianbegusch,3,0.00035,153171,17.79440,860782
8482,FlorinAlexandru,3,0.00035,153174,17.79475,860782
8483,Fluepke,3,0.00035,153177,17.79510,860782
8484,foobaar,3,0.00035,153180,17.79545,860782
8485,ForbesLindesay,3,0.00035,153183,17.79579,860782
8486,ForcemCS,3,0.00035,153186,17.79614,860782
8487,Forest-L,3,0.00035,153189,17.79649,860782
8488,Forget-C,3,0.00035,153192,17.79684,860782
8489,foshantiger,3,0.00035,153195,17.79719,860782
8490,fowlie,3,0.00035,153198,17.79754,860782
8491,foxDmu,3,0.00035,153201,17.79789,860782
8492,foxeng,3,0.00035,153204,17.79823,860782
8493,Francesco1971,3,0.00035,153207,17.79858,860782
8494,Francine09,3,0.00035,153210,17.79893,860782
8495,frankiecerk,3,0.00035,153213,17.79928,860782
8496,FrankieSanzica,3,0.00035,153216,17.79963,860782
8497,FreakTheMighty,3,0.00035,153219,17.79998,860782
8498,fredcb,3,0.00035,153222,17.80033,860782
8499,frederick-newtz,3,0.00035,153225,17.80067,860782
8500,fredsted,3,0.00035,153228,17.80102,860782
8501,fresaelens,3,0.00035,153231,17.80137,860782
8502,friederbluemle,3,0.00035,153234,17.80172,860782
8503,friegger,3,0.00035,153237,17.80207,860782
8504,FritschAuctores,3,0.00035,153240,17.80242,860782
8505,Frizlab,3,0.00035,153243,17.80277,860782
8506,futangwa,3,0.00035,153246,17.80311,860782
8507,fxnn,3,0.00035,153249,17.80346,860782
8508,fzxbl,3,0.00035,153252,17.80381,860782
8509,gagipro,3,0.00035,153255,17.80416,860782
8510,galileo-pkm,3,0.00035,153258,17.80451,860782
8511,GaneshbabuRamamoorthy,3,0.00035,153261,17.80486,860782
8512,ganeshr2,3,0.00035,153264,17.80521,860782
8513,g-angstrom,3,0.00035,153267,17.80555,860782
8514,gannan08,3,0.00035,153270,17.80590,860782
8515,gaodan-fang,3,0.00035,153273,17.80625,860782
8516,gaoyanyu,3,0.00035,153276,17.80660,860782
8517,gapariha,3,0.00035,153279,17.80695,860782
8518,garysdevil,3,0.00035,153282,17.80730,860782
8519,gatos-jd,3,0.00035,153285,17.80764,860782
8520,gaurav34065,3,0.00035,153288,17.80799,860782
8521,gauravsinghaec,3,0.00035,153291,17.80834,860782
8522,gautamr,3,0.00035,153294,17.80869,860782
8523,gautaz,3,0.00035,153297,17.80904,860782
8524,gbarre,3,0.00035,153300,17.80939,860782
8525,gbartolini,3,0.00035,153303,17.80974,860782
8526,gbates101,3,0.00035,153306,17.81008,860782
8527,gbonnefille,3,0.00035,153309,17.81043,860782
8528,gchenuet,3,0.00035,153312,17.81078,860782
8529,g-crocker,3,0.00035,153315,17.81113,860782
8530,gechr,3,0.00035,153318,17.81148,860782
8531,geezyx,3,0.00035,153321,17.81183,860782
8532,Gellardo,3,0.00035,153324,17.81218,860782
8533,geNAZt,3,0.00035,153327,17.81252,860782
8534,Genesis0x1b,3,0.00035,153330,17.81287,860782
8535,Genteure,3,0.00035,153333,17.81322,860782
8536,geoff-bleakley,3,0.00035,153336,17.81357,860782
8537,GeoffMillerAZ,3,0.00035,153339,17.81392,860782
8538,geraldnguyen,3,0.00035,153342,17.81427,860782
8539,getvivekv,3,0.00035,153345,17.81462,860782
8540,GFRPIG,3,0.00035,153348,17.81496,860782
8541,ghardin100,3,0.00035,153351,17.81531,860782
8542,ghfalcon7,3,0.00035,153354,17.81566,860782
8543,ghoben,3,0.00035,153357,17.81601,860782
8544,Ghostwritten,3,0.00035,153360,17.81636,860782
8545,gigi-at-zymergen,3,0.00035,153363,17.81671,860782
8546,Gii16,3,0.00035,153366,17.81705,860782
8547,gilmacieljr,3,0.00035,153369,17.81740,860782
8548,giovannifs,3,0.00035,153372,17.81775,860782
8549,gitbeyond,3,0.00035,153375,17.81810,860782
8550,gitcubehub,3,0.00035,153378,17.81845,860782
8551,GITHUBear,3,0.00035,153381,17.81880,860782
8552,githubyangxd,3,0.00035,153384,17.81915,860782
8553,gitolicious,3,0.00035,153387,17.81949,860782
8554,Gituser143,3,0.00035,153390,17.81984,860782
8555,givanov,3,0.00035,153393,17.82019,860782
8556,gjones-r7,3,0.00035,153396,17.82054,860782
8557,gkrizek,3,0.00035,153399,17.82089,860782
8558,gkwan,3,0.00035,153402,17.82124,860782
8559,glenonn,3,0.00035,153405,17.82159,860782
8560,gmcelhoe,3,0.00035,153408,17.82193,860782
8561,gmoshiko,3,0.00035,153411,17.82228,860782
8562,gmouchakis,3,0.00035,153414,17.82263,860782
8563,gnarl,3,0.00035,153417,17.82298,860782
8564,GnatorX,3,0.00035,153420,17.82333,860782
8565,goith,3,0.00035,153423,17.82368,860782
8566,gokulpotluri,3,0.00035,153426,17.82403,860782
8567,gokussx4,3,0.00035,153429,17.82437,860782
8568,GolubevV,3,0.00035,153432,17.82472,860782
8569,gongziyiyi,3,0.00035,153435,17.82507,860782
8570,goodbsw,3,0.00035,153438,17.82542,860782
8571,gopher194,3,0.00035,153441,17.82577,860782
8572,Gopichandar,3,0.00035,153444,17.82612,860782
8573,gopukrishnantec,3,0.00035,153447,17.82646,860782
8574,GotGit20,3,0.00035,153450,17.82681,860782
8575,gouravsw,3,0.00035,153453,17.82716,860782
8576,goyalmayankk,3,0.00035,153456,17.82751,860782
8577,gpetrousov,3,0.00035,153459,17.82786,860782
8578,GraemeMitchell84,3,0.00035,153462,17.82821,860782
8579,grahamsutton,3,0.00035,153465,17.82856,860782
8580,grandfield,3,0.00035,153468,17.82890,860782
8581,grdnrio,3,0.00035,153471,17.82925,860782
8582,greggilbert,3,0.00035,153474,17.82960,860782
8583,GregSharpe1,3,0.00035,153477,17.82995,860782
8584,grinnellian,3,0.00035,153480,17.83030,860782
8585,grovecai,3,0.00035,153483,17.83065,860782
8586,gsreis,3,0.00035,153486,17.83100,860782
8587,gsxmax,3,0.00035,153489,17.83134,860782
8588,GTP95,3,0.00035,153492,17.83169,860782
8589,guanzo,3,0.00035,153495,17.83204,860782
8590,guillaume-chervet,3,0.00035,153498,17.83239,860782
8591,GuillaumeOuint,3,0.00035,153501,17.83274,860782
8592,guofengzh,3,0.00035,153504,17.83309,860782
8593,guogang1990,3,0.00035,153507,17.83344,860782
8594,Guthrey,3,0.00035,153510,17.83378,860782
8595,gvko,3,0.00035,153513,17.83413,860782
8596,GWCLBN,3,0.00035,153516,17.83448,860782
8597,gyancs79,3,0.00035,153519,17.83483,860782
8598,h2xtreme,3,0.00035,153522,17.83518,860782
8599,H3rby7,3,0.00035,153525,17.83553,860782
8600,H3RSKO,3,0.00035,153528,17.83587,860782
8601,habuma,3,0.00035,153531,17.83622,860782
8602,haexhub,3,0.00035,153534,17.83657,860782
8603,haimari,3,0.00035,153537,17.83692,860782
8604,hallaroo,3,0.00035,153540,17.83727,860782
8605,hallgeirl,3,0.00035,153543,17.83762,860782
8606,halvards,3,0.00035,153546,17.83797,860782
8607,hamedg1,3,0.00035,153549,17.83831,860782
8608,hananiel,3,0.00035,153552,17.83866,860782
8609,haneychad,3,0.00035,153555,17.83901,860782
8610,hanjunlee,3,0.00035,153558,17.83936,860782
8611,hanwavefront,3,0.00035,153561,17.83971,860782
8612,hanyucui,3,0.00035,153564,17.84006,860782
8613,haofeif,3,0.00035,153567,17.84041,860782
8614,happyhq,3,0.00035,153570,17.84075,860782
8615,hargrave81,3,0.00035,153573,17.84110,860782
8616,hari2192,3,0.00035,153576,17.84145,860782
8617,harshsinh,3,0.00035,153579,17.84180,860782
8618,hasonhai,3,0.00035,153582,17.84215,860782
8619,HassanHashemi,3,0.00035,153585,17.84250,860782
8620,hayato1121,3,0.00035,153588,17.84285,860782
8621,hb0nes,3,0.00035,153591,17.84319,860782
8622,hckuo,3,0.00035,153594,17.84354,860782
8623,hdlbq,3,0.00035,153597,17.84389,860782
8624,hectorhuertas,3,0.00035,153600,17.84424,860782
8625,heikkikesa,3,0.00035,153603,17.84459,860782
8626,helenabutowatcisco,3,0.00035,153606,17.84494,860782
8627,hemachandrark,3,0.00035,153609,17.84528,860782
8628,hemalsolgama,3,0.00035,153612,17.84563,860782
8629,Henni,3,0.00035,153615,17.84598,860782
8630,HenriqueLBorges,3,0.00035,153618,17.84633,860782
8631,her,3,0.00035,153621,17.84668,860782
8632,hetii,3,0.00035,153624,17.84703,860782
8633,heweizhen0822,3,0.00035,153627,17.84738,860782
8634,hfuss,3,0.00035,153630,17.84772,860782
8635,hgoscenski-vail,3,0.00035,153633,17.84807,860782
8636,hhb,3,0.00035,153636,17.84842,860782
8637,hhsnow,3,0.00035,153639,17.84877,860782
8638,hieu29791,3,0.00035,153642,17.84912,860782
8639,hieumoscow,3,0.00035,153645,17.84947,860782
8640,hikaruna,3,0.00035,153648,17.84982,860782
8641,himanshumehta1114,3,0.00035,153651,17.85016,860782
8642,hinawatts,3,0.00035,153654,17.85051,860782
8643,HiremathPanchaxari,3,0.00035,153657,17.85086,860782
8644,hiromaily,3,0.00035,153660,17.85121,860782
8645,Hlorry,3,0.00035,153663,17.85156,860782
8646,hmmxp,3,0.00035,153666,17.85191,860782
8647,hnk-atheer,3,0.00035,153669,17.85226,860782
8648,hodur,3,0.00035,153672,17.85260,860782
8649,holgercn,3,0.00035,153675,17.85295,860782
8650,hongliang5316,3,0.00035,153678,17.85330,860782
8651,hongzhanchen,3,0.00035,153681,17.85365,860782
8652,HoustonPutman,3,0.00035,153684,17.85400,860782
8653,HP41,3,0.00035,153687,17.85435,860782
8654,hs115488,3,0.00035,153690,17.85469,860782
8655,HtcOrange,3,0.00035,153693,17.85504,860782
8656,huang339,3,0.00035,153696,17.85539,860782
8657,huangcuiyang,3,0.00035,153699,17.85574,860782
8658,HuangShujun,3,0.00035,153702,17.85609,860782
8659,HuJake,3,0.00035,153705,17.85644,860782
8660,Humberd,3,0.00035,153708,17.85679,860782
8661,hunjixin,3,0.00035,153711,17.85713,860782
8662,hunsche,3,0.00035,153714,17.85748,860782
8663,hunterli,3,0.00035,153717,17.85783,860782
8664,huzhao37,3,0.00035,153720,17.85818,860782
8665,huzilin,3,0.00035,153723,17.85853,860782
8666,hvandenb,3,0.00035,153726,17.85888,860782
8667,hwangseonbi,3,0.00035,153729,17.85923,860782
8668,hykych,3,0.00035,153732,17.85957,860782
8669,hynospt,3,0.00035,153735,17.85992,860782
8670,hypdeb,3,0.00035,153738,17.86027,860782
8671,hyperfocus1337,3,0.00035,153741,17.86062,860782
8672,iaas365-dev,3,0.00035,153744,17.86097,860782
8673,IagoLast,3,0.00035,153747,17.86132,860782
8674,iamamjad,3,0.00035,153750,17.86167,860782
8675,iamsanketsingh,3,0.00035,153753,17.86201,860782
8676,iamwillbar,3,0.00035,153756,17.86236,860782
8677,ianbishop,3,0.00035,153759,17.86271,860782
8678,ibmboy19,3,0.00035,153762,17.86306,860782
8679,ibrahimhaddad,3,0.00035,153765,17.86341,860782
8680,ican2002,3,0.00035,153768,17.86376,860782
8681,icco,3,0.00035,153771,17.86410,860782
8682,iceking2nd,3,0.00035,153774,17.86445,860782
8683,icsy7867,3,0.00035,153777,17.86480,860782
8684,idanya,3,0.00035,153780,17.86515,860782
8685,igordrnobrega,3,0.00035,153783,17.86550,860782
8686,igorstojanovski,3,0.00035,153786,17.86585,860782
8687,ikait,3,0.00035,153789,17.86620,860782
8688,ILovetheEarth,3,0.00035,153792,17.86654,860782
8689,ilpianista,3,0.00035,153795,17.86689,860782
8690,IlyaKochnev,3,0.00035,153798,17.86724,860782
8691,im-Angry,3,0.00035,153801,17.86759,860782
8692,imchand,3,0.00035,153804,17.86794,860782
8693,imic07,3,0.00035,153807,17.86829,860782
8694,imjoseangel,3,0.00035,153810,17.86864,860782
8695,impop,3,0.00035,153813,17.86898,860782
8696,Imputes,3,0.00035,153816,17.86933,860782
8697,imsrgadich,3,0.00035,153819,17.86968,860782
8698,Imunhatep,3,0.00035,153822,17.87003,860782
8699,inaitgaj,3,0.00035,153825,17.87038,860782
8700,indapublic,3,0.00035,153828,17.87073,860782
8701,inetika,3,0.00035,153831,17.87108,860782
8702,infa-ssaurabh,3,0.00035,153834,17.87142,860782
8703,innovorichy,3,0.00035,153837,17.87177,860782
8704,internetstaff,3,0.00035,153840,17.87212,860782
8705,intrand,3,0.00035,153843,17.87247,860782
8706,iondiode,3,0.00035,153846,17.87282,860782
8707,irfaanz,3,0.00035,153849,17.87317,860782
8708,iridian-ks,3,0.00035,153852,17.87352,860782
8709,ish1963,3,0.00035,153855,17.87386,860782
8710,isi-lincoln,3,0.00035,153858,17.87421,860782
8711,islamtaha,3,0.00035,153861,17.87456,860782
8712,israellot,3,0.00035,153864,17.87491,860782
8713,IsuruDilhan,3,0.00035,153867,17.87526,860782
8714,ItalyPaleAle,3,0.00035,153870,17.87561,860782
8715,ITD27M01,3,0.00035,153873,17.87595,860782
8716,itdoginfo,3,0.00035,153876,17.87630,860782
8717,itisdeep,3,0.00035,153879,17.87665,860782
8718,itmecho,3,0.00035,153882,17.87700,860782
8719,itsmeGaffoor,3,0.00035,153885,17.87735,860782
8720,itsursujit,3,0.00035,153888,17.87770,860782
8721,Iulian7,3,0.00035,153891,17.87805,860782
8722,ivanfitenko,3,0.00035,153894,17.87839,860782
8723,ivnilv,3,0.00035,153897,17.87874,860782
8724,iyurev,3,0.00035,153900,17.87909,860782
8725,iyuvalk,3,0.00035,153903,17.87944,860782
8726,izelnakri,3,0.00035,153906,17.87979,860782
8727,izhigalko,3,0.00035,153909,17.88014,860782
8728,J12934,3,0.00035,153912,17.88049,860782
8729,J3RN,3,0.00035,153915,17.88083,860782
8730,J4yD4n,3,0.00035,153918,17.88118,860782
8731,jachurra,3,0.00035,153921,17.88153,860782
8732,jack0liu,3,0.00035,153924,17.88188,860782
8733,JACKCHEN96,3,0.00035,153927,17.88223,860782
8734,jackhammer2k,3,0.00035,153930,17.88258,860782
8735,Jacky2,3,0.00035,153933,17.88293,860782
8736,Jacky2Wong,3,0.00035,153936,17.88327,860782
8737,JacobCalmes,3,0.00035,153939,17.88362,860782
8738,jacobdr,3,0.00035,153942,17.88397,860782
8739,jacobhjkim,3,0.00035,153945,17.88432,860782
8740,jacobsin,3,0.00035,153948,17.88467,860782
8741,jadeStoneStonger,3,0.00035,153951,17.88502,860782
8742,jagguli,3,0.00035,153954,17.88536,860782
8743,jainbhavya65,3,0.00035,153957,17.88571,860782
8744,Jainbrt,3,0.00035,153960,17.88606,860782
8745,Jajcoszek,3,0.00035,153963,17.88641,860782
8746,jamct,3,0.00035,153966,17.88676,860782
8747,james-choncholas,3,0.00035,153969,17.88711,860782
8748,james-crowley,3,0.00035,153972,17.88746,860782
8749,jamesholcomb,3,0.00035,153975,17.88780,860782
8750,james-r-smith,3,0.00035,153978,17.88815,860782
8751,jamesylgan,3,0.00035,153981,17.88850,860782
8752,jaredestroud,3,0.00035,153984,17.88885,860782
8753,jaredgorski,3,0.00035,153987,17.88920,860782
8754,jaredstehler,3,0.00035,153990,17.88955,860782
8755,jariolehtonen,3,0.00035,153993,17.88990,860782
8756,JaroVojtek,3,0.00035,153996,17.89024,860782
8757,JarrodJ83,3,0.00035,153999,17.89059,860782
8758,Jaskaranbir,3,0.00035,154002,17.89094,860782
8759,jasonsattler,3,0.00035,154005,17.89129,860782
8760,Jason-ZW,3,0.00035,154008,17.89164,860782
8761,jatinkushwaha,3,0.00035,154011,17.89199,860782
8762,javydreamercsw,3,0.00035,154014,17.89234,860782
8763,Jawastew,3,0.00035,154017,17.89268,860782
8764,jaydeland,3,0.00035,154020,17.89303,860782
8765,jaylinski,3,0.00035,154023,17.89338,860782
8766,jay-manday,3,0.00035,154026,17.89373,860782
8767,jaysonwor,3,0.00035,154029,17.89408,860782
8768,jbachorik,3,0.00035,154032,17.89443,860782
8769,jbactad,3,0.00035,154035,17.89477,860782
8770,JCchenxiang,3,0.00035,154038,17.89512,860782
8771,jcdavis,3,0.00035,154041,17.89547,860782
8772,jcuna,3,0.00035,154044,17.89582,860782
8773,jd615645,3,0.00035,154047,17.89617,860782
8774,JDavis10213,3,0.00035,154050,17.89652,860782
8775,jdcormie,3,0.00035,154053,17.89687,860782
8776,jdmarble,3,0.00035,154056,17.89721,860782
8777,jeffreybrowning,3,0.00035,154059,17.89756,860782
8778,jeffzhu503,3,0.00035,154062,17.89791,860782
8779,Jeinhaus,3,0.00035,154065,17.89826,860782
8780,jenningsloy318,3,0.00035,154068,17.89861,860782
8781,jepsenwan,3,0.00035,154071,17.89896,860782
8782,jeremiahrhall,3,0.00035,154074,17.89931,860782
8783,jeromebaude,3,0.00035,154077,17.89965,860782
8784,JesseAA,3,0.00035,154080,17.90000,860782
8785,JessedeJonge,3,0.00035,154083,17.90035,860782
8786,jetjo,3,0.00035,154086,17.90070,860782
8787,jf647,3,0.00035,154089,17.90105,860782
8788,jfancher,3,0.00035,154092,17.90140,860782
8789,jferr,3,0.00035,154095,17.90175,860782
8790,jfpucheu,3,0.00035,154098,17.90209,860782
8791,JGiola,3,0.00035,154101,17.90244,860782
8792,jhkimac,3,0.00035,154104,17.90279,860782
8793,jhrcz,3,0.00035,154107,17.90314,860782
8794,jhuliano,3,0.00035,154110,17.90349,860782
8795,jhuntwork,3,0.00035,154113,17.90384,860782
8796,jia2,3,0.00035,154116,17.90418,860782
8797,jiangxianliang007,3,0.00035,154119,17.90453,860782
8798,jianz,3,0.00035,154122,17.90488,860782
8799,jianzzz,3,0.00035,154125,17.90523,860782
8800,jiayiming001,3,0.00035,154128,17.90558,860782
8801,jickor,3,0.00035,154131,17.90593,860782
8802,Jille,3,0.00035,154134,17.90628,860782
8803,jilleJr,3,0.00035,154137,17.90662,860782
8804,jimersylee,3,0.00035,154140,17.90697,860782
8805,Jimmyjim123,3,0.00035,154143,17.90732,860782
8806,jimwrightcz,3,0.00035,154146,17.90767,860782
8807,JingangLi,3,0.00035,154149,17.90802,860782
8808,jingsam,3,0.00035,154152,17.90837,860782
8809,JinLinGan,3,0.00035,154155,17.90872,860782
8810,jinq0123,3,0.00035,154158,17.90906,860782
8811,jitenderchand,3,0.00035,154161,17.90941,860782
8812,JiyeYu,3,0.00035,154164,17.90976,860782
8813,jjjjeeffff,3,0.00035,154167,17.91011,860782
8814,jkjell,3,0.00035,154170,17.91046,860782
8815,jkklee,3,0.00035,154173,17.91081,860782
8816,jkraj,3,0.00035,154176,17.91116,860782
8817,jkuri,3,0.00035,154179,17.91150,860782
8818,j-landru,3,0.00035,154182,17.91185,860782
8819,jleloup,3,0.00035,154185,17.91220,860782
8820,jleopold28,3,0.00035,154188,17.91255,860782
8821,jlfowle,3,0.00035,154191,17.91290,860782
8822,jlgeering,3,0.00035,154194,17.91325,860782
8823,jl-gogovapps,3,0.00035,154197,17.91359,860782
8824,jlong4096,3,0.00035,154200,17.91394,860782
8825,jlosito,3,0.00035,154203,17.91429,860782
8826,jlsan92,3,0.00035,154206,17.91464,860782
8827,JLueke,3,0.00035,154209,17.91499,860782
8828,jm241825,3,0.00035,154212,17.91534,860782
8829,jmatthews79,3,0.00035,154215,17.91569,860782
8830,jmlogan,3,0.00035,154218,17.91603,860782
8831,jmulcahyTSC,3,0.00035,154221,17.91638,860782
8832,jniewt,3,0.00035,154224,17.91673,860782
8833,jnschaeffer,3,0.00035,154227,17.91708,860782
8834,JnsSo,3,0.00035,154230,17.91743,860782
8835,JoachimGross,3,0.00035,154233,17.91778,860782
8836,joberdick,3,0.00035,154236,17.91813,860782
8837,jochen42,3,0.00035,154239,17.91847,860782
8838,joelbernstein,3,0.00035,154242,17.91882,860782
8839,joelddiaz,3,0.00035,154245,17.91917,860782
8840,joesan,3,0.00035,154248,17.91952,860782
8841,Joeskyyy,3,0.00035,154251,17.91987,860782
8842,joe-sonrichard,3,0.00035,154254,17.92022,860782
8843,joesonw,3,0.00035,154257,17.92057,860782
8844,johnha,3,0.00035,154260,17.92091,860782
8845,johnmark,3,0.00035,154263,17.92126,860782
8846,johnnyhuy,3,0.00035,154266,17.92161,860782
8847,johnnyjacob,3,0.00035,154269,17.92196,860782
8848,johnor,3,0.00035,154272,17.92231,860782
8849,johnrkriter,3,0.00035,154275,17.92266,860782
8850,john-yick,3,0.00035,154278,17.92300,860782
8851,Johnz86,3,0.00035,154281,17.92335,860782
8852,Jolin-blank,3,0.00035,154284,17.92370,860782
8853,jonas27,3,0.00035,154287,17.92405,860782
8854,jonasbeyer,3,0.00035,154290,17.92440,860782
8855,jonasdebeukelaer,3,0.00035,154293,17.92475,860782
8856,jonaskello,3,0.00035,154296,17.92510,860782
8857,jonathancychow,3,0.00035,154299,17.92544,860782
8858,jonathanjuursema,3,0.00035,154302,17.92579,860782
8859,jonathanpdx,3,0.00035,154305,17.92614,860782
8860,jonayoung2003,3,0.00035,154308,17.92649,860782
8861,jonenst,3,0.00035,154311,17.92684,860782
8862,jongarate,3,0.00035,154314,17.92719,860782
8863,jongio,3,0.00035,154317,17.92754,860782
8864,jopfeffe,3,0.00035,154320,17.92788,860782
8865,JorgeReus,3,0.00035,154323,17.92823,860782
8866,jorjao81,3,0.00035,154326,17.92858,860782
8867,Josbrafe,3,0.00035,154329,17.92893,860782
8868,josefpodany,3,0.00035,154332,17.92928,860782
8869,josejulio,3,0.00035,154335,17.92963,860782
8870,Joseph-Goergen,3,0.00035,154338,17.92998,860782
8871,JoseThen,3,0.00035,154341,17.93032,860782
8872,joshatcaper,3,0.00035,154344,17.93067,860782
8873,JoshBroomberg,3,0.00035,154347,17.93102,860782
8874,joshshn,3,0.00035,154350,17.93137,860782
8875,joshuakapellen,3,0.00035,154353,17.93172,860782
8876,JoshVee,3,0.00035,154356,17.93207,860782
8877,Josua-SR,3,0.00035,154359,17.93241,860782
8878,jot-hub,3,0.00035,154362,17.93276,860782
8879,jozef-slezak,3,0.00035,154365,17.93311,860782
8880,JParkinson1991,3,0.00035,154368,17.93346,860782
8881,jpaskhay,3,0.00035,154371,17.93381,860782
8882,jpbelanger-mtl,3,0.00035,154374,17.93416,860782
8883,jpbochi,3,0.00035,154377,17.93451,860782
8884,jperucha,3,0.00035,154380,17.93485,860782
8885,jpmcb,3,0.00035,154383,17.93520,860782
8886,jpsalvesen,3,0.00035,154386,17.93555,860782
8887,jr0d,3,0.00035,154389,17.93590,860782
8888,jrevillas,3,0.00035,154392,17.93625,860782
8889,jsacapdev,3,0.00035,154395,17.93660,860782
8890,jsaulalonso,3,0.00035,154398,17.93695,860782
8891,JScon01,3,0.00035,154401,17.93729,860782
8892,jseiser,3,0.00035,154404,17.93764,860782
8893,jselleck,3,0.00035,154407,17.93799,860782
8894,jsmedmar,3,0.00035,154410,17.93834,860782
8895,jsmilani,3,0.00035,154413,17.93869,860782
8896,jtl0813,3,0.00035,154416,17.93904,860782
8897,jtnz,3,0.00035,154419,17.93939,860782
8898,Juanezm,3,0.00035,154422,17.93973,860782
8899,judexzhu,3,0.00035,154425,17.94008,860782
8900,judimator,3,0.00035,154428,17.94043,860782
8901,juergenschubert,3,0.00035,154431,17.94078,860782
8902,juettemann,3,0.00035,154434,17.94113,860782
8903,jughead,3,0.00035,154437,17.94148,860782
8904,julienym,3,0.00035,154440,17.94182,860782
8905,jungle-zh,3,0.00035,154443,17.94217,860782
8906,jungwookim,3,0.00035,154446,17.94252,860782
8907,jurim76,3,0.00035,154449,17.94287,860782
8908,just1900,3,0.00035,154452,17.94322,860782
8909,Justin417,3,0.00035,154455,17.94357,860782
8910,justincely,3,0.00035,154458,17.94392,860782
8911,juxuny,3,0.00035,154461,17.94426,860782
8912,juzhao,3,0.00035,154464,17.94461,860782
8913,jvanzyl,3,0.00035,154467,17.94496,860782
8914,jvesely,3,0.00035,154470,17.94531,860782
8915,jwfx,3,0.00035,154473,17.94566,860782
8916,jydonff,3,0.00035,154476,17.94601,860782
8917,jynok,3,0.00035,154479,17.94636,860782
8918,jzielke84,3,0.00035,154482,17.94670,860782
8919,j-zimnowoda,3,0.00035,154485,17.94705,860782
8920,k0t3n,3,0.00035,154488,17.94740,860782
8921,k4korea,3,0.00035,154491,17.94775,860782
8922,k8sz,3,0.00035,154494,17.94810,860782
8923,Kaali09,3,0.00035,154497,17.94845,860782
8924,KaelBaldwin,3,0.00035,154500,17.94880,860782
8925,kaharlichenko,3,0.00035,154503,17.94914,860782
8926,kaitlynbrown,3,0.00035,154506,17.94949,860782
8927,kaivean,3,0.00035,154509,17.94984,860782
8928,kaiwalyajoshi,3,0.00035,154512,17.95019,860782
8929,kajariagrawal,3,0.00035,154515,17.95054,860782
8930,kalgecin,3,0.00035,154518,17.95089,860782
8931,kamilpoleszczuk,3,0.00035,154521,17.95124,860782
8932,kangaechu,3,0.00035,154524,17.95158,860782
8933,kangdongjin,3,0.00035,154527,17.95193,860782
8934,kangshung,3,0.00035,154530,17.95228,860782
8935,Kapoorakul,3,0.00035,154533,17.95263,860782
8936,KarlCF,3,0.00035,154536,17.95298,860782
8937,karlfiabeschi,3,0.00035,154539,17.95333,860782
8938,karnauskas,3,0.00035,154542,17.95367,860782
8939,kashook,3,0.00035,154545,17.95402,860782
8940,kasiakepka,3,0.00035,154548,17.95437,860782
8941,kasramp,3,0.00035,154551,17.95472,860782
8942,katsuhisa91,3,0.00035,154554,17.95507,860782
8943,kbj22,3,0.00035,154557,17.95542,860782
8944,kbrowder,3,0.00035,154560,17.95577,860782
8945,kckipp,3,0.00035,154563,17.95611,860782
8946,kdoustar,3,0.00035,154566,17.95646,860782
8947,kdungs,3,0.00035,154569,17.95681,860782
8948,Keerthana2496,3,0.00035,154572,17.95716,860782
8949,Kelvin-M,3,0.00035,154575,17.95751,860782
8950,kel-web,3,0.00035,154578,17.95786,860782
8951,kenju,3,0.00035,154581,17.95821,860782
8952,kennygt51,3,0.00035,154584,17.95855,860782
8953,keriksson-rosenqvist,3,0.00035,154587,17.95890,860782
8954,kevinrademan,3,0.00035,154590,17.95925,860782
8955,kevinsmithwrs,3,0.00035,154593,17.95960,860782
8956,kevinwongtyl,3,0.00035,154596,17.95995,860782
8957,keycloak-nti,3,0.00035,154599,17.96030,860782
8958,Keyzi0,3,0.00035,154602,17.96065,860782
8959,Kezzsim,3,0.00035,154605,17.96099,860782
8960,khayalan-mathew,3,0.00035,154608,17.96134,860782
8961,khm,3,0.00035,154611,17.96169,860782
8962,kiaplayer,3,0.00035,154614,17.96204,860782
8963,kidlj,3,0.00035,154617,17.96239,860782
8964,kien-truong,3,0.00035,154620,17.96274,860782
8965,killy001,3,0.00035,154623,17.96308,860782
8966,kimberly-lee,3,0.00035,154626,17.96343,860782
8967,kimullamen,3,0.00035,154629,17.96378,860782
8968,kingaooto,3,0.00035,154632,17.96413,860782
8969,kingkangyu,3,0.00035,154635,17.96448,860782
8970,kingram6865,3,0.00035,154638,17.96483,860782
8971,kingsd041,3,0.00035,154641,17.96518,860782
8972,kiran-koshy,3,0.00035,154644,17.96552,860782
8973,kirnberger1980,3,0.00035,154647,17.96587,860782
8974,kitos9112,3,0.00035,154650,17.96622,860782
8975,kittylyst,3,0.00035,154653,17.96657,860782
8976,kkapoor1987,3,0.00035,154656,17.96692,860782
8977,klauskobald,3,0.00035,154659,17.96727,860782
8978,klihub,3,0.00035,154662,17.96762,860782
8979,kmindi,3,0.00035,154665,17.96796,860782
8980,kneitinger,3,0.00035,154668,17.96831,860782
8981,knraju483,3,0.00035,154671,17.96866,860782
8982,knyttl,3,0.00035,154674,17.96901,860782
8983,koba1t,3,0.00035,154677,17.96936,860782
8984,kobaji,3,0.00035,154680,17.96971,860782
8985,kohashi,3,0.00035,154683,17.97006,860782
8986,kohlerdominik,3,0.00035,154686,17.97040,860782
8987,kollerdroid,3,0.00035,154689,17.97075,860782
8988,kondr57,3,0.00035,154692,17.97110,860782
8989,konradjurk,3,0.00035,154695,17.97145,860782
8990,kopparam-gagan,3,0.00035,154698,17.97180,860782
8991,kostyay,3,0.00035,154701,17.97215,860782
8992,kotreshhr,3,0.00035,154704,17.97249,860782
8993,kozl,3,0.00035,154707,17.97284,860782
8994,kpiotrowski,3,0.00035,154710,17.97319,860782
8995,kpurdon,3,0.00035,154713,17.97354,860782
8996,krdhruva,3,0.00035,154716,17.97389,860782
8997,kreempuff,3,0.00035,154719,17.97424,860782
8998,Krever,3,0.00035,154722,17.97459,860782
8999,krish512,3,0.00035,154725,17.97493,860782
9000,krish7919,3,0.00035,154728,17.97528,860782
9001,krishna-birla,3,0.00035,154731,17.97563,860782
9002,krishnan-ramkumar,3,0.00035,154734,17.97598,860782
9003,KristiyanGergov,3,0.00035,154737,17.97633,860782
9004,krokk,3,0.00035,154740,17.97668,860782
9005,kr-pushpendra,3,0.00035,154743,17.97703,860782
9006,kruc,3,0.00035,154746,17.97737,860782
9007,kryptonite303,3,0.00035,154749,17.97772,860782
9008,krystalcode,3,0.00035,154752,17.97807,860782
9009,krystyw,3,0.00035,154755,17.97842,860782
9010,k-srkw,3,0.00035,154758,17.97877,860782
9011,ktalant,3,0.00035,154761,17.97912,860782
9012,ktarplee,3,0.00035,154764,17.97947,860782
9013,ktkfree,3,0.00035,154767,17.97981,860782
9014,kubefetch,3,0.00035,154770,17.98016,860782
9015,kubernetes-123,3,0.00035,154773,17.98051,860782
9016,kuja53,3,0.00035,154776,17.98086,860782
9017,kuldeepsingh99,3,0.00035,154779,17.98121,860782
9018,kumarsiyer,3,0.00035,154782,17.98156,860782
9019,kungfubamba,3,0.00035,154785,17.98190,860782
9020,kungfuchicken,3,0.00035,154788,17.98225,860782
9021,kunkkazhang,3,0.00035,154791,17.98260,860782
9022,kushalagrawal,3,0.00035,154794,17.98295,860782
9023,kush-patel-hs,3,0.00035,154797,17.98330,860782
9024,kustodian,3,0.00035,154800,17.98365,860782
9025,kuznetsovkk,3,0.00035,154803,17.98400,860782
9026,kverstr,3,0.00035,154806,17.98434,860782
9027,kwims,3,0.00035,154809,17.98469,860782
9028,KylePolansky,3,0.00035,154812,17.98504,860782
9029,l8huang,3,0.00035,154815,17.98539,860782
9030,lahsivjar,3,0.00035,154818,17.98574,860782
9031,laizy,3,0.00035,154821,17.98609,860782
9032,lalwk,3,0.00035,154824,17.98644,860782
9033,lamht,3,0.00035,154827,17.98678,860782
9034,lammh,3,0.00035,154830,17.98713,860782
9035,lammichael,3,0.00035,154833,17.98748,860782
9036,lann,3,0.00035,154836,17.98783,860782
9037,lanphan,3,0.00035,154839,17.98818,860782
9038,lanycrost,3,0.00035,154842,17.98853,860782
9039,larkee,3,0.00035,154845,17.98888,860782
9040,larribas,3,0.00035,154848,17.98922,860782
9041,larrywa,3,0.00035,154851,17.98957,860782
9042,lazy-always,3,0.00035,154854,17.98992,860782
9043,lazywhite,3,0.00035,154857,17.99027,860782
9044,lbar,3,0.00035,154860,17.99062,860782
9045,Lebronbingcheng,3,0.00035,154863,17.99097,860782
9046,leceshide,3,0.00035,154866,17.99131,860782
9047,leeallen337,3,0.00035,154869,17.99166,860782
9048,leelavg,3,0.00035,154872,17.99201,860782
9049,leequarella,3,0.00035,154875,17.99236,860782
9050,leichengkai,3,0.00035,154878,17.99271,860782
9051,LeifRoss,3,0.00035,154881,17.99306,860782
9052,leinad87,3,0.00035,154884,17.99341,860782
9053,Leletir,3,0.00035,154887,17.99375,860782
9054,lemaral,3,0.00035,154890,17.99410,860782
9055,lemaxw,3,0.00035,154893,17.99445,860782
9056,leogtzr,3,0.00035,154896,17.99480,860782
9057,leo-lb,3,0.00035,154899,17.99515,860782
9058,Leo-ljr,3,0.00035,154902,17.99550,860782
9059,leon-barrett,3,0.00035,154905,17.99585,860782
9060,leongyh,3,0.00035,154908,17.99619,860782
9061,leonsodhi-lf,3,0.00035,154911,17.99654,860782
9062,LeoQuote,3,0.00035,154914,17.99689,860782
9063,leoramirez-mulesoft,3,0.00035,154917,17.99724,860782
9064,LeroChen,3,0.00035,154920,17.99759,860782
9065,leuvataral,3,0.00035,154923,17.99794,860782
9066,levonet,3,0.00035,154926,17.99829,860782
9067,lexsys27,3,0.00035,154929,17.99863,860782
9068,lgmorand,3,0.00035,154932,17.99898,860782
9069,liangfb,3,0.00035,154935,17.99933,860782
9070,liangminhua,3,0.00035,154938,17.99968,860782
9071,liangruibupt,3,0.00035,154941,18.00003,860782
9072,lidavidm,3,0.00035,154944,18.00038,860782
9073,lidel,3,0.00035,154947,18.00072,860782
9074,liiling,3,0.00035,154950,18.00107,860782
9075,lilinghai,3,0.00035,154953,18.00142,860782
9076,LiMiToDriGe,3,0.00035,154956,18.00177,860782
9077,linasm,3,0.00035,154959,18.00212,860782
9078,linuxduduniao,3,0.00035,154962,18.00247,860782
9079,linxuyalun,3,0.00035,154965,18.00282,860782
9080,Liorba,3,0.00035,154968,18.00316,860782
9081,li-sen,3,0.00035,154971,18.00351,860782
9082,listepo,3,0.00035,154974,18.00386,860782
9083,litengfei-zz,3,0.00035,154977,18.00421,860782
9084,littlefoolkid,3,0.00035,154980,18.00456,860782
9085,liukeyou,3,0.00035,154983,18.00491,860782
9086,liushouxiang,3,0.00035,154986,18.00526,860782
9087,liuzhen,3,0.00035,154989,18.00560,860782
9088,liuzix,3,0.00035,154992,18.00595,860782
9089,lixiangmyehk,3,0.00035,154995,18.00630,860782
9090,lizztheblizz,3,0.00035,154998,18.00665,860782
9091,ljani,3,0.00035,155001,18.00700,860782
9092,lknaubkonrad,3,0.00035,155004,18.00735,860782
9093,lkusnadi,3,0.00035,155007,18.00770,860782
9094,llhhbc,3,0.00035,155010,18.00804,860782
9095,lllamnyp,3,0.00035,155013,18.00839,860782
9096,llylhz,3,0.00035,155016,18.00874,860782
9097,LMarkham,3,0.00035,155019,18.00909,860782
9098,lnparker,3,0.00035,155022,18.00944,860782
9099,lodow,3,0.00035,155025,18.00979,860782
9100,logart,3,0.00035,155028,18.01013,860782
9101,logicalphase,3,0.00035,155031,18.01048,860782
9102,Logixgroup,3,0.00035,155034,18.01083,860782
9103,logopk,3,0.00035,155037,18.01118,860782
9104,loivis,3,0.00035,155040,18.01153,860782
9105,loizoskounios,3,0.00035,155043,18.01188,860782
9106,Loki-Afro,3,0.00035,155046,18.01223,860782
9107,lolsharp,3,0.00035,155049,18.01257,860782
9108,longlnk,3,0.00035,155052,18.01292,860782
9109,looksworking,3,0.00035,155055,18.01327,860782
9110,lopes22,3,0.00035,155058,18.01362,860782
9111,lordcf,3,0.00035,155061,18.01397,860782
9112,lossanarch,3,0.00035,155064,18.01432,860782
9113,lostpoint-ru,3,0.00035,155067,18.01467,860782
9114,lotress,3,0.00035,155070,18.01501,860782
9115,lowellmower,3,0.00035,155073,18.01536,860782
9116,lowyuenan,3,0.00035,155076,18.01571,860782
9117,loxo33,3,0.00035,155079,18.01606,860782
9118,lretrain91,3,0.00035,155082,18.01641,860782
9119,LS80,3,0.00035,155085,18.01676,860782
9120,lthistle,3,0.00035,155088,18.01711,860782
9121,ltlf,3,0.00035,155091,18.01745,860782
9122,lucaelin,3,0.00035,155094,18.01780,860782
9123,lucaskanashiro,3,0.00035,155097,18.01815,860782
9124,lucastheisen,3,0.00035,155100,18.01850,860782
9125,luciano-nbs,3,0.00035,155103,18.01885,860782
9126,LuciferInLove,3,0.00035,155106,18.01920,860782
9127,Luciowl,3,0.00035,155109,18.01955,860782
9128,lucklyblue,3,0.00035,155112,18.01989,860782
9129,luckoseabraham,3,0.00035,155115,18.02024,860782
9130,L-U-C-K-Y,3,0.00035,155118,18.02059,860782
9131,luckyluc74,3,0.00035,155121,18.02094,860782
9132,luismartins-td,3,0.00035,155124,18.02129,860782
9133,Lujeni,3,0.00035,155127,18.02164,860782
9134,lukaslentner,3,0.00035,155130,18.02198,860782
9135,lukaspj,3,0.00035,155133,18.02233,860782
9136,Luke-Vear,3,0.00035,155136,18.02268,860782
9137,LukeWheeldon,3,0.00035,155139,18.02303,860782
9138,lukipro,3,0.00035,155142,18.02338,860782
9139,lulzmachine,3,0.00035,155145,18.02373,860782
9140,luniHw,3,0.00035,155148,18.02408,860782
9141,lutzmi,3,0.00035,155151,18.02442,860782
9142,lvisterin,3,0.00035,155154,18.02477,860782
9143,lvs071103,3,0.00035,155157,18.02512,860782
9144,lwsanty,3,0.00035,155160,18.02547,860782
9145,lyb0307,3,0.00035,155163,18.02582,860782
9146,lych77,3,0.00035,155166,18.02617,860782
9147,lyred193,3,0.00035,155169,18.02652,860782
9148,lyuma,3,0.00035,155172,18.02686,860782
9149,lywyue,3,0.00035,155175,18.02721,860782
9150,lyzhang1999,3,0.00035,155178,18.02756,860782
9151,M0rdecay,3,0.00035,155181,18.02791,860782
9152,mabukar,3,0.00035,155184,18.02826,860782
9153,MaciejKucia,3,0.00035,155187,18.02861,860782
9154,maciejqantas,3,0.00035,155190,18.02896,860782
9155,macleanj,3,0.00035,155193,18.02930,860782
9156,MacLeodMike,3,0.00035,155196,18.02965,860782
9157,MadEngineX,3,0.00035,155199,18.03000,860782
9158,madhuresh04,3,0.00035,155202,18.03035,860782
9159,MadVikingGod,3,0.00035,155205,18.03070,860782
9160,madz0,3,0.00035,155208,18.03105,860782
9161,maettu-this,3,0.00035,155211,18.03139,860782
9162,magederek,3,0.00035,155214,18.03174,860782
9163,magine1989,3,0.00035,155217,18.03209,860782
9164,magnussonsoftware,3,0.00035,155220,18.03244,860782
9165,mahendra-gefen,3,0.00035,155223,18.03279,860782
9166,MaiCw4J,3,0.00035,155226,18.03314,860782
9167,mailjunze,3,0.00035,155229,18.03349,860782
9168,mailofapideveloper,3,0.00035,155232,18.03383,860782
9169,Malax,3,0.00035,155235,18.03418,860782
9170,malcolm061990,3,0.00035,155238,18.03453,860782
9171,malimccalla,3,0.00035,155241,18.03488,860782
9172,mallow111,3,0.00035,155244,18.03523,860782
9173,malocar7,3,0.00035,155247,18.03558,860782
9174,malozanoff,3,0.00035,155250,18.03593,860782
9175,malvex,3,0.00035,155253,18.03627,860782
9176,manaschandrasahoo,3,0.00035,155256,18.03662,860782
9177,manideepl,3,0.00035,155259,18.03697,860782
9178,manitmalik,3,0.00035,155262,18.03732,860782
9179,mannssebastian,3,0.00035,155265,18.03767,860782
9180,manobi,3,0.00035,155268,18.03802,860782
9181,manoj260191,3,0.00035,155271,18.03837,860782
9182,manpreet1994,3,0.00035,155274,18.03871,860782
9183,mansing2,3,0.00035,155277,18.03906,860782
9184,MAnyKey,3,0.00035,155280,18.03941,860782
9185,maplebeats,3,0.00035,155283,18.03976,860782
9186,marcelbuesing,3,0.00035,155286,18.04011,860782
9187,MarcelHillmann,3,0.00035,155289,18.04046,860782
9188,marcelki,3,0.00035,155292,18.04080,860782
9189,marcfrederick,3,0.00035,155295,18.04115,860782
9190,marchenm,3,0.00035,155298,18.04150,860782
9191,marcinja,3,0.00035,155301,18.04185,860782
9192,marco69,3,0.00035,155304,18.04220,860782
9193,marcoboffi,3,0.00035,155307,18.04255,860782
9194,marcomezzaro,3,0.00035,155310,18.04290,860782
9195,MarcoPalomo,3,0.00035,155313,18.04324,860782
9196,marcotc,3,0.00035,155316,18.04359,860782
9197,marcozanghi,3,0.00035,155319,18.04394,860782
9198,marcstreeter,3,0.00035,155322,18.04429,860782
9199,MarianZoll,3,0.00035,155325,18.04464,860782
9200,Mario-Hofstaetter,3,0.00035,155328,18.04499,860782
9201,mariusmitrofan,3,0.00035,155331,18.04534,860782
9202,marko-asplund,3,0.00035,155334,18.04568,860782
9203,MarkRose,3,0.00035,155337,18.04603,860782
9204,marmelin,3,0.00035,155340,18.04638,860782
9205,marov,3,0.00035,155343,18.04673,860782
9206,marquetemb,3,0.00035,155346,18.04708,860782
9207,marsishandsome,3,0.00035,155349,18.04743,860782
9208,MartijnZuijd,3,0.00035,155352,18.04778,860782
9209,Martin20,3,0.00035,155355,18.04812,860782
9210,martin2176,3,0.00035,155358,18.04847,860782
9211,MartinKosicky,3,0.00035,155361,18.04882,860782
9212,martyspiewak,3,0.00035,155364,18.04917,860782
9213,marvelm,3,0.00035,155367,18.04952,860782
9214,marvin0815,3,0.00035,155370,18.04987,860782
9215,masa213f,3,0.00035,155373,18.05021,860782
9216,MaSer713,3,0.00035,155376,18.05056,860782
9217,matanmaman,3,0.00035,155379,18.05091,860782
9218,matanshukry,3,0.00035,155382,18.05126,860782
9219,matcha440,3,0.00035,155385,18.05161,860782
9220,MateuszGalasinski,3,0.00035,155388,18.05196,860782
9221,MathildeLeroi,3,0.00035,155391,18.05231,860782
9222,mathnitin,3,0.00035,155394,18.05265,860782
9223,matihost,3,0.00035,155397,18.05300,860782
9224,matpl,3,0.00035,155400,18.05335,860782
9225,mattcui,3,0.00035,155403,18.05370,860782
9226,matt-demers,3,0.00035,155406,18.05405,860782
9227,matthdan,3,0.00035,155409,18.05440,860782
9228,mat-tia,3,0.00035,155412,18.05475,860782
9229,mattlord,3,0.00035,155415,18.05509,860782
9230,Matty9191,3,0.00035,155418,18.05544,860782
9231,mavaa,3,0.00035,155421,18.05579,860782
9232,max70-root,3,0.00035,155424,18.05614,860782
9233,maxclac,3,0.00035,155427,18.05649,860782
9234,maxd,3,0.00035,155430,18.05684,860782
9235,maxdanilov,3,0.00035,155433,18.05719,860782
9236,maxdevp,3,0.00035,155436,18.05753,860782
9237,maximillianbrain1,3,0.00035,155439,18.05788,860782
9238,maxux,3,0.00035,155442,18.05823,860782
9239,MaxXor,3,0.00035,155445,18.05858,860782
9240,mayukh1,3,0.00035,155448,18.05893,860782
9241,m-basyou,3,0.00035,155451,18.05928,860782
9242,mbiesiad,3,0.00035,155454,18.05962,860782
9243,mbrowne,3,0.00035,155457,18.05997,860782
9244,mc0,3,0.00035,155460,18.06032,860782
9245,mc7857,3,0.00035,155463,18.06067,860782
9246,MCBrandenburg,3,0.00035,155466,18.06102,860782
9247,McCo0L,3,0.00035,155469,18.06137,860782
9248,mcdano,3,0.00035,155472,18.06172,860782
9249,mchiang-goo,3,0.00035,155475,18.06206,860782
9250,mckrl,3,0.00035,155478,18.06241,860782
9251,MCNVI,3,0.00035,155481,18.06276,860782
9252,mcollier,3,0.00035,155484,18.06311,860782
9253,mdoulaty,3,0.00035,155487,18.06346,860782
9254,MDrollette,3,0.00035,155490,18.06381,860782
9255,medkbadri,3,0.00035,155493,18.06416,860782
9256,meetme2meat,3,0.00035,155496,18.06450,860782
9257,mehmetekici,3,0.00035,155499,18.06485,860782
9258,memelet,3,0.00035,155502,18.06520,860782
9259,mendiolaC79,3,0.00035,155505,18.06555,860782
9260,mengskysama,3,0.00035,155508,18.06590,860782
9261,mengzyou,3,0.00035,155511,18.06625,860782
9262,mercury0114,3,0.00035,155514,18.06660,860782
9263,mestaritonttu,3,0.00035,155517,18.06694,860782
9264,metametadata,3,0.00035,155520,18.06729,860782
9265,metarag,3,0.00035,155523,18.06764,860782
9266,metellius,3,0.00035,155526,18.06799,860782
9267,mgasner,3,0.00035,155529,18.06834,860782
9268,mgodlewski,3,0.00035,155532,18.06869,860782
9269,mguao,3,0.00035,155535,18.06903,860782
9270,mhaley-miovision,3,0.00035,155538,18.06938,860782
9271,mhamann,3,0.00035,155541,18.06973,860782
9272,mhite,3,0.00035,155544,18.07008,860782
9273,michael-bud,3,0.00035,155547,18.07043,860782
9274,michael-odell,3,0.00035,155550,18.07078,860782
9275,michelbieleveld,3,0.00035,155553,18.07113,860782
9276,MICHELLHELEN,3,0.00035,155556,18.07147,860782
9277,micw,3,0.00035,155559,18.07182,860782
9278,miff2000,3,0.00035,155562,18.07217,860782
9279,mihaitodor,3,0.00035,155565,18.07252,860782
9280,mikecohen,3,0.00035,155568,18.07287,860782
9281,mikemccarty-vertex,3,0.00035,155571,18.07322,860782
9282,mike-stewart,3,0.00035,155574,18.07357,860782
9283,mikev1963,3,0.00035,155577,18.07391,860782
9284,mikeyGlitz,3,0.00035,155580,18.07426,860782
9285,mikonse,3,0.00035,155583,18.07461,860782
9286,mikosa,3,0.00035,155586,18.07496,860782
9287,mildmojo,3,0.00035,155589,18.07531,860782
9288,miloradtrninic,3,0.00035,155592,18.07566,860782
9289,milos-matijasevic,3,0.00035,155595,18.07601,860782
9290,milunski,3,0.00035,155598,18.07635,860782
9291,mimeie,3,0.00035,155601,18.07670,860782
9292,ming-ddtechcg,3,0.00035,155604,18.07705,860782
9293,mingrammer,3,0.00035,155607,18.07740,860782
9294,minh-thai,3,0.00035,155610,18.07775,860782
9295,minioin,3,0.00035,155613,18.07810,860782
9296,minSW,3,0.00035,155616,18.07844,860782
9297,miono,3,0.00035,155619,18.07879,860782
9298,MirahImage,3,0.00035,155622,18.07914,860782
9299,miro-grapeup,3,0.00035,155625,18.07949,860782
9300,mirwide,3,0.00035,155628,18.07984,860782
9301,missingcharacter,3,0.00035,155631,18.08019,860782
9302,mixecan,3,0.00035,155634,18.08054,860782
9303,mjgpy3,3,0.00035,155637,18.08088,860782
9304,mjpieters,3,0.00035,155640,18.08123,860782
9305,mk7run,3,0.00035,155643,18.08158,860782
9306,mk811,3,0.00035,155646,18.08193,860782
9307,mkanakis,3,0.00035,155649,18.08228,860782
9308,mkatt,3,0.00035,155652,18.08263,860782
9309,mknapphrt,3,0.00035,155655,18.08298,860782
9310,mkozioro,3,0.00035,155658,18.08332,860782
9311,mlarkin2015,3,0.00035,155661,18.08367,860782
9312,mmazek,3,0.00035,155664,18.08402,860782
9313,mmurrian,3,0.00035,155667,18.08437,860782
9314,mn0o7,3,0.00035,155670,18.08472,860782
9315,mnpenner,3,0.00035,155673,18.08507,860782
9316,mofirouz,3,0.00035,155676,18.08542,860782
9317,mogggggg,3,0.00035,155679,18.08576,860782
9318,MohamedKari,3,0.00035,155682,18.08611,860782
9319,mohamedkhaledhafez,3,0.00035,155685,18.08646,860782
9320,mohammad-yazdani,3,0.00035,155688,18.08681,860782
9321,mohammedalics,3,0.00035,155691,18.08716,860782
9322,mohammedi-haroune,3,0.00035,155694,18.08751,860782
9323,mohansitaram,3,0.00035,155697,18.08785,860782
9324,mohdirshad498,3,0.00035,155700,18.08820,860782
9325,mohit5577,3,0.00035,155703,18.08855,860782
9326,mohsinonxrm,3,0.00035,155706,18.08890,860782
9327,monofone,3,0.00035,155709,18.08925,860782
9328,moorepatrick,3,0.00035,155712,18.08960,860782
9329,mordowiciel,3,0.00035,155715,18.08995,860782
9330,morremeyer,3,0.00035,155718,18.09029,860782
9331,morsik,3,0.00035,155721,18.09064,860782
9332,mo-saeed,3,0.00035,155724,18.09099,860782
9333,mousiefasil,3,0.00035,155727,18.09134,860782
9334,mozai,3,0.00035,155730,18.09169,860782
9335,mpduarte,3,0.00035,155733,18.09204,860782
9336,mpeters,3,0.00035,155736,18.09239,860782
9337,mpolenchuk,3,0.00035,155739,18.09273,860782
9338,mponnambalam,3,0.00035,155742,18.09308,860782
9339,mpskovvang,3,0.00035,155745,18.09343,860782
9340,mqsoh,3,0.00035,155748,18.09378,860782
9341,mrbastian,3,0.00035,155751,18.09413,860782
9342,mrichman,3,0.00035,155754,18.09448,860782
9343,mrmrcoleman,3,0.00035,155757,18.09483,860782
9344,MrNorm,3,0.00035,155760,18.09517,860782
9345,msaunois-dzr,3,0.00035,155763,18.09552,860782
9346,mshasib,3,0.00035,155766,18.09587,860782
9347,msincuba,3,0.00035,155769,18.09622,860782
9348,msolimans,3,0.00035,155772,18.09657,860782
9349,mstoetzer,3,0.00035,155775,18.09692,860782
9350,mtalbot,3,0.00035,155778,18.09727,860782
9351,mtb-xt,3,0.00035,155781,18.09761,860782
9352,mterron,3,0.00035,155784,18.09796,860782
9353,mtmn,3,0.00035,155787,18.09831,860782
9354,mtopolnik,3,0.00035,155790,18.09866,860782
9355,mtp401,3,0.00035,155793,18.09901,860782
9356,muety,3,0.00035,155796,18.09936,860782
9357,mugdha-adhav,3,0.00035,155799,18.09970,860782
9358,mukulikak,3,0.00035,155802,18.10005,860782
9359,mukundmckinsey,3,0.00035,155805,18.10040,860782
9360,munagekar,3,0.00035,155808,18.10075,860782
9361,munjalpatel,3,0.00035,155811,18.10110,860782
9362,muratg,3,0.00035,155814,18.10145,860782
9363,muru,3,0.00035,155817,18.10180,860782
9364,musaprg,3,0.00035,155820,18.10214,860782
9365,muvster,3,0.00035,155823,18.10249,860782
9366,mveitas,3,0.00035,155826,18.10284,860782
9367,mveroone,3,0.00035,155829,18.10319,860782
9368,mwconceicao,3,0.00035,155832,18.10354,860782
9369,mxkmp,3,0.00035,155835,18.10389,860782
9370,mxmorin,3,0.00035,155838,18.10424,860782
9371,mx-psi,3,0.00035,155841,18.10458,860782
9372,mxtsuper,3,0.00035,155844,18.10493,860782
9373,myazid,3,0.00035,155847,18.10528,860782
9374,mycroft,3,0.00035,155850,18.10563,860782
9375,mytting,3,0.00035,155853,18.10598,860782
9376,mzehrer,3,0.00035,155856,18.10633,860782
9377,mzur-hv,3,0.00035,155859,18.10668,860782
9378,n0rig,3,0.00035,155862,18.10702,860782
9379,NA3,3,0.00035,155865,18.10737,860782
9380,nadilas,3,0.00035,155868,18.10772,860782
9381,NagaSamyuktha,3,0.00035,155871,18.10807,860782
9382,nagytech,3,0.00035,155874,18.10842,860782
9383,nahratzah,3,0.00035,155877,18.10877,860782
9384,naili-xing,3,0.00035,155880,18.10911,860782
9385,nakagawa424,3,0.00035,155883,18.10946,860782
9386,Naktibalda,3,0.00035,155886,18.10981,860782
9387,namloc2001,3,0.00035,155889,18.11016,860782
9388,namsoo2,3,0.00035,155892,18.11051,860782
9389,narayanan,3,0.00035,155895,18.11086,860782
9390,narendra0356,3,0.00035,155898,18.11121,860782
9391,Narrayahodeir,3,0.00035,155901,18.11155,860782
9392,Nastradamus,3,0.00035,155904,18.11190,860782
9393,nastrofaction,3,0.00035,155907,18.11225,860782
9394,NathanHowell,3,0.00035,155910,18.11260,860782
9395,Nathan-j-hardee,3,0.00035,155913,18.11295,860782
9396,Navaneeth-pk,3,0.00035,155916,18.11330,860782
9397,navkmurthy,3,0.00035,155919,18.11365,860782
9398,nbarrientos,3,0.00035,155922,18.11399,860782
9399,ndhanushkodi,3,0.00035,155925,18.11434,860782
9400,ndlygaSyr,3,0.00035,155928,18.11469,860782
9401,neatherweb,3,0.00035,155931,18.11504,860782
9402,nebed,3,0.00035,155934,18.11539,860782
9403,neelmehta247,3,0.00035,155937,18.11574,860782
9404,neilschelly,3,0.00035,155940,18.11609,860782
9405,nelsonflorez11,3,0.00035,155943,18.11643,860782
9406,nestoralonso,3,0.00035,155946,18.11678,860782
9407,nestorsokil,3,0.00035,155949,18.11713,860782
9408,neufeldtech,3,0.00035,155952,18.11748,860782
9409,new-commer,3,0.00035,155955,18.11783,860782
9410,newnius,3,0.00035,155958,18.11818,860782
9411,Nexproc,3,0.00035,155961,18.11852,860782
9412,Nexus-GT-One,3,0.00035,155964,18.11887,860782
9413,nhh-softwarehuset,3,0.00035,155967,18.11922,860782
9414,nhjiejan,3,0.00035,155970,18.11957,860782
9415,niachary,3,0.00035,155973,18.11992,860782
9416,nick-cromwell,3,0.00035,155976,18.12027,860782
9417,Nickev123,3,0.00035,155979,18.12062,860782
9418,nicksc423,3,0.00035,155982,18.12096,860782
9419,nicktate,3,0.00035,155985,18.12131,860782
9420,nicocesar,3,0.00035,155988,18.12166,860782
9421,nicolamarella,3,0.00035,155991,18.12201,860782
9422,nicolasdonoso,3,0.00035,155994,18.12236,860782
9423,niederee,3,0.00035,155997,18.12271,860782
9424,nielsonsantana,3,0.00035,156000,18.12306,860782
9425,nigelpoulton,3,0.00035,156003,18.12340,860782
9426,nijamashruwala,3,0.00035,156006,18.12375,860782
9427,nikiask,3,0.00035,156009,18.12410,860782
9428,Nikita128,3,0.00035,156012,18.12445,860782
9429,nikkolasg,3,0.00035,156015,18.12480,860782
9430,nikolamalesevic,3,0.00035,156018,18.12515,860782
9431,nikosmeds,3,0.00035,156021,18.12550,860782
9432,Nilegfx,3,0.00035,156024,18.12584,860782
9433,nilesh892003,3,0.00035,156027,18.12619,860782
9434,nilsga,3,0.00035,156030,18.12654,860782
9435,nilsonsfj,3,0.00035,156033,18.12689,860782
9436,nimi-d,3,0.00035,156036,18.12724,860782
9437,Nimrodda,3,0.00035,156039,18.12759,860782
9438,niravpatel27,3,0.00035,156042,18.12793,860782
9439,nirmannarang,3,0.00035,156045,18.12828,860782
9440,nischalsheth,3,0.00035,156048,18.12863,860782
9441,nisheet195,3,0.00035,156051,18.12898,860782
9442,NissesSenap,3,0.00035,156054,18.12933,860782
9443,Nitive,3,0.00035,156057,18.12968,860782
9444,nitnatsnocER,3,0.00035,156060,18.13003,860782
9445,niuyueyang1996,3,0.00035,156063,18.13037,860782
9446,NKztq,3,0.00035,156066,18.13072,860782
9447,nmr,3,0.00035,156069,18.13107,860782
9448,nnathan,3,0.00035,156072,18.13142,860782
9449,nniikkoollaaii,3,0.00035,156075,18.13177,860782
9450,nnthuanegany,3,0.00035,156078,18.13212,860782
9451,noelmcloughlin,3,0.00035,156081,18.13247,860782
9452,nohaapav,3,0.00035,156084,18.13281,860782
9453,nolith,3,0.00035,156087,18.13316,860782
9454,nomstradamus,3,0.00035,156090,18.13351,860782
9455,nonly,3,0.00035,156093,18.13386,860782
9456,nooradnan1,3,0.00035,156096,18.13421,860782
9457,norbjd,3,0.00035,156099,18.13456,860782
9458,notcool11,3,0.00035,156102,18.13491,860782
9459,Novota15,3,0.00035,156105,18.13525,860782
9460,NoWhere-zh,3,0.00035,156108,18.13560,860782
9461,nowylie,3,0.00035,156111,18.13595,860782
9462,Nox-404,3,0.00035,156114,18.13630,860782
9463,nshekhar221,3,0.00035,156117,18.13665,860782
9464,ntavares,3,0.00035,156120,18.13700,860782
9465,nukarajusundeep,3,0.00035,156123,18.13734,860782
9466,nurkiewicz,3,0.00035,156126,18.13769,860782
9467,nustiueudinastea,3,0.00035,156129,18.13804,860782
9468,nwclasantha,3,0.00035,156132,18.13839,860782
9469,nwv-danvulpe,3,0.00035,156135,18.13874,860782
9470,nycdotnet,3,0.00035,156138,18.13909,860782
9471,nylocx,3,0.00035,156141,18.13944,860782
9472,o0st,3,0.00035,156144,18.13978,860782
9473,oakad,3,0.00035,156147,18.14013,860782
9474,occasionallydavid,3,0.00035,156150,18.14048,860782
9475,octopyth,3,0.00035,156153,18.14083,860782
9476,oekarlsson,3,0.00035,156156,18.14118,860782
9477,ofer-tvil,3,0.00035,156159,18.14153,860782
9478,okrasz,3,0.00035,156162,18.14188,860782
9479,olawaleadenagbe,3,0.00035,156165,18.14222,860782
9480,olaxe,3,0.00035,156168,18.14257,860782
9481,oldman1991,3,0.00035,156171,18.14292,860782
9482,OleksandrBlack,3,0.00035,156174,18.14327,860782
9483,olevitt,3,0.00035,156177,18.14362,860782
9484,Olli64,3,0.00035,156180,18.14397,860782
9485,ollieayre-oc,3,0.00035,156183,18.14432,860782
9486,ollipa,3,0.00035,156186,18.14466,860782
9487,olomakovskyi-blackbird,3,0.00035,156189,18.14501,860782
9488,omnibs,3,0.00035,156192,18.14536,860782
9489,omriperi,3,0.00035,156195,18.14571,860782
9490,onpaws,3,0.00035,156198,18.14606,860782
9491,opendatakraken,3,0.00035,156201,18.14641,860782
9492,opensean,3,0.00035,156204,18.14675,860782
9493,opskumu,3,0.00035,156207,18.14710,860782
9494,OPSTime,3,0.00035,156210,18.14745,860782
9495,orangedeng,3,0.00035,156213,18.14780,860782
9496,oscni,3,0.00035,156216,18.14815,860782
9497,osso23,3,0.00035,156219,18.14850,860782
9498,ostera,3,0.00035,156222,18.14885,860782
9499,osterman,3,0.00035,156225,18.14919,860782
9500,outbackdingo,3,0.00035,156228,18.14954,860782
9501,outscale-nti,3,0.00035,156231,18.14989,860782
9502,Overbryd,3,0.00035,156234,18.15024,860782
9503,ovovchuk,3,0.00035,156237,18.15059,860782
9504,owenmonagan,3,0.00035,156240,18.15094,860782
9505,Owpac,3,0.00035,156243,18.15129,860782
9506,ozashu,3,0.00035,156246,18.15163,860782
9507,ozerovandrei,3,0.00035,156249,18.15198,860782
9508,ozeta,3,0.00035,156252,18.15233,860782
9509,ozhiwei,3,0.00035,156255,18.15268,860782
9510,pagdot,3,0.00035,156258,18.15303,860782
9511,panguncle,3,0.00035,156261,18.15338,860782
9512,panicbit,3,0.00035,156264,18.15373,860782
9513,panzhongxian,3,0.00035,156267,18.15407,860782
9514,paoloalba,3,0.00035,156270,18.15442,860782
9515,papovyr,3,0.00035,156273,18.15477,860782
9516,parambath92,3,0.00035,156276,18.15512,860782
9517,paravx2020,3,0.00035,156279,18.15547,860782
9518,pard68,3,0.00035,156282,18.15582,860782
9519,parkeunsoo,3,0.00035,156285,18.15616,860782
9520,pascals-ager,3,0.00035,156288,18.15651,860782
9521,Pasick,3,0.00035,156291,18.15686,860782
9522,pasimoes,3,0.00035,156294,18.15721,860782
9523,patgmiller,3,0.00035,156297,18.15756,860782
9524,pathorn,3,0.00035,156300,18.15791,860782
9525,patrickheinzelmann,3,0.00035,156303,18.15826,860782
9526,paulbdavis,3,0.00035,156306,18.15860,860782
9527,pauldotknopf,3,0.00035,156309,18.15895,860782
9528,pauldthomson,3,0.00035,156312,18.15930,860782
9529,paul-greidanus-hs,3,0.00035,156315,18.15965,860782
9530,paulmchen,3,0.00035,156318,18.16000,860782
9531,paulmorai4,3,0.00035,156321,18.16035,860782
9532,paulrostorp,3,0.00035,156324,18.16070,860782
9533,PaulWBrassard,3,0.00035,156327,18.16104,860782
9534,pavelsimo,3,0.00035,156330,18.16139,860782
9535,PavelSosin-320,3,0.00035,156333,18.16174,860782
9536,pawel-kedzior-sw,3,0.00035,156336,18.16209,860782
9537,pawelmy,3,0.00035,156339,18.16244,860782
9538,pbalash0v,3,0.00035,156342,18.16279,860782
9539,pbetkier,3,0.00035,156345,18.16314,860782
9540,pbradly,3,0.00035,156348,18.16348,860782
9541,pengux,3,0.00035,156351,18.16383,860782
9542,pere3,3,0.00035,156354,18.16418,860782
9543,perezjasonr,3,0.00035,156357,18.16453,860782
9544,persunde,3,0.00035,156360,18.16488,860782
9545,peteroneilljr,3,0.00035,156363,18.16523,860782
9546,peter-slovak,3,0.00035,156366,18.16558,860782
9547,petrukngantuk,3,0.00035,156369,18.16592,860782
9548,pguz,3,0.00035,156372,18.16627,860782
9549,phamvh,3,0.00035,156375,18.16662,860782
9550,phil-f,3,0.00035,156378,18.16697,860782
9551,phillc,3,0.00035,156381,18.16732,860782
9552,phillyb7,3,0.00035,156384,18.16767,860782
9553,philsttr,3,0.00035,156387,18.16801,860782
9554,phntom,3,0.00035,156390,18.16836,860782
9555,phormio,3,0.00035,156393,18.16871,860782
9556,phpHavok,3,0.00035,156396,18.16906,860782
9557,phpstudyer,3,0.00035,156399,18.16941,860782
9558,phxql,3,0.00035,156402,18.16976,860782
9559,pianeko,3,0.00035,156405,18.17011,860782
9560,PierreBrisorgueil,3,0.00035,156408,18.17045,860782
9561,pierre-emmanuelJ,3,0.00035,156411,18.17080,860782
9562,piersharding,3,0.00035,156414,18.17115,860782
9563,pjoomen,3,0.00035,156417,18.17150,860782
9564,plainlystated,3,0.00035,156420,18.17185,860782
9565,planetmarshall,3,0.00035,156423,18.17220,860782
9566,plisy,3,0.00035,156426,18.17255,860782
9567,ploef,3,0.00035,156429,18.17289,860782
9568,pmalmgren,3,0.00035,156432,18.17324,860782
9569,pmatheson-greenphire,3,0.00035,156435,18.17359,860782
9570,pmb311,3,0.00035,156438,18.17394,860782
9571,PmcFizz,3,0.00035,156441,18.17429,860782
9572,pmichna,3,0.00035,156444,18.17464,860782
9573,pnowy,3,0.00035,156447,18.17499,860782
9574,pokcetjokers87,3,0.00035,156450,18.17533,860782
9575,porrascarlos802018,3,0.00035,156453,18.17568,860782
9576,postmaxin,3,0.00035,156456,18.17603,860782
9577,posypanka,3,0.00035,156459,18.17638,860782
9578,Poytr1,3,0.00035,156462,18.17673,860782
9579,PPACI,3,0.00035,156465,18.17708,860782
9580,ppadmavilasom,3,0.00035,156468,18.17742,860782
9581,PPaviii,3,0.00035,156471,18.17777,860782
9582,PrahathessRaghavan,3,0.00035,156474,18.17812,860782
9583,prairiewolf-by,3,0.00035,156477,18.17847,860782
9584,prakashchoudhary110,3,0.00035,156480,18.17882,860782
9585,praneethvarma,3,0.00035,156483,18.17917,860782
9586,prasenforu,3,0.00035,156486,18.17952,860782
9587,prashanthc,3,0.00035,156489,18.17986,860782
9588,pratap-redi,3,0.00035,156492,18.18021,860782
9589,praveenravi77,3,0.00035,156495,18.18056,860782
9590,prima101112,3,0.00035,156498,18.18091,860782
9591,Priyanka098,3,0.00035,156501,18.18126,860782
9592,priyasubramanitvr,3,0.00035,156504,18.18161,860782
9593,ProdanLabs,3,0.00035,156507,18.18196,860782
9594,ps142020,3,0.00035,156510,18.18230,860782
9595,PSjoe,3,0.00035,156513,18.18265,860782
9596,psschwei,3,0.00035,156516,18.18300,860782
9597,pssvenkatrao,3,0.00035,156519,18.18335,860782
9598,PSTobiasMueller,3,0.00035,156522,18.18370,860782
9599,ptran32,3,0.00035,156525,18.18405,860782
9600,puneetguptanitj,3,0.00035,156528,18.18440,860782
9601,punkprzemo,3,0.00035,156531,18.18474,860782
9602,PureW,3,0.00035,156534,18.18509,860782
9603,PushkarJ,3,0.00035,156537,18.18544,860782
9604,putz612,3,0.00035,156540,18.18579,860782
9605,PzaZZ-8899,3,0.00035,156543,18.18614,860782
9606,QCU266,3,0.00035,156546,18.18649,860782
9607,QeyCoder,3,0.00035,156549,18.18683,860782
9608,qian2501,3,0.00035,156552,18.18718,860782
9609,qianfeiqianlan,3,0.00035,156555,18.18753,860782
9610,qiq,3,0.00035,156558,18.18788,860782
9611,qnighy,3,0.00035,156561,18.18823,860782
9612,quanweiZhou,3,0.00035,156564,18.18858,860782
9613,quentinalbertone,3,0.00035,156567,18.18893,860782
9614,qzx,3,0.00035,156570,18.18927,860782
9615,R0GG,3,0.00035,156573,18.18962,860782
9616,r0kas,3,0.00035,156576,18.18997,860782
9617,rabbitfang,3,0.00035,156579,18.19032,860782
9618,RafaelMarquesRodrigues,3,0.00035,156582,18.19067,860782
9619,rafi-greenberg,3,0.00035,156585,18.19102,860782
9620,rafilkmp3,3,0.00035,156588,18.19137,860782
9621,raghu017,3,0.00035,156591,18.19171,860782
9622,raghuP9,3,0.00035,156594,18.19206,860782
9623,rahulsharma2020,3,0.00035,156597,18.19241,860782
9624,RainistJordy,3,0.00035,156600,18.19276,860782
9625,rajakshay,3,0.00035,156603,18.19311,860782
9626,Rajeev9045,3,0.00035,156606,18.19346,860782
9627,rajesh0therascal,3,0.00035,156609,18.19381,860782
9628,rajesh-krishnan-tech,3,0.00035,156612,18.19415,860782
9629,rajmaniar,3,0.00035,156615,18.19450,860782
9630,rajshkr,3,0.00035,156618,18.19485,860782
9631,rambattu,3,0.00035,156621,18.19520,860782
9632,ramgesg,3,0.00035,156624,18.19555,860782
9633,ramsrib,3,0.00035,156627,18.19590,860782
9634,ramwolken9,3,0.00035,156630,18.19624,860782
9635,ramya-rao-a,3,0.00035,156633,18.19659,860782
9636,randall-rexmachines,3,0.00035,156636,18.19694,860782
9637,Randyshu2018,3,0.00035,156639,18.19729,860782
9638,Ranganaths8,3,0.00035,156642,18.19764,860782
9639,rangeryu,3,0.00035,156645,18.19799,860782
9640,Ranguo956,3,0.00035,156648,18.19834,860782
9641,ranjith-ka,3,0.00035,156651,18.19868,860782
9642,raphendyr,3,0.00035,156654,18.19903,860782
9643,raphink,3,0.00035,156657,18.19938,860782
9644,rara-tan,3,0.00035,156660,18.19973,860782
9645,rarick,3,0.00035,156663,18.20008,860782
9646,RascoApps,3,0.00035,156666,18.20043,860782
9647,rashmi-ibm,3,0.00035,156669,18.20078,860782
9648,rasoulivand,3,0.00035,156672,18.20112,860782
9649,rayfoss,3,0.00035,156675,18.20147,860782
9650,razvanonet,3,0.00035,156678,18.20182,860782
9651,rbailly-talend,3,0.00035,156681,18.20217,860782
9652,rbjorklin,3,0.00035,156684,18.20252,860782
9653,rboccadoro,3,0.00035,156687,18.20287,860782
9654,rcalosso,3,0.00035,156690,18.20322,860782
9655,realdave,3,0.00035,156693,18.20356,860782
9656,realshuting,3,0.00035,156696,18.20391,860782
9657,reaperes,3,0.00035,156699,18.20426,860782
9658,ReaperTech,3,0.00035,156702,18.20461,860782
9659,rearden-steel,3,0.00035,156705,18.20496,860782
9660,recabarren,3,0.00035,156708,18.20531,860782
9661,redradrat,3,0.00035,156711,18.20565,860782
9662,redsk,3,0.00035,156714,18.20600,860782
9663,refs,3,0.00035,156717,18.20635,860782
9664,regeldso,3,0.00035,156720,18.20670,860782
9665,reinaldo-pinto,3,0.00035,156723,18.20705,860782
9666,ReinitiaIized,3,0.00035,156726,18.20740,860782
9667,remcohaszing,3,0.00035,156729,18.20775,860782
9668,RemiGaudin,3,0.00035,156732,18.20809,860782
9669,renanramos,3,0.00035,156735,18.20844,860782
9670,rene-m-hernandez,3,0.00035,156738,18.20879,860782
9671,renhao-0518,3,0.00035,156741,18.20914,860782
9672,renkelvin,3,0.00035,156744,18.20949,860782
9673,reoxey,3,0.00035,156747,18.20984,860782
9674,rexroof,3,0.00035,156750,18.21019,860782
9675,rezagh2,3,0.00035,156753,18.21053,860782
9676,rezemble,3,0.00035,156756,18.21088,860782
9677,rfletcher,3,0.00035,156759,18.21123,860782
9678,rgaskill,3,0.00035,156762,18.21158,860782
9679,rhenwood-arm,3,0.00035,156765,18.21193,860782
9680,rhomel,3,0.00035,156768,18.21228,860782
9681,rhpereda,3,0.00035,156771,18.21263,860782
9682,rhuitl,3,0.00035,156774,18.21297,860782
9683,ricardo-larosa,3,0.00035,156777,18.21332,860782
9684,richardpoole,3,0.00035,156780,18.21367,860782
9685,rickwebiii,3,0.00035,156783,18.21402,860782
9686,rickysway,3,0.00035,156786,18.21437,860782
9687,RicoToothless,3,0.00035,156789,18.21472,860782
9688,rihabbanday,3,0.00035,156792,18.21506,860782
9689,rikmos,3,0.00035,156795,18.21541,860782
9690,rimantoro,3,0.00035,156798,18.21576,860782
9691,rimar,3,0.00035,156801,18.21611,860782
9692,rishindrasingh,3,0.00035,156804,18.21646,860782
9693,risinger,3,0.00035,156807,18.21681,860782
9694,ritzmann94,3,0.00035,156810,18.21716,860782
9695,rivenhk,3,0.00035,156813,18.21750,860782
9696,rizekmWWT,3,0.00035,156816,18.21785,860782
9697,rjarsenault1101,3,0.00035,156819,18.21820,860782
9698,rjhaylor,3,0.00035,156822,18.21855,860782
9699,rjshree,3,0.00035,156825,18.21890,860782
9700,rlanting,3,0.00035,156828,18.21925,860782
9701,rlibm,3,0.00035,156831,18.21960,860782
9702,rmarsch,3,0.00035,156834,18.21994,860782
9703,rmiller14,3,0.00035,156837,18.22029,860782
9704,rmweir,3,0.00035,156840,18.22064,860782
9705,rngy,3,0.00035,156843,18.22099,860782
9706,robarros,3,0.00035,156846,18.22134,860782
9707,robbdimitrov,3,0.00035,156849,18.22169,860782
9708,RobbinBaauw,3,0.00035,156852,18.22204,860782
9709,RobertDittmann,3,0.00035,156855,18.22238,860782
9710,robert-redshield,3,0.00035,156858,18.22273,860782
9711,robertverusen,3,0.00035,156861,18.22308,860782
9712,robertwb,3,0.00035,156864,18.22343,860782
9713,robg,3,0.00035,156867,18.22378,860782
9714,robinjmurphy,3,0.00035,156870,18.22413,860782
9715,robinlinden,3,0.00035,156873,18.22447,860782
9716,robinwangrubin,3,0.00035,156876,18.22482,860782
9717,robpou,3,0.00035,156879,18.22517,860782
9718,rocenpe,3,0.00035,156882,18.22552,860782
9719,rockholla,3,0.00035,156885,18.22587,860782
9720,rod3kartik,3,0.00035,156888,18.22622,860782
9721,rodricarvalho,3,0.00035,156891,18.22657,860782
9722,rodrigo-findhotel,3,0.00035,156894,18.22691,860782
9723,roelofjansen,3,0.00035,156897,18.22726,860782
9724,rogerdalvi,3,0.00035,156900,18.22761,860782
9725,rogeriob2br,3,0.00035,156903,18.22796,860782
9726,rolatsch,3,0.00035,156906,18.22831,860782
9727,Rolinh,3,0.00035,156909,18.22866,860782
9728,romulofagundes,3,0.00035,156912,18.22901,860782
9729,RoopGuron,3,0.00035,156915,18.22935,860782
9730,rosskusler,3,0.00035,156918,18.22970,860782
9731,royyap4221,3,0.00035,156921,18.23005,860782
9732,rparsonsbb,3,0.00035,156924,18.23040,860782
9733,rra,3,0.00035,156927,18.23075,860782
9734,rrueth,3,0.00035,156930,18.23110,860782
9735,rsevilla87,3,0.00035,156933,18.23145,860782
9736,rsilva-nk,3,0.00035,156936,18.23179,860782
9737,rsvalerio,3,0.00035,156939,18.23214,860782
9738,rtatnet3,3,0.00035,156942,18.23249,860782
9739,r-trigo,3,0.00035,156945,18.23284,860782
9740,rtttech,3,0.00035,156948,18.23319,860782
9741,ruanxingbaozi,3,0.00035,156951,18.23354,860782
9742,ruaridhangus-fbr,3,0.00035,156954,18.23389,860782
9743,rudo-thomas,3,0.00035,156957,18.23423,860782
9744,rugved-mahamune,3,0.00035,156960,18.23458,860782
9745,ruinshe,3,0.00035,156963,18.23493,860782
9746,runeanielsen,3,0.00035,156966,18.23528,860782
9747,Russell-IO,3,0.00035,156969,18.23563,860782
9748,rvakash,3,0.00035,156972,18.23598,860782
9749,rvora,3,0.00035,156975,18.23632,860782
9750,rvowles,3,0.00035,156978,18.23667,860782
9751,rwanyoike,3,0.00035,156981,18.23702,860782
9752,rwlove,3,0.00035,156984,18.23737,860782
9753,ryancnelson,3,0.00035,156987,18.23772,860782
9754,ryankiki86,3,0.00035,156990,18.23807,860782
9755,ryantstone,3,0.00035,156993,18.23842,860782
9756,ryanwilsonperkin,3,0.00035,156996,18.23876,860782
9757,s1lver,3,0.00035,156999,18.23911,860782
9758,s3rj1k,3,0.00035,157002,18.23946,860782
9759,saagar241290,3,0.00035,157005,18.23981,860782
9760,saberkan,3,0.00035,157008,18.24016,860782
9761,sabir-piludiya,3,0.00035,157011,18.24051,860782
9762,sabiurr,3,0.00035,157014,18.24086,860782
9763,sagardesai0094,3,0.00035,157017,18.24120,860782
9764,sagile1,3,0.00035,157020,18.24155,860782
9765,saidghamra,3,0.00035,157023,18.24190,860782
9766,saikatHi6,3,0.00035,157026,18.24225,860782
9767,SaiNageswarS,3,0.00035,157029,18.24260,860782
9768,saji-mathew72,3,0.00035,157032,18.24295,860782
9769,Sakkyoku-Sha,3,0.00035,157035,18.24330,860782
9770,salimuddin87,3,0.00035,157038,18.24364,860782
9771,saltybaker,3,0.00035,157041,18.24399,860782
9772,samarth-gupta-traceable,3,0.00035,157044,18.24434,860782
9773,samerbite,3,0.00035,157047,18.24469,860782
9774,samgurtman,3,0.00035,157050,18.24504,860782
9775,sammyKhan,3,0.00035,157053,18.24539,860782
9776,samsja,3,0.00035,157056,18.24573,860782
9777,sam-sla,3,0.00035,157059,18.24608,860782
9778,samstickland,3,0.00035,157062,18.24643,860782
9779,samtstern,3,0.00035,157065,18.24678,860782
9780,samuelfahrngruber,3,0.00035,157068,18.24713,860782
9781,sanbaideng,3,0.00035,157071,18.24748,860782
9782,sandstone-storage,3,0.00035,157074,18.24783,860782
9783,Sanghamitra-BEAGILE,3,0.00035,157077,18.24817,860782
9784,SanjayVas,3,0.00035,157080,18.24852,860782
9785,sanwishe,3,0.00035,157083,18.24887,860782
9786,saosebastiao,3,0.00035,157086,18.24922,860782
9787,sapeish,3,0.00035,157089,18.24957,860782
9788,sarahhenkens,3,0.00035,157092,18.24992,860782
9789,sarbajitpattanaik,3,0.00035,157095,18.25027,860782
9790,sarunask,3,0.00035,157098,18.25061,860782
9791,Sasasu,3,0.00035,157101,18.25096,860782
9792,sathish-pshvn,3,0.00035,157104,18.25131,860782
9793,satish3-ntap,3,0.00035,157107,18.25166,860782
9794,satishmane,3,0.00035,157110,18.25201,860782
9795,satva,3,0.00035,157113,18.25236,860782
9796,satyabhama,3,0.00035,157116,18.25271,860782
9797,satyamskic,3,0.00035,157119,18.25305,860782
9798,satyasure,3,0.00035,157122,18.25340,860782
9799,saurav-malani,3,0.00035,157125,18.25375,860782
9800,savagete2860,3,0.00035,157128,18.25410,860782
9801,sawadashota,3,0.00035,157131,18.25445,860782
9802,sb464f,3,0.00035,157134,18.25480,860782
9803,sbaier1,3,0.00035,157137,18.25514,860782
9804,sbhardwaj-mt,3,0.00035,157140,18.25549,860782
9805,sbiermann,3,0.00035,157143,18.25584,860782
9806,sbuvaneshkumar,3,0.00035,157146,18.25619,860782
9807,Sc0th,3,0.00035,157149,18.25654,860782
9808,scarybot,3,0.00035,157152,18.25689,860782
9809,scbjans,3,0.00035,157155,18.25724,860782
9810,sc-chad,3,0.00035,157158,18.25758,860782
9811,sccrthlt,3,0.00035,157161,18.25793,860782
9812,scevallos,3,0.00035,157164,18.25828,860782
9813,schegi,3,0.00035,157167,18.25863,860782
9814,scheleaap,3,0.00035,157170,18.25898,860782
9815,schmitt-kevin,3,0.00035,157173,18.25933,860782
9816,schosterbarak,3,0.00035,157176,18.25968,860782
9817,Scong,3,0.00035,157179,18.26002,860782
9818,scorsair,3,0.00035,157182,18.26037,860782
9819,scorsi,3,0.00035,157185,18.26072,860782
9820,scottfr,3,0.00035,157188,18.26107,860782
9821,sdusoe,3,0.00035,157191,18.26142,860782
9822,seankhliao,3,0.00035,157194,18.26177,860782
9823,SeanM96,3,0.00035,157197,18.26212,860782
9824,seanmck,3,0.00035,157200,18.26246,860782
9825,Seb0042,3,0.00035,157203,18.26281,860782
9826,sebarys,3,0.00035,157206,18.26316,860782
9827,seblu,3,0.00035,157209,18.26351,860782
9828,Sebuckle,3,0.00035,157212,18.26386,860782
9829,seepls,3,0.00035,157215,18.26421,860782
9830,seglberg,3,0.00035,157218,18.26455,860782
9831,senses0,3,0.00035,157221,18.26490,860782
9832,serdarkalayci,3,0.00035,157224,18.26525,860782
9833,sergiopena,3,0.00035,157227,18.26560,860782
9834,serverhorror,3,0.00035,157230,18.26595,860782
9835,Seshirantha,3,0.00035,157233,18.26630,860782
9836,sessfeld,3,0.00035,157236,18.26665,860782
9837,SetarehStar,3,0.00035,157239,18.26699,860782
9838,Setheck,3,0.00035,157242,18.26734,860782
9839,shachar-radoshinsky-sp,3,0.00035,157245,18.26769,860782
9840,shadowXVll,3,0.00035,157248,18.26804,860782
9841,shaggygi,3,0.00035,157251,18.26839,860782
9842,shahidhs-ibm,3,0.00035,157254,18.26874,860782
9843,ShanChathusanda93,3,0.00035,157257,18.26909,860782
9844,shanestarcher-okta,3,0.00035,157260,18.26943,860782
9845,shannonmitchell,3,0.00035,157263,18.26978,860782
9846,shantanugadgil,3,0.00035,157266,18.27013,860782
9847,ShaPoHun,3,0.00035,157269,18.27048,860782
9848,shariperryman,3,0.00035,157272,18.27083,860782
9849,shcherbak,3,0.00035,157275,18.27118,860782
9850,ShenXinKang,3,0.00035,157278,18.27153,860782
9851,shifuharris,3,0.00035,157281,18.27187,860782
9852,shijiesun,3,0.00035,157284,18.27222,860782
9853,shilpasshetty,3,0.00035,157287,18.27257,860782
9854,shimont,3,0.00035,157290,18.27292,860782
9855,shivalichauhan,3,0.00035,157293,18.27327,860782
9856,shivamnc,3,0.00035,157296,18.27362,860782
9857,sho-abe,3,0.00035,157299,18.27396,860782
9858,shockw4ver,3,0.00035,157302,18.27431,860782
9859,shootkin,3,0.00035,157305,18.27466,860782
9860,shouhei,3,0.00035,157308,18.27501,860782
9861,shravanachar,3,0.00035,157311,18.27536,860782
9862,shrirama,3,0.00035,157314,18.27571,860782
9863,shurshun,3,0.00035,157317,18.27606,860782
9864,shyamradhakrishnan,3,0.00035,157320,18.27640,860782
9865,siadat,3,0.00035,157323,18.27675,860782
9866,si-c613,3,0.00035,157326,18.27710,860782
9867,sid226,3,0.00035,157329,18.27745,860782
9868,siddth09,3,0.00035,157332,18.27780,860782
9869,SigfridStjarnholm,3,0.00035,157335,18.27815,860782
9870,silazare,3,0.00035,157338,18.27850,860782
9871,silhouette,3,0.00035,157341,18.27884,860782
9872,SimonCqk,3,0.00035,157344,18.27919,860782
9873,SimonHu-HN,3,0.00035,157347,18.27954,860782
9874,Sircular,3,0.00035,157350,18.27989,860782
9875,sirkkalap,3,0.00035,157353,18.28024,860782
9876,SirNexus,3,0.00035,157356,18.28059,860782
9877,siw36,3,0.00035,157359,18.28094,860782
9878,sizowie,3,0.00035,157362,18.28128,860782
9879,sjk07,3,0.00035,157365,18.28163,860782
9880,sk1188,3,0.00035,157368,18.28198,860782
9881,skieffer,3,0.00035,157371,18.28233,860782
9882,skmaingi,3,0.00035,157374,18.28268,860782
9883,skrtks,3,0.00035,157377,18.28303,860782
9884,sksaranraj,3,0.00035,157380,18.28337,860782
9885,Skuratau,3,0.00035,157383,18.28372,860782
9886,skuruppu,3,0.00035,157386,18.28407,860782
9887,sl4dy,3,0.00035,157389,18.28442,860782
9888,slashr,3,0.00035,157392,18.28477,860782
9889,slugalisk,3,0.00035,157395,18.28512,860782
9890,slz250,3,0.00035,157398,18.28547,860782
9891,Smita8081,3,0.00035,157401,18.28581,860782
9892,smoshiur1237,3,0.00035,157404,18.28616,860782
9893,smrutiranjantripathy,3,0.00035,157407,18.28651,860782
9894,smsilva,3,0.00035,157410,18.28686,860782
9895,snahelou,3,0.00035,157413,18.28721,860782
9896,Snake4life,3,0.00035,157416,18.28756,860782
9897,snawaz,3,0.00035,157419,18.28791,860782
9898,snc29590,3,0.00035,157422,18.28825,860782
9899,sneerin,3,0.00035,157425,18.28860,860782
9900,snehalasarode,3,0.00035,157428,18.28895,860782
9901,snirben,3,0.00035,157431,18.28930,860782
9902,snmagn,3,0.00035,157434,18.28965,860782
9903,snstanton,3,0.00035,157437,18.29000,860782
9904,snypez,3,0.00035,157440,18.29035,860782
9905,softwood777,3,0.00035,157443,18.29069,860782
9906,soheilade,3,0.00035,157446,18.29104,860782
9907,so-jelly,3,0.00035,157449,18.29139,860782
9908,sojoudian,3,0.00035,157452,18.29174,860782
9909,somaliz,3,0.00035,157455,18.29209,860782
9910,somethingnew2-0,3,0.00035,157458,18.29244,860782
9911,sonam1412,3,0.00035,157461,18.29278,860782
9912,soodr,3,0.00035,157464,18.29313,860782
9913,sorenbronsted,3,0.00035,157467,18.29348,860782
9914,sorinjulean,3,0.00035,157470,18.29383,860782
9915,SoumithKumarMudugonda,3,0.00035,157473,18.29418,860782
9916,sparqueur,3,0.00035,157476,18.29453,860782
9917,SpecialYang,3,0.00035,157479,18.29488,860782
9918,spiette,3,0.00035,157482,18.29522,860782
9919,SpikeW15,3,0.00035,157485,18.29557,860782
9920,spikewang,3,0.00035,157488,18.29592,860782
9921,spiritedfang,3,0.00035,157491,18.29627,860782
9922,SpontaneousDuck,3,0.00035,157494,18.29662,860782
9923,squalou,3,0.00035,157497,18.29697,860782
9924,srajkovic,3,0.00035,157500,18.29732,860782
9925,sramek5,3,0.00035,157503,18.29766,860782
9926,srbhklkrn,3,0.00035,157506,18.29801,860782
9927,Srikanthshetty,3,0.00035,157509,18.29836,860782
9928,srilumpa,3,0.00035,157512,18.29871,860782
9929,srini38,3,0.00035,157515,18.29906,860782
9930,srirammageswarank,3,0.00035,157518,18.29941,860782
9931,sshine,3,0.00035,157521,18.29976,860782
9932,sskmail14,3,0.00035,157524,18.30010,860782
9933,St1myL,3,0.00035,157527,18.30045,860782
9934,stanxing,3,0.00035,157530,18.30080,860782
9935,Starslider,3,0.00035,157533,18.30115,860782
9936,stchau4work,3,0.00035,157536,18.30150,860782
9937,steadysupply,3,0.00035,157539,18.30185,860782
9938,stefanalund,3,0.00035,157542,18.30219,860782
9939,stefanvangastel,3,0.00035,157545,18.30254,860782
9940,StefH,3,0.00035,157548,18.30289,860782
9941,stempler,3,0.00035,157551,18.30324,860782
9942,stephanecharette,3,0.00035,157554,18.30359,860782
9943,stephen-harris,3,0.00035,157557,18.30394,860782
9944,stephenshaw-felfel,3,0.00035,157560,18.30429,860782
9945,steve13814,3,0.00035,157563,18.30463,860782
9946,stevecrozz,3,0.00035,157566,18.30498,860782
9947,stevengibbszions,3,0.00035,157569,18.30533,860782
9948,stevesim101,3,0.00035,157572,18.30568,860782
9949,stianst,3,0.00035,157575,18.30603,860782
9950,s-tokutake,3,0.00035,157578,18.30638,860782
9951,StoneCut,3,0.00035,157581,18.30673,860782
9952,stone-z,3,0.00035,157584,18.30707,860782
9953,Storm-Born,3,0.00035,157587,18.30742,860782
9954,straynor705,3,0.00035,157590,18.30777,860782
9955,strus38,3,0.00035,157593,18.30812,860782
9956,ststeiger,3,0.00035,157596,18.30847,860782
9957,sturman,3,0.00035,157599,18.30882,860782
9958,subin8848,3,0.00035,157602,18.30917,860782
9959,subodh01,3,0.00035,157605,18.30951,860782
9960,suitupalex,3,0.00035,157608,18.30986,860782
9961,sujil02,3,0.00035,157611,18.31021,860782
9962,sujith-siva,3,0.00035,157614,18.31056,860782
9963,sukimoyoi,3,0.00035,157617,18.31091,860782
9964,sulaukad,3,0.00035,157620,18.31126,860782
9965,sunhubs,3,0.00035,157623,18.31161,860782
9966,Sunnykaby,3,0.00035,157626,18.31195,860782
9967,sunzhenyucn,3,0.00035,157629,18.31230,860782
9968,supermihi,3,0.00035,157632,18.31265,860782
9969,suppix,3,0.00035,157635,18.31300,860782
9970,surekha1723,3,0.00035,157638,18.31335,860782
9971,Sureya,3,0.00035,157641,18.31370,860782
9972,suryachaganti9,3,0.00035,157644,18.31404,860782
9973,susimsek,3,0.00035,157647,18.31439,860782
9974,suvyakta,3,0.00035,157650,18.31474,860782
9975,svanschalkwyk,3,0.00035,157653,18.31509,860782
9976,sveerabathini,3,0.00035,157656,18.31544,860782
9977,SvenC56,3,0.00035,157659,18.31579,860782
9978,svenhofstede,3,0.00035,157662,18.31614,860782
9979,SvenMW,3,0.00035,157665,18.31648,860782
9980,swagitda,3,0.00035,157668,18.31683,860782
9981,swinges,3,0.00035,157671,18.31718,860782
9982,swisspol,3,0.00035,157674,18.31753,860782
9983,swpoulin,3,0.00035,157677,18.31788,860782
9984,swrap,3,0.00035,157680,18.31823,860782
9985,SyamSundarKirubakaran,3,0.00035,157683,18.31858,860782
9986,sybrenstuvel,3,0.00035,157686,18.31892,860782
9987,SyedAsimAliSE,3,0.00035,157689,18.31927,860782
9988,syednadeembe,3,0.00035,157692,18.31962,860782
9989,Sylfrena,3,0.00035,157695,18.31997,860782
9990,sysadm-dev,3,0.00035,157698,18.32032,860782
9991,sysopsdev,3,0.00035,157701,18.32067,860782
9992,system51,3,0.00035,157704,18.32102,860782
9993,szymon3,3,0.00035,157707,18.32136,860782
9994,t1hom7as,3,0.00035,157710,18.32171,860782
9995,tabka,3,0.00035,157713,18.32206,860782
9996,tadamhicks,3,0.00035,157716,18.32241,860782
9997,tahnik,3,0.00035,157719,18.32276,860782
9998,Taiters,3,0.00035,157722,18.32311,860782
9999,takahser,3,0.00035,157725,18.32345,860782
10000,takakawa,3,0.00035,157728,18.32380,860782
10001,TakumaNakagame,3,0.00035,157731,18.32415,860782
10002,tallaxes,3,0.00035,157734,18.32450,860782
10003,TalZiv,3,0.00035,157737,18.32485,860782
10004,tanaka0325,3,0.00035,157740,18.32520,860782
10005,tanguyfalconnet,3,0.00035,157743,18.32555,860782
10006,tankbusta,3,0.00035,157746,18.32589,860782
10007,tanya-sy,3,0.00035,157749,18.32624,860782
10008,tapanhalani,3,0.00035,157752,18.32659,860782
10009,tariqkipkemei,3,0.00035,157755,18.32694,860782
10010,tarpanpathak,3,0.00035,157758,18.32729,860782
10011,tarunnarang0201,3,0.00035,157761,18.32764,860782
10012,Tausif28,3,0.00035,157764,18.32799,860782
10013,tcmichael,3,0.00035,157767,18.32833,860782
10014,tcordeu,3,0.00035,157770,18.32868,860782
10015,tdensmore,3,0.00035,157773,18.32903,860782
10016,tdickman,3,0.00035,157776,18.32938,860782
10017,techgnosis,3,0.00035,157779,18.32973,860782
10018,techieshark,3,0.00035,157782,18.33008,860782
10019,techmexdev,3,0.00035,157785,18.33043,860782
10020,ted-sigsci,3,0.00035,157788,18.33077,860782
10021,teebeey,3,0.00035,157791,18.33112,860782
10022,tehbrut,3,0.00035,157794,18.33147,860782
10023,tehlers320,3,0.00035,157797,18.33182,860782
10024,teiserse,3,0.00035,157800,18.33217,860782
10025,Tejeev,3,0.00035,157803,18.33252,860782
10026,tema-mazy,3,0.00035,157806,18.33286,860782
10027,Ten0,3,0.00035,157809,18.33321,860782
10028,tennessine,3,0.00035,157812,18.33356,860782
10029,tero-dev,3,0.00035,157815,18.33391,860782
10030,TeroPihlaja,3,0.00035,157818,18.33426,860782
10031,Terrones-Oscar,3,0.00035,157821,18.33461,860782
10032,terryherron,3,0.00035,157824,18.33496,860782
10033,tessykt,3,0.00035,157827,18.33530,860782
10034,texanraj,3,0.00035,157830,18.33565,860782
10035,tgunsch,3,0.00035,157833,18.33600,860782
10036,Th3Falc0n,3,0.00035,157836,18.33635,860782
10037,Thalhammer,3,0.00035,157839,18.33670,860782
10038,thamaraiselvam,3,0.00035,157842,18.33705,860782
10039,thatsmydoing,3,0.00035,157845,18.33740,860782
10040,theadityasam,3,0.00035,157848,18.33774,860782
10041,thearegee,3,0.00035,157851,18.33809,860782
10042,TheEnbyperor,3,0.00035,157854,18.33844,860782
10043,thefreeeman,3,0.00035,157857,18.33879,860782
10044,thekad,3,0.00035,157860,18.33914,860782
10045,TheKangaroo,3,0.00035,157863,18.33949,860782
10046,the-nw1-group,3,0.00035,157866,18.33984,860782
10047,theonlijuan,3,0.00035,157869,18.34018,860782
10048,ThePlenkov,3,0.00035,157872,18.34053,860782
10049,ThePolarNight,3,0.00035,157875,18.34088,860782
10050,thepythonista,3,0.00035,157878,18.34123,860782
10051,Therianthropie,3,0.00035,157881,18.34158,860782
10052,therne,3,0.00035,157884,18.34193,860782
10053,The-smooth-operator,3,0.00035,157887,18.34227,860782
10054,thesunnysky,3,0.00035,157890,18.34262,860782
10055,thisismz,3,0.00035,157893,18.34297,860782
10056,thomasjardin,3,0.00035,157896,18.34332,860782
10057,thomasjo,3,0.00035,157899,18.34367,860782
10058,thomaspedley,3,0.00035,157902,18.34402,860782
10059,ThomasRasmussen,3,0.00035,157905,18.34437,860782
10060,thomasrepnik,3,0.00035,157908,18.34471,860782
10061,Thunderbottom,3,0.00035,157911,18.34506,860782
10062,thyn,3,0.00035,157914,18.34541,860782
10063,tiagomistral,3,0.00035,157917,18.34576,860782
10064,tianhongw,3,0.00035,157920,18.34611,860782
10065,tierney,3,0.00035,157923,18.34646,860782
10066,Tikam02,3,0.00035,157926,18.34681,860782
10067,tilan7663,3,0.00035,157929,18.34715,860782
10068,till,3,0.00035,157932,18.34750,860782
10069,Timer-cxz,3,0.00035,157935,18.34785,860782
10070,timjonesdev,3,0.00035,157938,18.34820,860782
10071,timmi-on-rails,3,0.00035,157941,18.34855,860782
10072,timschneider,3,0.00035,157944,18.34890,860782
10073,tincopper,3,0.00035,157947,18.34925,860782
10074,tinselspoon,3,0.00035,157950,18.34959,860782
10075,tiras-j,3,0.00035,157953,18.34994,860782
10076,titansmc,3,0.00035,157956,18.35029,860782
10077,tkornai,3,0.00035,157959,18.35064,860782
10078,tlefevre,3,0.00035,157962,18.35099,860782
10079,tlhunter,3,0.00035,157965,18.35134,860782
10080,TLINDEN,3,0.00035,157968,18.35168,860782
10081,tlinhart,3,0.00035,157971,18.35203,860782
10082,tmbdev,3,0.00035,157974,18.35238,860782
10083,TMoynat,3,0.00035,157977,18.35273,860782
10084,tnimni,3,0.00035,157980,18.35308,860782
10085,TobiasWenzel,3,0.00035,157983,18.35343,860782
10086,todaywasawesome,3,0.00035,157986,18.35378,860782
10087,tomasfse,3,0.00035,157989,18.35412,860782
10088,tomekit,3,0.00035,157992,18.35447,860782
10089,tomhouweling1987,3,0.00035,157995,18.35482,860782
10090,tomhuang12,3,0.00035,157998,18.35517,860782
10091,tomoyamachi,3,0.00035,158001,18.35552,860782
10092,TomskDiver,3,0.00035,158004,18.35587,860782
10093,tortuoise,3,0.00035,158007,18.35622,860782
10094,toutdesuite,3,0.00035,158010,18.35656,860782
10095,touuzhankkoaexak,3,0.00035,158013,18.35691,860782
10096,toVersus,3,0.00035,158016,18.35726,860782
10097,ToWorld,3,0.00035,158019,18.35761,860782
10098,trajakovic,3,0.00035,158022,18.35796,860782
10099,transhapHigsn,3,0.00035,158025,18.35831,860782
10100,transnano,3,0.00035,158028,18.35866,860782
10101,trevor403,3,0.00035,158031,18.35900,860782
10102,TrevorPace,3,0.00035,158034,18.35935,860782
10103,TReZ42,3,0.00035,158037,18.35970,860782
10104,trieszklr,3,0.00035,158040,18.36005,860782
10105,trilom,3,0.00035,158043,18.36040,860782
10106,trodge,3,0.00035,158046,18.36075,860782
10107,trombka,3,0.00035,158049,18.36109,860782
10108,trozet,3,0.00035,158052,18.36144,860782
10109,trujamal,3,0.00035,158055,18.36179,860782
10110,trulede,3,0.00035,158058,18.36214,860782
10111,trustdark,3,0.00035,158061,18.36249,860782
10112,tschmittni,3,0.00035,158064,18.36284,860782
10113,tscni,3,0.00035,158067,18.36319,860782
10114,tsouche,3,0.00035,158070,18.36353,860782
10115,tstenvi,3,0.00035,158073,18.36388,860782
10116,tsusadivyago,3,0.00035,158076,18.36423,860782
10117,tuananh170489,3,0.00035,158079,18.36458,860782
10118,tuxknight,3,0.00035,158082,18.36493,860782
10119,tvanderka,3,0.00035,158085,18.36528,860782
10120,twobombs,3,0.00035,158088,18.36563,860782
10121,tyates-indeed,3,0.00035,158091,18.36597,860782
10122,ty-machine,3,0.00035,158094,18.36632,860782
10123,tzehetner,3,0.00035,158097,18.36667,860782
10124,uaparicio,3,0.00035,158100,18.36702,860782
10125,UdayVishwakarma,3,0.00035,158103,18.36737,860782
10126,Ufaowl,3,0.00035,158106,18.36772,860782
10127,ufou,3,0.00035,158109,18.36807,860782
10128,UgurTheG,3,0.00035,158112,18.36841,860782
10129,ujjboy,3,0.00035,158115,18.36876,860782
10130,UkonnRa,3,0.00035,158118,18.36911,860782
10131,Ulminator,3,0.00035,158121,18.36946,860782
10132,ultra-baba,3,0.00035,158124,18.36981,860782
10133,uma2203,3,0.00035,158127,18.37016,860782
10134,unacceptable,3,0.00035,158130,18.37050,860782
10135,uncycler,3,0.00035,158133,18.37085,860782
10136,undead00,3,0.00035,158136,18.37120,860782
10137,unstubbable,3,0.00035,158139,18.37155,860782
10138,Urhengulas,3,0.00035,158142,18.37190,860782
10139,urohit011,3,0.00035,158145,18.37225,860782
10140,UsamaMehboob,3,0.00035,158148,18.37260,860782
10141,usernameisnull,3,0.00035,158151,18.37294,860782
10142,Utsav2,3,0.00035,158154,18.37329,860782
10143,uveta,3,0.00035,158157,18.37364,860782
10144,uziela,3,0.00035,158160,18.37399,860782
10145,vab2048,3,0.00035,158163,18.37434,860782
10146,vacheli,3,0.00035,158166,18.37469,860782
10147,Vageesha17,3,0.00035,158169,18.37504,860782
10148,vaishali-prophecy,3,0.00035,158172,18.37538,860782
10149,valaparthvi,3,0.00035,158175,18.37573,860782
10150,valerauko,3,0.00035,158178,18.37608,860782
10151,valeriozhang,3,0.00035,158181,18.37643,860782
10152,vamshi67,3,0.00035,158184,18.37678,860782
10153,varunpal7,3,0.00035,158187,18.37713,860782
10154,varunpalekar,3,0.00035,158190,18.37748,860782
10155,VasilchukVV,3,0.00035,158193,18.37782,860782
10156,VasilSirakov,3,0.00035,158196,18.37817,860782
10157,vayyappaneni,3,0.00035,158199,18.37852,860782
10158,vbence,3,0.00035,158202,18.37887,860782
10159,vbuciuc,3,0.00035,158205,18.37922,860782
10160,vc43,3,0.00035,158208,18.37957,860782
10161,vchrisb,3,0.00035,158211,18.37992,860782
10162,vcorr,3,0.00035,158214,18.38026,860782
10163,vDMG,3,0.00035,158217,18.38061,860782
10164,vdotson,3,0.00035,158220,18.38096,860782
10165,vebis,3,0.00035,158223,18.38131,860782
10166,vedatappsamurai,3,0.00035,158226,18.38166,860782
10167,velkhatib,3,0.00035,158229,18.38201,860782
10168,VengefulAncient,3,0.00035,158232,18.38235,860782
10169,VenkataInduri,3,0.00035,158235,18.38270,860782
10170,venky999,3,0.00035,158238,18.38305,860782
10171,vennb,3,0.00035,158241,18.38340,860782
10172,vennemp,3,0.00035,158244,18.38375,860782
10173,venth,3,0.00035,158247,18.38410,860782
10174,ventifus,3,0.00035,158250,18.38445,860782
10175,vertextao,3,0.00035,158253,18.38479,860782
10176,vfiset,3,0.00035,158256,18.38514,860782
10177,VF-mbrauer,3,0.00035,158259,18.38549,860782
10178,vibridi,3,0.00035,158262,18.38584,860782
10179,vicmania2007,3,0.00035,158265,18.38619,860782
10180,vidalsysadmin,3,0.00035,158268,18.38654,860782
10181,VidarHUN,3,0.00035,158271,18.38689,860782
10182,vidushv,3,0.00035,158274,18.38723,860782
10183,vikaschenny,3,0.00035,158277,18.38758,860782
10184,viktorradnai,3,0.00035,158280,18.38793,860782
10185,Vilsol,3,0.00035,158283,18.38828,860782
10186,vince,3,0.00035,158286,18.38863,860782
10187,vinzent,3,0.00035,158289,18.38898,860782
10188,vipinponnarath,3,0.00035,158292,18.38933,860782
10189,virendrasuryavanshi,3,0.00035,158295,18.38967,860782
10190,viscountn7557,3,0.00035,158298,18.39002,860782
10191,vishalbollu,3,0.00035,158301,18.39037,860782
10192,VishalLahane,3,0.00035,158304,18.39072,860782
10193,vishal-swarankar-sdl,3,0.00035,158307,18.39107,860782
10194,Vislor,3,0.00035,158310,18.39142,860782
10195,vitalif,3,0.00035,158313,18.39176,860782
10196,vitalyrychkov,3,0.00035,158316,18.39211,860782
10197,vitovitolo,3,0.00035,158319,18.39246,860782
10198,vivekanandg,3,0.00035,158322,18.39281,860782
10199,vivekKodira,3,0.00035,158325,18.39316,860782
10200,vkanuri5,3,0.00035,158328,18.39351,860782
10201,vkasgit,3,0.00035,158331,18.39386,860782
10202,vklonghml,3,0.00035,158334,18.39420,860782
10203,vldungureanu,3,0.00035,158337,18.39455,860782
10204,vlucas,3,0.00035,158340,18.39490,860782
10205,vmandrychenko,3,0.00035,158343,18.39525,860782
10206,vmwarelab,3,0.00035,158346,18.39560,860782
10207,vniche,3,0.00035,158349,18.39595,860782
10208,voroniys,3,0.00035,158352,18.39630,860782
10209,vsadriano,3,0.00035,158355,18.39664,860782
10210,vsharathis,3,0.00035,158358,18.39699,860782
10211,vsvipul,3,0.00035,158361,18.39734,860782
10212,vterdunov,3,0.00035,158364,18.39769,860782
10213,vyckou,3,0.00035,158367,18.39804,860782
10214,vzabawski,3,0.00035,158370,18.39839,860782
10215,wacuuu,3,0.00035,158373,18.39874,860782
10216,Wade201801,3,0.00035,158376,18.39908,860782
10217,waeleethecoolboy111,3,0.00035,158379,18.39943,860782
10218,waisbrot,3,0.00035,158382,18.39978,860782
10219,wajika,3,0.00035,158385,18.40013,860782
10220,Walid47,3,0.00035,158388,18.40048,860782
10221,walterfranssen,3,0.00035,158391,18.40083,860782
10222,wangdwcsd,3,0.00035,158394,18.40117,860782
10223,wantdrink,3,0.00035,158397,18.40152,860782
10224,warrn,3,0.00035,158400,18.40187,860782
10225,wasimansari661,3,0.00035,158403,18.40222,860782
10226,waynesun09,3,0.00035,158406,18.40257,860782
10227,WBare,3,0.00035,158409,18.40292,860782
10228,wbuck,3,0.00035,158412,18.40327,860782
10229,wcs1only,3,0.00035,158415,18.40361,860782
10230,wcurry,3,0.00035,158418,18.40396,860782
10231,webPageDev,3,0.00035,158421,18.40431,860782
10232,wenxinnnnn,3,0.00035,158424,18.40466,860782
10233,WestFarmer,3,0.00035,158427,18.40501,860782
10234,wfxr,3,0.00035,158430,18.40536,860782
10235,whaike,3,0.00035,158433,18.40571,860782
10236,whillas,3,0.00035,158436,18.40605,860782
10237,whuang8,3,0.00035,158439,18.40640,860782
10238,Willem1987,3,0.00035,158442,18.40675,860782
10239,willfaught,3,0.00035,158445,18.40710,860782
10240,WilliamHoo,3,0.00035,158448,18.40745,860782
10241,william-lg,3,0.00035,158451,18.40780,860782
10242,wind2008hxy,3,0.00035,158454,18.40815,860782
10243,win-t,3,0.00035,158457,18.40849,860782
10244,witchbutter,3,0.00035,158460,18.40884,860782
10245,witcxc,3,0.00035,158463,18.40919,860782
10246,wjun,3,0.00035,158466,18.40954,860782
10247,wojciesze,3,0.00035,158469,18.40989,860782
10248,Woland2k,3,0.00035,158472,18.41024,860782
10249,wolandr,3,0.00035,158475,18.41058,860782
10250,wolverinets,3,0.00035,158478,18.41093,860782
10251,wongdu,3,0.00035,158481,18.41128,860782
10252,woniuzhang,3,0.00035,158484,18.41163,860782
10253,woz5999,3,0.00035,158487,18.41198,860782
10254,wsxiaozhang,3,0.00035,158490,18.41233,860782
10255,WtfJoke,3,0.00035,158493,18.41268,860782
10256,wuchencm,3,0.00035,158496,18.41302,860782
10257,wuchenzh,3,0.00035,158499,18.41337,860782
10258,wulou,3,0.00035,158502,18.41372,860782
10259,wuservices,3,0.00035,158505,18.41407,860782
10260,wushuyi,3,0.00035,158508,18.41442,860782
10261,wx-yz,3,0.00035,158511,18.41477,860782
10262,wy100101,3,0.00035,158514,18.41512,860782
10263,wzcwts521,3,0.00035,158517,18.41546,860782
10264,Xaeroxe,3,0.00035,158520,18.41581,860782
10265,xakraz,3,0.00035,158523,18.41616,860782
10266,xavierleune,3,0.00035,158526,18.41651,860782
10267,xbmono,3,0.00035,158529,18.41686,860782
10268,xfrogcn,3,0.00035,158532,18.41721,860782
10269,xhanin,3,0.00035,158535,18.41756,860782
10270,xhulioxole,3,0.00035,158538,18.41790,860782
10271,xiaket,3,0.00035,158541,18.41825,860782
10272,XiangLi0619,3,0.00035,158544,18.41860,860782
10273,XiaobinYuan,3,0.00035,158547,18.41895,860782
10274,xiaochen2993,3,0.00035,158550,18.41930,860782
10275,xiaooloong,3,0.00035,158553,18.41965,860782
10276,xiaopeng-han,3,0.00035,158556,18.41999,860782
10277,xiaoxiadazhi,3,0.00035,158559,18.42034,860782
10278,xiedidan,3,0.00035,158562,18.42069,860782
10279,xieqiang2020,3,0.00035,158565,18.42104,860782
10280,Xietaiy,3,0.00035,158568,18.42139,860782
10281,xieyunyue,3,0.00035,158571,18.42174,860782
10282,xilu0,3,0.00035,158574,18.42209,860782
10283,xiujuan95,3,0.00035,158577,18.42243,860782
10284,xkfen,3,0.00035,158580,18.42278,860782
10285,xkz0001,3,0.00035,158583,18.42313,860782
10286,xmik,3,0.00035,158586,18.42348,860782
10287,xmlking,3,0.00035,158589,18.42383,860782
10288,Xnyle,3,0.00035,158592,18.42418,860782
10289,xoac,3,0.00035,158595,18.42453,860782
10290,xocolatl-aficionado,3,0.00035,158598,18.42487,860782
10291,xring,3,0.00035,158601,18.42522,860782
10292,xuanyimo,3,0.00035,158604,18.42557,860782
10293,XuejiaoZhang,3,0.00035,158607,18.42592,860782
10294,xuxihao,3,0.00035,158610,18.42627,860782
10295,xuyang1996,3,0.00035,158613,18.42662,860782
10296,xwdreamer,3,0.00035,158616,18.42697,860782
10297,Yajo,3,0.00035,158619,18.42731,860782
10298,yakirch,3,0.00035,158622,18.42766,860782
10299,yangboz,3,0.00035,158625,18.42801,860782
10300,yangmingqi218,3,0.00035,158628,18.42836,860782
10301,yanwei2019,3,0.00035,158631,18.42871,860782
10302,yap-studios,3,0.00035,158634,18.42906,860782
10303,yashvardhan-kukreja,3,0.00035,158637,18.42940,860782
10304,ydemetriades,3,0.00035,158640,18.42975,860782
10305,ydesgagn,3,0.00035,158643,18.43010,860782
10306,yehaolan,3,0.00035,158646,18.43045,860782
10307,yeldiRium,3,0.00035,158649,18.43080,860782
10308,yellowmegaman,3,0.00035,158652,18.43115,860782
10309,yeoji,3,0.00035,158655,18.43150,860782
10310,yeplaa,3,0.00035,158658,18.43184,860782
10311,yfried,3,0.00035,158661,18.43219,860782
10312,YGwen,3,0.00035,158664,18.43254,860782
10313,yinchengjian,3,0.00035,158667,18.43289,860782
10314,yinkun111,3,0.00035,158670,18.43324,860782
10315,ykcilborw,3,0.00035,158673,18.43359,860782
10316,ykfq,3,0.00035,158676,18.43394,860782
10317,ymity,3,0.00035,158679,18.43428,860782
10318,yngwiewang,3,0.00035,158682,18.43463,860782
10319,ynkrish,3,0.00035,158685,18.43498,860782
10320,yokiworks,3,0.00035,158688,18.43533,860782
10321,yoniamir,3,0.00035,158691,18.43568,860782
10322,YourTechBud,3,0.00035,158694,18.43603,860782
10323,yousong,3,0.00035,158697,18.43638,860782
10324,youzipi,3,0.00035,158700,18.43672,860782
10325,yoyota,3,0.00035,158703,18.43707,860782
10326,yshcoffee2,3,0.00035,158706,18.43742,860782
10327,yuanxuzhang,3,0.00035,158709,18.43777,860782
10328,yubofredwang,3,0.00035,158712,18.43812,860782
10329,Yuggupta27,3,0.00035,158715,18.43847,860782
10330,yunj,3,0.00035,158718,18.43881,860782
10331,yustoris,3,0.00035,158721,18.43916,860782
10332,yuta1979,3,0.00035,158724,18.43951,860782
10333,yyaari,3,0.00035,158727,18.43986,860782
10334,zach-robinson,3,0.00035,158730,18.44021,860782
10335,zaherg,3,0.00035,158733,18.44056,860782
10336,zainhasib,3,0.00035,158736,18.44091,860782
10337,zaki-lknr,3,0.00035,158739,18.44125,860782
10338,zamirmf,3,0.00035,158742,18.44160,860782
10339,Zauxst,3,0.00035,158745,18.44195,860782
10340,zawawahoge,3,0.00035,158748,18.44230,860782
10341,zbbfufu,3,0.00035,158751,18.44265,860782
10342,zbrookle,3,0.00035,158754,18.44300,860782
10343,zclyne,3,0.00035,158757,18.44335,860782
10344,zdenekvicar,3,0.00035,158760,18.44369,860782
10345,zebraincognito,3,0.00035,158763,18.44404,860782
10346,zebralight,3,0.00035,158766,18.44439,860782
10347,Zelinzky,3,0.00035,158769,18.44474,860782
10348,zeppelinux,3,0.00035,158772,18.44509,860782
10349,zer0def,3,0.00035,158775,18.44544,860782
10350,zeraza,3,0.00035,158778,18.44579,860782
10351,zetsub0u,3,0.00035,158781,18.44613,860782
10352,zhangdb-git,3,0.00035,158784,18.44648,860782
10353,zhanghan12,3,0.00035,158787,18.44683,860782
10354,zhanglei216,3,0.00035,158790,18.44718,860782
10355,zhangschunfeng,3,0.00035,158793,18.44753,860782
10356,zhangxingdeppon,3,0.00035,158796,18.44788,860782
10357,zhangyang1997,3,0.00035,158799,18.44822,860782
10358,zhanxc,3,0.00035,158802,18.44857,860782
10359,ZhifengZhang-CN,3,0.00035,158805,18.44892,860782
10360,ZhiqiangTao,3,0.00035,158808,18.44927,860782
10361,zhishi,3,0.00035,158811,18.44962,860782
10362,zhsh16,3,0.00035,158814,18.44997,860782
10363,zhuaizhuaixi,3,0.00035,158817,18.45032,860782
10364,zhuboshuai,3,0.00035,158820,18.45066,860782
10365,zhuyouzhufu,3,0.00035,158823,18.45101,860782
10366,zillaer,3,0.00035,158826,18.45136,860782
10367,zimisu,3,0.00035,158829,18.45171,860782
10368,zinizhu,3,0.00035,158832,18.45206,860782
10369,zkl94,3,0.00035,158835,18.45241,860782
10370,ZLget,3,0.00035,158838,18.45276,860782
10371,zmarouf,3,0.00035,158841,18.45310,860782
10372,zoercai,3,0.00035,158844,18.45345,860782
10373,zopanix,3,0.00035,158847,18.45380,860782
10374,zorro786,3,0.00035,158850,18.45415,860782
10375,zoux86,3,0.00035,158853,18.45450,860782
10376,ZPJeck,3,0.00035,158856,18.45485,860782
10377,zshi-redhat,3,0.00035,158859,18.45520,860782
10378,ztf214,3,0.00035,158862,18.45554,860782
10379,ZukenHammer,3,0.00035,158865,18.45589,860782
10380,zuquan-song,3,0.00035,158868,18.45624,860782
10381,zvazquez,3,0.00035,158871,18.45659,860782
10382,zw0610,3,0.00035,158874,18.45694,860782
10383,zwangsh,3,0.00035,158877,18.45729,860782
10384,zxdyumiao,3,0.00035,158880,18.45764,860782
10385,zxpan,3,0.00035,158883,18.45798,860782
10386,zyc-ai,3,0.00035,158886,18.45833,860782
10387,zyq1994,3,0.00035,158889,18.45868,860782
10388,zyt312074545,3,0.00035,158892,18.45903,860782
10389,01mcgrady01,2,0.00023,158894,18.45926,860782
10390,0Delta,2,0.00023,158896,18.45949,860782
10391,0dragosh,2,0.00023,158898,18.45973,860782
10392,0x00-ketsu,2,0.00023,158900,18.45996,860782
10393,0x1D-1983,2,0.00023,158902,18.46019,860782
10394,0x646e78,2,0.00023,158904,18.46042,860782
10395,0x77dev,2,0.00023,158906,18.46066,860782
10396,0xa0ax0,2,0.00023,158908,18.46089,860782
10397,1046102779,2,0.00023,158910,18.46112,860782
10398,111qqz,2,0.00023,158912,18.46135,860782
10399,12Manoz,2,0.00023,158914,18.46158,860782
10400,1450793561,2,0.00023,158916,18.46182,860782
10401,1661788089,2,0.00023,158918,18.46205,860782
10402,1964405262,2,0.00023,158920,18.46228,860782
10403,1996Shubh,2,0.00023,158922,18.46251,860782
10404,19CMkudo,2,0.00023,158924,18.46275,860782
10405,20100b,2,0.00023,158926,18.46298,860782
10406,2018CRYPTO,2,0.00023,158928,18.46321,860782
10407,2blumen,2,0.00023,158930,18.46344,860782
10408,2kindsofcs,2,0.00023,158932,18.46368,860782
10409,2mf,2,0.00023,158934,18.46391,860782
10410,2nick,2,0.00023,158936,18.46414,860782
10411,2ZZ,2,0.00023,158938,18.46437,860782
10412,3j0s,2,0.00023,158940,18.46461,860782
10413,424D57,2,0.00023,158942,18.46484,860782
10414,46Wil,2,0.00023,158944,18.46507,860782
10415,4ndris,2,0.00023,158946,18.46530,860782
10416,4nx,2,0.00023,158948,18.46553,860782
10417,60south,2,0.00023,158950,18.46577,860782
10418,615Manu,2,0.00023,158952,18.46600,860782
10419,70k10,2,0.00023,158954,18.46623,860782
10420,7c,2,0.00023,158956,18.46646,860782
10421,7ko7,2,0.00023,158958,18.46670,860782
10422,86,2,0.00023,158960,18.46693,860782
10423,a102467,2,0.00023,158962,18.46716,860782
10424,a2z-ice,2,0.00023,158964,18.46739,860782
10425,a6kme,2,0.00023,158966,18.46763,860782
10426,aaasolo,2,0.00023,158968,18.46786,860782
10427,aabc123,2,0.00023,158970,18.46809,860782
10428,Aadil-Nabi,2,0.00023,158972,18.46832,860782
10429,aakashrshah,2,0.00023,158974,18.46856,860782
10430,aamirashid,2,0.00023,158976,18.46879,860782
10431,Aaquiff,2,0.00023,158978,18.46902,860782
10432,aaronhmiller,2,0.00023,158980,18.46925,860782
10433,aaronsuns,2,0.00023,158982,18.46948,860782
10434,aashu16,2,0.00023,158984,18.46972,860782
10435,abarke,2,0.00023,158986,18.46995,860782
10436,abaxo,2,0.00023,158988,18.47018,860782
10437,abaymar,2,0.00023,158990,18.47041,860782
10438,abderrahim,2,0.00023,158992,18.47065,860782
10439,abel-von,2,0.00023,158994,18.47088,860782
10440,Abhay11,2,0.00023,158996,18.47111,860782
10441,abhidha02,2,0.00023,158998,18.47134,860782
10442,abhi-dwivedi,2,0.00023,159000,18.47158,860782
10443,abhilash93,2,0.00023,159002,18.47181,860782
10444,Abhinandan-Purkait,2,0.00023,159004,18.47204,860782
10445,abhinavgarg956,2,0.00023,159006,18.47227,860782
10446,abhipth,2,0.00023,159008,18.47251,860782
10447,ABHISHARMAV,2,0.00023,159010,18.47274,860782
10448,abhishekd07,2,0.00023,159012,18.47297,860782
10449,AbhishekMallick,2,0.00023,159014,18.47320,860782
10450,abhushansahu,2,0.00023,159016,18.47343,860782
10451,about-code,2,0.00023,159018,18.47367,860782
10452,abowloflrf,2,0.00023,159020,18.47390,860782
10453,abregar,2,0.00023,159022,18.47413,860782
10454,AbScott1985,2,0.00023,159024,18.47436,860782
10455,absoutherland,2,0.00023,159026,18.47460,860782
10456,abstractj,2,0.00023,159028,18.47483,860782
10457,abutail,2,0.00023,159030,18.47506,860782
10458,aca,2,0.00023,159032,18.47529,860782
10459,accountgit,2,0.00023,159034,18.47553,860782
10460,acesir,2,0.00023,159036,18.47576,860782
10461,achisolomon,2,0.00023,159038,18.47599,860782
10462,achmstein,2,0.00023,159040,18.47622,860782
10463,achronak,2,0.00023,159042,18.47646,860782
10464,acoulon99,2,0.00023,159044,18.47669,860782
10465,acoulton,2,0.00023,159046,18.47692,860782
10466,ACure4IT,2,0.00023,159048,18.47715,860782
10467,adamchalmers,2,0.00023,159050,18.47738,860782
10468,adamdougal,2,0.00023,159052,18.47762,860782
10469,adamrushuk,2,0.00023,159054,18.47785,860782
10470,adamshone,2,0.00023,159056,18.47808,860782
10471,AdamSzendrei,2,0.00023,159058,18.47831,860782
10472,adamulacha,2,0.00023,159060,18.47855,860782
10473,adamzr,2,0.00023,159062,18.47878,860782
10474,adarshraj87,2,0.00023,159064,18.47901,860782
10475,addprs,2,0.00023,159066,18.47924,860782
10476,addyess,2,0.00023,159068,18.47948,860782
10477,aded,2,0.00023,159070,18.47971,860782
10478,adelisle,2,0.00023,159072,18.47994,860782
10479,adirg,2,0.00023,159074,18.48017,860782
10480,aditijadhav38,2,0.00023,159076,18.48041,860782
10481,aditsachde,2,0.00023,159078,18.48064,860782
10482,adnankobir,2,0.00023,159080,18.48087,860782
10483,adoyle-h,2,0.00023,159082,18.48110,860782
10484,adriank-convoy,2,0.00023,159084,18.48133,860782
10485,adrianovieira,2,0.00023,159086,18.48157,860782
10486,aellert,2,0.00023,159088,18.48180,860782
10487,aellett,2,0.00023,159090,18.48203,860782
10488,Aenima4six2,2,0.00023,159092,18.48226,860782
10489,aepuls,2,0.00023,159094,18.48250,860782
10490,aflag,2,0.00023,159096,18.48273,860782
10491,afoltzm,2,0.00023,159098,18.48296,860782
10492,agamezg,2,0.00023,159100,18.48319,860782
10493,agarwri,2,0.00023,159102,18.48343,860782
10494,agascon,2,0.00023,159104,18.48366,860782
10495,agasparovic-sabre,2,0.00023,159106,18.48389,860782
10496,agengdp,2,0.00023,159108,18.48412,860782
10497,agentreno,2,0.00023,159110,18.48435,860782
10498,aggrand,2,0.00023,159112,18.48459,860782
10499,AghaSaad04,2,0.00023,159114,18.48482,860782
10500,agracey,2,0.00023,159116,18.48505,860782
10501,AGSaidi,2,0.00023,159118,18.48528,860782
10502,agung-kargo,2,0.00023,159120,18.48552,860782
10503,agustinvinao,2,0.00023,159122,18.48575,860782
10504,ahamstra,2,0.00023,159124,18.48598,860782
10505,ahazelwood,2,0.00023,159126,18.48621,860782
10506,AHEADer,2,0.00023,159128,18.48645,860782
10507,ahjsun,2,0.00023,159130,18.48668,860782
10508,ahmadidev,2,0.00023,159132,18.48691,860782
10509,AhmedAskar,2,0.00023,159134,18.48714,860782
10510,ahmetgeymen,2,0.00023,159136,18.48738,860782
10511,ahmet-uyar,2,0.00023,159138,18.48761,860782
10512,ahollist,2,0.00023,159140,18.48784,860782
10513,AI-Joe,2,0.00023,159142,18.48807,860782
10514,airmonitor,2,0.00023,159144,18.48830,860782
10515,aisensiy,2,0.00023,159146,18.48854,860782
10516,aitorhh,2,0.00023,159148,18.48877,860782
10517,Aitozi,2,0.00023,159150,18.48900,860782
10518,aiziumov,2,0.00023,159152,18.48923,860782
10519,ajayz7,2,0.00023,159154,18.48947,860782
10520,ajbouh,2,0.00023,159156,18.48970,860782
10521,ajcann,2,0.00023,159158,18.48993,860782
10522,Ajmal-M-A,2,0.00023,159160,18.49016,860782
10523,ajs117,2,0.00023,159162,18.49040,860782
10524,A-Kamaee,2,0.00023,159164,18.49063,860782
10525,akan,2,0.00023,159166,18.49086,860782
10526,akanso,2,0.00023,159168,18.49109,860782
10527,AkarshES,2,0.00023,159170,18.49133,860782
10528,Akay7,2,0.00023,159172,18.49156,860782
10529,akehlenbeck,2,0.00023,159174,18.49179,860782
10530,akhfa,2,0.00023,159176,18.49202,860782
10531,akhmadfld,2,0.00023,159178,18.49225,860782
10532,akillcool,2,0.00023,159180,18.49249,860782
10533,Akinari1087,2,0.00023,159182,18.49272,860782
10534,aknakshay,2,0.00023,159184,18.49295,860782
10535,akohlislb,2,0.00023,159186,18.49318,860782
10536,akosma,2,0.00023,159188,18.49342,860782
10537,akostic-kostile,2,0.00023,159190,18.49365,860782
10538,akraitman,2,0.00023,159192,18.49388,860782
10539,akramwaseem,2,0.00023,159194,18.49411,860782
10540,aksgithub,2,0.00023,159196,18.49435,860782
10541,akshat-crypto,2,0.00023,159198,18.49458,860782
10542,akshathkaranam,2,0.00023,159200,18.49481,860782
10543,akshay071990,2,0.00023,159202,18.49504,860782
10544,akshaysu12,2,0.00023,159204,18.49528,860782
10545,aksika,2,0.00023,159206,18.49551,860782
10546,A-Kumpf,2,0.00023,159208,18.49574,860782
10547,akunszt,2,0.00023,159210,18.49597,860782
10548,akushsky,2,0.00023,159212,18.49620,860782
10549,al26p,2,0.00023,159214,18.49644,860782
10550,AlaaMansourTW,2,0.00023,159216,18.49667,860782
10551,alamintech,2,0.00023,159218,18.49690,860782
10552,alanisaac,2,0.00023,159220,18.49713,860782
10553,alanrellek,2,0.00023,159222,18.49737,860782
10554,alaudazzi,2,0.00023,159224,18.49760,860782
10555,Alb0t,2,0.00023,159226,18.49783,860782
10556,albachir,2,0.00023,159228,18.49806,860782
10557,albertmichaelj,2,0.00023,159230,18.49830,860782
10558,albertocorrales,2,0.00023,159232,18.49853,860782
10559,AlehB,2,0.00023,159234,18.49876,860782
10560,alejandrobonillamondragon,2,0.00023,159236,18.49899,860782
10561,aleksandrmelnikov,2,0.00023,159238,18.49923,860782
10562,aleksey-hariton,2,0.00023,159240,18.49946,860782
10563,AlekseyKalinin,2,0.00023,159242,18.49969,860782
10564,aleksf,2,0.00023,159244,18.49992,860782
10565,aleks-m,2,0.00023,159246,18.50015,860782
10566,alemonmk,2,0.00023,159248,18.50039,860782
10567,alenjursic1997,2,0.00023,159250,18.50062,860782
10568,alesgurd,2,0.00023,159252,18.50085,860782
10569,alesz,2,0.00023,159254,18.50108,860782
10570,alewitt2,2,0.00023,159256,18.50132,860782
10571,AlexanderChen1989,2,0.00023,159258,18.50155,860782
10572,alexandv,2,0.00023,159260,18.50178,860782
10573,alexbekir,2,0.00023,159262,18.50201,860782
10574,alexchiri,2,0.00023,159264,18.50225,860782
10575,alex-ferener,2,0.00023,159266,18.50248,860782
10576,alexgaganov-fiverr,2,0.00023,159268,18.50271,860782
10577,AlexHockey,2,0.00023,159270,18.50294,860782
10578,alexisalmeida,2,0.00023,159272,18.50318,860782
10579,AlexMikhalev,2,0.00023,159274,18.50341,860782
10580,alexmv,2,0.00023,159276,18.50364,860782
10581,alexpovel,2,0.00023,159278,18.50387,860782
10582,alexshtin,2,0.00023,159280,18.50410,860782
10583,AlexZalyalowa,2,0.00023,159282,18.50434,860782
10584,aliasmee,2,0.00023,159284,18.50457,860782
10585,alicekop,2,0.00023,159286,18.50480,860782
10586,AliMD,2,0.00023,159288,18.50503,860782
10587,alimirjahani7,2,0.00023,159290,18.50527,860782
10588,alireza1371,2,0.00023,159292,18.50550,860782
10589,aliusmiles,2,0.00023,159294,18.50573,860782
10590,AljoschaP,2,0.00023,159296,18.50596,860782
10591,alkoclick,2,0.00023,159298,18.50620,860782
10592,alk-rniveau,2,0.00023,159300,18.50643,860782
10593,AllaeddineEL,2,0.00023,159302,18.50666,860782
10594,allenmqcymp,2,0.00023,159304,18.50689,860782
10595,allx,2,0.00023,159306,18.50712,860782
10596,allyjweir,2,0.00023,159308,18.50736,860782
10597,Allyn69,2,0.00023,159310,18.50759,860782
10598,alok-anand1,2,0.00023,159312,18.50782,860782
10599,alphara,2,0.00023,159314,18.50805,860782
10600,alsuren,2,0.00023,159316,18.50829,860782
10601,altanai,2,0.00023,159318,18.50852,860782
10602,alxn,2,0.00023,159320,18.50875,860782
10603,amadav,2,0.00023,159322,18.50898,860782
10604,amadhaka,2,0.00023,159324,18.50922,860782
10605,amaheshwari21,2,0.00023,159326,18.50945,860782
10606,AmanMishra1321,2,0.00023,159328,18.50968,860782
10607,amanravi12,2,0.00023,159330,18.50991,860782
10608,amar1728,2,0.00023,159332,18.51015,860782
10609,amaraliou,2,0.00023,159334,18.51038,860782
10610,ameir,2,0.00023,159336,18.51061,860782
10611,amiller-gh,2,0.00023,159338,18.51084,860782
10612,amit23071982,2,0.00023,159340,18.51107,860782
10613,AmitBenAmi,2,0.00023,159342,18.51131,860782
10614,amitbhat-ct,2,0.00023,159344,18.51154,860782
10615,amitde69,2,0.00023,159346,18.51177,860782
10616,amithapa,2,0.00023,159348,18.51200,860782
10617,amitkrout,2,0.00023,159350,18.51224,860782
10618,amnk,2,0.00023,159352,18.51247,860782
10619,amon-ra,2,0.00023,159354,18.51270,860782
10620,Amoteamame,2,0.00023,159356,18.51293,860782
10621,am-oxipay,2,0.00023,159358,18.51317,860782
10622,amrragab8080,2,0.00023,159360,18.51340,860782
10623,amrynsky,2,0.00023,159362,18.51363,860782
10624,amukherj,2,0.00023,159364,18.51386,860782
10625,Amyth07,2,0.00023,159366,18.51410,860782
10626,anagha-microsoft,2,0.00023,159368,18.51433,860782
10627,analytically,2,0.00023,159370,18.51456,860782
10628,AnandhkumarTV,2,0.00023,159372,18.51479,860782
10629,anarcher,2,0.00023,159374,18.51502,860782
10630,anarwal,2,0.00023,159376,18.51526,860782
10631,anayrat,2,0.00023,159378,18.51549,860782
10632,anbern,2,0.00023,159380,18.51572,860782
10633,Anda-JasonSu,2,0.00023,159382,18.51595,860782
10634,anderspetersson,2,0.00023,159384,18.51619,860782
10635,andrealmar,2,0.00023,159386,18.51642,860782
10636,andreamaruccia,2,0.00023,159388,18.51665,860782
10637,AndreasKl,2,0.00023,159390,18.51688,860782
10638,andreaso,2,0.00023,159392,18.51712,860782
10639,andrecastro,2,0.00023,159394,18.51735,860782
10640,andreikom,2,0.00023,159396,18.51758,860782
10641,andrei-matei,2,0.00023,159398,18.51781,860782
10642,andrein,2,0.00023,159400,18.51805,860782
10643,AndresNamm,2,0.00023,159402,18.51828,860782
10644,Andrewangeta,2,0.00023,159404,18.51851,860782
10645,AndrewBoklashko,2,0.00023,159406,18.51874,860782
10646,andrewipmtl,2,0.00023,159408,18.51897,860782
10647,Andrewmatilde,2,0.00023,159410,18.51921,860782
10648,andrewmcguinness,2,0.00023,159412,18.51944,860782
10649,AndrewNeudegg,2,0.00023,159414,18.51967,860782
10650,AndrewWPhillips,2,0.00023,159416,18.51990,860782
10651,AndrewXWei,2,0.00023,159418,18.52014,860782
10652,andrijaperovic,2,0.00023,159420,18.52037,860782
10653,AndyAstrand,2,0.00023,159422,18.52060,860782
10654,andygikling,2,0.00023,159424,18.52083,860782
10655,AndyJS,2,0.00023,159426,18.52107,860782
10656,andyleap,2,0.00023,159428,18.52130,860782
10657,andywinslow,2,0.00023,159430,18.52153,860782
10658,angeloplsight,2,0.00023,159432,18.52176,860782
10659,angelotinho,2,0.00023,159434,18.52200,860782
10660,angelovopsan,2,0.00023,159436,18.52223,860782
10661,angryninja48,2,0.00023,159438,18.52246,860782
10662,angularsen,2,0.00023,159440,18.52269,860782
10663,anhuong,2,0.00023,159442,18.52292,860782
10664,anikafuchs,2,0.00023,159444,18.52316,860782
10665,anirtek,2,0.00023,159446,18.52339,860782
10666,anishakj,2,0.00023,159448,18.52362,860782
10667,Anishmourya,2,0.00023,159450,18.52385,860782
10668,anishshaw,2,0.00023,159452,18.52409,860782
10669,ankitgupta-ag,2,0.00023,159454,18.52432,860782
10670,ankitvgupta,2,0.00023,159456,18.52455,860782
10671,Ankur7890,2,0.00023,159458,18.52478,860782
10672,ankurnigam,2,0.00023,159460,18.52502,860782
10673,ankush-vijay,2,0.00023,159462,18.52525,860782
10674,anoop2503,2,0.00023,159464,18.52548,860782
10675,answerquest,2,0.00023,159466,18.52571,860782
10676,ant4ly,2,0.00023,159468,18.52595,860782
10677,AntoCanza,2,0.00023,159470,18.52618,860782
10678,AntoineRondelet,2,0.00023,159472,18.52641,860782
10679,AntoninCamus,2,0.00023,159474,18.52664,860782
10680,antonioberben,2,0.00023,159476,18.52687,860782
10681,antonLebiedyntsev,2,0.00023,159478,18.52711,860782
10682,anton-r,2,0.00023,159480,18.52734,860782
10683,antonsmelyanskiy,2,0.00023,159482,18.52757,860782
10684,anubhav-here,2,0.00023,159484,18.52780,860782
10685,anusricorp,2,0.00023,159486,18.52804,860782
10686,anxolerd,2,0.00023,159488,18.52827,860782
10687,aofekiko,2,0.00023,159490,18.52850,860782
10688,aoighost,2,0.00023,159492,18.52873,860782
10689,aparhatus,2,0.00023,159494,18.52897,860782
10690,apasrini,2,0.00023,159496,18.52920,860782
10691,aperkins1310,2,0.00023,159498,18.52943,860782
10692,appario,2,0.00023,159500,18.52966,860782
10693,appellod,2,0.00023,159502,18.52989,860782
10694,appfrilans,2,0.00023,159504,18.53013,860782
10695,a-prezioso,2,0.00023,159506,18.53036,860782
10696,APuertaSales,2,0.00023,159508,18.53059,860782
10697,apurvwagh,2,0.00023,159510,18.53082,860782
10698,aqw,2,0.00023,159512,18.53106,860782
10699,arcenik,2,0.00023,159514,18.53129,860782
10700,archichen,2,0.00023,159516,18.53152,860782
10701,archonic,2,0.00023,159518,18.53175,860782
10702,ardikabs,2,0.00023,159520,18.53199,860782
10703,aretakisv,2,0.00023,159522,18.53222,860782
10704,argha-c,2,0.00023,159524,18.53245,860782
10705,argos83,2,0.00023,159526,18.53268,860782
10706,argunasekhar,2,0.00023,159528,18.53292,860782
10707,arifwn,2,0.00023,159530,18.53315,860782
10708,arindam-bandyopadhyay,2,0.00023,159532,18.53338,860782
10709,arizvisa,2,0.00023,159534,18.53361,860782
10710,arjun228,2,0.00023,159536,18.53384,860782
10711,arjun921,2,0.00023,159538,18.53408,860782
10712,ar-mi6,2,0.00023,159540,18.53431,860782
10713,arminfelder,2,0.00023,159542,18.53454,860782
10714,arnediekmann,2,0.00023,159544,18.53477,860782
10715,arnitolog,2,0.00023,159546,18.53501,860782
10716,arnouthoebreckx,2,0.00023,159548,18.53524,860782
10717,aromalsbabu,2,0.00023,159550,18.53547,860782
10718,arontx,2,0.00023,159552,18.53570,860782
10719,aroramanish080282,2,0.00023,159554,18.53594,860782
10720,arpankapoor,2,0.00023,159556,18.53617,860782
10721,arranf,2,0.00023,159558,18.53640,860782
10722,ArseniiPetrovich,2,0.00023,159560,18.53663,860782
10723,arsoni20,2,0.00023,159562,18.53687,860782
10724,arteal,2,0.00023,159564,18.53710,860782
10725,artemvovk,2,0.00023,159566,18.53733,860782
10726,arthuryangcs,2,0.00023,159568,18.53756,860782
10727,arttolstykh,2,0.00023,159570,18.53779,860782
10728,arul24ar,2,0.00023,159572,18.53803,860782
10729,arul-gupta,2,0.00023,159574,18.53826,860782
10730,arunj78,2,0.00023,159576,18.53849,860782
10731,arvin6msd,2,0.00023,159578,18.53872,860782
10732,aryann,2,0.00023,159580,18.53896,860782
10733,arzarif,2,0.00023,159582,18.53919,860782
10734,as3445,2,0.00023,159584,18.53942,860782
10735,As9530272755,2,0.00023,159586,18.53965,860782
10736,asad-awadia,2,0.00023,159588,18.53989,860782
10737,asad-mahmood1,2,0.00023,159590,18.54012,860782
10738,aschleck,2,0.00023,159592,18.54035,860782
10739,Asem-AK,2,0.00023,159594,18.54058,860782
10740,aseovic,2,0.00023,159596,18.54082,860782
10741,asheynkmansafeguard,2,0.00023,159598,18.54105,860782
10742,ashleshmandke,2,0.00023,159600,18.54128,860782
10743,ashleywang1,2,0.00023,159602,18.54151,860782
10744,ashokspeelyaal,2,0.00023,159604,18.54174,860782
10745,AshRhazaly,2,0.00023,159606,18.54198,860782
10746,ashu82492,2,0.00023,159608,18.54221,860782
10747,ashwinidulams,2,0.00023,159610,18.54244,860782
10748,asingh16,2,0.00023,159612,18.54267,860782
10749,Asisranjan,2,0.00023,159614,18.54291,860782
10750,askya,2,0.00023,159616,18.54314,860782
10751,astha-jain,2,0.00023,159618,18.54337,860782
10752,a-teisseire,2,0.00023,159620,18.54360,860782
10753,atgaurav,2,0.00023,159622,18.54384,860782
10754,aTGuz,2,0.00023,159624,18.54407,860782
10755,atkrad,2,0.00023,159626,18.54430,860782
10756,attlee-wang,2,0.00023,159628,18.54453,860782
10757,attritionorg,2,0.00023,159630,18.54477,860782
10758,AtulDwivedi,2,0.00023,159632,18.54500,860782
10759,auduny,2,0.00023,159634,18.54523,860782
10760,augustoamormino,2,0.00023,159636,18.54546,860782
10761,austil,2,0.00023,159638,18.54569,860782
10762,AustinSchuh,2,0.00023,159640,18.54593,860782
10763,AustinSmart,2,0.00023,159642,18.54616,860782
10764,avadhut007,2,0.00023,159644,18.54639,860782
10765,avanier,2,0.00023,159646,18.54662,860782
10766,avaussant,2,0.00023,159648,18.54686,860782
10767,avbanks,2,0.00023,159650,18.54709,860782
10768,avbenavides,2,0.00023,159652,18.54732,860782
10769,avedpathak,2,0.00023,159654,18.54755,860782
10770,aviettran,2,0.00023,159656,18.54779,860782
10771,avinash92c,2,0.00023,159658,18.54802,860782
10772,avinashashukla,2,0.00023,159660,18.54825,860782
10773,AviorAlong,2,0.00023,159662,18.54848,860782
10774,AvivRubys,2,0.00023,159664,18.54872,860782
10775,avsej,2,0.00023,159666,18.54895,860782
10776,AWSNB,2,0.00023,159668,18.54918,860782
10777,axelsimon,2,0.00023,159670,18.54941,860782
10778,ax-meyer,2,0.00023,159672,18.54964,860782
10779,aychang95,2,0.00023,159674,18.54988,860782
10780,aydanjiwani,2,0.00023,159676,18.55011,860782
10781,aymenwerg,2,0.00023,159678,18.55034,860782
10782,aymericDD,2,0.00023,159680,18.55057,860782
10783,Ayush-Singhal28,2,0.00023,159682,18.55081,860782
10784,azalio,2,0.00023,159684,18.55104,860782
10785,az-iddouch,2,0.00023,159686,18.55127,860782
10786,B1XR11L729w583adTl5899556EJ5322a,2,0.00023,159688,18.55150,860782
10787,b8rq,2,0.00023,159690,18.55174,860782
10788,babakks,2,0.00023,159692,18.55197,860782
10789,babywaiting,2,0.00023,159694,18.55220,860782
10790,backkem,2,0.00023,159696,18.55243,860782
10791,backnotprop,2,0.00023,159698,18.55266,860782
10792,badakhgovind,2,0.00023,159700,18.55290,860782
10793,badaniya,2,0.00023,159702,18.55313,860782
10794,baikai,2,0.00023,159704,18.55336,860782
10795,balous,2,0.00023,159706,18.55359,860782
10796,baludba,2,0.00023,159708,18.55383,860782
10797,bansalrajat,2,0.00023,159710,18.55406,860782
10798,baolitoumu,2,0.00023,159712,18.55429,860782
10799,barnettZQG,2,0.00023,159714,18.55452,860782
10800,BarnumD,2,0.00023,159716,18.55476,860782
10801,BarrieShieh,2,0.00023,159718,18.55499,860782
10802,basroovers,2,0.00023,159720,18.55522,860782
10803,BassinD,2,0.00023,159722,18.55545,860782
10804,basu-ntnx,2,0.00023,159724,18.55569,860782
10805,battlemidget,2,0.00023,159726,18.55592,860782
10806,bbdtsof,2,0.00023,159728,18.55615,860782
10807,bbehnke,2,0.00023,159730,18.55638,860782
10808,BBenni,2,0.00023,159732,18.55661,860782
10809,bbhenry,2,0.00023,159734,18.55685,860782
10810,bbhupati,2,0.00023,159736,18.55708,860782
10811,bbkgh,2,0.00023,159738,18.55731,860782
10812,bbqtk,2,0.00023,159740,18.55754,860782
10813,bbyrne5,2,0.00023,159742,18.55778,860782
10814,bcorrigeux,2,0.00023,159744,18.55801,860782
10815,BcTpe4HbIu,2,0.00023,159746,18.55824,860782
10816,bdlb77,2,0.00023,159748,18.55847,860782
10817,BechirLandolsi,2,0.00023,159750,18.55871,860782
10818,beelzbozo,2,0.00023,159752,18.55894,860782
10819,behradanalui,2,0.00023,159754,18.55917,860782
10820,belemaire,2,0.00023,159756,18.55940,860782
10821,belo82,2,0.00023,159758,18.55964,860782
10822,ben-arnold-dbs,2,0.00023,159760,18.55987,860782
10823,benfen,2,0.00023,159762,18.56010,860782
10824,benhackett4,2,0.00023,159764,18.56033,860782
10825,benjaminguttmann-avtq,2,0.00023,159766,18.56056,860782
10826,bennycooly,2,0.00023,159768,18.56080,860782
10827,Bennyweasl,2,0.00023,159770,18.56103,860782
10828,bensimian,2,0.00023,159772,18.56126,860782
10829,benvdh,2,0.00023,159774,18.56149,860782
10830,Benwa-98,2,0.00023,159776,18.56173,860782
10831,benyanke,2,0.00023,159778,18.56196,860782
10832,beregon87,2,0.00023,159780,18.56219,860782
10833,bergur88,2,0.00023,159782,18.56242,860782
10834,bertbesser,2,0.00023,159784,18.56266,860782
10835,bert-laverman,2,0.00023,159786,18.56289,860782
10836,beyondexp,2,0.00023,159788,18.56312,860782
10837,BFrancisA,2,0.00023,159790,18.56335,860782
10838,bfznj,2,0.00023,159792,18.56359,860782
10839,bhandari8sujit,2,0.00023,159794,18.56382,860782
10840,bharatnc,2,0.00023,159796,18.56405,860782
10841,Bhard27,2,0.00023,159798,18.56428,860782
10842,bhartshorn,2,0.00023,159800,18.56451,860782
10843,bhavenjp,2,0.00023,159802,18.56475,860782
10844,bhiggins,2,0.00023,159804,18.56498,860782
10845,bhvishal9,2,0.00023,159806,18.56521,860782
10846,bibarrav,2,0.00023,159808,18.56544,860782
10847,biello,2,0.00023,159810,18.56568,860782
10848,BigeYoung,2,0.00023,159812,18.56591,860782
10849,bigon,2,0.00023,159814,18.56614,860782
10850,Billy99,2,0.00023,159816,18.56637,860782
10851,BillZong,2,0.00023,159818,18.56661,860782
10852,bimalvasan,2,0.00023,159820,18.56684,860782
10853,BinacsLee,2,0.00023,159822,18.56707,860782
10854,binaryfire,2,0.00023,159824,18.56730,860782
10855,binboum,2,0.00023,159826,18.56754,860782
10856,binititpro,2,0.00023,159828,18.56777,860782
10857,Binyang2014,2,0.00023,159830,18.56800,860782
10858,biohazd,2,0.00023,159832,18.56823,860782
10859,biqas,2,0.00023,159834,18.56846,860782
10860,Birdrock,2,0.00023,159836,18.56870,860782
10861,birmogave87,2,0.00023,159838,18.56893,860782
10862,Biswajitghosh98,2,0.00023,159840,18.56916,860782
10863,BitProcessor,2,0.00023,159842,18.56939,860782
10864,BitRacer,2,0.00023,159844,18.56963,860782
10865,biyanisuraj,2,0.00023,159846,18.56986,860782
10866,bjaglin,2,0.00023,159848,18.57009,860782
10867,bjoernw,2,0.00023,159850,18.57032,860782
10868,bkietz,2,0.00023,159852,18.57056,860782
10869,bkruger99,2,0.00023,159854,18.57079,860782
10870,BlackBsd,2,0.00023,159856,18.57102,860782
10871,blake-mealey,2,0.00023,159858,18.57125,860782
10872,blazhemitrev,2,0.00023,159860,18.57148,860782
10873,Bleoo,2,0.00023,159862,18.57172,860782
10874,blhagadorn,2,0.00023,159864,18.57195,860782
10875,BlindedByTheLight,2,0.00023,159866,18.57218,860782
10876,blockspacer,2,0.00023,159868,18.57241,860782
10877,BlueCrescent,2,0.00023,159870,18.57265,860782
10878,Bluesboy,2,0.00023,159872,18.57288,860782
10879,Blunderchips,2,0.00023,159874,18.57311,860782
10880,bmalynovytch,2,0.00023,159876,18.57334,860782
10881,bmarinov,2,0.00023,159878,18.57358,860782
10882,bnerd,2,0.00023,159880,18.57381,860782
10883,bneumann,2,0.00023,159882,18.57404,860782
10884,bnoeson,2,0.00023,159884,18.57427,860782
10885,bobo333,2,0.00023,159886,18.57451,860782
10886,BobVanB,2,0.00023,159888,18.57474,860782
10887,bobvanderlinden,2,0.00023,159890,18.57497,860782
10888,bochencwx,2,0.00023,159892,18.57520,860782
10889,bochuxt,2,0.00023,159894,18.57543,860782
10890,bodgit,2,0.00023,159896,18.57567,860782
10891,bodom0015,2,0.00023,159898,18.57590,860782
10892,bodote,2,0.00023,159900,18.57613,860782
10893,bogdaniel,2,0.00023,159902,18.57636,860782
10894,bogn83,2,0.00023,159904,18.57660,860782
10895,bogue1979,2,0.00023,159906,18.57683,860782
10896,bolthar,2,0.00023,159908,18.57706,860782
10897,bolt-juri-gavshin,2,0.00023,159910,18.57729,860782
10898,Bonjour123,2,0.00023,159912,18.57753,860782
10899,Bonjunior,2,0.00023,159914,18.57776,860782
10900,boopathykpm,2,0.00023,159916,18.57799,860782
10901,boostrack,2,0.00023,159918,18.57822,860782
10902,bo-quan,2,0.00023,159920,18.57846,860782
10903,borigas,2,0.00023,159922,18.57869,860782
10904,BoTranVan,2,0.00023,159924,18.57892,860782
10905,bourbonkk,2,0.00023,159926,18.57915,860782
10906,BoVice,2,0.00023,159928,18.57938,860782
10907,bowang-666,2,0.00023,159930,18.57962,860782
10908,bpaduch,2,0.00023,159932,18.57985,860782
10909,Br0wnHammer,2,0.00023,159934,18.58008,860782
10910,brackendawson,2,0.00023,159936,18.58031,860782
10911,bradfordcp,2,0.00023,159938,18.58055,860782
10912,bradjones1,2,0.00023,159940,18.58078,860782
10913,brainbug95,2,0.00023,159942,18.58101,860782
10914,brainwane,2,0.00023,159944,18.58124,860782
10915,bramvdklinkenberg,2,0.00023,159946,18.58148,860782
10916,brandonrising,2,0.00023,159948,18.58171,860782
10917,bratao,2,0.00023,159950,18.58194,860782
10918,breakboyandre,2,0.00023,159952,18.58217,860782
10919,brechtvalcke,2,0.00023,159954,18.58241,860782
10920,brendanstennett,2,0.00023,159956,18.58264,860782
10921,brennerm,2,0.00023,159958,18.58287,860782
10922,BrentChesny,2,0.00023,159960,18.58310,860782
10923,brentcklein,2,0.00023,159962,18.58333,860782
10924,BrentonWatt,2,0.00023,159964,18.58357,860782
10925,brettcurtis,2,0.00023,159966,18.58380,860782
10926,brettplarson,2,0.00023,159968,18.58403,860782
10927,brianrodecap,2,0.00023,159970,18.58426,860782
10928,brichins,2,0.00023,159972,18.58450,860782
10929,bridgewaterrobbie,2,0.00023,159974,18.58473,860782
10930,bringking,2,0.00023,159976,18.58496,860782
10931,britoaldan,2,0.00023,159978,18.58519,860782
10932,brumhard,2,0.00023,159980,18.58543,860782
10933,BrunoCode,2,0.00023,159982,18.58566,860782
10934,brunojcm,2,0.00023,159984,18.58589,860782
10935,brunswyck,2,0.00023,159986,18.58612,860782
10936,bryanisgreat,2,0.00023,159988,18.58636,860782
10937,Bryji,2,0.00023,159990,18.58659,860782
10938,bshishir,2,0.00023,159992,18.58682,860782
10939,bsquizz,2,0.00023,159994,18.58705,860782
10940,btbensoft,2,0.00023,159996,18.58728,860782
10941,buccella,2,0.00023,159998,18.58752,860782
10942,bufferx,2,0.00023,160000,18.58775,860782
10943,buggithubs,2,0.00023,160002,18.58798,860782
10944,bukito-ops,2,0.00023,160004,18.58821,860782
10945,buro9,2,0.00023,160006,18.58845,860782
10946,burtlo,2,0.00023,160008,18.58868,860782
10947,buzz-b,2,0.00023,160010,18.58891,860782
10948,bvandorf,2,0.00023,160012,18.58914,860782
10949,bvanelli,2,0.00023,160014,18.58938,860782
10950,bverschueren,2,0.00023,160016,18.58961,860782
10951,bwolfehcm,2,0.00023,160018,18.58984,860782
10952,by-maxx,2,0.00023,160020,18.59007,860782
10953,byue22,2,0.00023,160022,18.59031,860782
10954,c0ffeec0der,2,0.00023,160024,18.59054,860782
10955,c16a,2,0.00023,160026,18.59077,860782
10956,ca6a,2,0.00023,160028,18.59100,860782
10957,caboteria,2,0.00023,160030,18.59123,860782
10958,cadaats,2,0.00023,160032,18.59147,860782
10959,caffeinum,2,0.00023,160034,18.59170,860782
10960,caiconkhicon,2,0.00023,160036,18.59193,860782
10961,caixiangyue,2,0.00023,160038,18.59216,860782
10962,cakoose,2,0.00023,160040,18.59240,860782
10963,caleb15,2,0.00023,160042,18.59263,860782
10964,calerogers,2,0.00023,160044,18.59286,860782
10965,CAlexPac,2,0.00023,160046,18.59309,860782
10966,caliburn1994,2,0.00023,160048,18.59333,860782
10967,callicles,2,0.00023,160050,18.59356,860782
10968,Callie8909,2,0.00023,160052,18.59379,860782
10969,camgab,2,0.00023,160054,18.59402,860782
10970,campbel,2,0.00023,160056,18.59425,860782
10971,canozyurt,2,0.00023,160058,18.59449,860782
10972,caozhiyuan,2,0.00023,160060,18.59472,860782
10973,capnspacehook,2,0.00023,160062,18.59495,860782
10974,captncraig,2,0.00023,160064,18.59518,860782
10975,Cariaga,2,0.00023,160066,18.59542,860782
10976,caribru,2,0.00023,160068,18.59565,860782
10977,carlbraganza,2,0.00023,160070,18.59588,860782
10978,CarloColumna,2,0.00023,160072,18.59611,860782
10979,carlo-nomes,2,0.00023,160074,18.59635,860782
10980,carlosadean,2,0.00023,160076,18.59658,860782
10981,carlosreyna-bread,2,0.00023,160078,18.59681,860782
10982,carlwoodhouse,2,0.00023,160080,18.59704,860782
10983,case,2,0.00023,160082,18.59728,860782
10984,casperisfine,2,0.00023,160084,18.59751,860782
10985,CasperLiu,2,0.00023,160086,18.59774,860782
10986,cassandracomar,2,0.00023,160088,18.59797,860782
10987,cayla,2,0.00023,160090,18.59820,860782
10988,CBiX,2,0.00023,160092,18.59844,860782
10989,cbrisket,2,0.00023,160094,18.59867,860782
10990,CBytelabs,2,0.00023,160096,18.59890,860782
10991,ccjjxx99,2,0.00023,160098,18.59913,860782
10992,cctv86,2,0.00023,160100,18.59937,860782
10993,c-dante,2,0.00023,160102,18.59960,860782
10994,cdever,2,0.00023,160104,18.59983,860782
10995,cdlliuy,2,0.00023,160106,18.60006,860782
10996,cdyue,2,0.00023,160108,18.60030,860782
10997,celestialorb,2,0.00023,160110,18.60053,860782
10998,cerebrate,2,0.00023,160112,18.60076,860782
10999,cevian,2,0.00023,160114,18.60099,860782
11000,cg-adam,2,0.00023,160116,18.60123,860782
11001,cgiraldo,2,0.00023,160118,18.60146,860782
11002,cgrant,2,0.00023,160120,18.60169,860782
11003,cgulseni,2,0.00023,160122,18.60192,860782
11004,chadleeshaw,2,0.00023,160124,18.60215,860782
11005,chai-nadig,2,0.00023,160126,18.60239,860782
11006,chainhead,2,0.00023,160128,18.60262,860782
11007,challett,2,0.00023,160130,18.60285,860782
11008,changkun,2,0.00023,160132,18.60308,860782
11009,changqing98,2,0.00023,160134,18.60332,860782
11010,ChangSurrey,2,0.00023,160136,18.60355,860782
11011,chanhz,2,0.00023,160138,18.60378,860782
11012,chan-maddanna,2,0.00023,160140,18.60401,860782
11013,chaospuppy,2,0.00023,160142,18.60425,860782
11014,charandas,2,0.00023,160144,18.60448,860782
11015,charlesdee,2,0.00023,160146,18.60471,860782
11016,chattarajoy,2,0.00023,160148,18.60494,860782
11017,cheeye,2,0.00023,160150,18.60518,860782
11018,chenchunxiu,2,0.00023,160152,18.60541,860782
11019,chen-ding-airbnb,2,0.00023,160154,18.60564,860782
11020,cheneyzhao,2,0.00023,160156,18.60587,860782
11021,chengtong321,2,0.00023,160158,18.60610,860782
11022,chenjie222,2,0.00023,160160,18.60634,860782
11023,chenweiqiang7777,2,0.00023,160162,18.60657,860782
11024,chenxianpao,2,0.00023,160164,18.60680,860782
11025,chenyosef,2,0.00023,160166,18.60703,860782
11026,chenyw1990,2,0.00023,160168,18.60727,860782
11027,cherryland,2,0.00023,160170,18.60750,860782
11028,chetan-styra,2,0.00023,160172,18.60773,860782
11029,chetas411,2,0.00023,160174,18.60796,860782
11030,chicken231,2,0.00023,160176,18.60820,860782
11031,ChillarAnand,2,0.00023,160178,18.60843,860782
11032,chinedufn,2,0.00023,160180,18.60866,860782
11033,chinmay90kulkarni,2,0.00023,160182,18.60889,860782
11034,chinthakagodawita,2,0.00023,160184,18.60913,860782
11035,chiragtayal,2,0.00023,160186,18.60936,860782
11036,chiru091096,2,0.00023,160188,18.60959,860782
11037,cho45,2,0.00023,160190,18.60982,860782
11038,chorus12,2,0.00023,160192,18.61005,860782
11039,chowarth123,2,0.00023,160194,18.61029,860782
11040,CH-rahulprabhu,2,0.00023,160196,18.61052,860782
11041,chris-angeli-rft,2,0.00023,160198,18.61075,860782
11042,chrisbu,2,0.00023,160200,18.61098,860782
11043,ChrisCooney1,2,0.00023,160202,18.61122,860782
11044,chrisdone,2,0.00023,160204,18.61145,860782
11045,chrisfairc,2,0.00023,160206,18.61168,860782
11046,chrishepner,2,0.00023,160208,18.61191,860782
11047,chris-morandi,2,0.00023,160210,18.61215,860782
11048,chrisrossi,2,0.00023,160212,18.61238,860782
11049,chris-str-cst,2,0.00023,160214,18.61261,860782
11050,christarazi,2,0.00023,160216,18.61284,860782
11051,christinepuk,2,0.00023,160218,18.61308,860782
11052,christming,2,0.00023,160220,18.61331,860782
11053,christopappas,2,0.00023,160222,18.61354,860782
11054,Chrisupbound,2,0.00023,160224,18.61377,860782
11055,chriswue,2,0.00023,160226,18.61400,860782
11056,chrko,2,0.00023,160228,18.61424,860782
11057,chrvo,2,0.00023,160230,18.61447,860782
11058,chtcil,2,0.00023,160232,18.61470,860782
11059,chuansuo12,2,0.00023,160234,18.61493,860782
11060,chubirka,2,0.00023,160236,18.61517,860782
11061,chulup,2,0.00023,160238,18.61540,860782
11062,ChuntaoLu,2,0.00023,160240,18.61563,860782
11063,Chuongv,2,0.00023,160242,18.61586,860782
11064,chwzr,2,0.00023,160244,18.61610,860782
11065,chyroc,2,0.00023,160246,18.61633,860782
11066,ciaranRoche,2,0.00023,160248,18.61656,860782
11067,cifranix,2,0.00023,160250,18.61679,860782
11068,cigrainger,2,0.00023,160252,18.61702,860782
11069,cin,2,0.00023,160254,18.61726,860782
11070,cjroebuck,2,0.00023,160256,18.61749,860782
11071,ckanner,2,0.00023,160258,18.61772,860782
11072,ckdarby,2,0.00023,160260,18.61795,860782
11073,clebio,2,0.00023,160262,18.61819,860782
11074,clhain,2,0.00023,160264,18.61842,860782
11075,click2cloud-vivekg,2,0.00023,160266,18.61865,860782
11076,CloudAndContainer,2,0.00023,160268,18.61888,860782
11077,clrxbl,2,0.00023,160270,18.61912,860782
11078,cmars,2,0.00023,160272,18.61935,860782
11079,cmcga1125,2,0.00023,160274,18.61958,860782
11080,cmenzi,2,0.00023,160276,18.61981,860782
11081,cmillani,2,0.00023,160278,18.62005,860782
11082,cmlfxz,2,0.00023,160280,18.62028,860782
11083,cmontemuino,2,0.00023,160282,18.62051,860782
11084,cmsxbc,2,0.00023,160284,18.62074,860782
11085,CMYanko,2,0.00023,160286,18.62097,860782
11086,cnmcavoy,2,0.00023,160288,18.62121,860782
11087,cocoztho000,2,0.00023,160290,18.62144,860782
11088,code4free,2,0.00023,160292,18.62167,860782
11089,code871,2,0.00023,160294,18.62190,860782
11090,codeandqa,2,0.00023,160296,18.62214,860782
11091,codeanyway11,2,0.00023,160298,18.62237,860782
11092,codemanufaktur,2,0.00023,160300,18.62260,860782
11093,codeMingo,2,0.00023,160302,18.62283,860782
11094,codenoid,2,0.00023,160304,18.62307,860782
11095,codinl,2,0.00023,160306,18.62330,860782
11096,cohadar,2,0.00023,160308,18.62353,860782
11097,coldpenguin,2,0.00023,160310,18.62376,860782
11098,colinrymer,2,0.00023,160312,18.62400,860782
11099,collardmsc,2,0.00023,160314,18.62423,860782
11100,connorearl,2,0.00023,160316,18.62446,860782
11101,continuum-pooja,2,0.00023,160318,18.62469,860782
11102,coodie,2,0.00023,160320,18.62492,860782
11103,CoolDarran,2,0.00023,160322,18.62516,860782
11104,corburn,2,0.00023,160324,18.62539,860782
11105,CorentinHache,2,0.00023,160326,18.62562,860782
11106,coreyoconnor,2,0.00023,160328,18.62585,860782
11107,Corey-Wang,2,0.00023,160330,18.62609,860782
11108,corpix,2,0.00023,160332,18.62632,860782
11109,coryvirok,2,0.00023,160334,18.62655,860782
11110,cosborne83,2,0.00023,160336,18.62678,860782
11111,costap,2,0.00023,160338,18.62702,860782
11112,cotej,2,0.00023,160340,18.62725,860782
11113,coversb,2,0.00023,160342,18.62748,860782
11114,cpmoore,2,0.00023,160344,18.62771,860782
11115,cpxPratik,2,0.00023,160346,18.62795,860782
11116,craigcabrey,2,0.00023,160348,18.62818,860782
11117,crazy-canux,2,0.00023,160350,18.62841,860782
11118,Crazyscorpio88,2,0.00023,160352,18.62864,860782
11119,crazytera,2,0.00023,160354,18.62887,860782
11120,crazytom1988,2,0.00023,160356,18.62911,860782
11121,Creek-Shi,2,0.00023,160358,18.62934,860782
11122,crimpyhead,2,0.00023,160360,18.62957,860782
11123,cristaloleg,2,0.00023,160362,18.62980,860782
11124,cryptoluks,2,0.00023,160364,18.63004,860782
11125,cscareerkaizen,2,0.00023,160366,18.63027,860782
11126,csh995426531,2,0.00023,160368,18.63050,860782
11127,csi21,2,0.00023,160370,18.63073,860782
11128,cslanjian,2,0.00023,160372,18.63097,860782
11129,csonp,2,0.00023,160374,18.63120,860782
11130,c-stefan,2,0.00023,160376,18.63143,860782
11131,c-stoeckl,2,0.00023,160378,18.63166,860782
11132,cswatt,2,0.00023,160380,18.63190,860782
11133,cswinter,2,0.00023,160382,18.63213,860782
11134,ctalledo,2,0.00023,160384,18.63236,860782
11135,cthumuluru,2,0.00023,160386,18.63259,860782
11136,ctr06,2,0.00023,160388,18.63282,860782
11137,ctrahey,2,0.00023,160390,18.63306,860782
11138,ctrysbita,2,0.00023,160392,18.63329,860782
11139,cuonglm,2,0.00023,160394,18.63352,860782
11140,cuprumpea,2,0.00023,160396,18.63375,860782
11141,curio77,2,0.00023,160398,18.63399,860782
11142,CurtisFu,2,0.00023,160400,18.63422,860782
11143,cutdir,2,0.00023,160402,18.63445,860782
11144,cvernooy23,2,0.00023,160404,18.63468,860782
11145,CvR42,2,0.00023,160406,18.63492,860782
11146,cwegener,2,0.00023,160408,18.63515,860782
11147,c-x-berger,2,0.00023,160410,18.63538,860782
11148,Cyanopus,2,0.00023,160412,18.63561,860782
11149,cyberco,2,0.00023,160414,18.63585,860782
11150,cyberrecon,2,0.00023,160416,18.63608,860782
11151,cyrilix,2,0.00023,160418,18.63631,860782
11152,czheng94,2,0.00023,160420,18.63654,860782
11153,czuares,2,0.00023,160422,18.63677,860782
11154,d1egoaz,2,0.00023,160424,18.63701,860782
11155,dablyo,2,0.00023,160426,18.63724,860782
11156,dacamp,2,0.00023,160428,18.63747,860782
11157,dacodas,2,0.00023,160430,18.63770,860782
11158,dacruz21,2,0.00023,160432,18.63794,860782
11159,dahateb,2,0.00023,160434,18.63817,860782
11160,daheige,2,0.00023,160436,18.63840,860782
11161,daicang,2,0.00023,160438,18.63863,860782
11162,daikikatsuragawa,2,0.00023,160440,18.63887,860782
11163,DaInco,2,0.00023,160442,18.63910,860782
11164,dalekurt,2,0.00023,160444,18.63933,860782
11165,daloulou,2,0.00023,160446,18.63956,860782
11166,DamienBuhl-EH,2,0.00023,160448,18.63979,860782
11167,damozhiying,2,0.00023,160450,18.64003,860782
11168,damscott,2,0.00023,160452,18.64026,860782
11169,dan1el,2,0.00023,160454,18.64049,860782
11170,danackerson,2,0.00023,160456,18.64072,860782
11171,danboucher78,2,0.00023,160458,18.64096,860782
11172,danc,2,0.00023,160460,18.64119,860782
11173,dandosi,2,0.00023,160462,18.64142,860782
11174,dangelm,2,0.00023,160464,18.64165,860782
11175,DanHartman,2,0.00023,160466,18.64189,860782
11176,danibeca,2,0.00023,160468,18.64212,860782
11177,DaniDD,2,0.00023,160470,18.64235,860782
11178,DanielDent,2,0.00023,160472,18.64258,860782
11179,danieldn,2,0.00023,160474,18.64282,860782
11180,danielepo,2,0.00023,160476,18.64305,860782
11181,danielhanold,2,0.00023,160478,18.64328,860782
11182,daniellin215,2,0.00023,160480,18.64351,860782
11183,danielmai,2,0.00023,160482,18.64374,860782
11184,danielmellado,2,0.00023,160484,18.64398,860782
11185,danielo515,2,0.00023,160486,18.64421,860782
11186,DanielOstovary,2,0.00023,160488,18.64444,860782
11187,danielsand,2,0.00023,160490,18.64467,860782
11188,danielwegener,2,0.00023,160492,18.64491,860782
11189,danishkamili,2,0.00023,160494,18.64514,860782
11190,dankegel,2,0.00023,160496,18.64537,860782
11191,danmutblix,2,0.00023,160498,18.64560,860782
11192,dannym1986,2,0.00023,160500,18.64584,860782
11193,dano0b,2,0.00023,160502,18.64607,860782
11194,danoso10,2,0.00023,160504,18.64630,860782
11195,dantinr,2,0.00023,160506,18.64653,860782
11196,danwey,2,0.00023,160508,18.64677,860782
11197,daparthi001,2,0.00023,160510,18.64700,860782
11198,dar9468,2,0.00023,160512,18.64723,860782
11199,darioielardi,2,0.00023,160514,18.64746,860782
11200,darkdefender27,2,0.00023,160516,18.64769,860782
11201,darksinge,2,0.00023,160518,18.64793,860782
11202,daroga0002,2,0.00023,160520,18.64816,860782
11203,darren-steven,2,0.00023,160522,18.64839,860782
11204,DarthVader2409,2,0.00023,160524,18.64862,860782
11205,das7pad,2,0.00023,160526,18.64886,860782
11206,dashed,2,0.00023,160528,18.64909,860782
11207,dataplex,2,0.00023,160530,18.64932,860782
11208,DaveTorbeck,2,0.00023,160532,18.64955,860782
11209,davewongillies,2,0.00023,160534,18.64979,860782
11210,davidbyng,2,0.00023,160536,18.65002,860782
11211,davidcmitchell,2,0.00023,160538,18.65025,860782
11212,daviddetorres,2,0.00023,160540,18.65048,860782
11213,daviddyball,2,0.00023,160542,18.65072,860782
11214,davidgfolch,2,0.00023,160544,18.65095,860782
11215,davidh83110,2,0.00023,160546,18.65118,860782
11216,david-martyn-ford,2,0.00023,160548,18.65141,860782
11217,davidmogar,2,0.00023,160550,18.65164,860782
11218,davidnortonjr-sps,2,0.00023,160552,18.65188,860782
11219,davidparks21,2,0.00023,160554,18.65211,860782
11220,davidq2q,2,0.00023,160556,18.65234,860782
11221,davidshen84,2,0.00023,160558,18.65257,860782
11222,DavidWHarvey,2,0.00023,160560,18.65281,860782
11223,davies,2,0.00023,160562,18.65304,860782
11224,davissp14,2,0.00023,160564,18.65327,860782
11225,davwilliams,2,0.00023,160566,18.65350,860782
11226,DaytonG,2,0.00023,160568,18.65374,860782
11227,dazdaz,2,0.00023,160570,18.65397,860782
11228,dbecher-ito,2,0.00023,160572,18.65420,860782
11229,dbenoit17,2,0.00023,160574,18.65443,860782
11230,dberkov,2,0.00023,160576,18.65467,860782
11231,dblate,2,0.00023,160578,18.65490,860782
11232,DBosley,2,0.00023,160580,18.65513,860782
11233,dconger,2,0.00023,160582,18.65536,860782
11234,dctrwatson,2,0.00023,160584,18.65559,860782
11235,ddelange,2,0.00023,160586,18.65583,860782
11236,ddl-retornam,2,0.00023,160588,18.65606,860782
11237,dds-pwr,2,0.00023,160590,18.65629,860782
11238,DeanJain,2,0.00023,160592,18.65652,860782
11239,deanljohnson,2,0.00023,160594,18.65676,860782
11240,DeathBorn,2,0.00023,160596,18.65699,860782
11241,debjitk,2,0.00023,160598,18.65722,860782
11242,dedyyyy,2,0.00023,160600,18.65745,860782
11243,deepakrusia123,2,0.00023,160602,18.65769,860782
11244,deepakthaman,2,0.00023,160604,18.65792,860782
11245,deepayr,2,0.00023,160606,18.65815,860782
11246,defutian,2,0.00023,160608,18.65838,860782
11247,deigolocco,2,0.00023,160610,18.65862,860782
11248,dejo1307,2,0.00023,160612,18.65885,860782
11249,deliahu,2,0.00023,160614,18.65908,860782
11250,dElogics,2,0.00023,160616,18.65931,860782
11251,delphe,2,0.00023,160618,18.65954,860782
11252,delulu,2,0.00023,160620,18.65978,860782
11253,den3yx,2,0.00023,160622,18.66001,860782
11254,den-gts,2,0.00023,160624,18.66024,860782
11255,Deniallugo,2,0.00023,160626,18.66047,860782
11256,dennisjac,2,0.00023,160628,18.66071,860782
11257,dennyac,2,0.00023,160630,18.66094,860782
11258,deploymentking,2,0.00023,160632,18.66117,860782
11259,derektumulak,2,0.00023,160634,18.66140,860782
11260,deric,2,0.00023,160636,18.66164,860782
11261,desember,2,0.00023,160638,18.66187,860782
11262,despondency,2,0.00023,160640,18.66210,860782
11263,devdatta-m,2,0.00023,160642,18.66233,860782
11264,devgig,2,0.00023,160644,18.66256,860782
11265,devglrd,2,0.00023,160646,18.66280,860782
11266,devopsjonas,2,0.00023,160648,18.66303,860782
11267,DevsAnon,2,0.00023,160650,18.66326,860782
11268,devSolo,2,0.00023,160652,18.66349,860782
11269,dewanymca,2,0.00023,160654,18.66373,860782
11270,dfernandeza,2,0.00023,160656,18.66396,860782
11271,dhananjaya-senanayake,2,0.00023,160658,18.66419,860782
11272,dhaneesht,2,0.00023,160660,18.66442,860782
11273,dheerajpala,2,0.00023,160662,18.66466,860782
11274,dhoard,2,0.00023,160664,18.66489,860782
11275,diandiankou,2,0.00023,160666,18.66512,860782
11276,Diaoul,2,0.00023,160668,18.66535,860782
11277,dictcp,2,0.00023,160670,18.66559,860782
11278,DiegoLelis,2,0.00023,160672,18.66582,860782
11279,diegoroccia,2,0.00023,160674,18.66605,860782
11280,diem12315,2,0.00023,160676,18.66628,860782
11281,diestrin,2,0.00023,160678,18.66651,860782
11282,digaobarbosa,2,0.00023,160680,18.66675,860782
11283,digiserg,2,0.00023,160682,18.66698,860782
11284,digitalassembly,2,0.00023,160684,18.66721,860782
11285,DigitaMind,2,0.00023,160686,18.66744,860782
11286,dileekafernando,2,0.00023,160688,18.66768,860782
11287,dileepkeeppalli,2,0.00023,160690,18.66791,860782
11288,dileep-p,2,0.00023,160692,18.66814,860782
11289,DimitrijeManic,2,0.00023,160694,18.66837,860782
11290,dinesh,2,0.00023,160696,18.66861,860782
11291,dineshg24,2,0.00023,160698,18.66884,860782
11292,dingchenghong,2,0.00023,160700,18.66907,860782
11293,dinigo,2,0.00023,160702,18.66930,860782
11294,diraol,2,0.00023,160704,18.66954,860782
11295,dirien,2,0.00023,160706,18.66977,860782
11296,dirtbag,2,0.00023,160708,18.67000,860782
11297,Dishwasha,2,0.00023,160710,18.67023,860782
11298,divramod,2,0.00023,160712,18.67046,860782
11299,Djabx,2,0.00023,160714,18.67070,860782
11300,DjangoCalendar,2,0.00023,160716,18.67093,860782
11301,djboris9,2,0.00023,160718,18.67116,860782
11302,djj0809,2,0.00023,160720,18.67139,860782
11303,djkormo,2,0.00023,160722,18.67163,860782
11304,djschnei21,2,0.00023,160724,18.67186,860782
11305,dk-do,2,0.00023,160726,18.67209,860782
11306,dkhode,2,0.00023,160728,18.67232,860782
11307,d-kuhn,2,0.00023,160730,18.67256,860782
11308,dkwakkel,2,0.00023,160732,18.67279,860782
11309,dlabaj,2,0.00023,160734,18.67302,860782
11310,dlunch,2,0.00023,160736,18.67325,860782
11311,dmichel1,2,0.00023,160738,18.67349,860782
11312,dmikusa-pivotal,2,0.00023,160740,18.67372,860782
11313,dmitrii-clarifai,2,0.00023,160742,18.67395,860782
11314,Dmitry1987,2,0.00023,160744,18.67418,860782
11315,dmitrydiavita,2,0.00023,160746,18.67441,860782
11316,DmitryZayats,2,0.00023,160748,18.67465,860782
11317,dmoiseenko,2,0.00023,160750,18.67488,860782
11318,dmuir-g,2,0.00023,160752,18.67511,860782
11319,dnalborczyk,2,0.00023,160754,18.67534,860782
11320,dnbllglm,2,0.00023,160756,18.67558,860782
11321,dnix101,2,0.00023,160758,18.67581,860782
11322,doblerh,2,0.00023,160760,18.67604,860782
11323,doctornkz,2,0.00023,160762,18.67627,860782
11324,Domini,2,0.00023,160764,18.67651,860782
11325,domrod,2,0.00023,160766,18.67674,860782
11326,Donald-Sysdig,2,0.00023,160768,18.67697,860782
11327,dongzerun,2,0.00023,160770,18.67720,860782
11328,DonPerera,2,0.00023,160772,18.67744,860782
11329,DonSchenck,2,0.00023,160774,18.67767,860782
11330,dontmint,2,0.00023,160776,18.67790,860782
11331,DorianRoos,2,0.00023,160778,18.67813,860782
11332,dorongutman,2,0.00023,160780,18.67836,860782
11333,doryanmzr,2,0.00023,160782,18.67860,860782
11334,dotariel,2,0.00023,160784,18.67883,860782
11335,dotmaster,2,0.00023,160786,18.67906,860782
11336,DotNet-Ninja,2,0.00023,160788,18.67929,860782
11337,doublefx,2,0.00023,160790,18.67953,860782
11338,Doyle-net,2,0.00023,160792,18.67976,860782
11339,dpoetzschke,2,0.00023,160794,18.67999,860782
11340,dr4Ke,2,0.00023,160796,18.68022,860782
11341,DragonStuff,2,0.00023,160798,18.68046,860782
11342,drather19,2,0.00023,160800,18.68069,860782
11343,drazul,2,0.00023,160802,18.68092,860782
11344,drbugfinder,2,0.00023,160804,18.68115,860782
11345,drc0,2,0.00023,160806,18.68139,860782
11346,drequena,2,0.00023,160808,18.68162,860782
11347,drew-512,2,0.00023,160810,18.68185,860782
11348,drewripa,2,0.00023,160812,18.68208,860782
11349,dr-shim,2,0.00023,160814,18.68231,860782
11350,drunkirishcoder,2,0.00023,160816,18.68255,860782
11351,dsbrng25b,2,0.00023,160818,18.68278,860782
11352,dschmo,2,0.00023,160820,18.68301,860782
11353,dschnabel,2,0.00023,160822,18.68324,860782
11354,dsjlee2304,2,0.00023,160824,18.68348,860782
11355,dstephens-wsgc,2,0.00023,160826,18.68371,860782
11356,dtacalau,2,0.00023,160828,18.68394,860782
11357,d-tasaki,2,0.00023,160830,18.68417,860782
11358,dthaluru,2,0.00023,160832,18.68441,860782
11359,dtilsner,2,0.00023,160834,18.68464,860782
11360,dtpryce,2,0.00023,160836,18.68487,860782
11361,dualbus,2,0.00023,160838,18.68510,860782
11362,duguniu85,2,0.00023,160840,18.68533,860782
11363,DumpsterDoofus,2,0.00023,160842,18.68557,860782
11364,duritong,2,0.00023,160844,18.68580,860782
11365,dustinchilson,2,0.00023,160846,18.68603,860782
11366,DustinJSilk,2,0.00023,160848,18.68626,860782
11367,dustinrue,2,0.00023,160850,18.68650,860782
11368,duthifree,2,0.00023,160852,18.68673,860782
11369,duyet,2,0.00023,160854,18.68696,860782
11370,dv-bv,2,0.00023,160856,18.68719,860782
11371,DVGeoffrey,2,0.00023,160858,18.68743,860782
11372,dw250304,2,0.00023,160860,18.68766,860782
11373,dwhipstock,2,0.00023,160862,18.68789,860782
11374,dwyane3011,2,0.00023,160864,18.68812,860782
11375,dynamicwebpaige,2,0.00023,160866,18.68836,860782
11376,DzmitrySudnik,2,0.00023,160868,18.68859,860782
11377,eachirei,2,0.00023,160870,18.68882,860782
11378,eam-cs,2,0.00023,160872,18.68905,860782
11379,eamonryan,2,0.00023,160874,18.68928,860782
11380,easy999000,2,0.00023,160876,18.68952,860782
11381,ebakazu,2,0.00023,160878,18.68975,860782
11382,EBallou,2,0.00023,160880,18.68998,860782
11383,ebr,2,0.00023,160882,18.69021,860782
11384,ecda909,2,0.00023,160884,18.69045,860782
11385,echel0n,2,0.00023,160886,18.69068,860782
11386,ecklm,2,0.00023,160888,18.69091,860782
11387,edbighead,2,0.00023,160890,18.69114,860782
11388,EddieJamsession,2,0.00023,160892,18.69138,860782
11389,edgareler,2,0.00023,160894,18.69161,860782
11390,EdKingscote,2,0.00023,160896,18.69184,860782
11391,ednaganon,2,0.00023,160898,18.69207,860782
11392,edoardo-c,2,0.00023,160900,18.69231,860782
11393,edo-lynx,2,0.00023,160902,18.69254,860782
11394,EduardRosert,2,0.00023,160904,18.69277,860782
11395,eduscrakozabrus,2,0.00023,160906,18.69300,860782
11396,edusouzaxx,2,0.00023,160908,18.69323,860782
11397,edvher,2,0.00023,160910,18.69347,860782
11398,edwardbadboy,2,0.00023,160912,18.69370,860782
11399,edwin2804,2,0.00023,160914,18.69393,860782
11400,eestewart,2,0.00023,160916,18.69416,860782
11401,eexwhyzee,2,0.00023,160918,18.69440,860782
11402,efussi,2,0.00023,160920,18.69463,860782
11403,eggei,2,0.00023,160922,18.69486,860782
11404,egrimley,2,0.00023,160924,18.69509,860782
11405,ehlesp,2,0.00023,160926,18.69533,860782
11406,ehmke,2,0.00023,160928,18.69556,860782
11407,eht16,2,0.00023,160930,18.69579,860782
11408,ejacobhayes,2,0.00023,160932,18.69602,860782
11409,ejoreo,2,0.00023,160934,18.69626,860782
11410,ejpir,2,0.00023,160936,18.69649,860782
11411,eks5115,2,0.00023,160938,18.69672,860782
11412,EladioRodriguezVeve,2,0.00023,160940,18.69695,860782
11413,eldondevat,2,0.00023,160942,18.69718,860782
11414,eldruin,2,0.00023,160944,18.69742,860782
11415,eleblebici,2,0.00023,160946,18.69765,860782
11416,ElenaForester,2,0.00023,160948,18.69788,860782
11417,elfring,2,0.00023,160950,18.69811,860782
11418,Elhen15,2,0.00023,160952,18.69835,860782
11419,eliaskoromilas,2,0.00023,160954,18.69858,860782
11420,elindsey,2,0.00023,160956,18.69881,860782
11421,elliotfehr,2,0.00023,160958,18.69904,860782
11422,eloekset,2,0.00023,160960,18.69928,860782
11423,elrok123,2,0.00023,160962,18.69951,860782
11424,elstr,2,0.00023,160964,18.69974,860782
11425,eltonbfw,2,0.00023,160966,18.69997,860782
11426,elutsky,2,0.00023,160968,18.70021,860782
11427,Emeka-NMC,2,0.00023,160970,18.70044,860782
11428,emilwallner,2,0.00023,160972,18.70067,860782
11429,emin,2,0.00023,160974,18.70090,860782
11430,emrax,2,0.00023,160976,18.70113,860782
11431,endrton,2,0.00023,160978,18.70137,860782
11432,engaugusto,2,0.00023,160980,18.70160,860782
11433,enhellowhy,2,0.00023,160982,18.70183,860782
11434,EnzoJuan,2,0.00023,160984,18.70206,860782
11435,eperdeme,2,0.00023,160986,18.70230,860782
11436,EpicApex,2,0.00023,160988,18.70253,860782
11437,er0sin,2,0.00023,160990,18.70276,860782
11438,eReGeBe,2,0.00023,160992,18.70299,860782
11439,erenatas,2,0.00023,160994,18.70323,860782
11440,Erezf-p,2,0.00023,160996,18.70346,860782
11441,erganzi,2,0.00023,160998,18.70369,860782
11442,erharb,2,0.00023,161000,18.70392,860782
11443,erheng-dawnlight,2,0.00023,161002,18.70416,860782
11444,erhlee-bird,2,0.00023,161004,18.70439,860782
11445,eric-aops,2,0.00023,161006,18.70462,860782
11446,ericgrings-asapp,2,0.00023,161008,18.70485,860782
11447,erickfaustino,2,0.00023,161010,18.70508,860782
11448,ericmandm,2,0.00023,161012,18.70532,860782
11449,erikjohnston,2,0.00023,161014,18.70555,860782
11450,ErikTMA,2,0.00023,161016,18.70578,860782
11451,erismaster,2,0.00023,161018,18.70601,860782
11452,erkexzcx,2,0.00023,161020,18.70625,860782
11453,Erokos,2,0.00023,161022,18.70648,860782
11454,ESBA-salman,2,0.00023,161024,18.70671,860782
11455,eselvam,2,0.00023,161026,18.70694,860782
11456,esse,2,0.00023,161028,18.70718,860782
11457,essh,2,0.00023,161030,18.70741,860782
11458,esteban1983cl,2,0.00023,161032,18.70764,860782
11459,etby,2,0.00023,161034,18.70787,860782
11460,etherandrius,2,0.00023,161036,18.70810,860782
11461,etidalgo,2,0.00023,161038,18.70834,860782
11462,etopeter,2,0.00023,161040,18.70857,860782
11463,etuttle,2,0.00023,161042,18.70880,860782
11464,eugene-chernyshenko,2,0.00023,161044,18.70903,860782
11465,eugene-dm,2,0.00023,161046,18.70927,860782
11466,EugenFo,2,0.00023,161048,18.70950,860782
11467,eulertour,2,0.00023,161050,18.70973,860782
11468,Eunice-H,2,0.00023,161052,18.70996,860782
11469,evagonz,2,0.00023,161054,18.71020,860782
11470,evanlimanto,2,0.00023,161056,18.71043,860782
11471,evanmcclure,2,0.00023,161058,18.71066,860782
11472,evanniedojadlo,2,0.00023,161060,18.71089,860782
11473,EvanPrivate,2,0.00023,161062,18.71113,860782
11474,EvgeniGordeev,2,0.00023,161064,18.71136,860782
11475,evgkrsk,2,0.00023,161066,18.71159,860782
11476,ewiger,2,0.00023,161068,18.71182,860782
11477,ex3ndr,2,0.00023,161070,18.71205,860782
11478,exfly,2,0.00023,161072,18.71229,860782
11479,Exgc,2,0.00023,161074,18.71252,860782
11480,eyalzek,2,0.00023,161076,18.71275,860782
11481,eyeezzi,2,0.00023,161078,18.71298,860782
11482,eyexin,2,0.00023,161080,18.71322,860782
11483,f1-outsourcing,2,0.00023,161082,18.71345,860782
11484,f84anton,2,0.00023,161084,18.71368,860782
11485,fa-at-pulsit,2,0.00023,161086,18.71391,860782
11486,fabinou,2,0.00023,161088,18.71415,860782
11487,fabio-510,2,0.00023,161090,18.71438,860782
11488,facchettos,2,0.00023,161092,18.71461,860782
11489,fadao23,2,0.00023,161094,18.71484,860782
11490,FahimaGold,2,0.00023,161096,18.71508,860782
11491,faizanmohiuddin482,2,0.00023,161098,18.71531,860782
11492,faizanu,2,0.00023,161100,18.71554,860782
11493,Falconx1000,2,0.00023,161102,18.71577,860782
11494,falcoriss,2,0.00023,161104,18.71600,860782
11495,FallenWarrior2k,2,0.00023,161106,18.71624,860782
11496,fanruinet,2,0.00023,161108,18.71647,860782
11497,Farenheith,2,0.00023,161110,18.71670,860782
11498,Farhanfdema,2,0.00023,161112,18.71693,860782
11499,farlop,2,0.00023,161114,18.71717,860782
11500,farvour,2,0.00023,161116,18.71740,860782
11501,fastlorenzo,2,0.00023,161118,18.71763,860782
11502,faweis,2,0.00023,161120,18.71786,860782
11503,fboismenu,2,0.00023,161122,18.71810,860782
11504,fbrubbo,2,0.00023,161124,18.71833,860782
11505,fcolista,2,0.00023,161126,18.71856,860782
11506,fcrespofastly,2,0.00023,161128,18.71879,860782
11507,fearoffish,2,0.00023,161130,18.71903,860782
11508,FearTheBadger,2,0.00023,161132,18.71926,860782
11509,feguiguren,2,0.00023,161134,18.71949,860782
11510,felipecrs,2,0.00023,161136,18.71972,860782
11511,felipemouradev,2,0.00023,161138,18.71995,860782
11512,feliu,2,0.00023,161140,18.72019,860782
11513,felixgao,2,0.00023,161142,18.72042,860782
11514,FellSoCold,2,0.00023,161144,18.72065,860782
11515,feluxe,2,0.00023,161146,18.72088,860782
11516,fengweiyuan,2,0.00023,161148,18.72112,860782
11517,fernando-domenike,2,0.00023,161150,18.72135,860782
11518,ffftwo,2,0.00023,161152,18.72158,860782
11519,figassis,2,0.00023,161154,18.72181,860782
11520,filburt-turle,2,0.00023,161156,18.72205,860782
11521,filcoplax,2,0.00023,161158,18.72228,860782
11522,filipe-costa,2,0.00023,161160,18.72251,860782
11523,filippobosi,2,0.00023,161162,18.72274,860782
11524,FiloSottile,2,0.00023,161164,18.72298,860782
11525,FinalDes,2,0.00023,161166,18.72321,860782
11526,firmsoil,2,0.00023,161168,18.72344,860782
11527,FirstEncounter,2,0.00023,161170,18.72367,860782
11528,fishpenguin,2,0.00023,161172,18.72390,860782
11529,fivezerosix,2,0.00023,161174,18.72414,860782
11530,Fixmetal,2,0.00023,161176,18.72437,860782
11531,fky2015,2,0.00023,161178,18.72460,860782
11532,flabatut,2,0.00023,161180,18.72483,860782
11533,Flamefire,2,0.00023,161182,18.72507,860782
11534,FlamesCN,2,0.00023,161184,18.72530,860782
11535,flaudisio,2,0.00023,161186,18.72553,860782
11536,FLavalliere,2,0.00023,161188,18.72576,860782
11537,flaviodsr,2,0.00023,161190,18.72600,860782
11538,flixx,2,0.00023,161192,18.72623,860782
11539,flopes89,2,0.00023,161194,18.72646,860782
11540,florentvaldelievre,2,0.00023,161196,18.72669,860782
11541,floretan,2,0.00023,161198,18.72693,860782
11542,fmmatthewzeemann,2,0.00023,161200,18.72716,860782
11543,fmuyassarov,2,0.00023,161202,18.72739,860782
11544,fnikolov,2,0.00023,161204,18.72762,860782
11545,foggy-glasses,2,0.00023,161206,18.72785,860782
11546,forainychen,2,0.00023,161208,18.72809,860782
11547,foriusso84,2,0.00023,161210,18.72832,860782
11548,foxyoyo,2,0.00023,161212,18.72855,860782
11549,fpatino,2,0.00023,161214,18.72878,860782
11550,fpj,2,0.00023,161216,18.72902,860782
11551,FqqCS,2,0.00023,161218,18.72925,860782
11552,francistan89,2,0.00023,161220,18.72948,860782
11553,frank-xlj,2,0.00023,161222,18.72971,860782
11554,frant-hartm,2,0.00023,161224,18.72995,860782
11555,FrantzT,2,0.00023,161226,18.73018,860782
11556,frdeng,2,0.00023,161228,18.73041,860782
11557,fredbcode,2,0.00023,161230,18.73064,860782
11558,frelon,2,0.00023,161232,18.73087,860782
11559,frencopei,2,0.00023,161234,18.73111,860782
11560,Fresa,2,0.00023,161236,18.73134,860782
11561,FriedCircuits,2,0.00023,161238,18.73157,860782
11562,Friedrich42,2,0.00023,161240,18.73180,860782
11563,FrimIdan,2,0.00023,161242,18.73204,860782
11564,Frondall,2,0.00023,161244,18.73227,860782
11565,Fronox,2,0.00023,161246,18.73250,860782
11566,FruitSamurai,2,0.00023,161248,18.73273,860782
11567,fscan,2,0.00023,161250,18.73297,860782
11568,FuneralHomeFind,2,0.00023,161252,18.73320,860782
11569,funky81,2,0.00023,161254,18.73343,860782
11570,FurentesT,2,0.00023,161256,18.73366,860782
11571,Future2100,2,0.00023,161258,18.73390,860782
11572,fuxingloh,2,0.00023,161260,18.73413,860782
11573,fvahid,2,0.00023,161262,18.73436,860782
11574,fvdnabee,2,0.00023,161264,18.73459,860782
11575,fvoznika,2,0.00023,161266,18.73482,860782
11576,fyang-pivotal,2,0.00023,161268,18.73506,860782
11577,FZambia,2,0.00023,161270,18.73529,860782
11578,fzhsh-q,2,0.00023,161272,18.73552,860782
11579,g1bl3t,2,0.00023,161274,18.73575,860782
11580,Gabisonfire,2,0.00023,161276,18.73599,860782
11581,gabriel-stan,2,0.00023,161278,18.73622,860782
11582,gafoorraja,2,0.00023,161280,18.73645,860782
11583,gagado,2,0.00023,161282,18.73668,860782
11584,gaganhegde,2,0.00023,161284,18.73692,860782
11585,gaius-qi,2,0.00023,161286,18.73715,860782
11586,gakhrejah,2,0.00023,161288,18.73738,860782
11587,galaktipus,2,0.00023,161290,18.73761,860782
11588,galbacarys,2,0.00023,161292,18.73785,860782
11589,galiev,2,0.00023,161294,18.73808,860782
11590,gambuzzi,2,0.00023,161296,18.73831,860782
11591,gangyi89,2,0.00023,161298,18.73854,860782
11592,gaochundong,2,0.00023,161300,18.73877,860782
11593,gaogao1030,2,0.00023,161302,18.73901,860782
11594,gaonK,2,0.00023,161304,18.73924,860782
11595,GarbageYard,2,0.00023,161306,18.73947,860782
11596,gardnerdev,2,0.00023,161308,18.73970,860782
11597,GarrettGeorge,2,0.00023,161310,18.73994,860782
11598,garrettthomaskth,2,0.00023,161312,18.74017,860782
11599,gaulzhw,2,0.00023,161314,18.74040,860782
11600,gauravachatrath,2,0.00023,161316,18.74063,860782
11601,gaurav-ackotech,2,0.00023,161318,18.74087,860782
11602,gauravdasson,2,0.00023,161320,18.74110,860782
11603,Gavin-cn,2,0.00023,161322,18.74133,860782
11604,GavinOsborn,2,0.00023,161324,18.74156,860782
11605,gbrener,2,0.00023,161326,18.74180,860782
11606,gcaldeira,2,0.00023,161328,18.74203,860782
11607,gdemonet,2,0.00023,161330,18.74226,860782
11608,ge79so,2,0.00023,161332,18.74249,860782
11609,gecube,2,0.00023,161334,18.74272,860782
11610,geedoubleya,2,0.00023,161336,18.74296,860782
11611,geekq,2,0.00023,161338,18.74319,860782
11612,geetha-rangaswamaiah,2,0.00023,161340,18.74342,860782
11613,gennady-melesh,2,0.00023,161342,18.74365,860782
11614,geofflamrock,2,0.00023,161344,18.74389,860782
11615,georambo,2,0.00023,161346,18.74412,860782
11616,George-Chia,2,0.00023,161348,18.74435,860782
11617,george-haddad,2,0.00023,161350,18.74458,860782
11618,georgewilliamherbert,2,0.00023,161352,18.74482,860782
11619,Gerald-Wheaton,2,0.00023,161354,18.74505,860782
11620,gerhardgossen,2,0.00023,161356,18.74528,860782
11621,gerrit-dewitt-google,2,0.00023,161358,18.74551,860782
11622,gertjanvg,2,0.00023,161360,18.74575,860782
11623,gerwim,2,0.00023,161362,18.74598,860782
11624,GETandSELECT,2,0.00023,161364,18.74621,860782
11625,gezb,2,0.00023,161366,18.74644,860782
11626,gfokkema,2,0.00023,161368,18.74667,860782
11627,gfrankel97,2,0.00023,161370,18.74691,860782
11628,gfvirga,2,0.00023,161372,18.74714,860782
11629,ggogel,2,0.00023,161374,18.74737,860782
11630,ggordan,2,0.00023,161376,18.74760,860782
11631,gh67uyyghj,2,0.00023,161378,18.74784,860782
11632,ghhenry,2,0.00023,161380,18.74807,860782
11633,gholliday100,2,0.00023,161382,18.74830,860782
11634,GhostInThePotato,2,0.00023,161384,18.74853,860782
11635,gianpierocondorelli,2,0.00023,161386,18.74877,860782
11636,giezi,2,0.00023,161388,18.74900,860782
11637,gifanonim,2,0.00023,161390,18.74923,860782
11638,gigawhat,2,0.00023,161392,18.74946,860782
11639,gileez,2,0.00023,161394,18.74970,860782
11640,giliu,2,0.00023,161396,18.74993,860782
11641,GinoPane,2,0.00023,161398,18.75016,860782
11642,GinYM,2,0.00023,161400,18.75039,860782
11643,gioragutt,2,0.00023,161402,18.75062,860782
11644,girishnehte,2,0.00023,161404,18.75086,860782
11645,giskou,2,0.00023,161406,18.75109,860782
11646,git-enzo,2,0.00023,161408,18.75132,860782
11647,GitHanDong,2,0.00023,161410,18.75155,860782
11648,githubuser0xFFFF,2,0.00023,161412,18.75179,860782
11649,gitssie,2,0.00023,161414,18.75202,860782
11650,giuliano-barberi-tf,2,0.00023,161416,18.75225,860782
11651,gjenkins8,2,0.00023,161418,18.75248,860782
11652,gjie1991,2,0.00023,161420,18.75272,860782
11653,gjj2016,2,0.00023,161422,18.75295,860782
11654,gkdevops,2,0.00023,161424,18.75318,860782
11655,gkistler,2,0.00023,161426,18.75341,860782
11656,gkowalski-google,2,0.00023,161428,18.75364,860782
11657,Glarme,2,0.00023,161430,18.75388,860782
11658,glenn-m,2,0.00023,161432,18.75411,860782
11659,glinker,2,0.00023,161434,18.75434,860782
11660,glitchcrab,2,0.00023,161436,18.75457,860782
11661,GLOFonseca,2,0.00023,161438,18.75481,860782
11662,glucky009,2,0.00023,161440,18.75504,860782
11663,gm2211,2,0.00023,161442,18.75527,860782
11664,gmartinez-anchor,2,0.00023,161444,18.75550,860782
11665,Gmtstephane,2,0.00023,161446,18.75574,860782
11666,gna582,2,0.00023,161448,18.75597,860782
11667,gnasit,2,0.00023,161450,18.75620,860782
11668,gnufree,2,0.00023,161452,18.75643,860782
11669,GoaMind,2,0.00023,161454,18.75667,860782
11670,GoDllkE,2,0.00023,161456,18.75690,860782
11671,goek-han,2,0.00023,161458,18.75713,860782
11672,gogainda,2,0.00023,161460,18.75736,860782
11673,golance-mightydevops,2,0.00023,161462,18.75759,860782
11674,gonejack,2,0.00023,161464,18.75783,860782
11675,gongx,2,0.00023,161466,18.75806,860782
11676,goodforever,2,0.00023,161468,18.75829,860782
11677,goods4455,2,0.00023,161470,18.75852,860782
11678,goodspark,2,0.00023,161472,18.75876,860782
11679,goodwill,2,0.00023,161474,18.75899,860782
11680,gordillo-ramon,2,0.00023,161476,18.75922,860782
11681,gordiustechnologies,2,0.00023,161478,18.75945,860782
11682,gothrek22,2,0.00023,161480,18.75969,860782
11683,goudan-er,2,0.00023,161482,18.75992,860782
11684,GovardhanDo,2,0.00023,161484,18.76015,860782
11685,gowei710,2,0.00023,161486,18.76038,860782
11686,gpldirk,2,0.00023,161488,18.76062,860782
11687,gracewang510,2,0.00023,161490,18.76085,860782
11688,grailsweb,2,0.00023,161492,18.76108,860782
11689,grandseba,2,0.00023,161494,18.76131,860782
11690,grantsunny,2,0.00023,161496,18.76154,860782
11691,Grappeggia,2,0.00023,161498,18.76178,860782
11692,GrataHonoria,2,0.00023,161500,18.76201,860782
11693,graywolf,2,0.00023,161502,18.76224,860782
11694,graywolf-at-work,2,0.00023,161504,18.76247,860782
11695,greenrd,2,0.00023,161506,18.76271,860782
11696,GreenRover,2,0.00023,161508,18.76294,860782
11697,gregorkistler,2,0.00023,161510,18.76317,860782
11698,gregoryfranklin,2,0.00023,161512,18.76340,860782
11699,gregoryguillou,2,0.00023,161514,18.76364,860782
11700,Gremash,2,0.00023,161516,18.76387,860782
11701,grimoh,2,0.00023,161518,18.76410,860782
11702,gromgit,2,0.00023,161520,18.76433,860782
11703,Groxx,2,0.00023,161522,18.76457,860782
11704,Grubhart,2,0.00023,161524,18.76480,860782
11705,gruppferi,2,0.00023,161526,18.76503,860782
11706,grv-trip,2,0.00023,161528,18.76526,860782
11707,grzkv,2,0.00023,161530,18.76549,860782
11708,gsharma,2,0.00023,161532,18.76573,860782
11709,gshel,2,0.00023,161534,18.76596,860782
11710,gtato,2,0.00023,161536,18.76619,860782
11711,guanyuding,2,0.00023,161538,18.76642,860782
11712,guanzydev,2,0.00023,161540,18.76666,860782
11713,gudipudipradeep,2,0.00023,161542,18.76689,860782
11714,gudoy,2,0.00023,161544,18.76712,860782
11715,guiguan,2,0.00023,161546,18.76735,860782
11716,guillemj,2,0.00023,161548,18.76759,860782
11717,gun1x,2,0.00023,161550,18.76782,860782
11718,guobaorou-git,2,0.00023,161552,18.76805,860782
11719,guojingcheng,2,0.00023,161554,18.76828,860782
11720,GuoxiangZu,2,0.00023,161556,18.76852,860782
11721,guusvw,2,0.00023,161558,18.76875,860782
11722,guycla,2,0.00023,161560,18.76898,860782
11723,guy-frontegg,2,0.00023,161562,18.76921,860782
11724,guyromb,2,0.00023,161564,18.76944,860782
11725,gvagithub20,2,0.00023,161566,18.76968,860782
11726,gvwirth,2,0.00023,161568,18.76991,860782
11727,gws,2,0.00023,161570,18.77014,860782
11728,gzlj,2,0.00023,161572,18.77037,860782
11729,haarchri,2,0.00023,161574,18.77061,860782
11730,habib-ali,2,0.00023,161576,18.77084,860782
11731,habrlesni,2,0.00023,161578,18.77107,860782
11732,hack3d,2,0.00023,161580,18.77130,860782
11733,HadesArchitect,2,0.00023,161582,18.77154,860782
11734,haflinger,2,0.00023,161584,18.77177,860782
11735,haibinxie,2,0.00023,161586,18.77200,860782
11736,hakengineer,2,0.00023,161588,18.77223,860782
11737,halink0803,2,0.00023,161590,18.77247,860782
11738,Halytskyi,2,0.00023,161592,18.77270,860782
11739,hamid-elaosta,2,0.00023,161594,18.77293,860782
11740,hammzaza,2,0.00023,161596,18.77316,860782
11741,hamzabll5858,2,0.00023,161598,18.77339,860782
11742,HamzaZo,2,0.00023,161600,18.77363,860782
11743,HanaForward,2,0.00023,161602,18.77386,860782
11744,handymandorel,2,0.00023,161604,18.77409,860782
11745,HanleyCN,2,0.00023,161606,18.77432,860782
11746,hanoisteve,2,0.00023,161608,18.77456,860782
11747,haojingma,2,0.00023,161610,18.77479,860782
11748,haorenfsa,2,0.00023,161612,18.77502,860782
11749,HarikaGoli,2,0.00023,161614,18.77525,860782
11750,harivemula,2,0.00023,161616,18.77549,860782
11751,Harriiup,2,0.00023,161618,18.77572,860782
11752,harrisa1,2,0.00023,161620,18.77595,860782
11753,harsha-s,2,0.00023,161622,18.77618,860782
11754,harshithachowdaryt,2,0.00023,161624,18.77641,860782
11755,HarshithBolar,2,0.00023,161626,18.77665,860782
11756,harshwardhan-bit,2,0.00023,161628,18.77688,860782
11757,harveyxia,2,0.00023,161630,18.77711,860782
11758,hashbash,2,0.00023,161632,18.77734,860782
11759,hato221,2,0.00023,161634,18.77758,860782
11760,HattiMaTimTim,2,0.00023,161636,18.77781,860782
11761,haydnhkim,2,0.00023,161638,18.77804,860782
11762,hazzanz,2,0.00023,161640,18.77827,860782
11763,hdattada,2,0.00023,161642,18.77851,860782
11764,hdpe,2,0.00023,161644,18.77874,860782
11765,he19920226he,2,0.00023,161646,18.77897,860782
11766,HeathLee,2,0.00023,161648,18.77920,860782
11767,hedeesaa,2,0.00023,161650,18.77944,860782
11768,heicci,2,0.00023,161652,18.77967,860782
11769,Heiko-san,2,0.00023,161654,18.77990,860782
11770,heimdull,2,0.00023,161656,18.78013,860782
11771,heisenbergye,2,0.00023,161658,18.78036,860782
11772,hejunion,2,0.00023,161660,18.78060,860782
11773,Helcaraxan,2,0.00023,161662,18.78083,860782
11774,helgifeiti,2,0.00023,161664,18.78106,860782
11775,helloyi,2,0.00023,161666,18.78129,860782
11776,hemakl,2,0.00023,161668,18.78153,860782
11777,hemandee,2,0.00023,161670,18.78176,860782
11778,hennk,2,0.00023,161672,18.78199,860782
11779,henryodinaka,2,0.00023,161674,18.78222,860782
11780,HerHde,2,0.00023,161676,18.78246,860782
11781,heriet,2,0.00023,161678,18.78269,860782
11782,Hermsi1337,2,0.00023,161680,18.78292,860782
11783,herzogf,2,0.00023,161682,18.78315,860782
11784,hexdigest,2,0.00023,161684,18.78339,860782
11785,heyAyushh,2,0.00023,161686,18.78362,860782
11786,hfinucane,2,0.00023,161688,18.78385,860782
11787,hfutcbl,2,0.00023,161690,18.78408,860782
11788,hgibsonqb,2,0.00023,161692,18.78431,860782
11789,hhstu,2,0.00023,161694,18.78455,860782
11790,hhurtado,2,0.00023,161696,18.78478,860782
11791,hichihara,2,0.00023,161698,18.78501,860782
11792,HimanshPal,2,0.00023,161700,18.78524,860782
11793,Himself65,2,0.00023,161702,18.78548,860782
11794,hiraken-w,2,0.00023,161704,18.78571,860782
11795,hiro5id,2,0.00023,161706,18.78594,860782
11796,hiromipat,2,0.00023,161708,18.78617,860782
11797,hiu-phail,2,0.00023,161710,18.78641,860782
11798,hixichen,2,0.00023,161712,18.78664,860782
11799,hjanuschka,2,0.00023,161714,18.78687,860782
11800,HJK181,2,0.00023,161716,18.78710,860782
11801,hkiang01,2,0.00023,161718,18.78734,860782
11802,hklohar,2,0.00023,161720,18.78757,860782
11803,H-Kz,2,0.00023,161722,18.78780,860782
11804,hlieberman,2,0.00023,161724,18.78803,860782
11805,hmahmood,2,0.00023,161726,18.78826,860782
11806,hmthoo,2,0.00023,161728,18.78850,860782
11807,hnq90,2,0.00023,161730,18.78873,860782
11808,hnts,2,0.00023,161732,18.78896,860782
11809,hoboken515,2,0.00023,161734,18.78919,860782
11810,hognala,2,0.00023,161736,18.78943,860782
11811,hokiegeek2,2,0.00023,161738,18.78966,860782
11812,holizon9,2,0.00023,161740,18.78989,860782
11813,holypriest,2,0.00023,161742,18.79012,860782
11814,HongChenTW,2,0.00023,161744,18.79036,860782
11815,honghzzhang,2,0.00023,161746,18.79059,860782
11816,hongjic,2,0.00023,161748,18.79082,860782
11817,hongruiji,2,0.00023,161750,18.79105,860782
11818,hongyuxuan,2,0.00023,161752,18.79129,860782
11819,honi,2,0.00023,161754,18.79152,860782
11820,honnix,2,0.00023,161756,18.79175,860782
11821,hopkiw,2,0.00023,161758,18.79198,860782
11822,hottomato4,2,0.00023,161760,18.79221,860782
11823,howardtangck,2,0.00023,161762,18.79245,860782
11824,hparekh1982,2,0.00023,161764,18.79268,860782
11825,hr1sh1kesh,2,0.00023,161766,18.79291,860782
11826,hrsandhu,2,0.00023,161768,18.79314,860782
11827,hseipp,2,0.00023,161770,18.79338,860782
11828,hspak,2,0.00023,161772,18.79361,860782
11829,htlabc,2,0.00023,161774,18.79384,860782
11830,huangxinxin-szu,2,0.00023,161776,18.79407,860782
11831,huanhaixy,2,0.00023,161778,18.79431,860782
11832,huataihuang,2,0.00023,161780,18.79454,860782
11833,huats,2,0.00023,161782,18.79477,860782
11834,hubert-he,2,0.00023,161784,18.79500,860782
11835,HubertStefanski,2,0.00023,161786,18.79524,860782
11836,hubv,2,0.00023,161788,18.79547,860782
11837,huehnerlady,2,0.00023,161790,18.79570,860782
11838,Huhaokun,2,0.00023,161792,18.79593,860782
11839,hulucc,2,0.00023,161794,18.79616,860782
11840,humpylin,2,0.00023,161796,18.79640,860782
11841,hunchback,2,0.00023,161798,18.79663,860782
11842,hutger,2,0.00023,161800,18.79686,860782
11843,HuuPhuocNguyen,2,0.00023,161802,18.79709,860782
11844,huyturing,2,0.00023,161804,18.79733,860782
11845,h-vetinari,2,0.00023,161806,18.79756,860782
11846,hwacookie,2,0.00023,161808,18.79779,860782
11847,hydave25,2,0.00023,161810,18.79802,860782
11848,hymgg,2,0.00023,161812,18.79826,860782
11849,hyoung-90,2,0.00023,161814,18.79849,860782
11850,hzy46,2,0.00023,161816,18.79872,860782
11851,i9,2,0.00023,161818,18.79895,860782
11852,iainelder,2,0.00023,161820,18.79918,860782
11853,Ialuma,2,0.00023,161822,18.79942,860782
11854,iamktm,2,0.00023,161824,18.79965,860782
11855,IamonFireee,2,0.00023,161826,18.79988,860782
11856,iamparamvs,2,0.00023,161828,18.80011,860782
11857,iamsudip,2,0.00023,161830,18.80035,860782
11858,iamtakingiteasy,2,0.00023,161832,18.80058,860782
11859,ianbillett,2,0.00023,161834,18.80081,860782
11860,ianferguson,2,0.00023,161836,18.80104,860782
11861,iangkent,2,0.00023,161838,18.80128,860782
11862,Ianmward,2,0.00023,161840,18.80151,860782
11863,IanWoods1993,2,0.00023,161842,18.80174,860782
11864,iBavtovich,2,0.00023,161844,18.80197,860782
11865,iben12,2,0.00023,161846,18.80221,860782
11866,ibmdcb,2,0.00023,161848,18.80244,860782
11867,Ibra95ak,2,0.00023,161850,18.80267,860782
11868,ich199,2,0.00023,161852,18.80290,860782
11869,ievdokdm,2,0.00023,161854,18.80313,860782
11870,if6was9,2,0.00023,161856,18.80337,860782
11871,iggyvolz,2,0.00023,161858,18.80360,860782
11872,ignorantshr,2,0.00023,161860,18.80383,860782
11873,igorpalant,2,0.00023,161862,18.80406,860782
11874,ig-sinicyn,2,0.00023,161864,18.80430,860782
11875,igsong,2,0.00023,161866,18.80453,860782
11876,ihasnaoui,2,0.00023,161868,18.80476,860782
11877,ikovnatskymiacar,2,0.00023,161870,18.80499,860782
11878,ikramuallah,2,0.00023,161872,18.80523,860782
11879,IkshuDM,2,0.00023,161874,18.80546,860782
11880,ilib0x00000000,2,0.00023,161876,18.80569,860782
11881,illuminardy,2,0.00023,161878,18.80592,860782
11882,ils-rohits,2,0.00023,161880,18.80616,860782
11883,ilyakaznacheev,2,0.00023,161882,18.80639,860782
11884,imakewebthings,2,0.00023,161884,18.80662,860782
11885,imalik8088,2,0.00023,161886,18.80685,860782
11886,imanissy,2,0.00023,161888,18.80708,860782
11887,imarko,2,0.00023,161890,18.80732,860782
11888,imgroot1391,2,0.00023,161892,18.80755,860782
11889,iMichka,2,0.00023,161894,18.80778,860782
11890,iminto,2,0.00023,161896,18.80801,860782
11891,immiao,2,0.00023,161898,18.80825,860782
11892,imran20487,2,0.00023,161900,18.80848,860782
11893,imranrazakhan,2,0.00023,161902,18.80871,860782
11894,imriz,2,0.00023,161904,18.80894,860782
11895,imvak14,2,0.00023,161906,18.80918,860782
11896,imweijh,2,0.00023,161908,18.80941,860782
11897,InAnimaTe,2,0.00023,161910,18.80964,860782
11898,includerandom,2,0.00023,161912,18.80987,860782
11899,indera-shsp,2,0.00023,161914,18.81011,860782
11900,indiebrain,2,0.00023,161916,18.81034,860782
11901,iNecas,2,0.00023,161918,18.81057,860782
11902,infa-sathkuma,2,0.00023,161920,18.81080,860782
11903,IngaFeick,2,0.00023,161922,18.81103,860782
11904,ingnil,2,0.00023,161924,18.81127,860782
11905,inkychris,2,0.00023,161926,18.81150,860782
11906,innerpeacez,2,0.00023,161928,18.81173,860782
11907,innulic,2,0.00023,161930,18.81196,860782
11908,insectengine,2,0.00023,161932,18.81220,860782
11909,inseinjee,2,0.00023,161934,18.81243,860782
11910,insidewhy,2,0.00023,161936,18.81266,860782
11911,IoakeimSamarasGR,2,0.00023,161938,18.81289,860782
11912,ipince,2,0.00023,161940,18.81313,860782
11913,iposva-google,2,0.00023,161942,18.81336,860782
11914,iptizer,2,0.00023,161944,18.81359,860782
11915,iqbaalsingh,2,0.00023,161946,18.81382,860782
11916,Iracinder,2,0.00023,161948,18.81406,860782
11917,Iristyle,2,0.00023,161950,18.81429,860782
11918,irniaxsep,2,0.00023,161952,18.81452,860782
11919,iron9light,2,0.00023,161954,18.81475,860782
11920,ironhalik,2,0.00023,161956,18.81498,860782
11921,Isan-Rivkin,2,0.00023,161958,18.81522,860782
11922,ishandwivedi,2,0.00023,161960,18.81545,860782
11923,ishan-rep,2,0.00023,161962,18.81568,860782
11924,ishansd94,2,0.00023,161964,18.81591,860782
11925,Isolus,2,0.00023,161966,18.81615,860782
11926,istvanszoboszlai,2,0.00023,161968,18.81638,860782
11927,ititandev,2,0.00023,161970,18.81661,860782
11928,itssimon,2,0.00023,161972,18.81684,860782
11929,itzikban,2,0.00023,161974,18.81708,860782
11930,ivangreene,2,0.00023,161976,18.81731,860782
11931,ivanjaros,2,0.00023,161978,18.81754,860782
11932,ivanr,2,0.00023,161980,18.81777,860782
11933,ivanthelad,2,0.00023,161982,18.81801,860782
11934,ivcosla,2,0.00023,161984,18.81824,860782
11935,ivsokol,2,0.00023,161986,18.81847,860782
11936,iwangmian,2,0.00023,161988,18.81870,860782
11937,izeau,2,0.00023,161990,18.81893,860782
11938,izzatzr,2,0.00023,161992,18.81917,860782
11939,J000Z,2,0.00023,161994,18.81940,860782
11940,j0hnL,2,0.00023,161996,18.81963,860782
11941,j143,2,0.00023,161998,18.81986,860782
11942,j3j5,2,0.00023,162000,18.82010,860782
11943,j4y4r,2,0.00023,162002,18.82033,860782
11944,ja8zyjits,2,0.00023,162004,18.82056,860782
11945,jaakristioja,2,0.00023,162006,18.82079,860782
11946,jaceq,2,0.00023,162008,18.82103,860782
11947,JackieWu1219,2,0.00023,162010,18.82126,860782
11948,jackivanov,2,0.00023,162012,18.82149,860782
11949,JacksChoco,2,0.00023,162014,18.82172,860782
11950,jackskj,2,0.00023,162016,18.82195,860782
11951,jackywu,2,0.00023,162018,18.82219,860782
11952,JacobGabrielson,2,0.00023,162020,18.82242,860782
11953,JacobSMoller,2,0.00023,162022,18.82265,860782
11954,jaequery,2,0.00023,162024,18.82288,860782
11955,jaganrajagopalme,2,0.00023,162026,18.82312,860782
11956,jagodzinska,2,0.00023,162028,18.82335,860782
11957,jah-jh,2,0.00023,162030,18.82358,860782
11958,Jajitha94,2,0.00023,162032,18.82381,860782
11959,jakehamilton,2,0.00023,162034,18.82405,860782
11960,Jakub-B,2,0.00023,162036,18.82428,860782
11961,jakubpartyka,2,0.00023,162038,18.82451,860782
11962,jam0cam,2,0.00023,162040,18.82474,860782
11963,jamesdube,2,0.00023,162042,18.82498,860782
11964,JamesGordan11,2,0.00023,162044,18.82521,860782
11965,jamesthegiantpeach,2,0.00023,162046,18.82544,860782
11966,JamieMagee,2,0.00023,162048,18.82567,860782
11967,jamihuq,2,0.00023,162050,18.82590,860782
11968,jan0ski,2,0.00023,162052,18.82614,860782
11969,janavenkat,2,0.00023,162054,18.82637,860782
11970,JanScheurich,2,0.00023,162056,18.82660,860782
11971,jansci621,2,0.00023,162058,18.82683,860782
11972,jansenmccloud,2,0.00023,162060,18.82707,860782
11973,jaredkipe,2,0.00023,162062,18.82730,860782
11974,jaredsmithse,2,0.00023,162064,18.82753,860782
11975,Jarnek,2,0.00023,162066,18.82776,860782
11976,jaschaio,2,0.00023,162068,18.82800,860782
11977,jasoares,2,0.00023,162070,18.82823,860782
11978,jasonchester,2,0.00023,162072,18.82846,860782
11979,jasonrogena,2,0.00023,162074,18.82869,860782
11980,jasvantsingh,2,0.00023,162076,18.82893,860782
11981,jasvinder-tp,2,0.00023,162078,18.82916,860782
11982,Jatish-Khanna,2,0.00023,162080,18.82939,860782
11983,JavascriptMick,2,0.00023,162082,18.82962,860782
11984,javiercri,2,0.00023,162084,18.82985,860782
11985,jawhites,2,0.00023,162086,18.83009,860782
11986,jay13jay,2,0.00023,162088,18.83032,860782
11987,jayakumarj85,2,0.00023,162090,18.83055,860782
11988,Jaydee94,2,0.00023,162092,18.83078,860782
11989,Jayesh-upvision,2,0.00023,162094,18.83102,860782
11990,JayLeeResBio,2,0.00023,162096,18.83125,860782
11991,JaymoKang,2,0.00023,162098,18.83148,860782
11992,jaymzh,2,0.00023,162100,18.83171,860782
11993,jaypoulz,2,0.00023,162102,18.83195,860782
11994,jaysiee,2,0.00023,162104,18.83218,860782
11995,jayyeras,2,0.00023,162106,18.83241,860782
11996,jbiancot,2,0.00023,162108,18.83264,860782
11997,jbnjohnathan,2,0.00023,162110,18.83288,860782
11998,jbotelho2-bb,2,0.00023,162112,18.83311,860782
11999,jbritt1,2,0.00023,162114,18.83334,860782
12000,jbuettnerbild,2,0.00023,162116,18.83357,860782
12001,jburianek,2,0.00023,162118,18.83380,860782
12002,jbuse,2,0.00023,162120,18.83404,860782
12003,jbutler992,2,0.00023,162122,18.83427,860782
12004,Jc2k,2,0.00023,162124,18.83450,860782
12005,jcampbell05,2,0.00023,162126,18.83473,860782
12006,jcarvalho,2,0.00023,162128,18.83497,860782
12007,jcassee,2,0.00023,162130,18.83520,860782
12008,jcdecaux-oss,2,0.00023,162132,18.83543,860782
12009,jceresini,2,0.00023,162134,18.83566,860782
12010,jclangst,2,0.00023,162136,18.83590,860782
12011,jclulow,2,0.00023,162138,18.83613,860782
12012,jcmckay,2,0.00023,162140,18.83636,860782
12013,jcoconnor,2,0.00023,162142,18.83659,860782
12014,jconway,2,0.00023,162144,18.83683,860782
12015,jcorvino,2,0.00023,162146,18.83706,860782
12016,jCOTINEAU,2,0.00023,162148,18.83729,860782
12017,jcsky,2,0.00023,162150,18.83752,860782
12018,jdamato-fsly,2,0.00023,162152,18.83775,860782
12019,jdconti,2,0.00023,162154,18.83799,860782
12020,jdetering,2,0.00023,162156,18.83822,860782
12021,jdewinne,2,0.00023,162158,18.83845,860782
12022,jdonnell01,2,0.00023,162160,18.83868,860782
12023,je-al,2,0.00023,162162,18.83892,860782
12024,jean,2,0.00023,162164,18.83915,860782
12025,jeandevops,2,0.00023,162166,18.83938,860782
12026,jeansergegagnon,2,0.00023,162168,18.83961,860782
12027,JebasinghLuccas,2,0.00023,162170,18.83985,860782
12028,jeet1990,2,0.00023,162172,18.84008,860782
12029,jeff1985,2,0.00023,162174,18.84031,860782
12030,JEFFLUFC,2,0.00023,162176,18.84054,860782
12031,jeff-minard-ck,2,0.00023,162178,18.84078,860782
12032,jeluard,2,0.00023,162180,18.84101,860782
12033,jemag,2,0.00023,162182,18.84124,860782
12034,Jenniferstrej,2,0.00023,162184,18.84147,860782
12035,JennyMet,2,0.00023,162186,18.84170,860782
12036,jeopard,2,0.00023,162188,18.84194,860782
12037,Jeremy-boo,2,0.00023,162190,18.84217,860782
12038,Jeremyhoc,2,0.00023,162192,18.84240,860782
12039,JeroennC,2,0.00023,162194,18.84263,860782
12040,jerry3k,2,0.00023,162196,18.84287,860782
12041,jerryyanmj,2,0.00023,162198,18.84310,860782
12042,jes-micron,2,0.00023,162200,18.84333,860782
12043,JessieAMorris,2,0.00023,162202,18.84356,860782
12044,jesussancheztellomm,2,0.00023,162204,18.84380,860782
12045,jesusvazquez,2,0.00023,162206,18.84403,860782
12046,jewertow,2,0.00023,162208,18.84426,860782
12047,jfb74,2,0.00023,162210,18.84449,860782
12048,jfradley,2,0.00023,162212,18.84472,860782
12049,jg-26,2,0.00023,162214,18.84496,860782
12050,jgalliers,2,0.00023,162216,18.84519,860782
12051,jgaudy,2,0.00023,162218,18.84542,860782
12052,jgraettinger,2,0.00023,162220,18.84565,860782
12053,jgulick48,2,0.00023,162222,18.84589,860782
12054,jhahn21,2,0.00023,162224,18.84612,860782
12055,jh-lee,2,0.00023,162226,18.84635,860782
12056,jiafeicat,2,0.00023,162228,18.84658,860782
12057,jiapeish,2,0.00023,162230,18.84682,860782
12058,Jigar3,2,0.00023,162232,18.84705,860782
12059,jijojv,2,0.00023,162234,18.84728,860782
12060,JimmyGrover,2,0.00023,162236,18.84751,860782
12061,JimWen,2,0.00023,162238,18.84775,860782
12062,jincheng-xiaosu,2,0.00023,162240,18.84798,860782
12063,jingpengw,2,0.00023,162242,18.84821,860782
12064,jinnko,2,0.00023,162244,18.84844,860782
12065,jinxiao,2,0.00023,162246,18.84867,860782
12066,jiraguha,2,0.00023,162248,18.84891,860782
12067,jiribaloun,2,0.00023,162250,18.84914,860782
12068,JiriCtvrtka,2,0.00023,162252,18.84937,860782
12069,jishidaaaaa,2,0.00023,162254,18.84960,860782
12070,jithine,2,0.00023,162256,18.84984,860782
12071,jiths19,2,0.00023,162258,18.85007,860782
12072,jiuchen1986,2,0.00023,162260,18.85030,860782
12073,jjangchan,2,0.00023,162262,18.85053,860782
12074,jjangga0214,2,0.00023,162264,18.85077,860782
12075,jjatria,2,0.00023,162266,18.85100,860782
12076,jjELT,2,0.00023,162268,18.85123,860782
12077,jjimenezmont,2,0.00023,162270,18.85146,860782
12078,jjthom87,2,0.00023,162272,18.85170,860782
12079,jk2K,2,0.00023,162274,18.85193,860782
12080,jkh911208,2,0.00023,162276,18.85216,860782
12081,jlacoline,2,0.00023,162278,18.85239,860782
12082,jlegoff,2,0.00023,162280,18.85262,860782
12083,jlehtimaki,2,0.00023,162282,18.85286,860782
12084,jlohiya,2,0.00023,162284,18.85309,860782
12085,jlpedrosa,2,0.00023,162286,18.85332,860782
12086,jMarkP,2,0.00023,162288,18.85355,860782
12087,jmatt-cavli,2,0.00023,162290,18.85379,860782
12088,jmcduffie,2,0.00023,162292,18.85402,860782
12089,jmedberydsc,2,0.00023,162294,18.85425,860782
12090,jmeis,2,0.00023,162296,18.85448,860782
12091,jmprusi,2,0.00023,162298,18.85472,860782
12092,jmvbxx,2,0.00023,162300,18.85495,860782
12093,jncr,2,0.00023,162302,18.85518,860782
12094,joanne-gsl,2,0.00023,162304,18.85541,860782
12095,JoaquinScript,2,0.00023,162306,18.85565,860782
12096,jochenhebbrecht,2,0.00023,162308,18.85588,860782
12097,jocko-wowza,2,0.00023,162310,18.85611,860782
12098,joekhoobyar,2,0.00023,162312,18.85634,860782
12099,joell,2,0.00023,162314,18.85657,860782
12100,joelmccracken,2,0.00023,162316,18.85681,860782
12101,joelwilliamson,2,0.00023,162318,18.85704,860782
12102,JoeryH,2,0.00023,162320,18.85727,860782
12103,JoeSchr,2,0.00023,162322,18.85750,860782
12104,johan1252,2,0.00023,162324,18.85774,860782
12105,johan974,2,0.00023,162326,18.85797,860782
12106,johan-lejdung,2,0.00023,162328,18.85820,860782
12107,johanssone,2,0.00023,162330,18.85843,860782
12108,JohanWork,2,0.00023,162332,18.85867,860782
12109,johnbryan,2,0.00023,162334,18.85890,860782
12110,johnfedoruk,2,0.00023,162336,18.85913,860782
12111,johnmikel,2,0.00023,162338,18.85936,860782
12112,johnnyaug,2,0.00023,162340,18.85960,860782
12113,johnnyshields,2,0.00023,162342,18.85983,860782
12114,johnsonru,2,0.00023,162344,18.86006,860782
12115,johnwong369,2,0.00023,162346,18.86029,860782
12116,johnyb79,2,0.00023,162348,18.86052,860782
12117,johnyii0216,2,0.00023,162350,18.86076,860782
12118,Joldnine,2,0.00023,162352,18.86099,860782
12119,JonathanLachapelle,2,0.00023,162354,18.86122,860782
12120,jonathansm1th,2,0.00023,162356,18.86145,860782
12121,jones-gao,2,0.00023,162358,18.86169,860782
12122,jonesmith518,2,0.00023,162360,18.86192,860782
12123,jonnalagadda35153,2,0.00023,162362,18.86215,860782
12124,jon-ruckwood,2,0.00023,162364,18.86238,860782
12125,JordyBottelier,2,0.00023,162366,18.86262,860782
12126,jorenvs,2,0.00023,162368,18.86285,860782
12127,Jorgeguega,2,0.00023,162370,18.86308,860782
12128,jorgelbg,2,0.00023,162372,18.86331,860782
12129,jorgex1,2,0.00023,162374,18.86355,860782
12130,JorjBauer,2,0.00023,162376,18.86378,860782
12131,josedefrias,2,0.00023,162378,18.86401,860782
12132,JoseFlores97,2,0.00023,162380,18.86424,860782
12133,JoseFMP,2,0.00023,162382,18.86447,860782
12134,josephfinlayson,2,0.00023,162384,18.86471,860782
12135,josephmate,2,0.00023,162386,18.86494,860782
12136,joseph-ravenwolfe,2,0.00023,162388,18.86517,860782
12137,josephw,2,0.00023,162390,18.86540,860782
12138,JoshBargar,2,0.00023,162392,18.86564,860782
12139,josh-tracey,2,0.00023,162394,18.86587,860782
12140,joshuabeny1999,2,0.00023,162396,18.86610,860782
12141,joshwlewis,2,0.00023,162398,18.86633,860782
12142,josiasnonato,2,0.00023,162400,18.86657,860782
12143,joskfg,2,0.00023,162402,18.86680,860782
12144,josro,2,0.00023,162404,18.86703,860782
12145,josuemotte,2,0.00023,162406,18.86726,860782
12146,jowi24,2,0.00023,162408,18.86749,860782
12147,jpc4242,2,0.00023,162410,18.86773,860782
12148,jphuc96,2,0.00023,162412,18.86796,860782
12149,jpjeery6,2,0.00023,162414,18.86819,860782
12150,jpmolinamatute,2,0.00023,162416,18.86842,860782
12151,jpoikela,2,0.00023,162418,18.86866,860782
12152,JPSantistebanQ,2,0.00023,162420,18.86889,860782
12153,jpVm5jYYRE1VIKL,2,0.00023,162422,18.86912,860782
12154,JQrdan,2,0.00023,162424,18.86935,860782
12155,jrake-revelant,2,0.00023,162426,18.86959,860782
12156,jrinvictus,2,0.00023,162428,18.86982,860782
12157,jsbraich,2,0.00023,162430,18.87005,860782
12158,j-schultz,2,0.00023,162432,18.87028,860782
12159,JSIDELIVERETH,2,0.00023,162434,18.87052,860782
12160,jslay88,2,0.00023,162436,18.87075,860782
12161,js-max,2,0.00023,162438,18.87098,860782
12162,jsmith02,2,0.00023,162440,18.87121,860782
12163,jsonpang,2,0.00023,162442,18.87144,860782
12164,jstallings,2,0.00023,162444,18.87168,860782
12165,jtai-omniex,2,0.00023,162446,18.87191,860782
12166,jtestard,2,0.00023,162448,18.87214,860782
12167,ju187,2,0.00023,162450,18.87237,860782
12168,juanmatias,2,0.00023,162452,18.87261,860782
12169,JukicD-Symflower,2,0.00023,162454,18.87284,860782
12170,Jukie,2,0.00023,162456,18.87307,860782
12171,julianosilvaa,2,0.00023,162458,18.87330,860782
12172,julianwilkinson,2,0.00023,162460,18.87354,860782
12173,julienchastang,2,0.00023,162462,18.87377,860782
12174,julien-leclercq,2,0.00023,162464,18.87400,860782
12175,juliofalbo,2,0.00023,162466,18.87423,860782
12176,jun1220,2,0.00023,162468,18.87447,860782
12177,JuniorCtba,2,0.00023,162470,18.87470,860782
12178,juniormayhe,2,0.00023,162472,18.87493,860782
12179,justgotthis,2,0.00023,162474,18.87516,860782
12180,juusujanar,2,0.00023,162476,18.87539,860782
12181,juyttenh,2,0.00023,162478,18.87563,860782
12182,jvanenckevort,2,0.00023,162480,18.87586,860782
12183,jvigneshcs,2,0.00023,162482,18.87609,860782
12184,JVMartin,2,0.00023,162484,18.87632,860782
12185,jwandrews,2,0.00023,162486,18.87656,860782
12186,jwcheong0420,2,0.00023,162488,18.87679,860782
12187,jwhited,2,0.00023,162490,18.87702,860782
12188,jwu-dharmo,2,0.00023,162492,18.87725,860782
12189,jyaworski,2,0.00023,162494,18.87749,860782
12190,jzdayz,2,0.00023,162496,18.87772,860782
12191,jzeweniuk,2,0.00023,162498,18.87795,860782
12192,jzhang046,2,0.00023,162500,18.87818,860782
12193,K3UL,2,0.00023,162502,18.87842,860782
12194,k8sre,2,0.00023,162504,18.87865,860782
12195,KabirKwatra,2,0.00023,162506,18.87888,860782
12196,kadimulam,2,0.00023,162508,18.87911,860782
12197,kaheicanaan,2,0.00023,162510,18.87934,860782
12198,kaiiak,2,0.00023,162512,18.87958,860782
12199,kaiyou,2,0.00023,162514,18.87981,860782
12200,kalioz,2,0.00023,162516,18.88004,860782
12201,kallisti5,2,0.00023,162518,18.88027,860782
12202,kalman5,2,0.00023,162520,18.88051,860782
12203,KamalaRamas,2,0.00023,162522,18.88074,860782
12204,kamolhasan,2,0.00023,162524,18.88097,860782
12205,kaniapm,2,0.00023,162526,18.88120,860782
12206,kanishkarj,2,0.00023,162528,18.88144,860782
12207,kannanvr,2,0.00023,162530,18.88167,860782
12208,kanozec,2,0.00023,162532,18.88190,860782
12209,kanwar-saad,2,0.00023,162534,18.88213,860782
12210,kapilgarg83,2,0.00023,162536,18.88237,860782
12211,KapJI,2,0.00023,162538,18.88260,860782
12212,karanlik,2,0.00023,162540,18.88283,860782
12213,karlmuscat,2,0.00023,162542,18.88306,860782
12214,karlschu13,2,0.00023,162544,18.88329,860782
12215,Karthik11Hegde,2,0.00023,162546,18.88353,860782
12216,karthikdialpad,2,0.00023,162548,18.88376,860782
12217,KarthikRangaraju,2,0.00023,162550,18.88399,860782
12218,karthm12,2,0.00023,162552,18.88422,860782
12219,kartik-moolya,2,0.00023,162554,18.88446,860782
12220,kate-goldenring,2,0.00023,162556,18.88469,860782
12221,katherine-boost,2,0.00023,162558,18.88492,860782
12222,katiekeel,2,0.00023,162560,18.88515,860782
12223,kaushalendrakumar,2,0.00023,162562,18.88539,860782
12224,kaushikb11,2,0.00023,162564,18.88562,860782
12225,kavicse87,2,0.00023,162566,18.88585,860782
12226,kavin-kk,2,0.00023,162568,18.88608,860782
12227,kavitha-jm,2,0.00023,162570,18.88632,860782
12228,kazysgurskas,2,0.00023,162572,18.88655,860782
12229,KB3FN,2,0.00023,162574,18.88678,860782
12230,kbojjireddy,2,0.00023,162576,18.88701,860782
12231,kcwu,2,0.00023,162578,18.88724,860782
12232,keeferrourke,2,0.00023,162580,18.88748,860782
12233,keikomori,2,0.00023,162582,18.88771,860782
12234,KeithRichardLee,2,0.00023,162584,18.88794,860782
12235,kelvie,2,0.00023,162586,18.88817,860782
12236,kemra102,2,0.00023,162588,18.88841,860782
12237,kenans,2,0.00023,162590,18.88864,860782
12238,kendallroden,2,0.00023,162592,18.88887,860782
12239,KenjiChao,2,0.00023,162594,18.88910,860782
12240,kennethmyers,2,0.00023,162596,18.88934,860782
12241,kenota,2,0.00023,162598,18.88957,860782
12242,kentakozuka,2,0.00023,162600,18.88980,860782
12243,kenton18,2,0.00023,162602,18.89003,860782
12244,Kenzi007220,2,0.00023,162604,18.89026,860782
12245,kerherve,2,0.00023,162606,18.89050,860782
12246,kerOssinas,2,0.00023,162608,18.89073,860782
12247,kerwanp,2,0.00023,162610,18.89096,860782
12248,Kesslarr,2,0.00023,162612,18.89119,860782
12249,kethan,2,0.00023,162614,18.89143,860782
12250,kevin90n,2,0.00023,162616,18.89166,860782
12251,kevinbader,2,0.00023,162618,18.89189,860782
12252,kevinresol,2,0.00023,162620,18.89212,860782
12253,kevinsingapore,2,0.00023,162622,18.89236,860782
12254,KevinThompsonYCRX,2,0.00023,162624,18.89259,860782
12255,KevinWang15,2,0.00023,162626,18.89282,860782
12256,keviv123,2,0.00023,162628,18.89305,860782
12257,keyhan,2,0.00023,162630,18.89329,860782
12258,keyva,2,0.00023,162632,18.89352,860782
12259,keyvhinng,2,0.00023,162634,18.89375,860782
12260,kfantonio,2,0.00023,162636,18.89398,860782
12261,KfreeZ,2,0.00023,162638,18.89421,860782
12262,kgtom,2,0.00023,162640,18.89445,860782
12263,kgtw,2,0.00023,162642,18.89468,860782
12264,khalfan123,2,0.00023,162644,18.89491,860782
12265,khiemnd5,2,0.00023,162646,18.89514,860782
12266,KhoaNPA,2,0.00023,162648,18.89538,860782
12267,khrd,2,0.00023,162650,18.89561,860782
12268,khs1994,2,0.00023,162652,18.89584,860782
12269,kibs,2,0.00023,162654,18.89607,860782
12270,kicaj29,2,0.00023,162656,18.89631,860782
12271,kieronlanning,2,0.00023,162658,18.89654,860782
12272,KillerX,2,0.00023,162660,18.89677,860782
12273,kindermoumoute,2,0.00023,162662,18.89700,860782
12274,kinghrothgar,2,0.00023,162664,18.89724,860782
12275,king-jam,2,0.00023,162666,18.89747,860782
12276,kinglionsoft,2,0.00023,162668,18.89770,860782
12277,kingofmooks,2,0.00023,162670,18.89793,860782
12278,King-of-Spades,2,0.00023,162672,18.89816,860782
12279,kintoandar,2,0.00023,162674,18.89840,860782
12280,kinzleb,2,0.00023,162676,18.89863,860782
12281,Kirchen99,2,0.00023,162678,18.89886,860782
12282,kircherlike,2,0.00023,162680,18.89909,860782
12283,kirkdave,2,0.00023,162682,18.89933,860782
12284,kishoregv,2,0.00023,162684,18.89956,860782
12285,kislaykishore,2,0.00023,162686,18.89979,860782
12286,kitattyor,2,0.00023,162688,18.90002,860782
12287,kitsirota,2,0.00023,162690,18.90026,860782
12288,kivagant-ba,2,0.00023,162692,18.90049,860782
12289,Kixiron,2,0.00023,162694,18.90072,860782
12290,kiyutink,2,0.00023,162696,18.90095,860782
12291,kjge,2,0.00023,162698,18.90119,860782
12292,kjo6152,2,0.00023,162700,18.90142,860782
12293,k-kinzal,2,0.00023,162702,18.90165,860782
12294,kkobayachi,2,0.00023,162704,18.90188,860782
12295,kkorekk,2,0.00023,162706,18.90211,860782
12296,kkpatel2025,2,0.00023,162708,18.90235,860782
12297,kkyuri0419,2,0.00023,162710,18.90258,860782
12298,KlausTele,2,0.00023,162712,18.90281,860782
12299,klemens-morgenstern,2,0.00023,162714,18.90304,860782
12300,kleytonohare,2,0.00023,162716,18.90328,860782
12301,klyubin,2,0.00023,162718,18.90351,860782
12302,kmai,2,0.00023,162720,18.90374,860782
12303,k-mckinney,2,0.00023,162722,18.90397,860782
12304,KMFtcy,2,0.00023,162724,18.90421,860782
12305,kmjung,2,0.00023,162726,18.90444,860782
12306,kmk371661,2,0.00023,162728,18.90467,860782
12307,kmr0877,2,0.00023,162730,18.90490,860782
12308,knagu,2,0.00023,162732,18.90514,860782
12309,kncesarini,2,0.00023,162734,18.90537,860782
12310,knowlengr,2,0.00023,162736,18.90560,860782
12311,kobayashi,2,0.00023,162738,18.90583,860782
12312,kochetov-dmitrij,2,0.00023,162740,18.90606,860782
12313,koehn,2,0.00023,162742,18.90630,860782
12314,koenig-dominik,2,0.00023,162744,18.90653,860782
12315,kofl91,2,0.00023,162746,18.90676,860782
12316,kohithms,2,0.00023,162748,18.90699,860782
12317,kohsheen1234,2,0.00023,162750,18.90723,860782
12318,koji117,2,0.00023,162752,18.90746,860782
12319,koliyo,2,0.00023,162754,18.90769,860782
12320,Konmoron,2,0.00023,162756,18.90792,860782
12321,konokimo,2,0.00023,162758,18.90816,860782
12322,kono-paku,2,0.00023,162760,18.90839,860782
12323,kopal2212,2,0.00023,162762,18.90862,860782
12324,korjavin,2,0.00023,162764,18.90885,860782
12325,Kosmas,2,0.00023,162766,18.90908,860782
12326,kostab-sentinel,2,0.00023,162768,18.90932,860782
12327,kostrahb,2,0.00023,162770,18.90955,860782
12328,kosukeoya,2,0.00023,162772,18.90978,860782
12329,Kot-o-pes,2,0.00023,162774,18.91001,860782
12330,kotori2,2,0.00023,162776,18.91025,860782
12331,kozy,2,0.00023,162778,18.91048,860782
12332,Kozzers,2,0.00023,162780,18.91071,860782
12333,kranjcec,2,0.00023,162782,18.91094,860782
12334,kranthi117,2,0.00023,162784,18.91118,860782
12335,kriaos,2,0.00023,162786,18.91141,860782
12336,kriptor,2,0.00023,162788,18.91164,860782
12337,kris520,2,0.00023,162790,18.91187,860782
12338,krish143434,2,0.00023,162792,18.91211,860782
12339,kristapsstrals,2,0.00023,162794,18.91234,860782
12340,kristoflemmens,2,0.00023,162796,18.91257,860782
12341,krjw,2,0.00023,162798,18.91280,860782
12342,krjw-eyev,2,0.00023,162800,18.91303,860782
12343,kromulan,2,0.00023,162802,18.91327,860782
12344,krylovsk,2,0.00023,162804,18.91350,860782
12345,Kryptos-FR,2,0.00023,162806,18.91373,860782
12346,ksanghavi,2,0.00023,162808,18.91396,860782
12347,Ksmith30,2,0.00023,162810,18.91420,860782
12348,ksqsf,2,0.00023,162812,18.91443,860782
12349,kswong-sg,2,0.00023,162814,18.91466,860782
12350,kthommandra,2,0.00023,162816,18.91489,860782
12351,ktumu0225,2,0.00023,162818,18.91513,860782
12352,kubaj,2,0.00023,162820,18.91536,860782
12353,KubeLouis,2,0.00023,162822,18.91559,860782
12354,kubroid,2,0.00023,162824,18.91582,860782
12355,kuhar2007,2,0.00023,162826,18.91606,860782
12356,kumargauravin,2,0.00023,162828,18.91629,860782
12357,kumarvikas2020,2,0.00023,162830,18.91652,860782
12358,Kuri-su,2,0.00023,162832,18.91675,860782
12359,kursattokpinar,2,0.00023,162834,18.91698,860782
12360,kusor,2,0.00023,162836,18.91722,860782
12361,kvaster,2,0.00023,162838,18.91745,860782
12362,kvishweshwar,2,0.00023,162840,18.91768,860782
12363,kwaneung,2,0.00023,162842,18.91791,860782
12364,Kxrr,2,0.00023,162844,18.91815,860782
12365,kycfeel,2,0.00023,162846,18.91838,860782
12366,kycrow32,2,0.00023,162848,18.91861,860782
12367,kylebevans,2,0.00023,162850,18.91884,860782
12368,KyleGobel,2,0.00023,162852,18.91908,860782
12369,kyle--lee,2,0.00023,162854,18.91931,860782
12370,kyohmizu,2,0.00023,162856,18.91954,860782
12371,k-yomo,2,0.00023,162858,18.91977,860782
12372,Kyrklund,2,0.00023,162860,18.92001,860782
12373,kzap,2,0.00023,162862,18.92024,860782
12374,kzidane,2,0.00023,162864,18.92047,860782
12375,l0nax,2,0.00023,162866,18.92070,860782
12376,l30006821,2,0.00023,162868,18.92093,860782
12377,l4z41,2,0.00023,162870,18.92117,860782
12378,lacksfish,2,0.00023,162872,18.92140,860782
12379,ladeit,2,0.00023,162874,18.92163,860782
12380,lakers-jiangxp,2,0.00023,162876,18.92186,860782
12381,lakovmartin,2,0.00023,162878,18.92210,860782
12382,lakshmanpasala,2,0.00023,162880,18.92233,860782
12383,lalala0816,2,0.00023,162882,18.92256,860782
12384,LalexH,2,0.00023,162884,18.92279,860782
12385,lalithsuresh,2,0.00023,162886,18.92303,860782
12386,laloyalo,2,0.00023,162888,18.92326,860782
12387,larde,2,0.00023,162890,18.92349,860782
12388,larstiq,2,0.00023,162892,18.92372,860782
12389,lateparty,2,0.00023,162894,18.92396,860782
12390,Laterality,2,0.00023,162896,18.92419,860782
12391,laurenhughes,2,0.00023,162898,18.92442,860782
12392,laurentzoz,2,0.00023,162900,18.92465,860782
12393,lauriapple2,2,0.00023,162902,18.92488,860782
12394,Lavanya615,2,0.00023,162904,18.92512,860782
12395,lavanyachennupati,2,0.00023,162906,18.92535,860782
12396,LawrenceHecht,2,0.00023,162908,18.92558,860782
12397,ldath,2,0.00023,162910,18.92581,860782
12398,ldoublewood,2,0.00023,162912,18.92605,860782
12399,leandrocostam,2,0.00023,162914,18.92628,860782
12400,lee-byeoksan,2,0.00023,162916,18.92651,860782
12401,leepatrick-goop,2,0.00023,162918,18.92674,860782
12402,lehy786,2,0.00023,162920,18.92698,860782
12403,leigh-j,2,0.00023,162922,18.92721,860782
12404,leimort,2,0.00023,162924,18.92744,860782
12405,Leinad0033,2,0.00023,162926,18.92767,860782
12406,LeiYangGH,2,0.00023,162928,18.92791,860782
12407,LelandSindt,2,0.00023,162930,18.92814,860782
12408,leojonathanoh,2,0.00023,162932,18.92837,860782
12409,leokra,2,0.00023,162934,18.92860,860782
12410,leonaves,2,0.00023,162936,18.92883,860782
12411,leoneo048,2,0.00023,162938,18.92907,860782
12412,leongnaw8,2,0.00023,162940,18.92930,860782
12413,leopay,2,0.00023,162942,18.92953,860782
12414,leoschet,2,0.00023,162944,18.92976,860782
12415,leoweiyu,2,0.00023,162946,18.93000,860782
12416,LeoWenxiang,2,0.00023,162948,18.93023,860782
12417,leslitagordita,2,0.00023,162950,18.93046,860782
12418,levihoover,2,0.00023,162952,18.93069,860782
12419,lexfrei,2,0.00023,162954,18.93093,860782
12420,lezeroq,2,0.00023,162956,18.93116,860782
12421,lfe135,2,0.00023,162958,18.93139,860782
12422,lfzyx,2,0.00023,162960,18.93162,860782
12423,lhb008,2,0.00023,162962,18.93185,860782
12424,LHCGreg,2,0.00023,162964,18.93209,860782
12425,liamkell,2,0.00023,162966,18.93232,860782
12426,lianghao208,2,0.00023,162968,18.93255,860782
12427,liaotx,2,0.00023,162970,18.93278,860782
12428,liarco,2,0.00023,162972,18.93302,860782
12429,Liberxue,2,0.00023,162974,18.93325,860782
12430,licarpen,2,0.00023,162976,18.93348,860782
12431,lichenglin,2,0.00023,162978,18.93371,860782
12432,lichuan0620,2,0.00023,162980,18.93395,860782
12433,lichunzhu,2,0.00023,162982,18.93418,860782
12434,lijiapengsa,2,0.00023,162984,18.93441,860782
12435,lijinghuatongxue,2,0.00023,162986,18.93464,860782
12436,lijun727,2,0.00023,162988,18.93488,860782
12437,limingyao,2,0.00023,162990,18.93511,860782
12438,limpair,2,0.00023,162992,18.93534,860782
12439,lingabalaji17,2,0.00023,162994,18.93557,860782
12440,linqh1,2,0.00023,162996,18.93580,860782
12441,linux-user001,2,0.00023,162998,18.93604,860782
12442,linxing,2,0.00023,163000,18.93627,860782
12443,linzhaoming,2,0.00023,163002,18.93650,860782
12444,linzj3,2,0.00023,163004,18.93673,860782
12445,lionelyoung,2,0.00023,163006,18.93697,860782
12446,LiorBanai,2,0.00023,163008,18.93720,860782
12447,liorhar,2,0.00023,163010,18.93743,860782
12448,liorkesos,2,0.00023,163012,18.93766,860782
12449,lironrisk,2,0.00023,163014,18.93790,860782
12450,lishitiancn,2,0.00023,163016,18.93813,860782
12451,listaction,2,0.00023,163018,18.93836,860782
12452,LittleColin,2,0.00023,163020,18.93859,860782
12453,LittleLampLight,2,0.00023,163022,18.93883,860782
12454,liugangnhm,2,0.00023,163024,18.93906,860782
12455,liulangwa,2,0.00023,163026,18.93929,860782
12456,liutengfei0,2,0.00023,163028,18.93952,860782
12457,Liuxiayu,2,0.00023,163030,18.93975,860782
12458,liuyi520123,2,0.00023,163032,18.93999,860782
12459,liweitianux,2,0.00023,163034,18.94022,860782
12460,liyahui2012,2,0.00023,163036,18.94045,860782
12461,lizhanhui,2,0.00023,163038,18.94068,860782
12462,lizlooney,2,0.00023,163040,18.94092,860782
12463,ljk662,2,0.00023,163042,18.94115,860782
12464,lkh-smile,2,0.00023,163044,18.94138,860782
12465,lliknart,2,0.00023,163046,18.94161,860782
12466,llimon,2,0.00023,163048,18.94185,860782
12467,llnformer,2,0.00023,163050,18.94208,860782
12468,llorllale,2,0.00023,163052,18.94231,860782
12469,lloydchang,2,0.00023,163054,18.94254,860782
12470,llyons,2,0.00023,163056,18.94278,860782
12471,lmcdasm,2,0.00023,163058,18.94301,860782
12472,lmtyler,2,0.00023,163060,18.94324,860782
12473,loa,2,0.00023,163062,18.94347,860782
12474,logbon72,2,0.00023,163064,18.94370,860782
12475,lokeshjain279,2,0.00023,163066,18.94394,860782
12476,lokeshjava28,2,0.00023,163068,18.94417,860782
12477,lomkju,2,0.00023,163070,18.94440,860782
12478,lomniczi,2,0.00023,163072,18.94463,860782
12479,longkai,2,0.00023,163074,18.94487,860782
12480,longmiao1996,2,0.00023,163076,18.94510,860782
12481,lopeg,2,0.00023,163078,18.94533,860782
12482,lordk911,2,0.00023,163080,18.94556,860782
12483,loreleimccollum,2,0.00023,163082,18.94580,860782
12484,lorenzo-david,2,0.00023,163084,18.94603,860782
12485,louiscpalma,2,0.00023,163086,18.94626,860782
12486,louisnow,2,0.00023,163088,18.94649,860782
12487,lovettchris,2,0.00023,163090,18.94673,860782
12488,loxal,2,0.00023,163092,18.94696,860782
12489,lpan,2,0.00023,163094,18.94719,860782
12490,l-rossetti,2,0.00023,163096,18.94742,860782
12491,lruslan,2,0.00023,163098,18.94765,860782
12492,lsarangi1,2,0.00023,163100,18.94789,860782
12493,ls-brentsmith,2,0.00023,163102,18.94812,860782
12494,LSChyi,2,0.00023,163104,18.94835,860782
12495,ls-julien-deruere,2,0.00023,163106,18.94858,860782
12496,lsoica,2,0.00023,163108,18.94882,860782
12497,lspecian-olx,2,0.00023,163110,18.94905,860782
12498,lsyarn,2,0.00023,163112,18.94928,860782
12499,ltamas97,2,0.00023,163114,18.94951,860782
12500,luca-ammann,2,0.00023,163116,18.94975,860782
12501,Lucaarioo,2,0.00023,163118,18.94998,860782
12502,lucacasonato,2,0.00023,163120,18.95021,860782
12503,lucaghersi,2,0.00023,163122,18.95044,860782
12504,lucasarnulphy,2,0.00023,163124,18.95068,860782
12505,Lucas-H-NE,2,0.00023,163126,18.95091,860782
12506,lucaslcode,2,0.00023,163128,18.95114,860782
12507,lucasOliveira91,2,0.00023,163130,18.95137,860782
12508,lucaspouzac,2,0.00023,163132,18.95160,860782
12509,lucatk,2,0.00023,163134,18.95184,860782
12510,lucienfregosi,2,0.00023,163136,18.95207,860782
12511,lucinvitae,2,0.00023,163138,18.95230,860782
12512,luckydonald,2,0.00023,163140,18.95253,860782
12513,luckymagic7,2,0.00023,163142,18.95277,860782
12514,ludov04,2,0.00023,163144,18.95300,860782
12515,Luffy110,2,0.00023,163146,18.95323,860782
12516,luislhl,2,0.00023,163148,18.95346,860782
12517,LuisRG-GIG,2,0.00023,163150,18.95370,860782
12518,lukadante,2,0.00023,163152,18.95393,860782
12519,lukasgit,2,0.00023,163154,18.95416,860782
12520,luks,2,0.00023,163156,18.95439,860782
12521,LuluGO,2,0.00023,163158,18.95462,860782
12522,lummie,2,0.00023,163160,18.95486,860782
12523,luomoyisheng,2,0.00023,163162,18.95509,860782
12524,lvcaiping,2,0.00023,163164,18.95532,860782
12525,lvfei103650,2,0.00023,163166,18.95555,860782
12526,LWJ,2,0.00023,163168,18.95579,860782
12527,lw-mgr,2,0.00023,163170,18.95602,860782
12528,lwx294821,2,0.00023,163172,18.95625,860782
12529,lx308033262,2,0.00023,163174,18.95648,860782
12530,lypee,2,0.00023,163176,18.95672,860782
12531,lysliu,2,0.00023,163178,18.95695,860782
12532,LYU2026,2,0.00023,163180,18.95718,860782
12533,lzp0412,2,0.00023,163182,18.95741,860782
12534,m0rganic,2,0.00023,163184,18.95765,860782
12535,m287867,2,0.00023,163186,18.95788,860782
12536,m-abramovich,2,0.00023,163188,18.95811,860782
12537,maclockard,2,0.00023,163190,18.95834,860782
12538,macon,2,0.00023,163192,18.95857,860782
12539,MaConch,2,0.00023,163194,18.95881,860782
12540,madari,2,0.00023,163196,18.95904,860782
12541,madkote,2,0.00023,163198,18.95927,860782
12542,Maellooou,2,0.00023,163200,18.95950,860782
12543,maemigh,2,0.00023,163202,18.95974,860782
12544,maganaluis,2,0.00023,163204,18.95997,860782
12545,magescher,2,0.00023,163206,18.96020,860782
12546,magsoftware,2,0.00023,163208,18.96043,860782
12547,magthe,2,0.00023,163210,18.96067,860782
12548,maheshvra,2,0.00023,163212,18.96090,860782
12549,maicloudy,2,0.00023,163214,18.96113,860782
12550,maierlars,2,0.00023,163216,18.96136,860782
12551,mailprak,2,0.00023,163218,18.96160,860782
12552,Mais316,2,0.00023,163220,18.96183,860782
12553,maja42,2,0.00023,163222,18.96206,860782
12554,Majkl578,2,0.00023,163224,18.96229,860782
12555,makeItFuckingSustainable,2,0.00023,163226,18.96252,860782
12556,MakeshKathirvel,2,0.00023,163228,18.96276,860782
12557,makocchi-ca,2,0.00023,163230,18.96299,860782
12558,maktas,2,0.00023,163232,18.96322,860782
12559,malesgurd,2,0.00023,163234,18.96345,860782
12560,malkov82,2,0.00023,163236,18.96369,860782
12561,maltfield,2,0.00023,163238,18.96392,860782
12562,Mamba24L8,2,0.00023,163240,18.96415,860782
12563,mamiu,2,0.00023,163242,18.96438,860782
12564,mamullen13316,2,0.00023,163244,18.96462,860782
12565,MANA-1991,2,0.00023,163246,18.96485,860782
12566,manderson-it,2,0.00023,163248,18.96508,860782
12567,manikandanrapyder,2,0.00023,163250,18.96531,860782
12568,manikanta-kondeti,2,0.00023,163252,18.96555,860782
12569,maninp,2,0.00023,163254,18.96578,860782
12570,manish-eros,2,0.00023,163256,18.96601,860782
12571,manuel-koch,2,0.00023,163258,18.96624,860782
12572,manuelnp,2,0.00023,163260,18.96647,860782
12573,manupstairs,2,0.00023,163262,18.96671,860782
12574,manute,2,0.00023,163264,18.96694,860782
12575,mapdegree,2,0.00023,163266,18.96717,860782
12576,marandall,2,0.00023,163268,18.96740,860782
12577,maratsal,2,0.00023,163270,18.96764,860782
12578,MarcelTon,2,0.00023,163272,18.96787,860782
12579,marcinkoperski,2,0.00023,163274,18.96810,860782
12580,marcinma,2,0.00023,163276,18.96833,860782
12581,marcin-ptaszynski,2,0.00023,163278,18.96857,860782
12582,marcoacarvalho,2,0.00023,163280,18.96880,860782
12583,marcominetti,2,0.00023,163282,18.96903,860782
12584,marcoroganovic,2,0.00023,163284,18.96926,860782
12585,marcossv9,2,0.00023,163286,18.96950,860782
12586,marionxue,2,0.00023,163288,18.96973,860782
12587,mariusmotea,2,0.00023,163290,18.96996,860782
12588,MarkDeckert,2,0.00023,163292,18.97019,860782
12589,MarkIannucci,2,0.00023,163294,18.97042,860782
12590,markivancho,2,0.00023,163296,18.97066,860782
12591,markjfletcher,2,0.00023,163298,18.97089,860782
12592,markliederbach,2,0.00023,163300,18.97112,860782
12593,marklinders-planon,2,0.00023,163302,18.97135,860782
12594,marklshep,2,0.00023,163304,18.97159,860782
12595,markmsmith,2,0.00023,163306,18.97182,860782
12596,markoa,2,0.00023,163308,18.97205,860782
12597,markpundsack,2,0.00023,163310,18.97228,860782
12598,markstos,2,0.00023,163312,18.97252,860782
12599,markusheiden,2,0.00023,163314,18.97275,860782
12600,marouanabbessi,2,0.00023,163316,18.97298,860782
12601,martin-jamszolik,2,0.00023,163318,18.97321,860782
12602,MartinKirchner,2,0.00023,163320,18.97345,860782
12603,Martinnilsen99,2,0.00023,163322,18.97368,860782
12604,martinohansen,2,0.00023,163324,18.97391,860782
12605,MartinPotier,2,0.00023,163326,18.97414,860782
12606,MartinPriebe,2,0.00023,163328,18.97437,860782
12607,martin-schaefer,2,0.00023,163330,18.97461,860782
12608,martin-schibsted,2,0.00023,163332,18.97484,860782
12609,Martin-Weiss,2,0.00023,163334,18.97507,860782
12610,martrs,2,0.00023,163336,18.97530,860782
12611,marufmax,2,0.00023,163338,18.97554,860782
12612,maryamklabib,2,0.00023,163340,18.97577,860782
12613,marybe,2,0.00023,163342,18.97600,860782
12614,masarlabs,2,0.00023,163344,18.97623,860782
12615,mash-graz,2,0.00023,163346,18.97647,860782
12616,mat-613,2,0.00023,163348,18.97670,860782
12617,MatayoshiMariano,2,0.00023,163350,18.97693,860782
12618,mateusz-pietrzak,2,0.00023,163352,18.97716,860782
12619,matevz,2,0.00023,163354,18.97739,860782
12620,matias-devoto,2,0.00023,163356,18.97763,860782
12621,maticko,2,0.00023,163358,18.97786,860782
12622,matscederholm,2,0.00023,163360,18.97809,860782
12623,matt-canty-dragon,2,0.00023,163362,18.97832,860782
12624,Matt-Dee,2,0.00023,163364,18.97856,860782
12625,mattdodge,2,0.00023,163366,18.97879,860782
12626,matthaywardwebdesign,2,0.00023,163368,18.97902,860782
12627,matthew-horrocks,2,0.00023,163370,18.97925,860782
12628,matthewmichihara,2,0.00023,163372,18.97949,860782
12629,matti125,2,0.00023,163374,18.97972,860782
12630,mattiaforc,2,0.00023,163376,18.97995,860782
12631,MattiasSeeman,2,0.00023,163378,18.98018,860782
12632,mattjohnson,2,0.00023,163380,18.98042,860782
12633,mattpaletta,2,0.00023,163382,18.98065,860782
12634,mattrcampbell,2,0.00023,163384,18.98088,860782
12635,mattsanta,2,0.00023,163386,18.98111,860782
12636,mattskone,2,0.00023,163388,18.98134,860782
12637,mattwilliamson,2,0.00023,163390,18.98158,860782
12638,mattwillsher,2,0.00023,163392,18.98181,860782
12639,mattyev87,2,0.00023,163394,18.98204,860782
12640,Mauratay,2,0.00023,163396,18.98227,860782
12641,maurizio-lattuada,2,0.00023,163398,18.98251,860782
12642,mavenishere,2,0.00023,163400,18.98274,860782
12643,max8github,2,0.00023,163402,18.98297,860782
12644,maxcanna,2,0.00023,163404,18.98320,860782
12645,maximerenou50,2,0.00023,163406,18.98344,860782
12646,MaximilianMeister,2,0.00023,163408,18.98367,860782
12647,maximmold,2,0.00023,163410,18.98390,860782
12648,mayerg11,2,0.00023,163412,18.98413,860782
12649,mayukuse24,2,0.00023,163414,18.98437,860782
12650,mazen-hasoun,2,0.00023,163416,18.98460,860782
12651,mbanck,2,0.00023,163418,18.98483,860782
12652,mbaroody,2,0.00023,163420,18.98506,860782
12653,mberkow,2,0.00023,163422,18.98529,860782
12654,mbernasocchi,2,0.00023,163424,18.98553,860782
12655,mbs-c,2,0.00023,163426,18.98576,860782
12656,mbugert,2,0.00023,163428,18.98599,860782
12657,mcieplak,2,0.00023,163430,18.98622,860782
12658,mcsos,2,0.00023,163432,18.98646,860782
12659,mctata,2,0.00023,163434,18.98669,860782
12660,mdedetrich,2,0.00023,163436,18.98692,860782
12661,mdekrey,2,0.00023,163438,18.98715,860782
12662,mdmustafa1,2,0.00023,163440,18.98739,860782
12663,mdone-cloudian,2,0.00023,163442,18.98762,860782
12664,mdrobniu,2,0.00023,163444,18.98785,860782
12665,mds1455975151,2,0.00023,163446,18.98808,860782
12666,md-shabbir,2,0.00023,163448,18.98832,860782
12667,mdvorak,2,0.00023,163450,18.98855,860782
12668,meappy,2,0.00023,163452,18.98878,860782
12669,medhioub,2,0.00023,163454,18.98901,860782
12670,meghanagupta,2,0.00023,163456,18.98924,860782
12671,mehmetf,2,0.00023,163458,18.98948,860782
12672,mehrdadn,2,0.00023,163460,18.98971,860782
12673,mei-ling,2,0.00023,163462,18.98994,860782
12674,MelwinKfr,2,0.00023,163464,18.99017,860782
12675,Mengjianhua-c,2,0.00023,163466,18.99041,860782
12676,meniem,2,0.00023,163468,18.99064,860782
12677,Mercwri,2,0.00023,163470,18.99087,860782
12678,merishlalla,2,0.00023,163472,18.99110,860782
12679,metacyclic,2,0.00023,163474,18.99134,860782
12680,metasim,2,0.00023,163476,18.99157,860782
12681,metatick,2,0.00023,163478,18.99180,860782
12682,metro44060,2,0.00023,163480,18.99203,860782
12683,mformetal,2,0.00023,163482,18.99227,860782
12684,mfranklin,2,0.00023,163484,18.99250,860782
12685,mgerhardy,2,0.00023,163486,18.99273,860782
12686,mgonzaga1990,2,0.00023,163488,18.99296,860782
12687,mgxian,2,0.00023,163490,18.99319,860782
12688,mhaebler,2,0.00023,163492,18.99343,860782
12689,mhenniges,2,0.00023,163494,18.99366,860782
12690,mhoshim,2,0.00023,163496,18.99389,860782
12691,miaowing,2,0.00023,163498,18.99412,860782
12692,michael-bouvy,2,0.00023,163500,18.99436,860782
12693,michaeldbianchi,2,0.00023,163502,18.99459,860782
12694,michaeljoy,2,0.00023,163504,18.99482,860782
12695,MichaelKissling,2,0.00023,163506,18.99505,860782
12696,MichaelKueller,2,0.00023,163508,18.99529,860782
12697,MichaelMitchellM,2,0.00023,163510,18.99552,860782
12698,michaelstoica,2,0.00023,163512,18.99575,860782
12699,michelaquino,2,0.00023,163514,18.99598,860782
12700,MichelleNiedernhuber,2,0.00023,163516,18.99622,860782
12701,MichelleZ,2,0.00023,163518,18.99645,860782
12702,mick62,2,0.00023,163520,18.99668,860782
12703,mickmcgrath13,2,0.00023,163522,18.99691,860782
12704,mickstevenson,2,0.00023,163524,18.99714,860782
12705,micmax93,2,0.00023,163526,18.99738,860782
12706,micseydel,2,0.00023,163528,18.99761,860782
12707,micya,2,0.00023,163530,18.99784,860782
12708,midopooler,2,0.00023,163532,18.99807,860782
12709,mie00,2,0.00023,163534,18.99831,860782
12710,miecio45,2,0.00023,163536,18.99854,860782
12711,Mierpo,2,0.00023,163538,18.99877,860782
12712,MiguelElGallo,2,0.00023,163540,18.99900,860782
12713,mihaigalos,2,0.00023,163542,18.99924,860782
12714,mihailgmihaylov,2,0.00023,163544,18.99947,860782
12715,mihmatache,2,0.00023,163546,18.99970,860782
12716,mijamo,2,0.00023,163548,18.99993,860782
12717,mikalegall,2,0.00023,163550,19.00016,860782
12718,mik-dass,2,0.00023,163552,19.00040,860782
12719,mikecook,2,0.00023,163554,19.00063,860782
12720,mikeh2020,2,0.00023,163556,19.00086,860782
12721,MikeSofaer,2,0.00023,163558,19.00109,860782
12722,mikesplainsonos,2,0.00023,163560,19.00133,860782
12723,mikestef9,2,0.00023,163562,19.00156,860782
12724,MilanDasek,2,0.00023,163564,19.00179,860782
12725,millermatt,2,0.00023,163566,19.00202,860782
12726,ming2020,2,0.00023,163568,19.00226,860782
12727,mingyuejishi,2,0.00023,163570,19.00249,860782
12728,minhnnhat,2,0.00023,163572,19.00272,860782
12729,MiniPierre,2,0.00023,163574,19.00295,860782
12730,Minshu123,2,0.00023,163576,19.00319,860782
12731,minxuancao,2,0.00023,163578,19.00342,860782
12732,minyblossom,2,0.00023,163580,19.00365,860782
12733,Minyus,2,0.00023,163582,19.00388,860782
12734,miron9,2,0.00023,163584,19.00411,860782
12735,MischaPanch,2,0.00023,163586,19.00435,860782
12736,misha-ridge,2,0.00023,163588,19.00458,860782
12737,Mishraom99,2,0.00023,163590,19.00481,860782
12738,miso231,2,0.00023,163592,19.00504,860782
12739,MitchDart,2,0.00023,163594,19.00528,860782
12740,mitesh51,2,0.00023,163596,19.00551,860782
12741,mjallday,2,0.00023,163598,19.00574,860782
12742,mjavier2k,2,0.00023,163600,19.00597,860782
12743,mjm19091979,2,0.00023,163602,19.00621,860782
12744,mjsjinsu,2,0.00023,163604,19.00644,860782
12745,mKamleiter,2,0.00023,163606,19.00667,860782
12746,mkbhanda,2,0.00023,163608,19.00690,860782
12747,mkostersitz,2,0.00023,163610,19.00714,860782
12748,ml-,2,0.00023,163612,19.00737,860782
12749,mleneveut,2,0.00023,163614,19.00760,860782
12750,mlouage,2,0.00023,163616,19.00783,860782
12751,mmajko,2,0.00023,163618,19.00806,860782
12752,mmatusiak-atlassian,2,0.00023,163620,19.00830,860782
12753,mmerkes,2,0.00023,163622,19.00853,860782
12754,m-messiah,2,0.00023,163624,19.00876,860782
12755,mmohaveri,2,0.00023,163626,19.00899,860782
12756,mmouly,2,0.00023,163628,19.00923,860782
12757,mmusleh75,2,0.00023,163630,19.00946,860782
12758,mnaseef-gloo,2,0.00023,163632,19.00969,860782
12759,mnorrsken,2,0.00023,163634,19.00992,860782
12760,modir,2,0.00023,163636,19.01016,860782
12761,moeidsaleem,2,0.00023,163638,19.01039,860782
12762,Moep90,2,0.00023,163640,19.01062,860782
12763,moficodes,2,0.00023,163642,19.01085,860782
12764,mohag1412,2,0.00023,163644,19.01109,860782
12765,mohameddahrouj,2,0.00023,163646,19.01132,860782
12766,mohamedelbahr,2,0.00023,163648,19.01155,860782
12767,MohamedKhelifi,2,0.00023,163650,19.01178,860782
12768,mohammadasim,2,0.00023,163652,19.01201,860782
12769,mohammaddvlpr,2,0.00023,163654,19.01225,860782
12770,MohanSai1997,2,0.00023,163656,19.01248,860782
12771,moijes12,2,0.00023,163658,19.01271,860782
12772,molgor,2,0.00023,163660,19.01294,860782
12773,mo-mirzania,2,0.00023,163662,19.01318,860782
12774,monester,2,0.00023,163664,19.01341,860782
12775,montanaflynn,2,0.00023,163666,19.01364,860782
12776,moosahmed,2,0.00023,163668,19.01387,860782
12777,moosecanswim,2,0.00023,163670,19.01411,860782
12778,moreqpi,2,0.00023,163672,19.01434,860782
12779,moret,2,0.00023,163674,19.01457,860782
12780,morgoved,2,0.00023,163676,19.01480,860782
12781,moritz31,2,0.00023,163678,19.01504,860782
12782,moriyahazan,2,0.00023,163680,19.01527,860782
12783,mornindew,2,0.00023,163682,19.01550,860782
12784,MorphBonehunter,2,0.00023,163684,19.01573,860782
12785,MosaicThingsIoT,2,0.00023,163686,19.01596,860782
12786,Moser-ss,2,0.00023,163688,19.01620,860782
12787,mostafa-eltaher,2,0.00023,163690,19.01643,860782
12788,mouyang,2,0.00023,163692,19.01666,860782
12789,movd,2,0.00023,163694,19.01689,860782
12790,mozts2005,2,0.00023,163696,19.01713,860782
12791,mpahic,2,0.00023,163698,19.01736,860782
12792,MPickfield,2,0.00023,163700,19.01759,860782
12793,mpouyakh7,2,0.00023,163702,19.01782,860782
12794,mpreu,2,0.00023,163704,19.01806,860782
12795,mpsq,2,0.00023,163706,19.01829,860782
12796,mrafayaleem,2,0.00023,163708,19.01852,860782
12797,mramanathan,2,0.00023,163710,19.01875,860782
12798,MrArtichaut,2,0.00023,163712,19.01899,860782
12799,mrasband,2,0.00023,163714,19.01922,860782
12800,MrAta,2,0.00023,163716,19.01945,860782
12801,mr-bjerre,2,0.00023,163718,19.01968,860782
12802,mrbusche,2,0.00023,163720,19.01991,860782
12803,mreferre,2,0.00023,163722,19.02015,860782
12804,mrethers,2,0.00023,163724,19.02038,860782
12805,mristok,2,0.00023,163726,19.02061,860782
12806,mrjoesm,2,0.00023,163728,19.02084,860782
12807,mrlesmithjr,2,0.00023,163730,19.02108,860782
12808,mr-maksimov,2,0.00023,163732,19.02131,860782
12809,MrMikeFloyd,2,0.00023,163734,19.02154,860782
12810,MRostanski,2,0.00023,163736,19.02177,860782
12811,mrPsycho,2,0.00023,163738,19.02201,860782
12812,mr-rick,2,0.00023,163740,19.02224,860782
12813,mrshengzyzy,2,0.00023,163742,19.02247,860782
12814,mrtsrdm,2,0.00023,163744,19.02270,860782
12815,mruoss,2,0.00023,163746,19.02293,860782
12816,msatyan,2,0.00023,163748,19.02317,860782
12817,mschmidt1208,2,0.00023,163750,19.02340,860782
12818,msh111,2,0.00023,163752,19.02363,860782
12819,mshade,2,0.00023,163754,19.02386,860782
12820,mshivanna,2,0.00023,163756,19.02410,860782
12821,m-soltani,2,0.00023,163758,19.02433,860782
12822,MStausberg,2,0.00023,163760,19.02456,860782
12823,mstavrev,2,0.00023,163762,19.02479,860782
12824,mstevens-a3,2,0.00023,163764,19.02503,860782
12825,m-tanner,2,0.00023,163766,19.02526,860782
12826,mtatheonly,2,0.00023,163768,19.02549,860782
12827,mtessun,2,0.00023,163770,19.02572,860782
12828,mthird,2,0.00023,163772,19.02596,860782
12829,mtribes-ops,2,0.00023,163774,19.02619,860782
12830,mtryfoss,2,0.00023,163776,19.02642,860782
12831,mujibishola,2,0.00023,163778,19.02665,860782
12832,mukeshchouhan,2,0.00023,163780,19.02688,860782
12833,mumbleskates,2,0.00023,163782,19.02712,860782
12834,muralibabu,2,0.00023,163784,19.02735,860782
12835,muratcabuk,2,0.00023,163786,19.02758,860782
12836,murmur-wheel,2,0.00023,163788,19.02781,860782
12837,Murphy-OrangeMud,2,0.00023,163790,19.02805,860782
12838,mustufa5689,2,0.00023,163792,19.02828,860782
12839,muthu31kumar,2,0.00023,163794,19.02851,860782
12840,muzcategui1106-gs,2,0.00023,163796,19.02874,860782
12841,mvaknine,2,0.00023,163798,19.02898,860782
12842,mvalsells,2,0.00023,163800,19.02921,860782
12843,mwaggonerzam,2,0.00023,163802,19.02944,860782
12844,myersjustinc,2,0.00023,163804,19.02967,860782
12845,mygityf,2,0.00023,163806,19.02991,860782
12846,mymtak,2,0.00023,163808,19.03014,860782
12847,mysticaltech,2,0.00023,163810,19.03037,860782
12848,mythio,2,0.00023,163812,19.03060,860782
12849,myvelcn,2,0.00023,163814,19.03083,860782
12850,mzahorik,2,0.00023,163816,19.03107,860782
12851,mzdunek93,2,0.00023,163818,19.03130,860782
12852,n2aws,2,0.00023,163820,19.03153,860782
12853,nadundesilva,2,0.00023,163822,19.03176,860782
12854,na-ga,2,0.00023,163824,19.03200,860782
12855,nagisa,2,0.00023,163826,19.03223,860782
12856,nagstaku,2,0.00023,163828,19.03246,860782
12857,naikajah,2,0.00023,163830,19.03269,860782
12858,namaggarwal,2,0.00023,163832,19.03293,860782
12859,namaiiee2222,2,0.00023,163834,19.03316,860782
12860,namewxt1220,2,0.00023,163836,19.03339,860782
12861,namidairo777,2,0.00023,163838,19.03362,860782
12862,Nam-kyu,2,0.00023,163840,19.03386,860782
12863,namsoila,2,0.00023,163842,19.03409,860782
12864,nancybelser,2,0.00023,163844,19.03432,860782
12865,nancy-star,2,0.00023,163846,19.03455,860782
12866,nandaloussiBabylon,2,0.00023,163848,19.03478,860782
12867,nandeepmannava,2,0.00023,163850,19.03502,860782
12868,NandiniJB,2,0.00023,163852,19.03525,860782
12869,nanil4568,2,0.00023,163854,19.03548,860782
12870,nao-ri,2,0.00023,163856,19.03571,860782
12871,NaPs,2,0.00023,163858,19.03595,860782
12872,NaraVen,2,0.00023,163860,19.03618,860782
12873,narendranathreddythota,2,0.00023,163862,19.03641,860782
12874,narimantos,2,0.00023,163864,19.03664,860782
12875,narsii4u,2,0.00023,163866,19.03688,860782
12876,natcohen,2,0.00023,163868,19.03711,860782
12877,natemara,2,0.00023,163870,19.03734,860782
12878,nathan-b,2,0.00023,163872,19.03757,860782
12879,nathanwebsterdotme,2,0.00023,163874,19.03781,860782
12880,naturalwarren,2,0.00023,163876,19.03804,860782
12881,naveen27232,2,0.00023,163878,19.03827,860782
12882,naveenb29,2,0.00023,163880,19.03850,860782
12883,naveverm,2,0.00023,163882,19.03873,860782
12884,navinjoy,2,0.00023,163884,19.03897,860782
12885,nbenaglia,2,0.00023,163886,19.03920,860782
12886,nberlee,2,0.00023,163888,19.03943,860782
12887,nbn,2,0.00023,163890,19.03966,860782
12888,ncresswell,2,0.00023,163892,19.03990,860782
12889,ncri,2,0.00023,163894,19.04013,860782
12890,nd4pa,2,0.00023,163896,19.04036,860782
12891,ndascanio-asapp,2,0.00023,163898,19.04059,860782
12892,ne1000,2,0.00023,163900,19.04083,860782
12893,nealey,2,0.00023,163902,19.04106,860782
12894,nebi-frame,2,0.00023,163904,19.04129,860782
12895,nee1esh,2,0.00023,163906,19.04152,860782
12896,neel229,2,0.00023,163908,19.04176,860782
12897,neetra,2,0.00023,163910,19.04199,860782
12898,neilengineer,2,0.00023,163912,19.04222,860782
12899,NeilFataway,2,0.00023,163914,19.04245,860782
12900,neilghosh,2,0.00023,163916,19.04268,860782
12901,neil-pozetroninc,2,0.00023,163918,19.04292,860782
12902,nekator,2,0.00023,163920,19.04315,860782
12903,Neki,2,0.00023,163922,19.04338,860782
12904,nekinie,2,0.00023,163924,19.04361,860782
12905,Nemo157,2,0.00023,163926,19.04385,860782
12906,nemox,2,0.00023,163928,19.04408,860782
12907,nenadzaric,2,0.00023,163930,19.04431,860782
12908,NeolithEra,2,0.00023,163932,19.04454,860782
12909,nerdeveloper,2,0.00023,163934,19.04478,860782
12910,nerixim,2,0.00023,163936,19.04501,860782
12911,netent-perty,2,0.00023,163938,19.04524,860782
12912,nethi,2,0.00023,163940,19.04547,860782
12913,nevishs,2,0.00023,163942,19.04570,860782
12914,nghialt,2,0.00023,163944,19.04594,860782
12915,nglynn,2,0.00023,163946,19.04617,860782
12916,nguyenuet,2,0.00023,163948,19.04640,860782
12917,nhinds,2,0.00023,163950,19.04663,860782
12918,nhudson,2,0.00023,163952,19.04687,860782
12919,nHurD,2,0.00023,163954,19.04710,860782
12920,nicholaspier,2,0.00023,163956,19.04733,860782
12921,nickm924,2,0.00023,163958,19.04756,860782
12922,Nickoriuk,2,0.00023,163960,19.04780,860782
12923,nickwebha,2,0.00023,163962,19.04803,860782
12924,nickytd,2,0.00023,163964,19.04826,860782
12925,nicoclau,2,0.00023,163966,19.04849,860782
12926,nicolas-g,2,0.00023,163968,19.04873,860782
12927,nicolasscaerou,2,0.00023,163970,19.04896,860782
12928,nicolassdiaz,2,0.00023,163972,19.04919,860782
12929,nid06,2,0.00023,163974,19.04942,860782
12930,nielstanis,2,0.00023,163976,19.04965,860782
12931,nielsvbrecht,2,0.00023,163978,19.04989,860782
12932,niemyjski,2,0.00023,163980,19.05012,860782
12933,niketh,2,0.00023,163982,19.05035,860782
12934,niketjsh,2,0.00023,163984,19.05058,860782
12935,nikhilgorantla,2,0.00023,163986,19.05082,860782
12936,nikinaydenov,2,0.00023,163988,19.05105,860782
12937,niklaskorz,2,0.00023,163990,19.05128,860782
12938,niklun,2,0.00023,163992,19.05151,860782
12939,NikoGrano,2,0.00023,163994,19.05175,860782
12940,NikVolf,2,0.00023,163996,19.05198,860782
12941,nileshkumar01,2,0.00023,163998,19.05221,860782
12942,ninzavivek,2,0.00023,164000,19.05244,860782
12943,niranjan94,2,0.00023,164002,19.05268,860782
12944,nirmal-nath,2,0.00023,164004,19.05291,860782
12945,nirousseau,2,0.00023,164006,19.05314,860782
12946,nishant-ketu,2,0.00023,164008,19.05337,860782
12947,nishit93-hub,2,0.00023,164010,19.05360,860782
12948,nissrinchanisse,2,0.00023,164012,19.05384,860782
12949,nitesh-sharma-trilio,2,0.00023,164014,19.05407,860782
12950,Nitesh-vaidyanath,2,0.00023,164016,19.05430,860782
12951,nitinkapur,2,0.00023,164018,19.05453,860782
12952,nitinmuteja,2,0.00023,164020,19.05477,860782
12953,niuqg,2,0.00023,164022,19.05500,860782
12954,njduck,2,0.00023,164024,19.05523,860782
12955,njohnjoel,2,0.00023,164026,19.05546,860782
12956,nkol,2,0.00023,164028,19.05570,860782
12957,nkprince007,2,0.00023,164030,19.05593,860782
12958,nkukard,2,0.00023,164032,19.05616,860782
12959,nmenant,2,0.00023,164034,19.05639,860782
12960,nmeyerhans,2,0.00023,164036,19.05663,860782
12961,nmizeb,2,0.00023,164038,19.05686,860782
12962,nnasaki,2,0.00023,164040,19.05709,860782
12963,noahdietz,2,0.00023,164042,19.05732,860782
12964,noamarbel,2,0.00023,164044,19.05755,860782
12965,nodox,2,0.00023,164046,19.05779,860782
12966,noelleleigh,2,0.00023,164048,19.05802,860782
12967,nofalx,2,0.00023,164050,19.05825,860782
12968,Noksa,2,0.00023,164052,19.05848,860782
12969,NolanChan,2,0.00023,164054,19.05872,860782
12970,nomansadiq11,2,0.00023,164056,19.05895,860782
12971,nomatterz,2,0.00023,164058,19.05918,860782
12972,nomeelnoj,2,0.00023,164060,19.05941,860782
12973,nomis-rzp,2,0.00023,164062,19.05965,860782
12974,nonbob,2,0.00023,164064,19.05988,860782
12975,nonnontrivial,2,0.00023,164066,19.06011,860782
12976,nor-ko,2,0.00023,164068,19.06034,860782
12977,NormJohnIV,2,0.00023,164070,19.06058,860782
12978,noseratio,2,0.00023,164072,19.06081,860782
12979,nosqldb,2,0.00023,164074,19.06104,860782
12980,notjulian,2,0.00023,164076,19.06127,860782
12981,Novex,2,0.00023,164078,19.06150,860782
12982,nowke,2,0.00023,164080,19.06174,860782
12983,npulikanti,2,0.00023,164082,19.06197,860782
12984,nqd,2,0.00023,164084,19.06220,860782
12985,nrchakradhar,2,0.00023,164086,19.06243,860782
12986,nritsche,2,0.00023,164088,19.06267,860782
12987,nshampur,2,0.00023,164090,19.06290,860782
12988,nsmith5,2,0.00023,164092,19.06313,860782
12989,ntnchrrn07,2,0.00023,164094,19.06336,860782
12990,ntsh999,2,0.00023,164096,19.06360,860782
12991,nuarc,2,0.00023,164098,19.06383,860782
12992,nucleusv,2,0.00023,164100,19.06406,860782
12993,nucz,2,0.00023,164102,19.06429,860782
12994,nuharaf,2,0.00023,164104,19.06453,860782
12995,Numblesix,2,0.00023,164106,19.06476,860782
12996,nvidhub,2,0.00023,164108,19.06499,860782
12997,nvx,2,0.00023,164110,19.06522,860782
12998,nwbvt,2,0.00023,164112,19.06545,860782
12999,NW-MLakin,2,0.00023,164114,19.06569,860782
13000,Nyefan,2,0.00023,164116,19.06592,860782
13001,oana-samfirescu,2,0.00023,164118,19.06615,860782
13002,obawin,2,0.00023,164120,19.06638,860782
13003,obensouda,2,0.00023,164122,19.06662,860782
13004,obhadeka,2,0.00023,164124,19.06685,860782
13005,object88,2,0.00023,164126,19.06708,860782
13006,obolobova,2,0.00023,164128,19.06731,860782
13007,ocassetti,2,0.00023,164130,19.06755,860782
13008,ocisly,2,0.00023,164132,19.06778,860782
13009,ocket8888,2,0.00023,164134,19.06801,860782
13010,oconnelc,2,0.00023,164136,19.06824,860782
13011,ofrivera,2,0.00023,164138,19.06847,860782
13012,ofsaleem,2,0.00023,164140,19.06871,860782
13013,ogra,2,0.00023,164142,19.06894,860782
13014,oguzhanaygn,2,0.00023,164144,19.06917,860782
13015,ohmyhusky,2,0.00023,164146,19.06940,860782
13016,OIUE,2,0.00023,164148,19.06964,860782
13017,ojaswa1942,2,0.00023,164150,19.06987,860782
13018,okapies,2,0.00023,164152,19.07010,860782
13019,OkBeacon,2,0.00023,164154,19.07033,860782
13020,okwunna,2,0.00023,164156,19.07057,860782
13021,olavt,2,0.00023,164158,19.07080,860782
13022,Oldsouldier,2,0.00023,164160,19.07103,860782
13023,oldthreefeng,2,0.00023,164162,19.07126,860782
13024,olearycrew,2,0.00023,164164,19.07150,860782
13025,olegchorny,2,0.00023,164166,19.07173,860782
13026,OleksandrGavryliukTR,2,0.00023,164168,19.07196,860782
13027,olevski,2,0.00023,164170,19.07219,860782
13028,olib963,2,0.00023,164172,19.07242,860782
13029,oli-obk,2,0.00023,164174,19.07266,860782
13030,Oliveirakun,2,0.00023,164176,19.07289,860782
13031,OliverCole,2,0.00023,164178,19.07312,860782
13032,OliverLeighC,2,0.00023,164180,19.07335,860782
13033,ollyjshaw,2,0.00023,164182,19.07359,860782
13034,omarzouk,2,0.00023,164184,19.07382,860782
13035,omerli,2,0.00023,164186,19.07405,860782
13036,Omprakash50,2,0.00023,164188,19.07428,860782
13037,omriarieli,2,0.00023,164190,19.07452,860782
13038,ondrejtomcik,2,0.00023,164192,19.07475,860782
13039,OneFirefly,2,0.00023,164194,19.07498,860782
13040,Onlinehead,2,0.00023,164196,19.07521,860782
13041,onyn,2,0.00023,164198,19.07545,860782
13042,oocx,2,0.00023,164200,19.07568,860782
13043,oofnikj,2,0.00023,164202,19.07591,860782
13044,open-richard,2,0.00023,164204,19.07614,860782
13045,openrory,2,0.00023,164206,19.07637,860782
13046,operatorequals,2,0.00023,164208,19.07661,860782
13047,optix2000,2,0.00023,164210,19.07684,860782
13048,oren-nonamesecurity,2,0.00023,164212,19.07707,860782
13049,orirawlings,2,0.00023,164214,19.07730,860782
13050,orodbhen,2,0.00023,164216,19.07754,860782
13051,oseiberts11,2,0.00023,164218,19.07777,860782
13052,oslet,2,0.00023,164220,19.07800,860782
13053,ostavnaas,2,0.00023,164222,19.07823,860782
13054,otri,2,0.00023,164224,19.07847,860782
13055,oxr463,2,0.00023,164226,19.07870,860782
13056,ozhuang,2,0.00023,164228,19.07893,860782
13057,p3t3rp3pp3r,2,0.00023,164230,19.07916,860782
13058,pachico,2,0.00023,164232,19.07940,860782
13059,page4,2,0.00023,164234,19.07963,860782
13060,palma21,2,0.00023,164236,19.07986,860782
13061,paltaa,2,0.00023,164238,19.08009,860782
13062,panaobo,2,0.00023,164240,19.08032,860782
13063,panchoh,2,0.00023,164242,19.08056,860782
13064,pandeyvineet,2,0.00023,164244,19.08079,860782
13065,pandeyvinod,2,0.00023,164246,19.08102,860782
13066,pandvan,2,0.00023,164248,19.08125,860782
13067,pangsq,2,0.00023,164250,19.08149,860782
13068,pankhudinigam,2,0.00023,164252,19.08172,860782
13069,Panlichen,2,0.00023,164254,19.08195,860782
13070,pantosha,2,0.00023,164256,19.08218,860782
13071,panva,2,0.00023,164258,19.08242,860782
13072,panzhc,2,0.00023,164260,19.08265,860782
13073,paokrab,2,0.00023,164262,19.08288,860782
13074,PaoloneM,2,0.00023,164264,19.08311,860782
13075,papdaniel,2,0.00023,164266,19.08335,860782
13076,PapoyEdits,2,0.00023,164268,19.08358,860782
13077,Paragon1970,2,0.00023,164270,19.08381,860782
13078,paramacharya,2,0.00023,164272,19.08404,860782
13079,paranoidsp,2,0.00023,164274,19.08427,860782
13080,parasssh,2,0.00023,164276,19.08451,860782
13081,pardahlman,2,0.00023,164278,19.08474,860782
13082,parmarnikunj,2,0.00023,164280,19.08497,860782
13083,parth67,2,0.00023,164282,19.08520,860782
13084,parthjawale,2,0.00023,164284,19.08544,860782
13085,parvaths1118,2,0.00023,164286,19.08567,860782
13086,parveensindhwani,2,0.00023,164288,19.08590,860782
13087,pascalhobus,2,0.00023,164290,19.08613,860782
13088,pascapascapascapasca,2,0.00023,164292,19.08637,860782
13089,PastNullInfinity,2,0.00023,164294,19.08660,860782
13090,PatelRudra,2,0.00023,164296,19.08683,860782
13091,pather87,2,0.00023,164298,19.08706,860782
13092,patope,2,0.00023,164300,19.08730,860782
13093,patpicos,2,0.00023,164302,19.08753,860782
13094,PatrickDuncan,2,0.00023,164304,19.08776,860782
13095,patrickgardella,2,0.00023,164306,19.08799,860782
13096,patrickleet,2,0.00023,164308,19.08822,860782
13097,PatxD,2,0.00023,164310,19.08846,860782
13098,pauliusuza,2,0.00023,164312,19.08869,860782
13099,paulmwatson,2,0.00023,164314,19.08892,860782
13100,pauloconnor,2,0.00023,164316,19.08915,860782
13101,paulrwest,2,0.00023,164318,19.08939,860782
13102,pausa,2,0.00023,164320,19.08962,860782
13103,pavanfhw,2,0.00023,164322,19.08985,860782
13104,pavanmehtre69,2,0.00023,164324,19.09008,860782
13105,PavanVasist,2,0.00023,164326,19.09032,860782
13106,pavitrashah,2,0.00023,164328,19.09055,860782
13107,pawanvivekananda,2,0.00023,164330,19.09078,860782
13108,pawoolley,2,0.00023,164332,19.09101,860782
13109,PaxHumana,2,0.00023,164334,19.09124,860782
13110,pbadenski,2,0.00023,164336,19.09148,860782
13111,pbannykh,2,0.00023,164338,19.09171,860782
13112,pchugh79,2,0.00023,164340,19.09194,860782
13113,pc-jedi,2,0.00023,164342,19.09217,860782
13114,pcktdmp,2,0.00023,164344,19.09241,860782
13115,pc-rshetty,2,0.00023,164346,19.09264,860782
13116,pctr362979,2,0.00023,164348,19.09287,860782
13117,pcuzner,2,0.00023,164350,19.09310,860782
13118,pdeva,2,0.00023,164352,19.09334,860782
13119,pdhung,2,0.00023,164354,19.09357,860782
13120,pdrakeweb,2,0.00023,164356,19.09380,860782
13121,pdstefan,2,0.00023,164358,19.09403,860782
13122,peco8,2,0.00023,164360,19.09427,860782
13123,pedh,2,0.00023,164362,19.09450,860782
13124,pedro93,2,0.00023,164364,19.09473,860782
13125,Peggy4444,2,0.00023,164366,19.09496,860782
13126,peishuli,2,0.00023,164368,19.09519,860782
13127,pengchaoqun,2,0.00023,164370,19.09543,860782
13128,PennyScissors,2,0.00023,164372,19.09566,860782
13129,peppy,2,0.00023,164374,19.09589,860782
13130,percenuage,2,0.00023,164376,19.09612,860782
13131,PercleChiu,2,0.00023,164378,19.09636,860782
13132,Perdjesk,2,0.00023,164380,19.09659,860782
13133,Pesir,2,0.00023,164382,19.09682,860782
13134,petebirk,2,0.00023,164384,19.09705,860782
13135,peterebden,2,0.00023,164386,19.09729,860782
13136,peterfeifanchen,2,0.00023,164388,19.09752,860782
13137,peterfraedrich,2,0.00023,164390,19.09775,860782
13138,PeterGrace,2,0.00023,164392,19.09798,860782
13139,peterholak,2,0.00023,164394,19.09822,860782
13140,PeterQiao,2,0.00023,164396,19.09845,860782
13141,PeterUherek,2,0.00023,164398,19.09868,860782
13142,peterwilson,2,0.00023,164400,19.09891,860782
13143,peteski22,2,0.00023,164402,19.09914,860782
13144,pgiles,2,0.00023,164404,19.09938,860782
13145,phakkarainen,2,0.00023,164406,19.09961,860782
13146,phal0r,2,0.00023,164408,19.09984,860782
13147,PhaniKumar,2,0.00023,164410,19.10007,860782
13148,Philippe-Bailer-ck,2,0.00023,164412,19.10031,860782
13149,philippe-boyd-3r,2,0.00023,164414,19.10054,860782
13150,philippeLepage,2,0.00023,164416,19.10077,860782
13151,philkry,2,0.00023,164418,19.10100,860782
13152,phillipgibson,2,0.00023,164420,19.10124,860782
13153,PHILLIPS71,2,0.00023,164422,19.10147,860782
13154,phiran,2,0.00023,164424,19.10170,860782
13155,PhoenixMage,2,0.00023,164426,19.10193,860782
13156,phong2tran,2,0.00023,164428,19.10217,860782
13157,Phosphorus15,2,0.00023,164430,19.10240,860782
13158,photoszzt,2,0.00023,164432,19.10263,860782
13159,phreaks,2,0.00023,164434,19.10286,860782
13160,phsteve,2,0.00023,164436,19.10309,860782
13161,phudtran,2,0.00023,164438,19.10333,860782
13162,Phydeauxman,2,0.00023,164440,19.10356,860782
13163,pie-r,2,0.00023,164442,19.10379,860782
13164,pierrecregut,2,0.00023,164444,19.10402,860782
13165,pierresteiner,2,0.00023,164446,19.10426,860782
13166,piersdd,2,0.00023,164448,19.10449,860782
13167,Piknik1990,2,0.00023,164450,19.10472,860782
13168,pingsutw,2,0.00023,164452,19.10495,860782
13169,Pinox,2,0.00023,164454,19.10519,860782
13170,PinZhang,2,0.00023,164456,19.10542,860782
13171,pinzhourk,2,0.00023,164458,19.10565,860782
13172,PiotrKlimczak,2,0.00023,164460,19.10588,860782
13173,piraces,2,0.00023,164462,19.10612,860782
13174,piroszhog,2,0.00023,164464,19.10635,860782
13175,pixxet,2,0.00023,164466,19.10658,860782
13176,pjaitken,2,0.00023,164468,19.10681,860782
13177,pjan,2,0.00023,164470,19.10704,860782
13178,pjshort22,2,0.00023,164472,19.10728,860782
13179,pkankar1,2,0.00023,164474,19.10751,860782
13180,pkaske,2,0.00023,164476,19.10774,860782
13181,pkbehera,2,0.00023,164478,19.10797,860782
13182,pkhatrihds,2,0.00023,164480,19.10821,860782
13183,pkoushik,2,0.00023,164482,19.10844,860782
13184,pkuma001,2,0.00023,164484,19.10867,860782
13185,placaze,2,0.00023,164486,19.10890,860782
13186,platten,2,0.00023,164488,19.10914,860782
13187,pleshakov,2,0.00023,164490,19.10937,860782
13188,pmalek,2,0.00023,164492,19.10960,860782
13189,pmcgraw-lucidyne,2,0.00023,164494,19.10983,860782
13190,PMDubuc,2,0.00023,164496,19.11007,860782
13191,pnathan,2,0.00023,164498,19.11030,860782
13192,poga,2,0.00023,164500,19.11053,860782
13193,pogao,2,0.00023,164502,19.11076,860782
13194,policeman-kh,2,0.00023,164504,19.11099,860782
13195,policeme,2,0.00023,164506,19.11123,860782
13196,pomcho555,2,0.00023,164508,19.11146,860782
13197,PoojaChandak,2,0.00023,164510,19.11169,860782
13198,popsky,2,0.00023,164512,19.11192,860782
13199,Porges,2,0.00023,164514,19.11216,860782
13200,posuch,2,0.00023,164516,19.11239,860782
13201,ppcano,2,0.00023,164518,19.11262,860782
13202,ppihus,2,0.00023,164520,19.11285,860782
13203,ppodolsky,2,0.00023,164522,19.11309,860782
13204,prabhu,2,0.00023,164524,19.11332,860782
13205,PrachYothaprasert,2,0.00023,164526,19.11355,860782
13206,PradeepKC,2,0.00023,164528,19.11378,860782
13207,prageethw,2,0.00023,164530,19.11401,860782
13208,prakashshp92,2,0.00023,164532,19.11425,860782
13209,prakhag-1,2,0.00023,164534,19.11448,860782
13210,prana24,2,0.00023,164536,19.11471,860782
13211,prasadkps,2,0.00023,164538,19.11494,860782
13212,Prasanna-sr,2,0.00023,164540,19.11518,860782
13213,prashantbhutani90,2,0.00023,164542,19.11541,860782
13214,prashantgupta24,2,0.00023,164544,19.11564,860782
13215,prashantpsr24,2,0.00023,164546,19.11587,860782
13216,Prashy27,2,0.00023,164548,19.11611,860782
13217,prasy-loyola,2,0.00023,164550,19.11634,860782
13218,praveenkumarKajla,2,0.00023,164552,19.11657,860782
13219,PRaviKumarAdmin,2,0.00023,164554,19.11680,860782
13220,pravin-singhal,2,0.00023,164556,19.11704,860782
13221,prein,2,0.00023,164558,19.11727,860782
13222,PrettySolution,2,0.00023,164560,19.11750,860782
13223,previsenathan,2,0.00023,164562,19.11773,860782
13224,Prideauxx,2,0.00023,164564,19.11796,860782
13225,Priyankasaggu11929,2,0.00023,164566,19.11820,860782
13226,prj,2,0.00023,164568,19.11843,860782
13227,ProcedureMonkeyB,2,0.00023,164570,19.11866,860782
13228,prochac,2,0.00023,164572,19.11889,860782
13229,programistka,2,0.00023,164574,19.11913,860782
13230,Projoke,2,0.00023,164576,19.11936,860782
13231,prongs,2,0.00023,164578,19.11959,860782
13232,proserie,2,0.00023,164580,19.11982,860782
13233,protos37,2,0.00023,164582,19.12006,860782
13234,Prototik,2,0.00023,164584,19.12029,860782
13235,proua,2,0.00023,164586,19.12052,860782
13236,psigen,2,0.00023,164588,19.12075,860782
13237,pswalia06,2,0.00023,164590,19.12099,860782
13238,PsychoSid,2,0.00023,164592,19.12122,860782
13239,pugangxa,2,0.00023,164594,19.12145,860782
13240,pulakiitr,2,0.00023,164596,19.12168,860782
13241,pulkitmehra,2,0.00023,164598,19.12191,860782
13242,Pulz,2,0.00023,164600,19.12215,860782
13243,punia14,2,0.00023,164602,19.12238,860782
13244,pupudu,2,0.00023,164604,19.12261,860782
13245,Purneau,2,0.00023,164606,19.12284,860782
13246,purplepalmdash,2,0.00023,164608,19.12308,860782
13247,pvillard31,2,0.00023,164610,19.12331,860782
13248,pvnovarese,2,0.00023,164612,19.12354,860782
13249,pvsone,2,0.00023,164614,19.12377,860782
13250,pwall-tyro,2,0.00023,164616,19.12401,860782
13251,pyfdtic,2,0.00023,164618,19.12424,860782
13252,pyssling,2,0.00023,164620,19.12447,860782
13253,pythonzm,2,0.00023,164622,19.12470,860782
13254,pzmi,2,0.00023,164624,19.12494,860782
13255,q843922994,2,0.00023,164626,19.12517,860782
13256,qcastel,2,0.00023,164628,19.12540,860782
13257,qcd0710,2,0.00023,164630,19.12563,860782
13258,qclaogui,2,0.00023,164632,19.12586,860782
13259,qdongxu,2,0.00023,164634,19.12610,860782
13260,qgervacio,2,0.00023,164636,19.12633,860782
13261,qibobo,2,0.00023,164638,19.12656,860782
13262,qindng,2,0.00023,164640,19.12679,860782
13263,qingquanhuazi,2,0.00023,164642,19.12703,860782
13264,qins,2,0.00023,164644,19.12726,860782
13265,qinxx108,2,0.00023,164646,19.12749,860782
13266,qiujun623,2,0.00023,164648,19.12772,860782
13267,qiuqiuqiubo,2,0.00023,164650,19.12796,860782
13268,qixiang-liu,2,0.00023,164652,19.12819,860782
13269,qjcg,2,0.00023,164654,19.12842,860782
13270,qqshow,2,0.00023,164656,19.12865,860782
13271,Qquanwei,2,0.00023,164658,19.12889,860782
13272,QuaereMe,2,0.00023,164660,19.12912,860782
13273,quaffpotion,2,0.00023,164662,19.12935,860782
13274,quanbisen,2,0.00023,164664,19.12958,860782
13275,Quicksy,2,0.00023,164666,19.12981,860782
13276,QuixoticJoe,2,0.00023,164668,19.13005,860782
13277,Q-Zhan,2,0.00023,164670,19.13028,860782
13278,raanand-home,2,0.00023,164672,19.13051,860782
13279,racheruk,2,0.00023,164674,19.13074,860782
13280,radekgs,2,0.00023,164676,19.13098,860782
13281,rafabios,2,0.00023,164678,19.13121,860782
13282,rafael-fecha,2,0.00023,164680,19.13144,860782
13283,rafaelpereyra,2,0.00023,164682,19.13167,860782
13284,rafagsiqueira,2,0.00023,164684,19.13191,860782
13285,rafalparadowski,2,0.00023,164686,19.13214,860782
13286,rafaribe,2,0.00023,164688,19.13237,860782
13287,ragingpastry,2,0.00023,164690,19.13260,860782
13288,Ragin-LundF,2,0.00023,164692,19.13284,860782
13289,ragsonline,2,0.00023,164694,19.13307,860782
13290,rahul-gupta-1525,2,0.00023,164696,19.13330,860782
13291,rahulraykor,2,0.00023,164698,19.13353,860782
13292,rahulsadanandan,2,0.00023,164700,19.13376,860782
13293,Rahulsharma0810,2,0.00023,164702,19.13400,860782
13294,RainingNight,2,0.00023,164704,19.13423,860782
13295,rajanikantpatel,2,0.00023,164706,19.13446,860782
13296,rajansh5,2,0.00023,164708,19.13469,860782
13297,rajattrt,2,0.00023,164710,19.13493,860782
13298,rajcool1239,2,0.00023,164712,19.13516,860782
13299,rajdeepbhattacharya,2,0.00023,164714,19.13539,860782
13300,rajendraprasad9,2,0.00023,164716,19.13562,860782
13301,Rajesh-Ayaldasani,2,0.00023,164718,19.13586,860782
13302,rajeshaz09,2,0.00023,164720,19.13609,860782
13303,rajha-korithrien,2,0.00023,164722,19.13632,860782
13304,rajivml,2,0.00023,164724,19.13655,860782
13305,rajivreddy,2,0.00023,164726,19.13678,860782
13306,rajma,2,0.00023,164728,19.13702,860782
13307,rakeshk121,2,0.00023,164730,19.13725,860782
13308,RakeshNagarajan,2,0.00023,164732,19.13748,860782
13309,raksha1,2,0.00023,164734,19.13771,860782
13310,ramakrishnateja,2,0.00023,164736,19.13795,860782
13311,ramazanpolat,2,0.00023,164738,19.13818,860782
13312,ramchandgadde,2,0.00023,164740,19.13841,860782
13313,rameshpasunoori,2,0.00023,164742,19.13864,860782
13314,Ramneekkhurana,2,0.00023,164744,19.13888,860782
13315,rams3sh,2,0.00023,164746,19.13911,860782
13316,ramsuriti,2,0.00023,164748,19.13934,860782
13317,ramthi,2,0.00023,164750,19.13957,860782
13318,Rand01ph,2,0.00023,164752,19.13981,860782
13319,randomnoise,2,0.00023,164754,19.14004,860782
13320,raqqun,2,0.00023,164756,19.14027,860782
13321,rarruda,2,0.00023,164758,19.14050,860782
13322,rasooll,2,0.00023,164760,19.14073,860782
13323,Rassred,2,0.00023,164762,19.14097,860782
13324,Rathgore,2,0.00023,164764,19.14120,860782
13325,ratnadeep007,2,0.00023,164766,19.14143,860782
13326,ratulbasak,2,0.00023,164768,19.14166,860782
13327,raunaqgupta,2,0.00023,164770,19.14190,860782
13328,ravens,2,0.00023,164772,19.14213,860782
13329,ravigude,2,0.00023,164774,19.14236,860782
13330,ravinderb2,2,0.00023,164776,19.14259,860782
13331,rayisbadat,2,0.00023,164778,19.14283,860782
13332,RaymondAudet,2,0.00023,164780,19.14306,860782
13333,razorsk8jz,2,0.00023,164782,19.14329,860782
13334,rbentaarit,2,0.00023,164784,19.14352,860782
13335,rbizzell40,2,0.00023,164786,19.14376,860782
13336,rb-nr,2,0.00023,164788,19.14399,860782
13337,RCantw3ll,2,0.00023,164790,19.14422,860782
13338,rchessa,2,0.00023,164792,19.14445,860782
13339,rcny,2,0.00023,164794,19.14468,860782
13340,rcompos,2,0.00023,164796,19.14492,860782
13341,rdconnelly,2,0.00023,164798,19.14515,860782
13342,rdepke,2,0.00023,164800,19.14538,860782
13343,RdL87,2,0.00023,164802,19.14561,860782
13344,real420og,2,0.00023,164804,19.14585,860782
13345,realdream,2,0.00023,164806,19.14608,860782
13346,realei,2,0.00023,164808,19.14631,860782
13347,realknorke,2,0.00023,164810,19.14654,860782
13348,RealRiceCake,2,0.00023,164812,19.14678,860782
13349,reaperhero,2,0.00023,164814,19.14701,860782
13350,Reasno,2,0.00023,164816,19.14724,860782
13351,RecentlyRezzed,2,0.00023,164818,19.14747,860782
13352,recurlybrad,2,0.00023,164820,19.14771,860782
13353,redcricket,2,0.00023,164822,19.14794,860782
13354,redfoxfox,2,0.00023,164824,19.14817,860782
13355,redscaresu,2,0.00023,164826,19.14840,860782
13356,redxdevops,2,0.00023,164828,19.14863,860782
13357,Regevd,2,0.00023,164830,19.14887,860782
13358,REHMAN-AFZAL,2,0.00023,164832,19.14910,860782
13359,relnetops,2,0.00023,164834,19.14933,860782
13360,relu,2,0.00023,164836,19.14956,860782
13361,relvira,2,0.00023,164838,19.14980,860782
13362,remiphilippe,2,0.00023,164840,19.15003,860782
13363,renbingdong,2,0.00023,164842,19.15026,860782
13364,renchili,2,0.00023,164844,19.15049,860782
13365,renepardon,2,0.00023,164846,19.15073,860782
13366,renich,2,0.00023,164848,19.15096,860782
13367,RenukuntlaMonisha,2,0.00023,164850,19.15119,860782
13368,Reponic,2,0.00023,164852,19.15142,860782
13369,rerime,2,0.00023,164854,19.15166,860782
13370,resamaraschi,2,0.00023,164856,19.15189,860782
13371,reselbobasg,2,0.00023,164858,19.15212,860782
13372,retroflexer,2,0.00023,164860,19.15235,860782
13373,retzkek,2,0.00023,164862,19.15258,860782
13374,rextca,2,0.00023,164864,19.15282,860782
13375,reymalahay,2,0.00023,164866,19.15305,860782
13376,reynaulaque,2,0.00023,164868,19.15328,860782
13377,rez0n,2,0.00023,164870,19.15351,860782
13378,RezaRahmati,2,0.00023,164872,19.15375,860782
13379,rfwankenobi,2,0.00023,164874,19.15398,860782
13380,rg2609,2,0.00023,164876,19.15421,860782
13381,rgachet,2,0.00023,164878,19.15444,860782
13382,rgadeev,2,0.00023,164880,19.15468,860782
13383,rgime,2,0.00023,164882,19.15491,860782
13384,rgoldfinger-quizlet,2,0.00023,164884,19.15514,860782
13385,rgombash,2,0.00023,164886,19.15537,860782
13386,rgssingh,2,0.00023,164888,19.15561,860782
13387,rh01,2,0.00023,164890,19.15584,860782
13388,rhysemmas,2,0.00023,164892,19.15607,860782
13389,ricfeatherstone,2,0.00023,164894,19.15630,860782
13390,RichardHCL,2,0.00023,164896,19.15653,860782
13391,richwhitjr,2,0.00023,164898,19.15677,860782
13392,rickdonato,2,0.00023,164900,19.15700,860782
13393,ricoms,2,0.00023,164902,19.15723,860782
13394,rileyhun,2,0.00023,164904,19.15746,860782
13395,rim-wood,2,0.00023,164906,19.15770,860782
13396,riosje,2,0.00023,164908,19.15793,860782
13397,riponbanik,2,0.00023,164910,19.15816,860782
13398,rishgh,2,0.00023,164912,19.15839,860782
13399,rivetmichael,2,0.00023,164914,19.15863,860782
13400,riyafa,2,0.00023,164916,19.15886,860782
13401,rizsotto,2,0.00023,164918,19.15909,860782
13402,rizwan-star,2,0.00023,164920,19.15932,860782
13403,rjean-gilles,2,0.00023,164922,19.15955,860782
13404,rkand4,2,0.00023,164924,19.15979,860782
13405,rkatti,2,0.00023,164926,19.16002,860782
13406,r-kgy,2,0.00023,164928,19.16025,860782
13407,rmahroua,2,0.00023,164930,19.16048,860782
13408,rmarchei,2,0.00023,164932,19.16072,860782
13409,rmasclef,2,0.00023,164934,19.16095,860782
13410,rmauge,2,0.00023,164936,19.16118,860782
13411,rmccarthy-ellevation,2,0.00023,164938,19.16141,860782
13412,rmja,2,0.00023,164940,19.16165,860782
13413,rmvalliappan,2,0.00023,164942,19.16188,860782
13414,rnachire,2,0.00023,164944,19.16211,860782
13415,robbieknuth,2,0.00023,164946,19.16234,860782
13416,robcecil,2,0.00023,164948,19.16258,860782
13417,robertaramar,2,0.00023,164950,19.16281,860782
13418,Roberto-89,2,0.00023,164952,19.16304,860782
13419,Robert-Stam,2,0.00023,164954,19.16327,860782
13420,roberttco,2,0.00023,164956,19.16350,860782
13421,robevansuk,2,0.00023,164958,19.16374,860782
13422,RobReus,2,0.00023,164960,19.16397,860782
13423,robsonke,2,0.00023,164962,19.16420,860782
13424,rodrigopandini,2,0.00023,164964,19.16443,860782
13425,rodzac,2,0.00023,164966,19.16467,860782
13426,RoeeShlomo,2,0.00023,164968,19.16490,860782
13427,rofra,2,0.00023,164970,19.16513,860782
13428,rogerioefonseca,2,0.00023,164972,19.16536,860782
13429,RogerReed,2,0.00023,164974,19.16560,860782
13430,rogperez,2,0.00023,164976,19.16583,860782
13431,rohaldbUni,2,0.00023,164978,19.16606,860782
13432,rohansadale,2,0.00023,164980,19.16629,860782
13433,rohitanair,2,0.00023,164982,19.16653,860782
13434,rohithhasher,2,0.00023,164984,19.16676,860782
13435,rohith-vallabhaneni,2,0.00023,164986,19.16699,860782
13436,RohitRox,2,0.00023,164988,19.16722,860782
13437,rokej,2,0.00023,164990,19.16745,860782
13438,rokii,2,0.00023,164992,19.16769,860782
13439,roksys,2,0.00023,164994,19.16792,860782
13440,rolandg,2,0.00023,164996,19.16815,860782
13441,roldevg,2,0.00023,164998,19.16838,860782
13442,RomainWilbert,2,0.00023,165000,19.16862,860782
13443,RomanKisilenko,2,0.00023,165002,19.16885,860782
13444,romanvog,2,0.00023,165004,19.16908,860782
13445,romap0,2,0.00023,165006,19.16931,860782
13446,romnnn,2,0.00023,165008,19.16955,860782
13447,ronreichert,2,0.00023,165010,19.16978,860782
13448,rooftop90,2,0.00023,165012,19.17001,860782
13449,root1250,2,0.00023,165014,19.17024,860782
13450,rosanch,2,0.00023,165016,19.17048,860782
13451,roshnaeem,2,0.00023,165018,19.17071,860782
13452,rossdotpink,2,0.00023,165020,19.17094,860782
13453,RossyWhite,2,0.00023,165022,19.17117,860782
13454,rot1024,2,0.00023,165024,19.17140,860782
13455,rotemironsrc,2,0.00023,165026,19.17164,860782
13456,rowanj,2,0.00023,165028,19.17187,860782
13457,rparvizian-rbx,2,0.00023,165030,19.17210,860782
13458,rpf3,2,0.00023,165032,19.17233,860782
13459,rpiteira,2,0.00023,165034,19.17257,860782
13460,rpthms,2,0.00023,165036,19.17280,860782
13461,RR90,2,0.00023,165038,19.17303,860782
13462,rrajaram,2,0.00023,165040,19.17326,860782
13463,rsaffi,2,0.00023,165042,19.17350,860782
13464,rsassPwC,2,0.00023,165044,19.17373,860782
13465,RSBlek,2,0.00023,165046,19.17396,860782
13466,rsendil,2,0.00023,165048,19.17419,860782
13467,rsjohn,2,0.00023,165050,19.17443,860782
13468,rslinckx,2,0.00023,165052,19.17466,860782
13469,rsolano,2,0.00023,165054,19.17489,860782
13470,rtchinnachot,2,0.00023,165056,19.17512,860782
13471,rtshadow,2,0.00023,165058,19.17535,860782
13472,rtsisyk,2,0.00023,165060,19.17559,860782
13473,rubenstolk,2,0.00023,165062,19.17582,860782
13474,Rubenvdveen,2,0.00023,165064,19.17605,860782
13475,rubiojr,2,0.00023,165066,19.17628,860782
13476,rudolphjacksonm,2,0.00023,165068,19.17652,860782
13477,rudyfly,2,0.00023,165070,19.17675,860782
13478,ruicraveiro,2,0.00023,165072,19.17698,860782
13479,Ruilkyu,2,0.00023,165074,19.17721,860782
13480,rumanzo,2,0.00023,165076,19.17745,860782
13481,runefs,2,0.00023,165078,19.17768,860782
13482,runewake2,2,0.00023,165080,19.17791,860782
13483,rungej,2,0.00023,165082,19.17814,860782
13484,runi95,2,0.00023,165084,19.17838,860782
13485,RuriRyan,2,0.00023,165086,19.17861,860782
13486,ruster-cn,2,0.00023,165088,19.17884,860782
13487,rvadim,2,0.00023,165090,19.17907,860782
13488,rvarunikaa,2,0.00023,165092,19.17930,860782
13489,rwmajor2,2,0.00023,165094,19.17954,860782
13490,ryanalbon,2,0.00023,165096,19.17977,860782
13491,ryancastle,2,0.00023,165098,19.18000,860782
13492,ryanc-me,2,0.00023,165100,19.18023,860782
13493,ryan-dyer-sp,2,0.00023,165102,19.18047,860782
13494,ryanhall07,2,0.00023,165104,19.18070,860782
13495,ryli17,2,0.00023,165106,19.18093,860782
13496,Ryner51,2,0.00023,165108,19.18116,860782
13497,ryu25ish,2,0.00023,165110,19.18140,860782
13498,ryuichi1208,2,0.00023,165112,19.18163,860782
13499,ryu-sato,2,0.00023,165114,19.18186,860782
13500,s2000coder,2,0.00023,165116,19.18209,860782
13501,s709t,2,0.00023,165118,19.18232,860782
13502,s97712,2,0.00023,165120,19.18256,860782
13503,sabaini,2,0.00023,165122,19.18279,860782
13504,sabarnwa,2,0.00023,165124,19.18302,860782
13505,sabiland,2,0.00023,165126,19.18325,860782
13506,sabriel27,2,0.00023,165128,19.18349,860782
13507,sachin67007,2,0.00023,165130,19.18372,860782
13508,sachrajneesh,2,0.00023,165132,19.18395,860782
13509,safoorsafdar,2,0.00023,165134,19.18418,860782
13510,Sagar2366,2,0.00023,165136,19.18442,860782
13511,sagiru,2,0.00023,165138,19.18465,860782
13512,sagyvolkov,2,0.00023,165140,19.18488,860782
13513,saidmasoud,2,0.00023,165142,19.18511,860782
13514,saikaushik-itsmyworld,2,0.00023,165144,19.18535,860782
13515,saikrishna4d8,2,0.00023,165146,19.18558,860782
13516,saikrishna-commits,2,0.00023,165148,19.18581,860782
13517,SaintDubious,2,0.00023,165150,19.18604,860782
13518,sajayantony,2,0.00023,165152,19.18627,860782
13519,sakaia-test,2,0.00023,165154,19.18651,860782
13520,Salamandastron1,2,0.00023,165156,19.18674,860782
13521,salamovz,2,0.00023,165158,19.18697,860782
13522,salla2,2,0.00023,165160,19.18720,860782
13523,SalmanIsha,2,0.00023,165162,19.18744,860782
13524,salotz,2,0.00023,165164,19.18767,860782
13525,salujanitin,2,0.00023,165166,19.18790,860782
13526,samantha-theorem,2,0.00023,165168,19.18813,860782
13527,SamChapler,2,0.00023,165170,19.18837,860782
13528,sameerbhadouria,2,0.00023,165172,19.18860,860782
13529,Samet-MohamedAmin,2,0.00023,165174,19.18883,860782
13530,samgoncalves90,2,0.00023,165176,19.18906,860782
13531,samkerner,2,0.00023,165178,19.18930,860782
13532,sam-mccall,2,0.00023,165180,19.18953,860782
13533,samn,2,0.00023,165182,19.18976,860782
13534,samrees,2,0.00023,165184,19.18999,860782
13535,samsam2310,2,0.00023,165186,19.19022,860782
13536,samtonyclarke,2,0.00023,165188,19.19046,860782
13537,SamuelMarks,2,0.00023,165190,19.19069,860782
13538,samwhite,2,0.00023,165192,19.19092,860782
13539,SamyCoenen,2,0.00023,165194,19.19115,860782
13540,sandipchitale,2,0.00023,165196,19.19139,860782
13541,SandyLing,2,0.00023,165198,19.19162,860782
13542,sanjaygopinath89,2,0.00023,165200,19.19185,860782
13543,sankalp7654,2,0.00023,165202,19.19208,860782
13544,Sanket110297,2,0.00023,165204,19.19232,860782
13545,sannadi99,2,0.00023,165206,19.19255,860782
13546,sanskriti-s,2,0.00023,165208,19.19278,860782
13547,santhoshs123,2,0.00023,165210,19.19301,860782
13548,santhoshtricon,2,0.00023,165212,19.19325,860782
13549,santmcodes,2,0.00023,165214,19.19348,860782
13550,Sanyamgrover1,2,0.00023,165216,19.19371,860782
13551,sarandia,2,0.00023,165218,19.19394,860782
13552,sarath4,2,0.00023,165220,19.19417,860782
13553,saravana-code,2,0.00023,165222,19.19441,860782
13554,sardella,2,0.00023,165224,19.19464,860782
13555,Sargababu,2,0.00023,165226,19.19487,860782
13556,sarkarsaurabh27,2,0.00023,165228,19.19510,860782
13557,sarslanhan,2,0.00023,165230,19.19534,860782
13558,sascha-wolf,2,0.00023,165232,19.19557,860782
13559,sasskinn12,2,0.00023,165234,19.19580,860782
13560,SASUKE40,2,0.00023,165236,19.19603,860782
13561,satishrao84,2,0.00023,165238,19.19627,860782
13562,satishviswanathan,2,0.00023,165240,19.19650,860782
13563,satvan23,2,0.00023,165242,19.19673,860782
13564,saunderslink,2,0.00023,165244,19.19696,860782
13565,saurav-bhagat,2,0.00023,165246,19.19720,860782
13566,saurav-k,2,0.00023,165248,19.19743,860782
13567,savealive,2,0.00023,165250,19.19766,860782
13568,Savitha-Pai,2,0.00023,165252,19.19789,860782
13569,saxicek,2,0.00023,165254,19.19812,860782
13570,sayan-rudder,2,0.00023,165256,19.19836,860782
13571,sayedihashimi,2,0.00023,165258,19.19859,860782
13572,sayeduzzamancuet,2,0.00023,165260,19.19882,860782
13573,sayeedc,2,0.00023,165262,19.19905,860782
13574,sbellan,2,0.00023,165264,19.19929,860782
13575,sbhat1a,2,0.00023,165266,19.19952,860782
13576,SBNTT,2,0.00023,165268,19.19975,860782
13577,sbocinec,2,0.00023,165270,19.19998,860782
13578,sbsends,2,0.00023,165272,19.20022,860782
13579,sbussard,2,0.00023,165274,19.20045,860782
13580,sc0ttbeardsley,2,0.00023,165276,19.20068,860782
13581,scabana,2,0.00023,165278,19.20091,860782
13582,Sceat,2,0.00023,165280,19.20115,860782
13583,schleyfox,2,0.00023,165282,19.20138,860782
13584,schrej,2,0.00023,165284,19.20161,860782
13585,Science-and-Motion-Sports,2,0.00023,165286,19.20184,860782
13586,scivm,2,0.00023,165288,19.20207,860782
13587,sclark39,2,0.00023,165290,19.20231,860782
13588,scornelissen85,2,0.00023,165292,19.20254,860782
13589,Scorpiion,2,0.00023,165294,19.20277,860782
13590,scottprichard,2,0.00023,165296,19.20300,860782
13591,scvRdy,2,0.00023,165298,19.20324,860782
13592,scytem,2,0.00023,165300,19.20347,860782
13593,sd2302,2,0.00023,165302,19.20370,860782
13594,sdatspun2,2,0.00023,165304,19.20393,860782
13595,sdavids,2,0.00023,165306,19.20417,860782
13596,sdghchj,2,0.00023,165308,19.20440,860782
13597,sdib,2,0.00023,165310,19.20463,860782
13598,sdjdd,2,0.00023,165312,19.20486,860782
13599,sdorra,2,0.00023,165314,19.20509,860782
13600,sdputurn,2,0.00023,165316,19.20533,860782
13601,sdsantos,2,0.00023,165318,19.20556,860782
13602,se7en102,2,0.00023,165320,19.20579,860782
13603,Seabizkit,2,0.00023,165322,19.20602,860782
13604,SeagleLiu,2,0.00023,165324,19.20626,860782
13605,Sealteam56,2,0.00023,165326,19.20649,860782
13606,seanchen1991,2,0.00023,165328,19.20672,860782
13607,seandilda,2,0.00023,165330,19.20695,860782
13608,SeanKnight,2,0.00023,165332,19.20719,860782
13609,seanmcconkey,2,0.00023,165334,19.20742,860782
13610,seanmwinn,2,0.00023,165336,19.20765,860782
13611,sebastianBD95,2,0.00023,165338,19.20788,860782
13612,sebastianguzera,2,0.00023,165340,19.20812,860782
13613,SebJansen,2,0.00023,165342,19.20835,860782
13614,sebleclerc,2,0.00023,165344,19.20858,860782
13615,seemonicago,2,0.00023,165346,19.20881,860782
13616,sehadnassim,2,0.00023,165348,19.20904,860782
13617,seho-kim-do-something,2,0.00023,165350,19.20928,860782
13618,seifchen,2,0.00023,165352,19.20951,860782
13619,seime,2,0.00023,165354,19.20974,860782
13620,Seklfreak,2,0.00023,165356,19.20997,860782
13621,sekrett,2,0.00023,165358,19.21021,860782
13622,selimnl,2,0.00023,165360,19.21044,860782
13623,selvamt70,2,0.00023,165362,19.21067,860782
13624,SemiLavender,2,0.00023,165364,19.21090,860782
13625,semin-park,2,0.00023,165366,19.21114,860782
13626,semyont,2,0.00023,165368,19.21137,860782
13627,sen-subhabrata,2,0.00023,165370,19.21160,860782
13628,SergeMerge,2,0.00023,165372,19.21183,860782
13629,sertoa812,2,0.00023,165374,19.21207,860782
13630,sesteel,2,0.00023,165376,19.21230,860782
13631,sethgrid,2,0.00023,165378,19.21253,860782
13632,sethpeterson,2,0.00023,165380,19.21276,860782
13633,sfiligoi,2,0.00023,165382,19.21299,860782
13634,sfmskywalker,2,0.00023,165384,19.21323,860782
13635,sfwtoms2030,2,0.00023,165386,19.21346,860782
13636,sgrimes-stackod,2,0.00023,165388,19.21369,860782
13637,shabbir1679,2,0.00023,165390,19.21392,860782
13638,shacharSilbert,2,0.00023,165392,19.21416,860782
13639,shaekhhasanshoron,2,0.00023,165394,19.21439,860782
13640,shahmirn,2,0.00023,165396,19.21462,860782
13641,shaijain,2,0.00023,165398,19.21485,860782
13642,shailegu,2,0.00023,165400,19.21509,860782
13643,ShakataGaNai,2,0.00023,165402,19.21532,860782
13644,shakti-garg,2,0.00023,165404,19.21555,860782
13645,shaktiprasadrath,2,0.00023,165406,19.21578,860782
13646,shaloba,2,0.00023,165408,19.21602,860782
13647,shanalily,2,0.00023,165410,19.21625,860782
13648,shanel-at-google,2,0.00023,165412,19.21648,860782
13649,shankar95raju,2,0.00023,165414,19.21671,860782
13650,shankarkc,2,0.00023,165416,19.21694,860782
13651,shanmukhavardhan,2,0.00023,165418,19.21718,860782
13652,shannoncarver,2,0.00023,165420,19.21741,860782
13653,Shantanu35,2,0.00023,165422,19.21764,860782
13654,shaochengwang,2,0.00023,165424,19.21787,860782
13655,shaojielinux,2,0.00023,165426,19.21811,860782
13656,shaozi,2,0.00023,165428,19.21834,860782
13657,shapor,2,0.00023,165430,19.21857,860782
13658,sharif-rahman,2,0.00023,165432,19.21880,860782
13659,Shashankft9,2,0.00023,165434,19.21904,860782
13660,shatravko,2,0.00023,165436,19.21927,860782
13661,shayan09,2,0.00023,165438,19.21950,860782
13662,shayanjalil,2,0.00023,165440,19.21973,860782
13663,shd4,2,0.00023,165442,19.21997,860782
13664,shehryarhashmi71,2,0.00023,165444,19.22020,860782
13665,SherazShahid17,2,0.00023,165446,19.22043,860782
13666,shikanon,2,0.00023,165448,19.22066,860782
13667,shimeon8129,2,0.00023,165450,19.22089,860782
13668,shivamSharmaMWP,2,0.00023,165452,19.22113,860782
13669,shivamsoni640,2,0.00023,165454,19.22136,860782
13670,shivdeepnv,2,0.00023,165456,19.22159,860782
13671,shivshankarb,2,0.00023,165458,19.22182,860782
13672,shiying2012,2,0.00023,165460,19.22206,860782
13673,shmpub,2,0.00023,165462,19.22229,860782
13674,shotor,2,0.00023,165464,19.22252,860782
13675,shousper,2,0.00023,165466,19.22275,860782
13676,showsmall,2,0.00023,165468,19.22299,860782
13677,Shraddhak22,2,0.00023,165470,19.22322,860782
13678,ShramikGajlekar,2,0.00023,165472,19.22345,860782
13679,shrapx,2,0.00023,165474,19.22368,860782
13680,Shreyahcd,2,0.00023,165476,19.22391,860782
13681,shrikantumadi,2,0.00023,165478,19.22415,860782
13682,Shruti1970,2,0.00023,165480,19.22438,860782
13683,sh-sekigawa,2,0.00023,165482,19.22461,860782
13684,shubb30,2,0.00023,165484,19.22484,860782
13685,shubhamgupta2956,2,0.00023,165486,19.22508,860782
13686,shukla2009,2,0.00023,165488,19.22531,860782
13687,ShuLian1984,2,0.00023,165490,19.22554,860782
13688,shumiao,2,0.00023,165492,19.22577,860782
13689,shuyanzhu,2,0.00023,165494,19.22601,860782
13690,siadark,2,0.00023,165496,19.22624,860782
13691,siddheshbhasme,2,0.00023,165498,19.22647,860782
13692,sidewinder12s,2,0.00023,165500,19.22670,860782
13693,sidharthk,2,0.00023,165502,19.22694,860782
13694,sidharthvengala,2,0.00023,165504,19.22717,860782
13695,sidred,2,0.00023,165506,19.22740,860782
13696,siebenmann,2,0.00023,165508,19.22763,860782
13697,siggaardio,2,0.00023,165510,19.22786,860782
13698,sigmaol,2,0.00023,165512,19.22810,860782
13699,Sil3ntStorm,2,0.00023,165514,19.22833,860782
13700,silverwind,2,0.00023,165516,19.22856,860782
13701,simar7,2,0.00023,165518,19.22879,860782
13702,simon71,2,0.00023,165520,19.22903,860782
13703,simonjam,2,0.00023,165522,19.22926,860782
13704,simon-swanson-leapyear,2,0.00023,165524,19.22949,860782
13705,simonxmh,2,0.00023,165526,19.22972,860782
13706,Simwar,2,0.00023,165528,19.22996,860782
13707,sinethra,2,0.00023,165530,19.23019,860782
13708,singhpraveen2010,2,0.00023,165532,19.23042,860782
13709,singlakirti,2,0.00023,165534,19.23065,860782
13710,sinonkt,2,0.00023,165536,19.23089,860782
13711,sinvalmendes,2,0.00023,165538,19.23112,860782
13712,sinzin91,2,0.00023,165540,19.23135,860782
13713,sionsmith,2,0.00023,165542,19.23158,860782
13714,siqjonathan,2,0.00023,165544,19.23181,860782
13715,siroossarmadi,2,0.00023,165546,19.23205,860782
13716,sirupsen,2,0.00023,165548,19.23228,860782
13717,sithembiso,2,0.00023,165550,19.23251,860782
13718,situjianxiong,2,0.00023,165552,19.23274,860782
13719,sivaguru-nathan,2,0.00023,165554,19.23298,860782
13720,sixer101,2,0.00023,165556,19.23321,860782
13721,sjkim2322,2,0.00023,165558,19.23344,860782
13722,skayikci,2,0.00023,165560,19.23367,860782
13723,skchinna7,2,0.00023,165562,19.23391,860782
13724,ske5074,2,0.00023,165564,19.23414,860782
13725,skipor,2,0.00023,165566,19.23437,860782
13726,Sklodow,2,0.00023,165568,19.23460,860782
13727,skob,2,0.00023,165570,19.23484,860782
13728,skofgar,2,0.00023,165572,19.23507,860782
13729,skynetrulz,2,0.00023,165574,19.23530,860782
13730,sky-philipalmeida,2,0.00023,165576,19.23553,860782
13731,sl805,2,0.00023,165578,19.23576,860782
13732,SlashTeen,2,0.00023,165580,19.23600,860782
13733,slavabulgakov,2,0.00023,165582,19.23623,860782
13734,slayer,2,0.00023,165584,19.23646,860782
13735,slayer01,2,0.00023,165586,19.23669,860782
13736,slconley,2,0.00023,165588,19.23693,860782
13737,sl-erictravers,2,0.00023,165590,19.23716,860782
13738,sljeff,2,0.00023,165592,19.23739,860782
13739,sl-maximevendrand,2,0.00023,165594,19.23762,860782
13740,slobo,2,0.00023,165596,19.23786,860782
13741,slovdahl,2,0.00023,165598,19.23809,860782
13742,slrz,2,0.00023,165600,19.23832,860782
13743,smahalingam,2,0.00023,165602,19.23855,860782
13744,small-egg,2,0.00023,165604,19.23879,860782
13745,smarterallen,2,0.00023,165606,19.23902,860782
13746,smartyal,2,0.00023,165608,19.23925,860782
13747,smaslennikov,2,0.00023,165610,19.23948,860782
13748,smflorentino,2,0.00023,165612,19.23971,860782
13749,smhmayboudi,2,0.00023,165614,19.23995,860782
13750,smklein,2,0.00023,165616,19.24018,860782
13751,smlHao,2,0.00023,165618,19.24041,860782
13752,smoelius,2,0.00023,165620,19.24064,860782
13753,smowafy,2,0.00023,165622,19.24088,860782
13754,snappyjig,2,0.00023,165624,19.24111,860782
13755,snayakie,2,0.00023,165626,19.24134,860782
13756,Snede,2,0.00023,165628,19.24157,860782
13757,snedi,2,0.00023,165630,19.24181,860782
13758,snevilleshinn,2,0.00023,165632,19.24204,860782
13759,snicholas,2,0.00023,165634,19.24227,860782
13760,snowei,2,0.00023,165636,19.24250,860782
13761,snow-flow,2,0.00023,165638,19.24274,860782
13762,snuglove,2,0.00023,165640,19.24297,860782
13763,soarez,2,0.00023,165642,19.24320,860782
13764,sodabrew,2,0.00023,165644,19.24343,860782
13765,sofat1989,2,0.00023,165646,19.24366,860782
13766,softputer,2,0.00023,165648,19.24390,860782
13767,soilerl,2,0.00023,165650,19.24413,860782
13768,soksanichenko,2,0.00023,165652,19.24436,860782
13769,solmon,2,0.00023,165654,19.24459,860782
13770,SomboChea,2,0.00023,165656,19.24483,860782
13771,somdoron,2,0.00023,165658,19.24506,860782
13772,somelinuxguy,2,0.00023,165660,19.24529,860782
13773,SomeoneWeird,2,0.00023,165662,19.24552,860782
13774,somnathpawar,2,0.00023,165664,19.24576,860782
13775,sondnpt00343,2,0.00023,165666,19.24599,860782
13776,SonicGD,2,0.00023,165668,19.24622,860782
13777,sonisaurabh19,2,0.00023,165670,19.24645,860782
13778,souchprod,2,0.00023,165672,19.24668,860782
13779,soumilshah1995,2,0.00023,165674,19.24692,860782
13780,sp0f,2,0.00023,165676,19.24715,860782
13781,SpaaarK,2,0.00023,165678,19.24738,860782
13782,space88man,2,0.00023,165680,19.24761,860782
13783,spacem,2,0.00023,165682,19.24785,860782
13784,Spareo,2,0.00023,165684,19.24808,860782
13785,spatel-37,2,0.00023,165686,19.24831,860782
13786,spensireli,2,0.00023,165688,19.24854,860782
13787,spicysomtam,2,0.00023,165690,19.24878,860782
13788,splicemaahs,2,0.00023,165692,19.24901,860782
13789,splnanthakumar,2,0.00023,165694,19.24924,860782
13790,spommerening,2,0.00023,165696,19.24947,860782
13791,sppakal,2,0.00023,165698,19.24971,860782
13792,spynode,2,0.00023,165700,19.24994,860782
13793,srajagopalan-fliptrx,2,0.00023,165702,19.25017,860782
13794,sreya92,2,0.00023,165704,19.25040,860782
13795,srikanthcs,2,0.00023,165706,19.25063,860782
13796,srikanthp488,2,0.00023,165708,19.25087,860782
13797,srini1978,2,0.00023,165710,19.25110,860782
13798,Srini-B-GIT,2,0.00023,165712,19.25133,860782
13799,sriramana,2,0.00023,165714,19.25156,860782
13800,srknc,2,0.00023,165716,19.25180,860782
13801,srprash,2,0.00023,165718,19.25203,860782
13802,SrslyJosh,2,0.00023,165720,19.25226,860782
13803,ssdowd,2,0.00023,165722,19.25249,860782
13804,ssesha,2,0.00023,165724,19.25273,860782
13805,ssh2n,2,0.00023,165726,19.25296,860782
13806,sstubbs,2,0.00023,165728,19.25319,860782
13807,standup-jb,2,0.00023,165730,19.25342,860782
13808,stanislaw55,2,0.00023,165732,19.25366,860782
13809,stanleynguyen,2,0.00023,165734,19.25389,860782
13810,stantonk,2,0.00023,165736,19.25412,860782
13811,Starbix,2,0.00023,165738,19.25435,860782
13812,stefanbirkner,2,0.00023,165740,19.25458,860782
13813,Stefanbs23,2,0.00023,165742,19.25482,860782
13814,stefanhengl,2,0.00023,165744,19.25505,860782
13815,stefanolczak,2,0.00023,165746,19.25528,860782
13816,stefanomerlano,2,0.00023,165748,19.25551,860782
13817,stefanoparkopedia,2,0.00023,165750,19.25575,860782
13818,stefanotauriello,2,0.00023,165752,19.25598,860782
13819,steghio,2,0.00023,165754,19.25621,860782
13820,steinz,2,0.00023,165756,19.25644,860782
13821,stekershaw,2,0.00023,165758,19.25668,860782
13822,StephanX,2,0.00023,165760,19.25691,860782
13823,stephenrjohnson,2,0.00023,165762,19.25714,860782
13824,stepupit-work,2,0.00023,165764,19.25737,860782
13825,stevegszabo,2,0.00023,165766,19.25761,860782
13826,stevengubler,2,0.00023,165768,19.25784,860782
13827,StevenLiekens,2,0.00023,165770,19.25807,860782
13828,stevenolen,2,0.00023,165772,19.25830,860782
13829,stevenwjy,2,0.00023,165774,19.25853,860782
13830,stockersky,2,0.00023,165776,19.25877,860782
13831,stopsopa,2,0.00023,165778,19.25900,860782
13832,stpierre,2,0.00023,165780,19.25923,860782
13833,strantalis,2,0.00023,165782,19.25946,860782
13834,stratusjerry,2,0.00023,165784,19.25970,860782
13835,stuart-c,2,0.00023,165786,19.25993,860782
13836,stvnwrgs,2,0.00023,165788,19.26016,860782
13837,sudevva,2,0.00023,165790,19.26039,860782
13838,sudobhat,2,0.00023,165792,19.26063,860782
13839,sudoforge,2,0.00023,165794,19.26086,860782
13840,sudomaxime,2,0.00023,165796,19.26109,860782
13841,sujiths,2,0.00023,165798,19.26132,860782
13842,sukhinin,2,0.00023,165800,19.26156,860782
13843,sulenn,2,0.00023,165802,19.26179,860782
13844,sumankumar001,2,0.00023,165804,19.26202,860782
13845,SumantPangotra,2,0.00023,165806,19.26225,860782
13846,sumukhballal,2,0.00023,165808,19.26248,860782
13847,sunbinnnnn,2,0.00023,165810,19.26272,860782
13848,sunfangGit,2,0.00023,165812,19.26295,860782
13849,sunshine69,2,0.00023,165814,19.26318,860782
13850,supermuka,2,0.00023,165816,19.26341,860782
13851,superstator,2,0.00023,165818,19.26365,860782
13852,surbhiagrawal22,2,0.00023,165820,19.26388,860782
13853,sureshballa,2,0.00023,165822,19.26411,860782
13854,sureshkallem,2,0.00023,165824,19.26434,860782
13855,sureshkvl,2,0.00023,165826,19.26458,860782
13856,sureshsankaran,2,0.00023,165828,19.26481,860782
13857,Surya2709,2,0.00023,165830,19.26504,860782
13858,Suse130224,2,0.00023,165832,19.26527,860782
13859,sushanco,2,0.00023,165834,19.26551,860782
13860,Sushant20,2,0.00023,165836,19.26574,860782
13861,sushiMix,2,0.00023,165838,19.26597,860782
13862,sushmithakumar,2,0.00023,165840,19.26620,860782
13863,susinmotion,2,0.00023,165842,19.26643,860782
13864,svachmic,2,0.00023,165844,19.26667,860782
13865,svallala,2,0.00023,165846,19.26690,860782
13866,svangeepuram,2,0.00023,165848,19.26713,860782
13867,SvenDhaens,2,0.00023,165850,19.26736,860782
13868,svgreatest,2,0.00023,165852,19.26760,860782
13869,s-vivien,2,0.00023,165854,19.26783,860782
13870,svrc-pivotal,2,0.00023,165856,19.26806,860782
13871,svua,2,0.00023,165858,19.26829,860782
13872,sw919678915,2,0.00023,165860,19.26853,860782
13873,swamibluedata,2,0.00023,165862,19.26876,860782
13874,sw-fastec,2,0.00023,165864,19.26899,860782
13875,swiftugandan,2,0.00023,165866,19.26922,860782
13876,Swoorup,2,0.00023,165868,19.26945,860782
13877,swqmaven,2,0.00023,165870,19.26969,860782
13878,syck40,2,0.00023,165872,19.26992,860782
13879,syedimranhassan,2,0.00023,165874,19.27015,860782
13880,syklevin,2,0.00023,165876,19.27038,860782
13881,sykp241095,2,0.00023,165878,19.27062,860782
13882,sysadmind,2,0.00023,165880,19.27085,860782
13883,Sytten,2,0.00023,165882,19.27108,860782
13884,syurchenko,2,0.00023,165884,19.27131,860782
13885,szberko,2,0.00023,165886,19.27155,860782
13886,szEvEz,2,0.00023,165888,19.27178,860782
13887,szikanova,2,0.00023,165890,19.27201,860782
13888,szimonek,2,0.00023,165892,19.27224,860782
13889,szlyunnan,2,0.00023,165894,19.27248,860782
13890,szpuni,2,0.00023,165896,19.27271,860782
13891,t3hmrman,2,0.00023,165898,19.27294,860782
13892,taamit1,2,0.00023,165900,19.27317,860782
13893,TabbySableDD,2,0.00023,165902,19.27340,860782
13894,tagoro9,2,0.00023,165904,19.27364,860782
13895,tahirarain085,2,0.00023,165906,19.27387,860782
13896,Talador12,2,0.00023,165908,19.27410,860782
13897,talebook,2,0.00023,165910,19.27433,860782
13898,talmarco,2,0.00023,165912,19.27457,860782
13899,tamilhce,2,0.00023,165914,19.27480,860782
13900,Tamronimus,2,0.00023,165916,19.27503,860782
13901,tan31989,2,0.00023,165918,19.27526,860782
13902,TangLi-Xuke,2,0.00023,165920,19.27550,860782
13903,TangqiFeng,2,0.00023,165922,19.27573,860782
13904,tangx,2,0.00023,165924,19.27596,860782
13905,tangyanhan,2,0.00023,165926,19.27619,860782
13906,tangyibo,2,0.00023,165928,19.27643,860782
13907,tangzhankun,2,0.00023,165930,19.27666,860782
13908,tanmayv25,2,0.00023,165932,19.27689,860782
13909,Taranasaur,2,0.00023,165934,19.27712,860782
13910,tareqhs,2,0.00023,165936,19.27735,860782
13911,tarunptala,2,0.00023,165938,19.27759,860782
13912,tatiesmars,2,0.00023,165940,19.27782,860782
13913,tatsu-yam,2,0.00023,165942,19.27805,860782
13914,TAvardit,2,0.00023,165944,19.27828,860782
13915,Tawmu,2,0.00023,165946,19.27852,860782
13916,Tazminia,2,0.00023,165948,19.27875,860782
13917,tboemker,2,0.00023,165950,19.27898,860782
13918,tbragin,2,0.00023,165952,19.27921,860782
13919,tcdowney,2,0.00023,165954,19.27945,860782
13920,tckb,2,0.00023,165956,19.27968,860782
13921,tcoln,2,0.00023,165958,19.27991,860782
13922,tde908,2,0.00023,165960,19.28014,860782
13923,tdesmet,2,0.00023,165962,19.28038,860782
13924,tdfirth,2,0.00023,165964,19.28061,860782
13925,tdk-github,2,0.00023,165966,19.28084,860782
13926,tdmanv,2,0.00023,165968,19.28107,860782
13927,tdwyer,2,0.00023,165970,19.28130,860782
13928,teachersun,2,0.00023,165972,19.28154,860782
13929,tech-dragon157,2,0.00023,165974,19.28177,860782
13930,technologynongmin,2,0.00023,165976,19.28200,860782
13931,techxel,2,0.00023,165978,19.28223,860782
13932,Techyuvi,2,0.00023,165980,19.28247,860782
13933,ted222,2,0.00023,165982,19.28270,860782
13934,teke97,2,0.00023,165984,19.28293,860782
13935,temujin9,2,0.00023,165986,19.28316,860782
13936,teozkr,2,0.00023,165988,19.28340,860782
13937,teraflik,2,0.00023,165990,19.28363,860782
13938,teramucho,2,0.00023,165992,19.28386,860782
13939,terrafying,2,0.00023,165994,19.28409,860782
13940,terrycain,2,0.00023,165996,19.28433,860782
13941,terry-sm,2,0.00023,165998,19.28456,860782
13942,TerryTab,2,0.00023,166000,19.28479,860782
13943,TeruakiNoyama,2,0.00023,166002,19.28502,860782
13944,terzonstefano,2,0.00023,166004,19.28525,860782
13945,tetchel,2,0.00023,166006,19.28549,860782
13946,tetrash,2,0.00023,166008,19.28572,860782
13947,tettusud,2,0.00023,166010,19.28595,860782
13948,tfkinc,2,0.00023,166012,19.28618,860782
13949,tgeens,2,0.00023,166014,19.28642,860782
13950,tgwizard,2,0.00023,166016,19.28665,860782
13951,thaishankar,2,0.00023,166018,19.28688,860782
13952,thangchung,2,0.00023,166020,19.28711,860782
13953,Tharun-Sabbu,2,0.00023,166022,19.28735,860782
13954,the4thamigo-uk,2,0.00023,166024,19.28758,860782
13955,TheAli711,2,0.00023,166026,19.28781,860782
13956,theangrydev,2,0.00023,166028,19.28804,860782
13957,thebigcorporation,2,0.00023,166030,19.28828,860782
13958,TheCamNelson,2,0.00023,166032,19.28851,860782
13959,TheDiveO,2,0.00023,166034,19.28874,860782
13960,TheDruidsKeeper,2,0.00023,166036,19.28897,860782
13961,theevocater,2,0.00023,166038,19.28920,860782
13962,thefringeninja,2,0.00023,166040,19.28944,860782
13963,thehappycoder,2,0.00023,166042,19.28967,860782
13964,theis188,2,0.00023,166044,19.28990,860782
13965,theletterf,2,0.00023,166046,19.29013,860782
13966,theothertomelliott,2,0.00023,166048,19.29037,860782
13967,thepwagner,2,0.00023,166050,19.29060,860782
13968,theresac23,2,0.00023,166052,19.29083,860782
13969,the-scott-hand,2,0.00023,166054,19.29106,860782
13970,TheSpbra1n,2,0.00023,166056,19.29130,860782
13971,thestarmaker,2,0.00023,166058,19.29153,860782
13972,TheUltimateC0der,2,0.00023,166060,19.29176,860782
13973,the-yash,2,0.00023,166062,19.29199,860782
13974,thiagonache,2,0.00023,166064,19.29222,860782
13975,ThiagoT1,2,0.00023,166066,19.29246,860782
13976,thiDucTran,2,0.00023,166068,19.29269,860782
13977,ThilinaManamgoda,2,0.00023,166070,19.29292,860782
13978,thirstycrow,2,0.00023,166072,19.29315,860782
13979,ThisGuyCodes,2,0.00023,166074,19.29339,860782
13980,thisisabhishek,2,0.00023,166076,19.29362,860782
13981,thomasdanan,2,0.00023,166078,19.29385,860782
13982,thomasfrisko,2,0.00023,166080,19.29408,860782
13983,Thomas-In,2,0.00023,166082,19.29432,860782
13984,Thoro,2,0.00023,166084,19.29455,860782
13985,thothothotho,2,0.00023,166086,19.29478,860782
13986,thulle,2,0.00023,166088,19.29501,860782
13987,tiagoIW,2,0.00023,166090,19.29525,860782
13988,tiancaiamao,2,0.00023,166092,19.29548,860782
13989,tianxiaoliang,2,0.00023,166094,19.29571,860782
13990,tibcoplord,2,0.00023,166096,19.29594,860782
13991,tibin-mfl,2,0.00023,166098,19.29617,860782
13992,tibodf,2,0.00023,166100,19.29641,860782
13993,tibuntu,2,0.00023,166102,19.29664,860782
13994,tiendungitd,2,0.00023,166104,19.29687,860782
13995,tigran-a,2,0.00023,166106,19.29710,860782
13996,tillt,2,0.00023,166108,19.29734,860782
13997,TiloGit,2,0.00023,166110,19.29757,860782
13998,tim-a17,2,0.00023,166112,19.29780,860782
13999,timam,2,0.00023,166114,19.29803,860782
14000,timbocau,2,0.00023,166116,19.29827,860782
14001,timboven,2,0.00023,166118,19.29850,860782
14002,timcappalli,2,0.00023,166120,19.29873,860782
14003,timothy-spencer,2,0.00023,166122,19.29896,860782
14004,tina1296,2,0.00023,166124,19.29920,860782
14005,tinder-shivagopalan,2,0.00023,166126,19.29943,860782
14006,tinder-vibhorkumar,2,0.00023,166128,19.29966,860782
14007,tingweiwu,2,0.00023,166130,19.29989,860782
14008,tkawachi,2,0.00023,166132,19.30012,860782
14009,tkbrex,2,0.00023,166134,19.30036,860782
14010,tle209,2,0.00023,166136,19.30059,860782
14011,tlex,2,0.00023,166138,19.30082,860782
14012,TMaYaD,2,0.00023,166140,19.30105,860782
14013,tndhagedorn,2,0.00023,166142,19.30129,860782
14014,toadjaune,2,0.00023,166144,19.30152,860782
14015,tobbaumgartner,2,0.00023,166146,19.30175,860782
14016,tobybellwood,2,0.00023,166148,19.30198,860782
14017,todd-berger,2,0.00023,166150,19.30222,860782
14018,tofele,2,0.00023,166152,19.30245,860782
14019,togis123,2,0.00023,166154,19.30268,860782
14020,toha-tk,2,0.00023,166156,19.30291,860782
14021,tokheim,2,0.00023,166158,19.30315,860782
14022,tokiwinter,2,0.00023,166160,19.30338,860782
14023,tolgaingenc,2,0.00023,166162,19.30361,860782
14024,tomassatka,2,0.00023,166164,19.30384,860782
14025,tomaszstaniewicz,2,0.00023,166166,19.30407,860782
14026,tomatac,2,0.00023,166168,19.30431,860782
14027,tomelliff,2,0.00023,166170,19.30454,860782
14028,tomiaijo,2,0.00023,166172,19.30477,860782
14029,tomkivlin,2,0.00023,166174,19.30500,860782
14030,TomL-dev,2,0.00023,166176,19.30524,860782
14031,tomoyk,2,0.00023,166178,19.30547,860782
14032,TomShawn,2,0.00023,166180,19.30570,860782
14033,tong-luo1,2,0.00023,166182,19.30593,860782
14034,TonyBogdanov,2,0.00023,166184,19.30617,860782
14035,TonyHuaPei,2,0.00023,166186,19.30640,860782
14036,tony-liuliu,2,0.00023,166188,19.30663,860782
14037,tores1,2,0.00023,166190,19.30686,860782
14038,torubylist,2,0.00023,166192,19.30710,860782
14039,toshyak,2,0.00023,166194,19.30733,860782
14040,toyaser,2,0.00023,166196,19.30756,860782
14041,tqangxl,2,0.00023,166198,19.30779,860782
14042,TqrHsn,2,0.00023,166200,19.30802,860782
14043,traviswt,2,0.00023,166202,19.30826,860782
14044,tredmon,2,0.00023,166204,19.30849,860782
14045,tretos53,2,0.00023,166206,19.30872,860782
14046,TritonNet,2,0.00023,166208,19.30895,860782
14047,Trojan295,2,0.00023,166210,19.30919,860782
14048,TrongTran95,2,0.00023,166212,19.30942,860782
14049,troygraben,2,0.00023,166214,19.30965,860782
14050,trranjith,2,0.00023,166216,19.30988,860782
14051,trsreagan3,2,0.00023,166218,19.31012,860782
14052,truealex81,2,0.00023,166220,19.31035,860782
14053,trunal-vinerkar,2,0.00023,166222,19.31058,860782
14054,truongtrevor,2,0.00023,166224,19.31081,860782
14055,tsaylor,2,0.00023,166226,19.31105,860782
14056,TsingLiang,2,0.00023,166228,19.31128,860782
14057,tterrace,2,0.00023,166230,19.31151,860782
14058,ttreuthardt,2,0.00023,166232,19.31174,860782
14059,tuapuikia,2,0.00023,166234,19.31197,860782
14060,turnes,2,0.00023,166236,19.31221,860782
14061,tushi0407,2,0.00023,166238,19.31244,860782
14062,tux-o-matic,2,0.00023,166240,19.31267,860782
14063,tvannahl,2,0.00023,166242,19.31290,860782
14064,tw666,2,0.00023,166244,19.31314,860782
14065,Twinuma,2,0.00023,166246,19.31337,860782
14066,twixthehero,2,0.00023,166248,19.31360,860782
14067,twreid,2,0.00023,166250,19.31383,860782
14068,txynidakis,2,0.00023,166252,19.31407,860782
14069,TXZQ1899,2,0.00023,166254,19.31430,860782
14070,TylerBrock,2,0.00023,166256,19.31453,860782
14071,tylerohlsen,2,0.00023,166258,19.31476,860782
14072,tylerposey59,2,0.00023,166260,19.31499,860782
14073,Typraeurion,2,0.00023,166262,19.31523,860782
14074,Tyrael,2,0.00023,166264,19.31546,860782
14075,tzz,2,0.00023,166266,19.31569,860782
14076,ubaierbhat,2,0.00023,166268,19.31592,860782
14077,ubhide,2,0.00023,166270,19.31616,860782
14078,ubombi,2,0.00023,166272,19.31639,860782
14079,Ufoton,2,0.00023,166274,19.31662,860782
14080,uhcl-lund,2,0.00023,166276,19.31685,860782
14081,ujued,2,0.00023,166278,19.31709,860782
14082,Ulanmax,2,0.00023,166280,19.31732,860782
14083,UlTriX,2,0.00023,166282,19.31755,860782
14084,umairmkhan,2,0.00023,166284,19.31778,860782
14085,uma-spatil,2,0.00023,166286,19.31802,860782
14086,Unb9rn,2,0.00023,166288,19.31825,860782
14087,unfor19,2,0.00023,166290,19.31848,860782
14088,UnluckyAj,2,0.00023,166292,19.31871,860782
14089,Unniboy,2,0.00023,166294,19.31894,860782
14090,upendrap,2,0.00023,166296,19.31918,860782
14091,upsuper,2,0.00023,166298,19.31941,860782
14092,uronce-cc,2,0.00023,166300,19.31964,860782
14093,usrbinkat,2,0.00023,166302,19.31987,860782
14094,ussuritiger,2,0.00023,166304,19.32011,860782
14095,usualstuff,2,0.00023,166306,19.32034,860782
14096,uttamanand,2,0.00023,166308,19.32057,860782
14097,Va1,2,0.00023,166310,19.32080,860782
14098,vaibhavgulati,2,0.00023,166312,19.32104,860782
14099,vaidik,2,0.00023,166314,19.32127,860782
14100,valaymerick,2,0.00023,166316,19.32150,860782
14101,Valgard,2,0.00023,166318,19.32173,860782
14102,valiantljk,2,0.00023,166320,19.32197,860782
14103,valters,2,0.00023,166322,19.32220,860782
14104,valvin1,2,0.00023,166324,19.32243,860782
14105,vanakema,2,0.00023,166326,19.32266,860782
14106,vanHoesel,2,0.00023,166328,19.32289,860782
14107,vanhumbeecka,2,0.00023,166330,19.32313,860782
14108,vap78,2,0.00023,166332,19.32336,860782
14109,VariableDeclared,2,0.00023,166334,19.32359,860782
14110,Varorbc,2,0.00023,166336,19.32382,860782
14111,varsharain-a11y,2,0.00023,166338,19.32406,860782
14112,varunpurohit76,2,0.00023,166340,19.32429,860782
14113,VarunSrinivasa,2,0.00023,166342,19.32452,860782
14114,vasiliy-t,2,0.00023,166344,19.32475,860782
14115,vasuadari,2,0.00023,166346,19.32499,860782
14116,vburckhardt,2,0.00023,166348,19.32522,860782
14117,vcidst,2,0.00023,166350,19.32545,860782
14118,vctrferreira,2,0.00023,166352,19.32568,860782
14119,vctrmn,2,0.00023,166354,19.32592,860782
14120,vdabbara,2,0.00023,166356,19.32615,860782
14121,vdeturckheim,2,0.00023,166358,19.32638,860782
14122,vd-rd,2,0.00023,166360,19.32661,860782
14123,Vedadiyan,2,0.00023,166362,19.32684,860782
14124,Vedanshshri,2,0.00023,166364,19.32708,860782
14125,veily,2,0.00023,166366,19.32731,860782
14126,velickym,2,0.00023,166368,19.32754,860782
14127,venkatakrishna-biarca,2,0.00023,166370,19.32777,860782
14128,VenkateshSrini,2,0.00023,166372,19.32801,860782
14129,venomwaqar,2,0.00023,166374,19.32824,860782
14130,vergissmiNET,2,0.00023,166376,19.32847,860782
14131,verrocchimarco,2,0.00023,166378,19.32870,860782
14132,vetyy,2,0.00023,166380,19.32894,860782
14133,vfabi,2,0.00023,166382,19.32917,860782
14134,Vfialkin,2,0.00023,166384,19.32940,860782
14135,vfolk30,2,0.00023,166386,19.32963,860782
14136,v-gu,2,0.00023,166388,19.32987,860782
14137,vhuang0501,2,0.00023,166390,19.33010,860782
14138,viacheslave,2,0.00023,166392,19.33033,860782
14139,victorBychinski,2,0.00023,166394,19.33056,860782
14140,victorpaulo,2,0.00023,166396,19.33079,860782
14141,VictorRobellini,2,0.00023,166398,19.33103,860782
14142,victorv587,2,0.00023,166400,19.33126,860782
14143,victoryNap,2,0.00023,166402,19.33149,860782
14144,vidolch,2,0.00023,166404,19.33172,860782
14145,vidurgupta,2,0.00023,166406,19.33196,860782
14146,vietnguyen3-tiki,2,0.00023,166408,19.33219,860782
14147,vietwow,2,0.00023,166410,19.33242,860782
14148,vigneshsolution,2,0.00023,166412,19.33265,860782
14149,vijay-dcrust,2,0.00023,166414,19.33289,860782
14150,vijesh12,2,0.00023,166416,19.33312,860782
14151,vijtrip2,2,0.00023,166418,19.33335,860782
14152,vikramhome,2,0.00023,166420,19.33358,860782
14153,vikramkhatri,2,0.00023,166422,19.33382,860782
14154,vikrant82,2,0.00023,166424,19.33405,860782
14155,vikstlu,2,0.00023,166426,19.33428,860782
14156,ViktorFefilov,2,0.00023,166428,19.33451,860782
14157,viktoriaas,2,0.00023,166430,19.33474,860782
14158,villesau,2,0.00023,166432,19.33498,860782
14159,Vinay328,2,0.00023,166434,19.33521,860782
14160,vinaykv1991,2,0.00023,166436,19.33544,860782
14161,vinaymorkar,2,0.00023,166438,19.33567,860782
14162,vinayxbox,2,0.00023,166440,19.33591,860782
14163,vince329,2,0.00023,166442,19.33614,860782
14164,vincentjocodes,2,0.00023,166444,19.33637,860782
14165,vincentnawrocki,2,0.00023,166446,19.33660,860782
14166,vindvaki,2,0.00023,166448,19.33684,860782
14167,viniciusgarcia-hotmart,2,0.00023,166450,19.33707,860782
14168,violentmagician,2,0.00023,166452,19.33730,860782
14169,virkt25,2,0.00023,166454,19.33753,860782
14170,vishnu-narayanan,2,0.00023,166456,19.33776,860782
14171,vitalybibikov,2,0.00023,166458,19.33800,860782
14172,VitalySh,2,0.00023,166460,19.33823,860782
14173,VivekMittals,2,0.00023,166462,19.33846,860782
14174,vivisidea,2,0.00023,166464,19.33869,860782
14175,vjtm,2,0.00023,166466,19.33893,860782
14176,vladimirshefer,2,0.00023,166468,19.33916,860782
14177,vladislav-kiva,2,0.00023,166470,19.33939,860782
14178,VladoPortos,2,0.00023,166472,19.33962,860782
14179,vlandau,2,0.00023,166474,19.33986,860782
14180,vlopezferrando,2,0.00023,166476,19.34009,860782
14181,vlvasilev,2,0.00023,166478,19.34032,860782
14182,vml19,2,0.00023,166480,19.34055,860782
14183,vmohariya,2,0.00023,166482,19.34079,860782
14184,vmuzikar,2,0.00023,166484,19.34102,860782
14185,vnktram,2,0.00023,166486,19.34125,860782
14186,VoidAndAny,2,0.00023,166488,19.34148,860782
14187,voldemortensen,2,0.00023,166490,19.34171,860782
14188,volnt,2,0.00023,166492,19.34195,860782
14189,volvicoasis,2,0.00023,166494,19.34218,860782
14190,Vorian-Atreides,2,0.00023,166496,19.34241,860782
14191,vorticalbox,2,0.00023,166498,19.34264,860782
14192,vosmax,2,0.00023,166500,19.34288,860782
14193,vp642,2,0.00023,166502,19.34311,860782
14194,vpatodia,2,0.00023,166504,19.34334,860782
14195,vprus,2,0.00023,166506,19.34357,860782
14196,vputz,2,0.00023,166508,19.34381,860782
14197,vreuland,2,0.00023,166510,19.34404,860782
14198,v-reutov,2,0.00023,166512,19.34427,860782
14199,vs102000,2,0.00023,166514,19.34450,860782
14200,vsinghal13,2,0.00023,166516,19.34474,860782
14201,vssirigiri,2,0.00023,166518,19.34497,860782
14202,vtomar01,2,0.00023,166520,19.34520,860782
14203,vvkkhjt,2,0.00023,166522,19.34543,860782
14204,vvlookman,2,0.00023,166524,19.34566,860782
14205,w3blogfr,2,0.00023,166526,19.34590,860782
14206,wade19870531,2,0.00023,166528,19.34613,860782
14207,Waitfish,2,0.00023,166530,19.34636,860782
14208,Walther,2,0.00023,166532,19.34659,860782
14209,Wambou,2,0.00023,166534,19.34683,860782
14210,wangfeiping,2,0.00023,166536,19.34706,860782
14211,wanghao923,2,0.00023,166538,19.34729,860782
14212,wanghualei,2,0.00023,166540,19.34752,860782
14213,wanghy8166,2,0.00023,166542,19.34776,860782
14214,wangjian138,2,0.00023,166544,19.34799,860782
14215,wangweihong,2,0.00023,166546,19.34822,860782
14216,wangyjx,2,0.00023,166548,19.34845,860782
14217,wanjunlei,2,0.00023,166550,19.34869,860782
14218,wanyingd1996,2,0.00023,166552,19.34892,860782
14219,wardbekker,2,0.00023,166554,19.34915,860782
14220,wardviaene,2,0.00023,166556,19.34938,860782
14221,washtubs,2,0.00023,166558,19.34961,860782
14222,wasifkh,2,0.00023,166560,19.34985,860782
14223,Wastack,2,0.00023,166562,19.35008,860782
14224,watsh-rajneesh,2,0.00023,166564,19.35031,860782
14225,waylan-zest,2,0.00023,166566,19.35054,860782
14226,waynewong-ascenda,2,0.00023,166568,19.35078,860782
14227,wbcsmarteezgithub,2,0.00023,166570,19.35101,860782
14228,wbean1,2,0.00023,166572,19.35124,860782
14229,WB-jastme,2,0.00023,166574,19.35147,860782
14230,wbyun,2,0.00023,166576,19.35171,860782
14231,wdoekes,2,0.00023,166578,19.35194,860782
14232,Weasy666,2,0.00023,166580,19.35217,860782
14233,webster-chainalysis,2,0.00023,166582,19.35240,860782
14234,wedud6,2,0.00023,166584,19.35264,860782
14235,wenjiehs,2,0.00023,166586,19.35287,860782
14236,WesleyBatista,2,0.00023,166588,19.35310,860782
14237,WesleyVestjens,2,0.00023,166590,19.35333,860782
14238,Westacular,2,0.00023,166592,19.35356,860782
14239,wfagan,2,0.00023,166594,19.35380,860782
14240,whdckszxxx,2,0.00023,166596,19.35403,860782
14241,whiskerch,2,0.00023,166598,19.35426,860782
14242,whitlaaa,2,0.00023,166600,19.35449,860782
14243,whmountains,2,0.00023,166602,19.35473,860782
14244,whut,2,0.00023,166604,19.35496,860782
14245,wi1dcard,2,0.00023,166606,19.35519,860782
14246,wikusbrinkNearmap,2,0.00023,166608,19.35542,860782
14247,wildbinaryforest,2,0.00023,166610,19.35566,860782
14248,willgleich,2,0.00023,166612,19.35589,860782
14249,WilliamABradley,2,0.00023,166614,19.35612,860782
14250,Willjay90,2,0.00023,166616,19.35635,860782
14251,Wilson13,2,0.00023,166618,19.35659,860782
14252,wilsonfv,2,0.00023,166620,19.35682,860782
14253,Win0818,2,0.00023,166622,19.35705,860782
14254,win5do,2,0.00023,166624,19.35728,860782
14255,wiruzman,2,0.00023,166626,19.35751,860782
14256,withgod,2,0.00023,166628,19.35775,860782
14257,wiv33,2,0.00023,166630,19.35798,860782
14258,wjl120,2,0.00023,166632,19.35821,860782
14259,wjrenren,2,0.00023,166634,19.35844,860782
14260,wlchn,2,0.00023,166636,19.35868,860782
14261,wlucjan,2,0.00023,166638,19.35891,860782
14262,wmtylerbrown,2,0.00023,166640,19.35914,860782
14263,wojtekmach,2,0.00023,166642,19.35937,860782
14264,wolfeidau,2,0.00023,166644,19.35961,860782
14265,wonderland,2,0.00023,166646,19.35984,860782
14266,WoodyFleurant,2,0.00023,166648,19.36007,860782
14267,Woofenator,2,0.00023,166650,19.36030,860782
14268,wouterhund,2,0.00023,166652,19.36053,860782
14269,wphe,2,0.00023,166654,19.36077,860782
14270,wreulicke,2,0.00023,166656,19.36100,860782
14271,wsams,2,0.00023,166658,19.36123,860782
14272,wtask,2,0.00023,166660,19.36146,860782
14273,wtlucy,2,0.00023,166662,19.36170,860782
14274,wuchuxiong,2,0.00023,166664,19.36193,860782
14275,wujianqiangwjq,2,0.00023,166666,19.36216,860782
14276,wujun8,2,0.00023,166668,19.36239,860782
14277,wusphinx,2,0.00023,166670,19.36263,860782
14278,wwz801226,2,0.00023,166672,19.36286,860782
14279,wxdlong,2,0.00023,166674,19.36309,860782
14280,WXM99,2,0.00023,166676,19.36332,860782
14281,wxy325,2,0.00023,166678,19.36356,860782
14282,wyaopeng,2,0.00023,166680,19.36379,860782
14283,wylazy,2,0.00023,166682,19.36402,860782
14284,wzharies,2,0.00023,166684,19.36425,860782
14285,wzrdtales,2,0.00023,166686,19.36448,860782
14286,wzxmt,2,0.00023,166688,19.36472,860782
14287,Xaelias,2,0.00023,166690,19.36495,860782
14288,xagent003,2,0.00023,166692,19.36518,860782
14289,xamox,2,0.00023,166694,19.36541,860782
14290,xanthoc,2,0.00023,166696,19.36565,860782
14291,xAt0mZ,2,0.00023,166698,19.36588,860782
14292,xavierW,2,0.00023,166700,19.36611,860782
14293,xcrezd,2,0.00023,166702,19.36634,860782
14294,xdeepanshu,2,0.00023,166704,19.36658,860782
14295,XDex,2,0.00023,166706,19.36681,860782
14296,xgao3,2,0.00023,166708,19.36704,860782
14297,xiangwangcheng,2,0.00023,166710,19.36727,860782
14298,xiaolin8,2,0.00023,166712,19.36751,860782
14299,xiaolixi,2,0.00023,166714,19.36774,860782
14300,xiaonancc77,2,0.00023,166716,19.36797,860782
14301,xichen2020,2,0.00023,166718,19.36820,860782
14302,XieGuochao,2,0.00023,166720,19.36843,860782
14303,xiezhw3,2,0.00023,166722,19.36867,860782
14304,xin478,2,0.00023,166724,19.36890,860782
14305,xinghui-hou,2,0.00023,166726,19.36913,860782
14306,xino12,2,0.00023,166728,19.36936,860782
14307,xinxiao,2,0.00023,166730,19.36960,860782
14308,xinzhang,2,0.00023,166732,19.36983,860782
14309,xiongkun01,2,0.00023,166734,19.37006,860782
14310,xjuric29,2,0.00023,166736,19.37029,860782
14311,xkortex,2,0.00023,166738,19.37053,860782
14312,xontab,2,0.00023,166740,19.37076,860782
14313,xopham,2,0.00023,166742,19.37099,860782
14314,xose,2,0.00023,166744,19.37122,860782
14315,xPB12,2,0.00023,166746,19.37146,860782
14316,xpirt,2,0.00023,166748,19.37169,860782
14317,xsbchen,2,0.00023,166750,19.37192,860782
14318,xSystemErrorx,2,0.00023,166752,19.37215,860782
14319,xuanyunhui,2,0.00023,166754,19.37238,860782
14320,xvrlee,2,0.00023,166756,19.37262,860782
14321,xxchan,2,0.00023,166758,19.37285,860782
14322,xxwassyxx,2,0.00023,166760,19.37308,860782
14323,y0zg,2,0.00023,166762,19.37331,860782
14324,ya5u,2,0.00023,166764,19.37355,860782
14325,yadvlz,2,0.00023,166766,19.37378,860782
14326,yagince,2,0.00023,166768,19.37401,860782
14327,Yalafeg,2,0.00023,166770,19.37424,860782
14328,yamagai,2,0.00023,166772,19.37448,860782
14329,yamajik,2,0.00023,166774,19.37471,860782
14330,yan636,2,0.00023,166776,19.37494,860782
14331,yangjieer,2,0.00023,166778,19.37517,860782
14332,YangKian,2,0.00023,166780,19.37541,860782
14333,Yangstatus,2,0.00023,166782,19.37564,860782
14334,yanjunli76,2,0.00023,166784,19.37587,860782
14335,YanlongLi,2,0.00023,166786,19.37610,860782
14336,YannikSc,2,0.00023,166788,19.37633,860782
14337,YanSushchynski,2,0.00023,166790,19.37657,860782
14338,yanzacheus,2,0.00023,166792,19.37680,860782
14339,yaominator,2,0.00023,166794,19.37703,860782
14340,yaoyuandota,2,0.00023,166796,19.37726,860782
14341,yarix,2,0.00023,166798,19.37750,860782
14342,yasensim,2,0.00023,166800,19.37773,860782
14343,yashraj021,2,0.00023,166802,19.37796,860782
14344,yashwanthkalva,2,0.00023,166804,19.37819,860782
14345,yauhen-sobaleu,2,0.00023,166806,19.37843,860782
14346,yawboateng,2,0.00023,166808,19.37866,860782
14347,y-batsianouski,2,0.00023,166810,19.37889,860782
14348,ybnelson,2,0.00023,166812,19.37912,860782
14349,ycao56,2,0.00023,166814,19.37936,860782
14350,ye,2,0.00023,166816,19.37959,860782
14351,yedward,2,0.00023,166818,19.37982,860782
14352,YeongchanSeo,2,0.00023,166820,19.38005,860782
14353,yertym,2,0.00023,166822,19.38028,860782
14354,yeruvass,2,0.00023,166824,19.38052,860782
14355,yhding2003,2,0.00023,166826,19.38075,860782
14356,yifan,2,0.00023,166828,19.38098,860782
14357,yilongrong,2,0.00023,166830,19.38121,860782
14358,yineima,2,0.00023,166832,19.38145,860782
14359,yingfengxiaowangzi,2,0.00023,166834,19.38168,860782
14360,yingjieLi01,2,0.00023,166836,19.38191,860782
14361,yishaihl,2,0.00023,166838,19.38214,860782
14362,yiyijin,2,0.00023,166840,19.38238,860782
14363,yizhu-wish,2,0.00023,166842,19.38261,860782
14364,ykthree,2,0.00023,166844,19.38284,860782
14365,ymettier,2,0.00023,166846,19.38307,860782
14366,yoavcloud,2,0.00023,166848,19.38330,860782
14367,yoda,2,0.00023,166850,19.38354,860782
14368,yogesh9391,2,0.00023,166852,19.38377,860782
14369,yolossn,2,0.00023,166854,19.38400,860782
14370,Yomanz,2,0.00023,166856,19.38423,860782
14371,YonaLugassi,2,0.00023,166858,19.38447,860782
14372,yongliu1992,2,0.00023,166860,19.38470,860782
14373,yongyct,2,0.00023,166862,19.38493,860782
14374,yoplait,2,0.00023,166864,19.38516,860782
14375,yoshz,2,0.00023,166866,19.38540,860782
14376,yossisegev,2,0.00023,166868,19.38563,860782
14377,yra-wtag,2,0.00023,166870,19.38586,860782
14378,yrro,2,0.00023,166872,19.38609,860782
14379,yrwal,2,0.00023,166874,19.38633,860782
14380,ys-achinta,2,0.00023,166876,19.38656,860782
14381,ysaito1001,2,0.00023,166878,19.38679,860782
14382,ysjjovo,2,0.00023,166880,19.38702,860782
14383,ytjohn,2,0.00023,166882,19.38725,860782
14384,yuanfeilv,2,0.00023,166884,19.38749,860782
14385,yuguorui,2,0.00023,166886,19.38772,860782
14386,yujhe,2,0.00023,166888,19.38795,860782
14387,Yukariko,2,0.00023,166890,19.38818,860782
14388,yunfan,2,0.00023,166892,19.38842,860782
14389,yungvj,2,0.00023,166894,19.38865,860782
14390,yuquan-wang,2,0.00023,166896,19.38888,860782
14391,yurenchen000,2,0.00023,166898,19.38911,860782
14392,YuriyBufeev,2,0.00023,166900,19.38935,860782
14393,yusiwen,2,0.00023,166902,19.38958,860782
14394,yusufyildiz,2,0.00023,166904,19.38981,860782
14395,yutnagase,2,0.00023,166906,19.39004,860782
14396,yutsengwei,2,0.00023,166908,19.39028,860782
14397,yuwaMSFT2,2,0.00023,166910,19.39051,860782
14398,yuxiaoba,2,0.00023,166912,19.39074,860782
14399,yuzujoe,2,0.00023,166914,19.39097,860782
14400,yvinap,2,0.00023,166916,19.39120,860782
14401,YYashwanth,2,0.00023,166918,19.39144,860782
14402,yyyiue,2,0.00023,166920,19.39167,860782
14403,yz1509,2,0.00023,166922,19.39190,860782
14404,yzargari,2,0.00023,166924,19.39213,860782
14405,yzz-ihep,2,0.00023,166926,19.39237,860782
14406,z0r0,2,0.00023,166928,19.39260,860782
14407,zaaxch,2,0.00023,166930,19.39283,860782
14408,zadm,2,0.00023,166932,19.39306,860782
14409,zadunn,2,0.00023,166934,19.39330,860782
14410,zafercavdar,2,0.00023,166936,19.39353,860782
14411,zaggash,2,0.00023,166938,19.39376,860782
14412,zaisongz,2,0.00023,166940,19.39399,860782
14413,zatamine,2,0.00023,166942,19.39423,860782
14414,zbialik,2,0.00023,166944,19.39446,860782
14415,Z-BUMBLEBEE-Z,2,0.00023,166946,19.39469,860782
14416,zd0106,2,0.00023,166948,19.39492,860782
14417,zd08135,2,0.00023,166950,19.39515,860782
14418,zdhamasha,2,0.00023,166952,19.39539,860782
14419,z-dmitri,2,0.00023,166954,19.39562,860782
14420,zeed-w-beez,2,0.00023,166956,19.39585,860782
14421,zeemba,2,0.00023,166958,19.39608,860782
14422,zeeZ,2,0.00023,166960,19.39632,860782
14423,zegerius,2,0.00023,166962,19.39655,860782
14424,zeidlermicha,2,0.00023,166964,19.39678,860782
14425,Zeka13,2,0.00023,166966,19.39701,860782
14426,zemiret,2,0.00023,166968,19.39725,860782
14427,zendril,2,0.00023,166970,19.39748,860782
14428,zenion,2,0.00023,166972,19.39771,860782
14429,zepatrik,2,0.00023,166974,19.39794,860782
14430,zerospiel,2,0.00023,166976,19.39818,860782
14431,zeshahid,2,0.00023,166978,19.39841,860782
14432,zet694,2,0.00023,166980,19.39864,860782
14433,zeusxs,2,0.00023,166982,19.39887,860782
14434,zexi,2,0.00023,166984,19.39910,860782
14435,zhaijunming,2,0.00023,166986,19.39934,860782
14436,zhangbitao,2,0.00023,166988,19.39957,860782
14437,zhangfeifeifei,2,0.00023,166990,19.39980,860782
14438,zhanghongtong,2,0.00023,166992,19.40003,860782
14439,zhanglistar,2,0.00023,166994,19.40027,860782
14440,zhangpengchen,2,0.00023,166996,19.40050,860782
14441,zhangru-dev,2,0.00023,166998,19.40073,860782
14442,Zhangxiancheng63,2,0.00023,167000,19.40096,860782
14443,zhangyang-gg,2,0.00023,167002,19.40120,860782
14444,zhangzhihui1,2,0.00023,167004,19.40143,860782
14445,zhaogaolong,2,0.00023,167006,19.40166,860782
14446,zhaojizhuang,2,0.00023,167008,19.40189,860782
14447,zhengyangyong,2,0.00023,167010,19.40213,860782
14448,zhenjiaogao,2,0.00023,167012,19.40236,860782
14449,zhh2005757,2,0.00023,167014,19.40259,860782
14450,zhimsel,2,0.00023,167016,19.40282,860782
14451,zhiyouce,2,0.00023,167018,19.40305,860782
14452,zhiyxu,2,0.00023,167020,19.40329,860782
14453,zhongj0802,2,0.00023,167022,19.40352,860782
14454,zhouxyang,2,0.00023,167024,19.40375,860782
14455,zhranklin,2,0.00023,167026,19.40398,860782
14456,zhulinwei,2,0.00023,167028,19.40422,860782
14457,zhumo27,2,0.00023,167030,19.40445,860782
14458,zhxnlai,2,0.00023,167032,19.40468,860782
14459,zifeo,2,0.00023,167034,19.40491,860782
14460,ZihanJiang96,2,0.00023,167036,19.40515,860782
14461,ZiheLiu,2,0.00023,167038,19.40538,860782
14462,zirpu,2,0.00023,167040,19.40561,860782
14463,ziyangczi,2,0.00023,167042,19.40584,860782
14464,zkendra,2,0.00023,167044,19.40607,860782
14465,zlfzy,2,0.00023,167046,19.40631,860782
14466,znicholsec,2,0.00023,167048,19.40654,860782
14467,zodiac12k,2,0.00023,167050,19.40677,860782
14468,zokrezyl,2,0.00023,167052,19.40700,860782
14469,ZongbaoLiu,2,0.00023,167054,19.40724,860782
14470,zoonage,2,0.00023,167056,19.40747,860782
14471,zoroyouxi,2,0.00023,167058,19.40770,860782
14472,zqwlai,2,0.00023,167060,19.40793,860782
14473,zshorz,2,0.00023,167062,19.40817,860782
14474,zsolt-keseru-epam,2,0.00023,167064,19.40840,860782
14475,ztj,2,0.00023,167066,19.40863,860782
14476,zub0r,2,0.00023,167068,19.40886,860782
14477,zubenkoivan,2,0.00023,167070,19.40910,860782
14478,zuiurs,2,0.00023,167072,19.40933,860782
14479,zuozp8,2,0.00023,167074,19.40956,860782
14480,zupermanOK,2,0.00023,167076,19.40979,860782
14481,zvaraondrej,2,0.00023,167078,19.41002,860782
14482,zwobill,2,0.00023,167080,19.41026,860782
14483,zxgm,2,0.00023,167082,19.41049,860782
14484,zxmrlc,2,0.00023,167084,19.41072,860782
14485,zxyxz,2,0.00023,167086,19.41095,860782
14486,zycon,2,0.00023,167088,19.41119,860782
14487,zyf0330,2,0.00023,167090,19.41142,860782
14488,zygiss,2,0.00023,167092,19.41165,860782
14489,zyxue,2,0.00023,167094,19.41188,860782
14490,zyy17,2,0.00023,167096,19.41212,860782
14491,zyyettie,2,0.00023,167098,19.41235,860782
14492,zzguang520,2,0.00023,167100,19.41258,860782
14493,zzh-wisdom,2,0.00023,167102,19.41281,860782
14494,ZzzJing,2,0.00023,167104,19.41305,860782
14495,zzzming,2,0.00023,167106,19.41328,860782
14496,00r2,1,0.00012,167107,19.41339,860782
14497,00subra8,1,0.00012,167108,19.41351,860782
14498,071300726,1,0.00012,167109,19.41363,860782
14499,07pia05,1,0.00012,167110,19.41374,860782
14500,0815pascal,1,0.00012,167111,19.41386,860782
14501,0944336868,1,0.00012,167112,19.41397,860782
14502,0blu,1,0.00012,167113,19.41409,860782
14503,0neSe7en,1,0.00012,167114,19.41421,860782
14504,0x0000-dot-ru,1,0.00012,167115,19.41432,860782
14505,0xlen,1,0.00012,167116,19.41444,860782
14506,1067511899,1,0.00012,167117,19.41456,860782
14507,111andre111,1,0.00012,167118,19.41467,860782
14508,11399371,1,0.00012,167119,19.41479,860782
14509,1194117884,1,0.00012,167120,19.41490,860782
14510,1194570458,1,0.00012,167121,19.41502,860782
14511,123Manoz,1,0.00012,167122,19.41514,860782
14512,1506430045,1,0.00012,167123,19.41525,860782
14513,15922521059,1,0.00012,167124,19.41537,860782
14514,18056371002,1,0.00012,167125,19.41548,860782
14515,1ber,1,0.00012,167126,19.41560,860782
14516,1bigchonk,1,0.00012,167127,19.41572,860782
14517,1kaushik1,1,0.00012,167128,19.41583,860782
14518,1nfility,1,0.00012,167129,19.41595,860782
14519,1player,1,0.00012,167130,19.41607,860782
14520,2020758,1,0.00012,167131,19.41618,860782
14521,27bharath,1,0.00012,167132,19.41630,860782
14522,27claudia,1,0.00012,167133,19.41641,860782
14523,2build,1,0.00012,167134,19.41653,860782
14524,2mind,1,0.00012,167135,19.41665,860782
14525,2pai,1,0.00012,167136,19.41676,860782
14526,2qif49lt,1,0.00012,167137,19.41688,860782
14527,2shsh,1,0.00012,167138,19.41700,860782
14528,2stacks,1,0.00012,167139,19.41711,860782
14529,2tim,1,0.00012,167140,19.41723,860782
14530,329888410,1,0.00012,167141,19.41734,860782
14531,376466932,1,0.00012,167142,19.41746,860782
14532,3d0c,1,0.00012,167143,19.41758,860782
14533,3nueves,1,0.00012,167144,19.41769,860782
14534,3rmack,1,0.00012,167145,19.41781,860782
14535,3tilley,1,0.00012,167146,19.41792,860782
14536,41tair,1,0.00012,167147,19.41804,860782
14537,42wim,1,0.00012,167148,19.41816,860782
14538,45736735,1,0.00012,167149,19.41827,860782
14539,4m3ndy,1,0.00012,167150,19.41839,860782
14540,4ndrewchin,1,0.00012,167151,19.41851,860782
14541,4ng31,1,0.00012,167152,19.41862,860782
14542,4ntoine,1,0.00012,167153,19.41874,860782
14543,4ss3g4f,1,0.00012,167154,19.41885,860782
14544,50n1c,1,0.00012,167155,19.41897,860782
14545,52devops,1,0.00012,167156,19.41909,860782
14546,573009114,1,0.00012,167157,19.41920,860782
14547,5kr1p7,1,0.00012,167158,19.41932,860782
14548,5RK7N,1,0.00012,167159,19.41943,860782
14549,6174495,1,0.00012,167160,19.41955,860782
14550,622michael,1,0.00012,167161,19.41967,860782
14551,6forcs,1,0.00012,167162,19.41978,860782
14552,6unpk,1,0.00012,167163,19.41990,860782
14553,758109577,1,0.00012,167164,19.42002,860782
14554,769344359,1,0.00012,167165,19.42013,860782
14555,7rulnik,1,0.00012,167166,19.42025,860782
14556,8160960572,1,0.00012,167167,19.42036,860782
14557,8573,1,0.00012,167168,19.42048,860782
14558,86label,1,0.00012,167169,19.42060,860782
14559,922mbb,1,0.00012,167170,19.42071,860782
14560,96RadhikaJadhav,1,0.00012,167171,19.42083,860782
14561,a180285,1,0.00012,167172,19.42095,860782
14562,a31amit,1,0.00012,167173,19.42106,860782
14563,a4aditya,1,0.00012,167174,19.42118,860782
14564,a5a5a9,1,0.00012,167175,19.42129,860782
14565,a62mds,1,0.00012,167176,19.42141,860782
14566,a85302543,1,0.00012,167177,19.42153,860782
14567,a8j8i8t8,1,0.00012,167178,19.42164,860782
14568,a8nova,1,0.00012,167179,19.42176,860782
14569,a9kitkumarsinha,1,0.00012,167180,19.42187,860782
14570,aa250816,1,0.00012,167181,19.42199,860782
14571,aaam,1,0.00012,167182,19.42211,860782
14572,AAber,1,0.00012,167183,19.42222,860782
14573,aadhik,1,0.00012,167184,19.42234,860782
14574,aakarshgupta97,1,0.00012,167185,19.42246,860782
14575,aalexsanyan,1,0.00012,167186,19.42257,860782
14576,aalloosshh,1,0.00012,167187,19.42269,860782
14577,aalsabag,1,0.00012,167188,19.42280,860782
14578,aandryashin,1,0.00012,167189,19.42292,860782
14579,aapjeisbaas,1,0.00012,167190,19.42304,860782
14580,aaron0609,1,0.00012,167191,19.42315,860782
14581,aaron5523,1,0.00012,167192,19.42327,860782
14582,aaronaddleman,1,0.00012,167193,19.42338,860782
14583,aaronhenshaw,1,0.00012,167194,19.42350,860782
14584,aaronhudon,1,0.00012,167195,19.42362,860782
14585,aaron-kasten,1,0.00012,167196,19.42373,860782
14586,aaronma5989,1,0.00012,167197,19.42385,860782
14587,aaronnewcomb,1,0.00012,167198,19.42397,860782
14588,AaronWashington,1,0.00012,167199,19.42408,860782
14589,aarrtteemmuuss,1,0.00012,167200,19.42420,860782
14590,AashishChughHome,1,0.00012,167201,19.42431,860782
14591,aaugustinas,1,0.00012,167202,19.42443,860782
14592,aauren,1,0.00012,167203,19.42455,860782
14593,Abandonsun,1,0.00012,167204,19.42466,860782
14594,abaurens,1,0.00012,167205,19.42478,860782
14595,abb3r,1,0.00012,167206,19.42490,860782
14596,AbbetWang,1,0.00012,167207,19.42501,860782
14597,abbi-gaurav,1,0.00012,167208,19.42513,860782
14598,abdelhalimresu,1,0.00012,167209,19.42524,860782
14599,abdidarmawan007,1,0.00012,167210,19.42536,860782
14600,abdulfasithgit,1,0.00012,167211,19.42548,860782
14601,abdullaheldemerdash,1,0.00012,167212,19.42559,860782
14602,abdusamed91,1,0.00012,167213,19.42571,860782
14603,abe545,1,0.00012,167214,19.42582,860782
14604,abenokraitis,1,0.00012,167215,19.42594,860782
14605,aberenshtein,1,0.00012,167216,19.42606,860782
14606,abhassine,1,0.00012,167217,19.42617,860782
14607,abhayyb,1,0.00012,167218,19.42629,860782
14608,abhianand09,1,0.00012,167219,19.42641,860782
14609,AbhijitGite4Git,1,0.00012,167220,19.42652,860782
14610,abhimanyu-babbar,1,0.00012,167221,19.42664,860782
14611,abhinavg97,1,0.00012,167222,19.42675,860782
14612,AbhinayGupta741,1,0.00012,167223,19.42687,860782
14613,abhinbalur,1,0.00012,167224,19.42699,860782
14614,Ab-hishek,1,0.00012,167225,19.42710,860782
14615,abhishekanne,1,0.00012,167226,19.42722,860782
14616,abhishekkarigar,1,0.00012,167227,19.42733,860782
14617,abhishekp1996,1,0.00012,167228,19.42745,860782
14618,abhishek-sehgal954,1,0.00012,167229,19.42757,860782
14619,abhishekweb,1,0.00012,167230,19.42768,860782
14620,abhishyam21,1,0.00012,167231,19.42780,860782
14621,AbirHamzi,1,0.00012,167232,19.42792,860782
14622,abisare,1,0.00012,167233,19.42803,860782
14623,abjennings,1,0.00012,167234,19.42815,860782
14624,Abn02,1,0.00012,167235,19.42826,860782
14625,ABNER-1,1,0.00012,167236,19.42838,860782
14626,aborilov,1,0.00012,167237,19.42850,860782
14627,abraaojs,1,0.00012,167238,19.42861,860782
14628,abrahamfathman,1,0.00012,167239,19.42873,860782
14629,abraverm,1,0.00012,167240,19.42884,860782
14630,abravo73,1,0.00012,167241,19.42896,860782
14631,abrenneke,1,0.00012,167242,19.42908,860782
14632,abritabroad,1,0.00012,167243,19.42919,860782
14633,AbsentLung,1,0.00012,167244,19.42931,860782
14634,absolutejam,1,0.00012,167245,19.42943,860782
14635,abstrask,1,0.00012,167246,19.42954,860782
14636,abualy,1,0.00012,167247,19.42966,860782
14637,abuango,1,0.00012,167248,19.42977,860782
14638,abuccts,1,0.00012,167249,19.42989,860782
14639,abudavis,1,0.00012,167250,19.43001,860782
14640,aburakab,1,0.00012,167251,19.43012,860782
14641,aburgos02,1,0.00012,167252,19.43024,860782
14642,aburomaissae,1,0.00012,167253,19.43036,860782
14643,abusaidm,1,0.00012,167254,19.43047,860782
14644,acannon828,1,0.00012,167255,19.43059,860782
14645,acardy,1,0.00012,167256,19.43070,860782
14646,acarsercan,1,0.00012,167257,19.43082,860782
14647,acazacu,1,0.00012,167258,19.43094,860782
14648,acca,1,0.00012,167259,19.43105,860782
14649,accu4x,1,0.00012,167260,19.43117,860782
14650,Accuratiorem,1,0.00012,167261,19.43128,860782
14651,acefei,1,0.00012,167262,19.43140,860782
14652,acehead,1,0.00012,167263,19.43152,860782
14653,acgray,1,0.00012,167264,19.43163,860782
14654,AchalGupta277,1,0.00012,167265,19.43175,860782
14655,achantavy,1,0.00012,167266,19.43187,860782
14656,achesin,1,0.00012,167267,19.43198,860782
14657,achevalet,1,0.00012,167268,19.43210,860782
14658,achmudas,1,0.00012,167269,19.43221,860782
14659,acidwars,1,0.00012,167270,19.43233,860782
14660,ackerleytng,1,0.00012,167271,19.43245,860782
14661,acscott,1,0.00012,167272,19.43256,860782
14662,Activehigh,1,0.00012,167273,19.43268,860782
14663,acurat,1,0.00012,167274,19.43279,860782
14664,acutebubblin,1,0.00012,167275,19.43291,860782
14665,adacaccia,1,0.00012,167276,19.43303,860782
14666,adambabik,1,0.00012,167277,19.43314,860782
14667,adam-carbone,1,0.00012,167278,19.43326,860782
14668,adamcavendish,1,0.00012,167279,19.43338,860782
14669,adamdelarosa,1,0.00012,167280,19.43349,860782
14670,adamf,1,0.00012,167281,19.43361,860782
14671,adamglang,1,0.00012,167282,19.43372,860782
14672,AdamiHamza,1,0.00012,167283,19.43384,860782
14673,AdamPodolski,1,0.00012,167284,19.43396,860782
14674,adamretter,1,0.00012,167285,19.43407,860782
14675,adamxy,1,0.00012,167286,19.43419,860782
14676,ADanilychevJr,1,0.00012,167287,19.43431,860782
14677,adarsh-zededa,1,0.00012,167288,19.43442,860782
14678,addis144,1,0.00012,167289,19.43454,860782
14679,addozhang,1,0.00012,167290,19.43465,860782
14680,adelca,1,0.00012,167291,19.43477,860782
14681,Adel-Magebinary,1,0.00012,167292,19.43489,860782
14682,adelsz,1,0.00012,167293,19.43500,860782
14683,aderuwe,1,0.00012,167294,19.43512,860782
14684,adeshmukh-quizlet,1,0.00012,167295,19.43523,860782
14685,adhocore,1,0.00012,167296,19.43535,860782
14686,adhodgson1,1,0.00012,167297,19.43547,860782
14687,adi90x,1,0.00012,167298,19.43558,860782
14688,adigunhammedolalekan,1,0.00012,167299,19.43570,860782
14689,adiithyan,1,0.00012,167300,19.43582,860782
14690,Adirael,1,0.00012,167301,19.43593,860782
14691,adirc-rnd,1,0.00012,167302,19.43605,860782
14692,adityagoel123,1,0.00012,167303,19.43616,860782
14693,AdnanHodzic,1,0.00012,167304,19.43628,860782
14694,adotg,1,0.00012,167305,19.43640,860782
14695,adr-arroyo,1,0.00012,167306,19.43651,860782
14696,adream307,1,0.00012,167307,19.43663,860782
14697,adrianblakey,1,0.00012,167308,19.43674,860782
14698,AdrianBunk,1,0.00012,167309,19.43686,860782
14699,adrian-dinu,1,0.00012,167310,19.43698,860782
14700,adriangay,1,0.00012,167311,19.43709,860782
14701,adriangonz,1,0.00012,167312,19.43721,860782
14702,adrianRiobo,1,0.00012,167313,19.43733,860782
14703,adrianschroeter,1,0.00012,167314,19.43744,860782
14704,AdrienKuhn,1,0.00012,167315,19.43756,860782
14705,adugeek,1,0.00012,167316,19.43767,860782
14706,aduncmj,1,0.00012,167317,19.43779,860782
14707,advaithm,1,0.00012,167318,19.43791,860782
14708,adzuci,1,0.00012,167319,19.43802,860782
14709,aeb-1,1,0.00012,167320,19.43814,860782
14710,aeciopires,1,0.00012,167321,19.43825,860782
14711,aelij,1,0.00012,167322,19.43837,860782
14712,aelkz,1,0.00012,167323,19.43849,860782
14713,aengusrooneygrafana,1,0.00012,167324,19.43860,860782
14714,aeoluswing,1,0.00012,167325,19.43872,860782
14715,aescanero,1,0.00012,167326,19.43884,860782
14716,aetherith,1,0.00012,167327,19.43895,860782
14717,afarah1,1,0.00012,167328,19.43907,860782
14718,afeiszli,1,0.00012,167329,19.43918,860782
14719,afilipchik,1,0.00012,167330,19.43930,860782
14720,AFKD98,1,0.00012,167331,19.43942,860782
14721,afkham,1,0.00012,167332,19.43953,860782
14722,aflatto,1,0.00012,167333,19.43965,860782
14723,AFriemann,1,0.00012,167334,19.43977,860782
14724,afrimberger,1,0.00012,167335,19.43988,860782
14725,Afshin-Ofx,1,0.00012,167336,19.44000,860782
14726,agamjain2012,1,0.00012,167337,19.44011,860782
14727,agarwal188,1,0.00012,167338,19.44023,860782
14728,agbanagba,1,0.00012,167339,19.44035,860782
14729,agileknight,1,0.00012,167340,19.44046,860782
14730,agoodgithubname,1,0.00012,167341,19.44058,860782
14731,agorina,1,0.00012,167342,19.44069,860782
14732,agrajm,1,0.00012,167343,19.44081,860782
14733,agreddyapps,1,0.00012,167344,19.44093,860782
14734,agudpp,1,0.00012,167345,19.44104,860782
14735,ahadrez,1,0.00012,167346,19.44116,860782
14736,a-hahn,1,0.00012,167347,19.44128,860782
14737,aharper273,1,0.00012,167348,19.44139,860782
14738,aheadmode,1,0.00012,167349,19.44151,860782
14739,AhireSwati,1,0.00012,167350,19.44162,860782
14740,ahjmorton,1,0.00012,167351,19.44174,860782
14741,ahm8dx86,1,0.00012,167352,19.44186,860782
14742,Ahmadabed83,1,0.00012,167353,19.44197,860782
14743,AhmadMS1988,1,0.00012,167354,19.44209,860782
14744,ahmedsza,1,0.00012,167355,19.44220,860782
14745,AhmedZoo,1,0.00012,167356,19.44232,860782
14746,ahmetkotan,1,0.00012,167357,19.44244,860782
14747,ahmgeek,1,0.00012,167358,19.44255,860782
14748,ahoehma,1,0.00012,167359,19.44267,860782
14749,ahsanabbas406,1,0.00012,167360,19.44279,860782
14750,Ahtshamulhaq-star,1,0.00012,167361,19.44290,860782
14751,aiarchitect,1,0.00012,167362,19.44302,860782
14752,aidapsibr,1,0.00012,167363,19.44313,860782
14753,aido,1,0.00012,167364,19.44325,860782
14754,AI-H,1,0.00012,167365,19.44337,860782
14755,aimarjs,1,0.00012,167366,19.44348,860782
14756,aimichelle,1,0.00012,167367,19.44360,860782
14757,airclear,1,0.00012,167368,19.44372,860782
14758,airen29,1,0.00012,167369,19.44383,860782
14759,airwalk225,1,0.00012,167370,19.44395,860782
14760,aishvaryaps,1,0.00012,167371,19.44406,860782
14761,AiswaryaM13,1,0.00012,167372,19.44418,860782
14762,aivarasbaranauskas,1,0.00012,167373,19.44430,860782
14763,aixi,1,0.00012,167374,19.44441,860782
14764,ajaegle,1,0.00012,167375,19.44453,860782
14765,ajay1206,1,0.00012,167376,19.44464,860782
14766,Ajay41117,1,0.00012,167377,19.44476,860782
14767,ajay-bp,1,0.00012,167378,19.44488,860782
14768,ajaygautam,1,0.00012,167379,19.44499,860782
14769,ajayyuvraj,1,0.00012,167380,19.44511,860782
14770,ajbosco,1,0.00012,167381,19.44523,860782
14771,ajeetj,1,0.00012,167382,19.44534,860782
14772,ajft,1,0.00012,167383,19.44546,860782
14773,ajgajg1134,1,0.00012,167384,19.44557,860782
14774,ajinkya-dhamnaskar,1,0.00012,167385,19.44569,860782
14775,ajitchahal,1,0.00012,167386,19.44581,860782
14776,ajkaanbal,1,0.00012,167387,19.44592,860782
14777,AjohnsonLS,1,0.00012,167388,19.44604,860782
14778,ajorg-aws,1,0.00012,167389,19.44615,860782
14779,akahunas,1,0.00012,167390,19.44627,860782
14780,akai257,1,0.00012,167391,19.44639,860782
14781,akanix42,1,0.00012,167392,19.44650,860782
14782,aka-peter,1,0.00012,167393,19.44662,860782
14783,AKarbas,1,0.00012,167394,19.44674,860782
14784,akaRem,1,0.00012,167395,19.44685,860782
14785,AkarshAgarwal99,1,0.00012,167396,19.44697,860782
14786,akchamps,1,0.00012,167397,19.44708,860782
14787,akcrisp,1,0.00012,167398,19.44720,860782
14788,akdes,1,0.00012,167399,19.44732,860782
14789,akefirad,1,0.00012,167400,19.44743,860782
14790,akemner,1,0.00012,167401,19.44755,860782
14791,akestner,1,0.00012,167402,19.44767,860782
14792,Akezh,1,0.00012,167403,19.44778,860782
14793,akhettal,1,0.00012,167404,19.44790,860782
14794,AkhilKavuri,1,0.00012,167405,19.44801,860782
14795,akingscote,1,0.00012,167406,19.44813,860782
14796,akin-tekeoglu,1,0.00012,167407,19.44825,860782
14797,AkiraBow,1,0.00012,167408,19.44836,860782
14798,akkibatra,1,0.00012,167409,19.44848,860782
14799,aklinkert,1,0.00012,167410,19.44859,860782
14800,akoita,1,0.00012,167411,19.44871,860782
14801,akolosov-a,1,0.00012,167412,19.44883,860782
14802,akonale,1,0.00012,167413,19.44894,860782
14803,akoshok1,1,0.00012,167414,19.44906,860782
14804,akretschmar-IP,1,0.00012,167415,19.44918,860782
14805,akrock,1,0.00012,167416,19.44929,860782
14806,aksharj,1,0.00012,167417,19.44941,860782
14807,akshatailakal,1,0.00012,167418,19.44952,860782
14808,akshaysin,1,0.00012,167419,19.44964,860782
14809,akshaysngupta,1,0.00012,167420,19.44976,860782
14810,akshayvijapur,1,0.00012,167421,19.44987,860782
14811,akulkarni,1,0.00012,167422,19.44999,860782
14812,akunaatrium,1,0.00012,167423,19.45010,860782
14813,akv3132,1,0.00012,167424,19.45022,860782
14814,Al3x4n,1,0.00012,167425,19.45034,860782
14815,alacret,1,0.00012,167426,19.45045,860782
14816,ALA-DQ,1,0.00012,167427,19.45057,860782
14817,alanbrent,1,0.00012,167428,19.45069,860782
14818,alan-copeland-keysight,1,0.00012,167429,19.45080,860782
14819,alankwon,1,0.00012,167430,19.45092,860782
14820,alasla,1,0.00012,167431,19.45103,860782
14821,alaxalves,1,0.00012,167432,19.45115,860782
14822,AlbertePeng,1,0.00012,167433,19.45127,860782
14823,alberto,1,0.00012,167434,19.45138,860782
14824,AlbertoDePena,1,0.00012,167435,19.45150,860782
14825,albertogviana,1,0.00012,167436,19.45161,860782
14826,Albertoimpl,1,0.00012,167437,19.45173,860782
14827,albertsebastian1,1,0.00012,167438,19.45185,860782
14828,albix,1,0.00012,167439,19.45196,860782
14829,Alcatros,1,0.00012,167440,19.45208,860782
14830,AlcipPopa,1,0.00012,167441,19.45220,860782
14831,aleafboat,1,0.00012,167442,19.45231,860782
14832,alebedev87,1,0.00012,167443,19.45243,860782
14833,alebsack,1,0.00012,167444,19.45254,860782
14834,alecor191,1,0.00012,167445,19.45266,860782
14835,aledr,1,0.00012,167446,19.45278,860782
14836,alee792,1,0.00012,167447,19.45289,860782
14837,aleksandrov,1,0.00012,167448,19.45301,860782
14838,alekseiaksenov,1,0.00012,167449,19.45313,860782
14839,AlekseiMarinichenko,1,0.00012,167450,19.45324,860782
14840,aleks-sidorenko,1,0.00012,167451,19.45336,860782
14841,alek-sys,1,0.00012,167452,19.45347,860782
14842,AlekzanderDee,1,0.00012,167453,19.45359,860782
14843,aleliaert,1,0.00012,167454,19.45371,860782
14844,aleneum,1,0.00012,167455,19.45382,860782
14845,alequadro,1,0.00012,167456,19.45394,860782
14846,alex0ptr,1,0.00012,167457,19.45405,860782
14847,alex8866,1,0.00012,167458,19.45417,860782
14848,Alexand,1,0.00012,167459,19.45429,860782
14849,Alexander1000,1,0.00012,167460,19.45440,860782
14850,alexander-hughes,1,0.00012,167461,19.45452,860782
14851,AlexanderJLiu,1,0.00012,167462,19.45464,860782
14852,alexanderLog,1,0.00012,167463,19.45475,860782
14853,alexanderniebuhr,1,0.00012,167464,19.45487,860782
14854,AlexanderWert,1,0.00012,167465,19.45498,860782
14855,alexandrafren,1,0.00012,167466,19.45510,860782
14856,AlexandreDusseault,1,0.00012,167467,19.45522,860782
14857,alexandre-normand,1,0.00012,167468,19.45533,860782
14858,alexandrud,1,0.00012,167469,19.45545,860782
14859,alexandru-ersenie,1,0.00012,167470,19.45556,860782
14860,alexbarcelo,1,0.00012,167471,19.45568,860782
14861,alexbarnes,1,0.00012,167472,19.45580,860782
14862,alexburlton-sonocent,1,0.00012,167473,19.45591,860782
14863,Alexbyy,1,0.00012,167474,19.45603,860782
14864,alexcarol,1,0.00012,167475,19.45615,860782
14865,alexcern,1,0.00012,167476,19.45626,860782
14866,alexd88,1,0.00012,167477,19.45638,860782
14867,alexdyas,1,0.00012,167478,19.45649,860782
14868,alexey-boyko,1,0.00012,167479,19.45661,860782
14869,alexey-medvedchikov,1,0.00012,167480,19.45673,860782
14870,AlexeyPirogov,1,0.00012,167481,19.45684,860782
14871,AlexeyUzhva,1,0.00012,167482,19.45696,860782
14872,alexforster,1,0.00012,167483,19.45708,860782
14873,alexfpontes,1,0.00012,167484,19.45719,860782
14874,alexfrolov,1,0.00012,167485,19.45731,860782
14875,alexfulsome,1,0.00012,167486,19.45742,860782
14876,alex-hempel,1,0.00012,167487,19.45754,860782
14877,alexhowardconga,1,0.00012,167488,19.45766,860782
14878,alexhwoods,1,0.00012,167489,19.45777,860782
14879,alexises,1,0.00012,167490,19.45789,860782
14880,alexjmbarton,1,0.00012,167491,19.45800,860782
14881,AlexMorreale,1,0.00012,167492,19.45812,860782
14882,alexmsu,1,0.00012,167493,19.45824,860782
14883,alexnauda,1,0.00012,167494,19.45835,860782
14884,AlexOQ,1,0.00012,167495,19.45847,860782
14885,alex-oren,1,0.00012,167496,19.45859,860782
14886,alex-pi,1,0.00012,167497,19.45870,860782
14887,AlexPSplunk,1,0.00012,167498,19.45882,860782
14888,alexr-plutoflume,1,0.00012,167499,19.45893,860782
14889,alexshavelev44,1,0.00012,167500,19.45905,860782
14890,AlexShuraits,1,0.00012,167501,19.45917,860782
14891,alextaran1996,1,0.00012,167502,19.45928,860782
14892,alextarrell,1,0.00012,167503,19.45940,860782
14893,alextomaili,1,0.00012,167504,19.45951,860782
14894,alexvaluyskiy,1,0.00012,167505,19.45963,860782
14895,Alexx-G,1,0.00012,167506,19.45975,860782
14896,AlfaJackal,1,0.00012,167507,19.45986,860782
14897,alfieyfc,1,0.00012,167508,19.45998,860782
14898,AlfredoFausto,1,0.00012,167509,19.46010,860782
14899,alhails,1,0.00012,167510,19.46021,860782
14900,alheld,1,0.00012,167511,19.46033,860782
14901,aliasgharmhowwala,1,0.00012,167512,19.46044,860782
14902,aligandi,1,0.00012,167513,19.46056,860782
14903,aliharis,1,0.00012,167514,19.46068,860782
14904,alikaba,1,0.00012,167515,19.46079,860782
14905,alimeerutech,1,0.00012,167516,19.46091,860782
14906,alin-t,1,0.00012,167517,19.46102,860782
14907,AliredDevils,1,0.00012,167518,19.46114,860782
14908,alisabraverman-anaplan,1,0.00012,167519,19.46126,860782
14909,alisher-agzamov,1,0.00012,167520,19.46137,860782
14910,alizarion,1,0.00012,167521,19.46149,860782
14911,alkov-ibm,1,0.00012,167522,19.46161,860782
14912,all43,1,0.00012,167523,19.46172,860782
14913,allanvmat,1,0.00012,167524,19.46184,860782
14914,AllDayAlone,1,0.00012,167525,19.46195,860782
14915,allej,1,0.00012,167526,19.46207,860782
14916,allensiho,1,0.00012,167527,19.46219,860782
14917,allenyhu,1,0.00012,167528,19.46230,860782
14918,allenyinx,1,0.00012,167529,19.46242,860782
14919,Allesha,1,0.00012,167530,19.46254,860782
14920,allupaku,1,0.00012,167531,19.46265,860782
14921,AlmogCohen,1,0.00012,167532,19.46277,860782
14922,almogh52,1,0.00012,167533,19.46288,860782
14923,aloisiobilck,1,0.00012,167534,19.46300,860782
14924,alok-lw,1,0.00012,167535,19.46312,860782
14925,alonisser,1,0.00012,167536,19.46323,860782
14926,alpapad,1,0.00012,167537,19.46335,860782
14927,alram,1,0.00012,167538,19.46346,860782
14928,alternaivan,1,0.00012,167539,19.46358,860782
14929,alunsford,1,0.00012,167540,19.46370,860782
14930,alwibrm,1,0.00012,167541,19.46381,860782
14931,Alxander64,1,0.00012,167542,19.46393,860782
14932,alyosha,1,0.00012,167543,19.46405,860782
14933,AmaanC,1,0.00012,167544,19.46416,860782
14934,Amaelb,1,0.00012,167545,19.46428,860782
14935,amalemail2021,1,0.00012,167546,19.46439,860782
14936,AmalMattyAntony,1,0.00012,167547,19.46451,860782
14937,amanakshe,1,0.00012,167548,19.46463,860782
14938,amandahla,1,0.00012,167549,19.46474,860782
14939,amandeep009,1,0.00012,167550,19.46486,860782
14940,amanhigh,1,0.00012,167551,19.46497,860782
14941,amanz25,1,0.00012,167552,19.46509,860782
14942,Amar69,1,0.00012,167553,19.46521,860782
14943,amarvin,1,0.00012,167554,19.46532,860782
14944,AmazingTurtle,1,0.00012,167555,19.46544,860782
14945,ambarve,1,0.00012,167556,19.46556,860782
14946,ambientlabs,1,0.00012,167557,19.46567,860782
14947,amboowang,1,0.00012,167558,19.46579,860782
14948,Ambrose12Silveira,1,0.00012,167559,19.46590,860782
14949,amcleodca,1,0.00012,167560,19.46602,860782
14950,amcnicho,1,0.00012,167561,19.46614,860782
14951,amdm01,1,0.00012,167562,19.46625,860782
14952,amefonaffia,1,0.00012,167563,19.46637,860782
14953,amerine,1,0.00012,167564,19.46649,860782
14954,ameyah,1,0.00012,167565,19.46660,860782
14955,amine250,1,0.00012,167566,19.46672,860782
14956,aminhjz-bux,1,0.00012,167567,19.46683,860782
14957,AminuIsrael,1,0.00012,167568,19.46695,860782
14958,amirdt22,1,0.00012,167569,19.46707,860782
14959,amir-hadi,1,0.00012,167570,19.46718,860782
14960,amir-khalili,1,0.00012,167571,19.46730,860782
14961,amiryeshurun,1,0.00012,167572,19.46741,860782
14962,amit21thakur,1,0.00012,167573,19.46753,860782
14963,amitach,1,0.00012,167574,19.46765,860782
14964,amitainz,1,0.00012,167575,19.46776,860782
14965,amitc-agr,1,0.00012,167576,19.46788,860782
14966,amitcmore,1,0.00012,167577,19.46800,860782
14967,amitgilad3,1,0.00012,167578,19.46811,860782
14968,amit-gshe,1,0.00012,167579,19.46823,860782
14969,amitkrperf,1,0.00012,167580,19.46834,860782
14970,amitm02,1,0.00012,167581,19.46846,860782
14971,amitmahbubani,1,0.00012,167582,19.46858,860782
14972,amitranjan02051988,1,0.00012,167583,19.46869,860782
14973,amizzo87,1,0.00012,167584,19.46881,860782
14974,amoravek,1,0.00012,167585,19.46892,860782
14975,amorenoz,1,0.00012,167586,19.46904,860782
14976,ampyla,1,0.00012,167587,19.46916,860782
14977,amtkhdkr,1,0.00012,167588,19.46927,860782
14978,amunaf,1,0.00012,167589,19.46939,860782
14979,AmundsenJunior,1,0.00012,167590,19.46951,860782
14980,amyangfei,1,0.00012,167591,19.46962,860782
14981,An0nymous0,1,0.00012,167592,19.46974,860782
14982,analytik,1,0.00012,167593,19.46985,860782
14983,ananace,1,0.00012,167594,19.46997,860782
14984,anandgbhat,1,0.00012,167595,19.47009,860782
14985,AnandKatta,1,0.00012,167596,19.47020,860782
14986,anand-nair,1,0.00012,167597,19.47032,860782
14987,anandrgitnirman,1,0.00012,167598,19.47044,860782
14988,anandsinghkunwar,1,0.00012,167599,19.47055,860782
14989,ananthdurai,1,0.00012,167600,19.47067,860782
14990,Anany-k,1,0.00012,167601,19.47078,860782
14991,anasal,1,0.00012,167602,19.47090,860782
14992,AnatoliiStepaniuk,1,0.00012,167603,19.47102,860782
14993,anchal-chaudhary,1,0.00012,167604,19.47113,860782
14994,anchel,1,0.00012,167605,19.47125,860782
14995,andarob,1,0.00012,167606,19.47136,860782
14996,andehen,1,0.00012,167607,19.47148,860782
14997,andersbo87,1,0.00012,167608,19.47160,860782
14998,andersharrisson-ess,1,0.00012,167609,19.47171,860782
14999,andersliland,1,0.00012,167610,19.47183,860782
15000,andfom83,1,0.00012,167611,19.47195,860782
15001,andoriyu,1,0.00012,167612,19.47206,860782
15002,Andre448,1,0.00012,167613,19.47218,860782
15003,andrea-82,1,0.00012,167614,19.47229,860782
15004,andreafresa,1,0.00012,167615,19.47241,860782
15005,AndreasBurger,1,0.00012,167616,19.47253,860782
15006,andreas-kr,1,0.00012,167617,19.47264,860782
15007,andreas-lundgren-storytel,1,0.00012,167618,19.47276,860782
15008,AndreasMueller-SAP,1,0.00012,167619,19.47287,860782
15009,AndreasPresthammer,1,0.00012,167620,19.47299,860782
15010,andreazorzetto,1,0.00012,167621,19.47311,860782
15011,AndreBritoKD,1,0.00012,167622,19.47322,860782
15012,andreddie81,1,0.00012,167623,19.47334,860782
15013,andredrumond1995,1,0.00012,167624,19.47346,860782
15014,andredurao,1,0.00012,167625,19.47357,860782
15015,AndreiBrajnicov,1,0.00012,167626,19.47369,860782
15016,andrei-dobre-ts,1,0.00012,167627,19.47380,860782
15017,andreijco,1,0.00012,167628,19.47392,860782
15018,AndreKapraty,1,0.00012,167629,19.47404,860782
15019,andrekoehler,1,0.00012,167630,19.47415,860782
15020,AndreKoepke,1,0.00012,167631,19.47427,860782
15021,andreladocruz,1,0.00012,167632,19.47438,860782
15022,AndresBott,1,0.00012,167633,19.47450,860782
15023,AndresDevelop,1,0.00012,167634,19.47462,860782
15024,andresetevejob,1,0.00012,167635,19.47473,860782
15025,andre-taveira,1,0.00012,167636,19.47485,860782
15026,andrew-aladev,1,0.00012,167637,19.47497,860782
15027,andrewballantyne,1,0.00012,167638,19.47508,860782
15028,andrewdavidmackenzie,1,0.00012,167639,19.47520,860782
15029,andrewdavies-net,1,0.00012,167640,19.47531,860782
15030,andrewinston,1,0.00012,167641,19.47543,860782
15031,Andrewjeska,1,0.00012,167642,19.47555,860782
15032,andrewjstone,1,0.00012,167643,19.47566,860782
15033,andrewkaczynski,1,0.00012,167644,19.47578,860782
15034,andrewl3wis,1,0.00012,167645,19.47590,860782
15035,andrew-lee-metaswitch,1,0.00012,167646,19.47601,860782
15036,andrewm659,1,0.00012,167647,19.47613,860782
15037,Andrew-M-C,1,0.00012,167648,19.47624,860782
15038,andrew-musoke,1,0.00012,167649,19.47636,860782
15039,andrewoma,1,0.00012,167650,19.47648,860782
15040,AndrewPanov,1,0.00012,167651,19.47659,860782
15041,andrewpmartinez,1,0.00012,167652,19.47671,860782
15042,andrewrk,1,0.00012,167653,19.47682,860782
15043,andrewschmidt-a,1,0.00012,167654,19.47694,860782
15044,andrewslotin,1,0.00012,167655,19.47706,860782
15045,andrewward,1,0.00012,167656,19.47717,860782
15046,AndrianD,1,0.00012,167657,19.47729,860782
15047,andriodjinguang,1,0.00012,167658,19.47741,860782
15048,andrusstrockiy,1,0.00012,167659,19.47752,860782
15049,Andy546,1,0.00012,167660,19.47764,860782
15050,andy812,1,0.00012,167661,19.47775,860782
15051,AndyBarron,1,0.00012,167662,19.47787,860782
15052,andygarfield,1,0.00012,167663,19.47799,860782
15053,AndyKilpatrick,1,0.00012,167664,19.47810,860782
15054,andywatts,1,0.00012,167665,19.47822,860782
15055,andywhiteglobal,1,0.00012,167666,19.47833,860782
15056,aneesinaec,1,0.00012,167667,19.47845,860782
15057,anekdoti,1,0.00012,167668,19.47857,860782
15058,anestos,1,0.00012,167669,19.47868,860782
15059,AngelaSalgarelli,1,0.00012,167670,19.47880,860782
15060,angelofdeauth,1,0.00012,167671,19.47892,860782
15061,angeloudy,1,0.00012,167672,19.47903,860782
15062,angiglesias,1,0.00012,167673,19.47915,860782
15063,Angry-Potato,1,0.00012,167674,19.47926,860782
15064,angusturner,1,0.00012,167675,19.47938,860782
15065,anil7411,1,0.00012,167676,19.47950,860782
15066,anilkumarmd,1,0.00012,167677,19.47961,860782
15067,AnilPothula,1,0.00012,167678,19.47973,860782
15068,anil-venkata,1,0.00012,167679,19.47985,860782
15069,Anindya-Kar,1,0.00012,167680,19.47996,860782
15070,anirudha16101,1,0.00012,167681,19.48008,860782
15071,AnishAnil,1,0.00012,167682,19.48019,860782
15072,anjali-globallogic,1,0.00012,167683,19.48031,860782
15073,anjibabueluri,1,0.00012,167684,19.48043,860782
15074,anjyed,1,0.00012,167685,19.48054,860782
15075,ankilosaurus,1,0.00012,167686,19.48066,860782
15076,ankit13690,1,0.00012,167687,19.48077,860782
15077,ankit1mg,1,0.00012,167688,19.48089,860782
15078,ankit82,1,0.00012,167689,19.48101,860782
15079,ankit8sri,1,0.00012,167690,19.48112,860782
15080,ankita-1420,1,0.00012,167691,19.48124,860782
15081,ankitavsingh,1,0.00012,167692,19.48136,860782
15082,ankitgulati24,1,0.00012,167693,19.48147,860782
15083,ankitjaishwal,1,0.00012,167694,19.48159,860782
15084,ankitkumarsrivastava,1,0.00012,167695,19.48170,860782
15085,ankitpateledu,1,0.00012,167696,19.48182,860782
15086,anklei,1,0.00012,167697,19.48194,860782
15087,anks333,1,0.00012,167698,19.48205,860782
15088,ankushChatterjee,1,0.00012,167699,19.48217,860782
15089,ankushganatra,1,0.00012,167700,19.48228,860782
15090,anlsergio,1,0.00012,167701,19.48240,860782
15091,anmo13,1,0.00012,167702,19.48252,860782
15092,anmol,1,0.00012,167703,19.48263,860782
15093,Anmolreshi,1,0.00012,167704,19.48275,860782
15094,annai-murakami,1,0.00012,167705,19.48287,860782
15095,anneqm,1,0.00012,167706,19.48298,860782
15096,annkam,1,0.00012,167707,19.48310,860782
15097,annymsMthd,1,0.00012,167708,19.48321,860782
15098,anokun7,1,0.00012,167709,19.48333,860782
15099,AnonymousNoob,1,0.00012,167710,19.48345,860782
15100,anoopmaurya,1,0.00012,167711,19.48356,860782
15101,anooppb,1,0.00012,167712,19.48368,860782
15102,anooshcnayak,1,0.00012,167713,19.48379,860782
15103,anorek,1,0.00012,167714,19.48391,860782
15104,anotherandi,1,0.00012,167715,19.48403,860782
15105,anothersrewhocancode,1,0.00012,167716,19.48414,860782
15106,anouarchattouna,1,0.00012,167717,19.48426,860782
15107,anpryl,1,0.00012,167718,19.48438,860782
15108,anschoewe,1,0.00012,167719,19.48449,860782
15109,anshul-harness,1,0.00012,167720,19.48461,860782
15110,ansilh,1,0.00012,167721,19.48472,860782
15111,ansjcy,1,0.00012,167722,19.48484,860782
15112,ansraliant,1,0.00012,167723,19.48496,860782
15113,anstns,1,0.00012,167724,19.48507,860782
15114,Ansudeen,1,0.00012,167725,19.48519,860782
15115,antelman107,1,0.00012,167726,19.48531,860782
15116,ant-giannone,1,0.00012,167727,19.48542,860782
15117,antheajung,1,0.00012,167728,19.48554,860782
15118,anthonyeleven,1,0.00012,167729,19.48565,860782
15119,anthonyrouseau,1,0.00012,167730,19.48577,860782
15120,AnthonyZ71,1,0.00012,167731,19.48589,860782
15121,AnticliMaxtic,1,0.00012,167732,19.48600,860782
15122,AntoineGodard,1,0.00012,167733,19.48612,860782
15123,antoinep92,1,0.00012,167734,19.48623,860782
15124,antoinevokleber,1,0.00012,167735,19.48635,860782
15125,antonagestam,1,0.00012,167736,19.48647,860782
15126,antong,1,0.00012,167737,19.48658,860782
15127,AntonInglebert,1,0.00012,167738,19.48670,860782
15128,AntonioGonz,1,0.00012,167739,19.48682,860782
15129,antonionappi88,1,0.00012,167740,19.48693,860782
15130,AntonOfTheWoods,1,0.00012,167741,19.48705,860782
15131,antonvlassov,1,0.00012,167742,19.48716,860782
15132,AntonyNET,1,0.00012,167743,19.48728,860782
15133,anton-yurchenko,1,0.00012,167744,19.48740,860782
15134,Anuj2512,1,0.00012,167745,19.48751,860782
15135,anujbiyani,1,0.00012,167746,19.48763,860782
15136,anukul,1,0.00012,167747,19.48774,860782
15137,anumodkubernetes,1,0.00012,167748,19.48786,860782
15138,AnumSheraz,1,0.00012,167749,19.48798,860782
15139,Anumshr,1,0.00012,167750,19.48809,860782
15140,anupam587,1,0.00012,167751,19.48821,860782
15141,anupriya17,1,0.00012,167752,19.48833,860782
15142,AnuRam123,1,0.00012,167753,19.48844,860782
15143,Anushamobis,1,0.00012,167754,19.48856,860782
15144,anvarich,1,0.00012,167755,19.48867,860782
15145,anwald,1,0.00012,167756,19.48879,860782
15146,anyname2,1,0.00012,167757,19.48891,860782
15147,anywherepilot,1,0.00012,167758,19.48902,860782
15148,aogonevskiy,1,0.00012,167759,19.48914,860782
15149,aohren,1,0.00012,167760,19.48926,860782
15150,aoldershaw,1,0.00012,167761,19.48937,860782
15151,ao-picterra,1,0.00012,167762,19.48949,860782
15152,apagac2,1,0.00012,167763,19.48960,860782
15153,apahim,1,0.00012,167764,19.48972,860782
15154,apanagiotou,1,0.00012,167765,19.48984,860782
15155,aparmet-toast,1,0.00012,167766,19.48995,860782
15156,Aparratus,1,0.00012,167767,19.49007,860782
15157,apetrovYa,1,0.00012,167768,19.49018,860782
15158,apettinen,1,0.00012,167769,19.49030,860782
15159,apicht,1,0.00012,167770,19.49042,860782
15160,apinnick,1,0.00012,167771,19.49053,860782
15161,apisyurga,1,0.00012,167772,19.49065,860782
15162,apnar,1,0.00012,167773,19.49077,860782
15163,apolegoshko,1,0.00012,167774,19.49088,860782
15164,apolishch,1,0.00012,167775,19.49100,860782
15165,apollo13,1,0.00012,167776,19.49111,860782
15166,Apologiz,1,0.00012,167777,19.49123,860782
15167,apoorv-beeq,1,0.00012,167778,19.49135,860782
15168,apptut,1,0.00012,167779,19.49146,860782
15169,appuyaragal12,1,0.00012,167780,19.49158,860782
15170,aps831,1,0.00012,167781,19.49169,860782
15171,apsraj01,1,0.00012,167782,19.49181,860782
15172,apu1111,1,0.00012,167783,19.49193,860782
15173,aquilesb,1,0.00012,167784,19.49204,860782
15174,arabustams,1,0.00012,167785,19.49216,860782
15175,aramalipoor,1,0.00012,167786,19.49228,860782
15176,aramhakobyan,1,0.00012,167787,19.49239,860782
15177,aranair,1,0.00012,167788,19.49251,860782
15178,arashkaffamanesh,1,0.00012,167789,19.49262,860782
15179,aravindpl,1,0.00012,167790,19.49274,860782
15180,arazmj,1,0.00012,167791,19.49286,860782
15181,Archer1A,1,0.00012,167792,19.49297,860782
15182,ArcticLight,1,0.00012,167793,19.49309,860782
15183,ArcticTee,1,0.00012,167794,19.49321,860782
15184,ardylin,1,0.00012,167795,19.49332,860782
15185,aredridel,1,0.00012,167796,19.49344,860782
15186,arencibiafrancisco,1,0.00012,167797,19.49355,860782
15187,arenstar,1,0.00012,167798,19.49367,860782
15188,arfiqbal,1,0.00012,167799,19.49379,860782
15189,argreig,1,0.00012,167800,19.49390,860782
15190,ArgTang,1,0.00012,167801,19.49402,860782
15191,arhue,1,0.00012,167802,19.49413,860782
15192,ariacop,1,0.00012,167803,19.49425,860782
15193,arianaw66,1,0.00012,167804,19.49437,860782
15194,aribalam,1,0.00012,167805,19.49448,860782
15195,arielb135,1,0.00012,167806,19.49460,860782
15196,arielcarrera,1,0.00012,167807,19.49472,860782
15197,arieltw1,1,0.00012,167808,19.49483,860782
15198,ariep,1,0.00012,167809,19.49495,860782
15199,aritas1,1,0.00012,167810,19.49506,860782
15200,arizawan,1,0.00012,167811,19.49518,860782
15201,ariz-kargo,1,0.00012,167812,19.49530,860782
15202,arjuin,1,0.00012,167813,19.49541,860782
15203,arjunprasad2143,1,0.00012,167814,19.49553,860782
15204,arjunyel,1,0.00012,167815,19.49564,860782
15205,arkentos,1,0.00012,167816,19.49576,860782
15206,arlyon,1,0.00012,167817,19.49588,860782
15207,Armagedoom,1,0.00012,167818,19.49599,860782
15208,armin-th,1,0.00012,167819,19.49611,860782
15209,armourshield,1,0.00012,167820,19.49623,860782
15210,arnarg,1,0.00012,167821,19.49634,860782
15211,arnaud-skillz,1,0.00012,167822,19.49646,860782
15212,arnavbose,1,0.00012,167823,19.49657,860782
15213,arndt-s,1,0.00012,167824,19.49669,860782
15214,Arno500,1,0.00012,167825,19.49681,860782
15215,arocki7,1,0.00012,167826,19.49692,860782
15216,arogarth,1,0.00012,167827,19.49704,860782
15217,ARogovsky,1,0.00012,167828,19.49715,860782
15218,aronip,1,0.00012,167829,19.49727,860782
15219,AronllStone,1,0.00012,167830,19.49739,860782
15220,aroute,1,0.00012,167831,19.49750,860782
15221,arowser,1,0.00012,167832,19.49762,860782
15222,Arpeet-gupta,1,0.00012,167833,19.49774,860782
15223,arpit6070,1,0.00012,167834,19.49785,860782
15224,arpit728,1,0.00012,167835,19.49797,860782
15225,arrase,1,0.00012,167836,19.49808,860782
15226,ArraysStartAt2,1,0.00012,167837,19.49820,860782
15227,arroo,1,0.00012,167838,19.49832,860782
15228,arsenhovhannisyan95,1,0.00012,167839,19.49843,860782
15229,arshadansari27,1,0.00012,167840,19.49855,860782
15230,arshadsiddique-jfl,1,0.00012,167841,19.49867,860782
15231,arshamsedaghatbin,1,0.00012,167842,19.49878,860782
15232,Arshdeep88,1,0.00012,167843,19.49890,860782
15233,arshvin,1,0.00012,167844,19.49901,860782
15234,arslanabbasi,1,0.00012,167845,19.49913,860782
15235,artefactop,1,0.00012,167846,19.49925,860782
15236,artemmikhalitsin,1,0.00012,167847,19.49936,860782
15237,artem-zinnatullin,1,0.00012,167848,19.49948,860782
15238,arthfl,1,0.00012,167849,19.49959,860782
15239,arthur25000,1,0.00012,167850,19.49971,860782
15240,arthur-tacca,1,0.00012,167851,19.49983,860782
15241,ArtoKeskiniva,1,0.00012,167852,19.49994,860782
15242,ArturBumbu,1,0.00012,167853,19.50006,860782
15243,ArturChe,1,0.00012,167854,19.50018,860782
15244,arturslogins,1,0.00012,167855,19.50029,860782
15245,arun007amazon,1,0.00012,167856,19.50041,860782
15246,arunbpt7,1,0.00012,167857,19.50052,860782
15247,arun-wrk,1,0.00012,167858,19.50064,860782
15248,arvera,1,0.00012,167859,19.50076,860782
15249,arvin495,1,0.00012,167860,19.50087,860782
15250,Arvintian,1,0.00012,167861,19.50099,860782
15251,aryehb,1,0.00012,167862,19.50110,860782
15252,aryuan,1,0.00012,167863,19.50122,860782
15253,Asadullah1996,1,0.00012,167864,19.50134,860782
15254,asadullahrao,1,0.00012,167865,19.50145,860782
15255,asafdav2,1,0.00012,167866,19.50157,860782
15256,asafdl,1,0.00012,167867,19.50169,860782
15257,Asaf-m,1,0.00012,167868,19.50180,860782
15258,asanami,1,0.00012,167869,19.50192,860782
15259,asandulescu,1,0.00012,167870,19.50203,860782
15260,ASangave,1,0.00012,167871,19.50215,860782
15261,asatrur,1,0.00012,167872,19.50227,860782
15262,asavpatel92,1,0.00012,167873,19.50238,860782
15263,aschepp,1,0.00012,167874,19.50250,860782
15264,ascherkus,1,0.00012,167875,19.50262,860782
15265,asghaier76,1,0.00012,167876,19.50273,860782
15266,ash7985,1,0.00012,167877,19.50285,860782
15267,ashafer01,1,0.00012,167878,19.50296,860782
15268,ashak,1,0.00012,167879,19.50308,860782
15269,asharabu,1,0.00012,167880,19.50320,860782
15270,a-sharma11,1,0.00012,167881,19.50331,860782
15271,Asherslab,1,0.00012,167882,19.50343,860782
15272,asheynkman78,1,0.00012,167883,19.50354,860782
15273,ashf,1,0.00012,167884,19.50366,860782
15274,ashidhull,1,0.00012,167885,19.50378,860782
15275,ashishaffinion,1,0.00012,167886,19.50389,860782
15276,AshishKapoor,1,0.00012,167887,19.50401,860782
15277,AshishVarshneyy,1,0.00012,167888,19.50413,860782
15278,ashleyfreeth,1,0.00012,167889,19.50424,860782
15279,ashlineldridge,1,0.00012,167890,19.50436,860782
15280,ashmckenzie,1,0.00012,167891,19.50447,860782
15281,ashoke-cube,1,0.00012,167892,19.50459,860782
15282,AshokRamasamy,1,0.00012,167893,19.50471,860782
15283,ashu2207,1,0.00012,167894,19.50482,860782
15284,ashukm11,1,0.00012,167895,19.50494,860782
15285,ashvarts,1,0.00012,167896,19.50505,860782
15286,ashvindeodhar,1,0.00012,167897,19.50517,860782
15287,ashwani7273,1,0.00012,167898,19.50529,860782
15288,Ashwin-ks,1,0.00012,167899,19.50540,860782
15289,Ashwitha01,1,0.00012,167900,19.50552,860782
15290,AshwithaCrasta,1,0.00012,167901,19.50564,860782
15291,asido,1,0.00012,167902,19.50575,860782
15292,asifansari80,1,0.00012,167903,19.50587,860782
15293,asimhon,1,0.00012,167904,19.50598,860782
15294,asingh014,1,0.00012,167905,19.50610,860782
15295,asinha08,1,0.00012,167906,19.50622,860782
15296,ASinha24,1,0.00012,167907,19.50633,860782
15297,asipras,1,0.00012,167908,19.50645,860782
15298,Ask-Subhasmita,1,0.00012,167909,19.50656,860782
15299,aslambaba,1,0.00012,167910,19.50668,860782
15300,asldevi,1,0.00012,167911,19.50680,860782
15301,asloan7,1,0.00012,167912,19.50691,860782
15302,aslobodskoy-fiksu,1,0.00012,167913,19.50703,860782
15303,asm76,1,0.00012,167914,19.50715,860782
15304,asmi10,1,0.00012,167915,19.50726,860782
15305,aspring,1,0.00012,167916,19.50738,860782
15306,asrail,1,0.00012,167917,19.50749,860782
15307,asthasr,1,0.00012,167918,19.50761,860782
15308,Astone-Chou,1,0.00012,167919,19.50773,860782
15309,astral303,1,0.00012,167920,19.50784,860782
15310,astraldragon,1,0.00012,167921,19.50796,860782
15311,astriker,1,0.00012,167922,19.50808,860782
15312,astrixj,1,0.00012,167923,19.50819,860782
15313,asumner,1,0.00012,167924,19.50831,860782
15314,asurin,1,0.00012,167925,19.50842,860782
15315,asutosh24,1,0.00012,167926,19.50854,860782
15316,asutoshgec,1,0.00012,167927,19.50866,860782
15317,aswinsuryan,1,0.00012,167928,19.50877,860782
15318,aswitahidayat,1,0.00012,167929,19.50889,860782
15319,atanchev,1,0.00012,167930,19.50900,860782
15320,atcastel,1,0.00012,167931,19.50912,860782
15321,Atem18,1,0.00012,167932,19.50924,860782
15322,athira0809,1,0.00012,167933,19.50935,860782
15323,athulnath,1,0.00012,167934,19.50947,860782
15324,atimeless,1,0.00012,167935,19.50959,860782
15325,atjeff,1,0.00012,167936,19.50970,860782
15326,atnanda,1,0.00012,167937,19.50982,860782
15327,atomaras,1,0.00012,167938,19.50993,860782
15328,atomd,1,0.00012,167939,19.51005,860782
15329,atresnjo,1,0.00012,167940,19.51017,860782
15330,atsai1220,1,0.00012,167941,19.51028,860782
15331,atsaur,1,0.00012,167942,19.51040,860782
15332,atsikham,1,0.00012,167943,19.51051,860782
15333,atulsharma2000,1,0.00012,167944,19.51063,860782
15334,auberta2,1,0.00012,167945,19.51075,860782
15335,audunmg,1,0.00012,167946,19.51086,860782
15336,aug70,1,0.00012,167947,19.51098,860782
15337,aunrai,1,0.00012,167948,19.51110,860782
15338,Aurelian-Shuttleworth,1,0.00012,167949,19.51121,860782
15339,austinpapp,1,0.00012,167950,19.51133,860782
15340,AustinSchuhBRT,1,0.00012,167951,19.51144,860782
15341,austintp,1,0.00012,167952,19.51156,860782
15342,AutonomicMattRoy,1,0.00012,167953,19.51168,860782
15343,autopwn,1,0.00012,167954,19.51179,860782
15344,av1430,1,0.00012,167955,19.51191,860782
15345,avairava,1,0.00012,167956,19.51203,860782
15346,avalon1610,1,0.00012,167957,19.51214,860782
15347,Avdhesh30,1,0.00012,167958,19.51226,860782
15348,averi,1,0.00012,167959,19.51237,860782
15349,aviam,1,0.00012,167960,19.51249,860782
15350,avila3a,1,0.00012,167961,19.51261,860782
15351,avinash-kumaar-singh,1,0.00012,167962,19.51272,860782
15352,avinash-s-singh,1,0.00012,167963,19.51284,860782
15353,avishaiNB,1,0.00012,167964,19.51295,860782
15354,avoine,1,0.00012,167965,19.51307,860782
15355,avpines,1,0.00012,167966,19.51319,860782
15356,avz,1,0.00012,167967,19.51330,860782
15357,awagneratzendesk,1,0.00012,167968,19.51342,860782
15358,AWDDude,1,0.00012,167969,19.51354,860782
15359,awdm,1,0.00012,167970,19.51365,860782
15360,awesometown,1,0.00012,167971,19.51377,860782
15361,Awezome,1,0.00012,167972,19.51388,860782
15362,awinlei,1,0.00012,167973,19.51400,860782
15363,awltux,1,0.00012,167974,19.51412,860782
15364,awmcclain,1,0.00012,167975,19.51423,860782
15365,awssandra,1,0.00012,167976,19.51435,860782
15366,axel3rd,1,0.00012,167977,19.51446,860782
15367,axlrosen,1,0.00012,167978,19.51458,860782
15368,axsc,1,0.00012,167979,19.51470,860782
15369,Ayan189,1,0.00012,167980,19.51481,860782
15370,ayberk,1,0.00012,167981,19.51493,860782
15371,a-yiorgos,1,0.00012,167982,19.51505,860782
15372,aykevl,1,0.00012,167983,19.51516,860782
15373,aykutfarsak,1,0.00012,167984,19.51528,860782
15374,AyliD,1,0.00012,167985,19.51539,860782
15375,ayoubbensakhria,1,0.00012,167986,19.51551,860782
15376,ayoubelmimouni,1,0.00012,167987,19.51563,860782
15377,ayousef1,1,0.00012,167988,19.51574,860782
15378,Ayush1gupta,1,0.00012,167989,19.51586,860782
15379,ayushpawar21,1,0.00012,167990,19.51598,860782
15380,AyushSenapati,1,0.00012,167991,19.51609,860782
15381,ayush-sharma-devops,1,0.00012,167992,19.51621,860782
15382,az82,1,0.00012,167993,19.51632,860782
15383,azaiter,1,0.00012,167994,19.51644,860782
15384,azeem2412,1,0.00012,167995,19.51656,860782
15385,azelezni,1,0.00012,167996,19.51667,860782
15386,azepedaas,1,0.00012,167997,19.51679,860782
15387,azharakbar,1,0.00012,167998,19.51690,860782
15388,AzharMobeen,1,0.00012,167999,19.51702,860782
15389,azilber,1,0.00012,168000,19.51714,860782
15390,azizzoaib786,1,0.00012,168001,19.51725,860782
15391,azkore,1,0.00012,168002,19.51737,860782
15392,azuroff,1,0.00012,168003,19.51749,860782
15393,azzamhafez,1,0.00012,168004,19.51760,860782
15394,b2cbre,1,0.00012,168005,19.51772,860782
15395,b2jude,1,0.00012,168006,19.51783,860782
15396,b3zn0gim,1,0.00012,168007,19.51795,860782
15397,b41sh,1,0.00012,168008,19.51807,860782
15398,b802,1,0.00012,168009,19.51818,860782
15399,babafakruddin476,1,0.00012,168010,19.51830,860782
15400,babitha-mathew,1,0.00012,168011,19.51841,860782
15401,baboune,1,0.00012,168012,19.51853,860782
15402,babvin,1,0.00012,168013,19.51865,860782
15403,babytiger0929,1,0.00012,168014,19.51876,860782
15404,BABYYYLOVEEEEEEEE,1,0.00012,168015,19.51888,860782
15405,bacicrajko,1,0.00012,168016,19.51900,860782
15406,Badawekoo,1,0.00012,168017,19.51911,860782
15407,badjware,1,0.00012,168018,19.51923,860782
15408,Badr-essa,1,0.00012,168019,19.51934,860782
15409,baduba,1,0.00012,168020,19.51946,860782
15410,bagadev,1,0.00012,168021,19.51958,860782
15411,baha2046,1,0.00012,168022,19.51969,860782
15412,bahman616,1,0.00012,168023,19.51981,860782
15413,baidengtian,1,0.00012,168024,19.51992,860782
15414,baifuwa,1,0.00012,168025,19.52004,860782
15415,bajnokk,1,0.00012,168026,19.52016,860782
15416,Bak3y,1,0.00012,168027,19.52027,860782
15417,bala83,1,0.00012,168028,19.52039,860782
15418,Balakrishna625,1,0.00012,168029,19.52051,860782
15419,balasgit,1,0.00012,168030,19.52062,860782
15420,BalassaMarton,1,0.00012,168031,19.52074,860782
15421,balingmo403,1,0.00012,168032,19.52085,860782
15422,BalkrishanAggarwal,1,0.00012,168033,19.52097,860782
15423,balleon,1,0.00012,168034,19.52109,860782
15424,banpei-dbart,1,0.00012,168035,19.52120,860782
15425,bantonsson,1,0.00012,168036,19.52132,860782
15426,banyejinghungui,1,0.00012,168037,19.52144,860782
15427,Banzy666,1,0.00012,168038,19.52155,860782
15428,baojr,1,0.00012,168039,19.52167,860782
15429,baoroushi,1,0.00012,168040,19.52178,860782
15430,baoyiquan,1,0.00012,168041,19.52190,860782
15431,bapata,1,0.00012,168042,19.52202,860782
15432,baptiste-s,1,0.00012,168043,19.52213,860782
15433,baracoder,1,0.00012,168044,19.52225,860782
15434,BarberEngineering,1,0.00012,168045,19.52236,860782
15435,barborico,1,0.00012,168046,19.52248,860782
15436,barcoders,1,0.00012,168047,19.52260,860782
15437,bariatul,1,0.00012,168048,19.52271,860782
15438,barisucar4041,1,0.00012,168049,19.52283,860782
15439,barovic,1,0.00012,168050,19.52295,860782
15440,Barry-Xu-2018,1,0.00012,168051,19.52306,860782
15441,bartkim0426,1,0.00012,168052,19.52318,860782
15442,bartlettt,1,0.00012,168053,19.52329,860782
15443,bartosz-r-o-l-l,1,0.00012,168054,19.52341,860782
15444,barumpus,1,0.00012,168055,19.52353,860782
15445,basavarajdhanashetti,1,0.00012,168056,19.52364,860782
15446,bashsiz,1,0.00012,168057,19.52376,860782
15447,basireddym,1,0.00012,168058,19.52387,860782
15448,baskinsy,1,0.00012,168059,19.52399,860782
15449,basstart98,1,0.00012,168060,19.52411,860782
15450,bastienbc,1,0.00012,168061,19.52422,860782
15451,bastova,1,0.00012,168062,19.52434,860782
15452,bat79a,1,0.00012,168063,19.52446,860782
15453,batara666,1,0.00012,168064,19.52457,860782
15454,batchamalick,1,0.00012,168065,19.52469,860782
15455,batmac,1,0.00012,168066,19.52480,860782
15456,batmancn,1,0.00012,168067,19.52492,860782
15457,baturorkun,1,0.00012,168068,19.52504,860782
15458,BaudouinH,1,0.00012,168069,19.52515,860782
15459,bauerd,1,0.00012,168070,19.52527,860782
15460,ba-work,1,0.00012,168071,19.52539,860782
15461,bayudwiyansatria,1,0.00012,168072,19.52550,860782
15462,bazimov,1,0.00012,168073,19.52562,860782
15463,bbdimitriu,1,0.00012,168074,19.52573,860782
15464,bbeausej,1,0.00012,168075,19.52585,860782
15465,BBerastegui,1,0.00012,168076,19.52597,860782
15466,bbobrov,1,0.00012,168077,19.52608,860782
15467,bboortz,1,0.00012,168078,19.52620,860782
15468,bbpowerup,1,0.00012,168079,19.52631,860782
15469,bbrauzzi,1,0.00012,168080,19.52643,860782
15470,bburky,1,0.00012,168081,19.52655,860782
15471,bcdunbar,1,0.00012,168082,19.52666,860782
15472,bcharron,1,0.00012,168083,19.52678,860782
15473,bcheung,1,0.00012,168084,19.52690,860782
15474,bclaise,1,0.00012,168085,19.52701,860782
15475,bclinkinbeard,1,0.00012,168086,19.52713,860782
15476,bclouser,1,0.00012,168087,19.52724,860782
15477,bc-mahesh,1,0.00012,168088,19.52736,860782
15478,bcroq,1,0.00012,168089,19.52748,860782
15479,bdabburi3091,1,0.00012,168090,19.52759,860782
15480,bdhess,1,0.00012,168091,19.52771,860782
15481,be1be1,1,0.00012,168092,19.52782,860782
15482,BeamerIsHere,1,0.00012,168093,19.52794,860782
15483,beatsandpics,1,0.00012,168094,19.52806,860782
15484,Beatus8,1,0.00012,168095,19.52817,860782
15485,beautifulpython,1,0.00012,168096,19.52829,860782
15486,beccabau,1,0.00012,168097,19.52841,860782
15487,beckyjmcdabq,1,0.00012,168098,19.52852,860782
15488,beditarun,1,0.00012,168099,19.52864,860782
15489,beef3333,1,0.00012,168100,19.52875,860782
15490,belidzs,1,0.00012,168101,19.52887,860782
15491,BelieverDZG,1,0.00012,168102,19.52899,860782
15492,belissner,1,0.00012,168103,19.52910,860782
15493,belkin-ps,1,0.00012,168104,19.52922,860782
15494,bellezunwen,1,0.00012,168105,19.52933,860782
15495,BellonXiao,1,0.00012,168106,19.52945,860782
15496,belminf,1,0.00012,168107,19.52957,860782
15497,Belorus,1,0.00012,168108,19.52968,860782
15498,belvederef,1,0.00012,168109,19.52980,860782
15499,bemyak,1,0.00012,168110,19.52992,860782
15500,ben11211,1,0.00012,168111,19.53003,860782
15501,ben-bourdin451,1,0.00012,168112,19.53015,860782
15502,bench87,1,0.00012,168113,19.53026,860782
15503,BenConstable,1,0.00012,168114,19.53038,860782
15504,BenCoughlan15,1,0.00012,168115,19.53050,860782
15505,bendemott,1,0.00012,168116,19.53061,860782
15506,Bendu-Olo,1,0.00012,168117,19.53073,860782
15507,bengbeng-pp,1,0.00012,168118,19.53085,860782
15508,benh,1,0.00012,168119,19.53096,860782
15509,beni20,1,0.00012,168120,19.53108,860782
15510,benitogf,1,0.00012,168121,19.53119,860782
15511,benjamink,1,0.00012,168122,19.53131,860782
15512,benjaminp,1,0.00012,168123,19.53143,860782
15513,benjaminxie,1,0.00012,168124,19.53154,860782
15514,benjaques,1,0.00012,168125,19.53166,860782
15515,benjlai,1,0.00012,168126,19.53177,860782
15516,ben-kletzine-jdas,1,0.00012,168127,19.53189,860782
15517,benmezger,1,0.00012,168128,19.53201,860782
15518,BenoitCattie,1,0.00012,168129,19.53212,860782
15519,benpigchu,1,0.00012,168130,19.53224,860782
15520,bentatham,1,0.00012,168131,19.53236,860782
15521,BenteleFlorian,1,0.00012,168132,19.53247,860782
15522,bentucker,1,0.00012,168133,19.53259,860782
15523,benzispawn,1,0.00012,168134,19.53270,860782
15524,berenddeschouwer,1,0.00012,168135,19.53282,860782
15525,bergbrains,1,0.00012,168136,19.53294,860782
15526,bergkvist,1,0.00012,168137,19.53305,860782
15527,bergmeister,1,0.00012,168138,19.53317,860782
15528,berkcan77,1,0.00012,168139,19.53328,860782
15529,bernard-wagner,1,0.00012,168140,19.53340,860782
15530,bernielomax,1,0.00012,168141,19.53352,860782
15531,bertoost,1,0.00012,168142,19.53363,860782
15532,bertrmz,1,0.00012,168143,19.53375,860782
15533,betermieux,1,0.00012,168144,19.53387,860782
15534,betNevS,1,0.00012,168145,19.53398,860782
15535,beyondmars3,1,0.00012,168146,19.53410,860782
15536,bfil,1,0.00012,168147,19.53421,860782
15537,bframke,1,0.00012,168148,19.53433,860782
15538,bfrost2893,1,0.00012,168149,19.53445,860782
15539,bgbraga,1,0.00012,168150,19.53456,860782
15540,bgcorreia,1,0.00012,168151,19.53468,860782
15541,bgehman,1,0.00012,168152,19.53480,860782
15542,bgilmore,1,0.00012,168153,19.53491,860782
15543,bgpat,1,0.00012,168154,19.53503,860782
15544,bgruenefeld,1,0.00012,168155,19.53514,860782
15545,bgst,1,0.00012,168156,19.53526,860782
15546,bgsz,1,0.00012,168157,19.53538,860782
15547,bgulla,1,0.00012,168158,19.53549,860782
15548,bguseman,1,0.00012,168159,19.53561,860782
15549,bharathguvvala,1,0.00012,168160,19.53572,860782
15550,bharathpantala,1,0.00012,168161,19.53584,860782
15551,bharatprakashparakh,1,0.00012,168162,19.53596,860782
15552,bhargodevarya,1,0.00012,168163,19.53607,860782
15553,Bhashit,1,0.00012,168164,19.53619,860782
15554,Bhashitha123,1,0.00012,168165,19.53631,860782
15555,bhaumik1802,1,0.00012,168166,19.53642,860782
15556,BhavishyaR,1,0.00012,168167,19.53654,860782
15557,Bheesma,1,0.00012,168168,19.53665,860782
15558,BHeinson-rms,1,0.00012,168169,19.53677,860782
15559,bhushan558,1,0.00012,168170,19.53689,860782
15560,bhushanahirrao,1,0.00012,168171,19.53700,860782
15561,biancajiang,1,0.00012,168172,19.53712,860782
15562,bibekmantree,1,0.00012,168173,19.53723,860782
15563,bibincatchme,1,0.00012,168174,19.53735,860782
15564,bicepjai,1,0.00012,168175,19.53747,860782
15565,biels,1,0.00012,168176,19.53758,860782
15566,BigaDev,1,0.00012,168177,19.53770,860782
15567,bigbitbus,1,0.00012,168178,19.53782,860782
15568,bigd510,1,0.00012,168179,19.53793,860782
15569,bigvandi,1,0.00012,168180,19.53805,860782
15570,bigzuo,1,0.00012,168181,19.53816,860782
15571,bijay-ps,1,0.00012,168182,19.53828,860782
15572,bijugs,1,0.00012,168183,19.53840,860782
15573,bikescholl,1,0.00012,168184,19.53851,860782
15574,bikramnehra,1,0.00012,168185,19.53863,860782
15575,bilalmalik777,1,0.00012,168186,19.53875,860782
15576,biliwewe,1,0.00012,168187,19.53886,860782
15577,billcrook,1,0.00012,168188,19.53898,860782
15578,billhoph,1,0.00012,168189,19.53909,860782
15579,billkuku,1,0.00012,168190,19.53921,860782
15580,BillSchumacher,1,0.00012,168191,19.53933,860782
15581,billtian,1,0.00012,168192,19.53944,860782
15582,billybanfield,1,0.00012,168193,19.53956,860782
15583,billysutomo,1,0.00012,168194,19.53967,860782
15584,billyzs,1,0.00012,168195,19.53979,860782
15585,bilxio,1,0.00012,168196,19.53991,860782
15586,bimmerkiev,1,0.00012,168197,19.54002,860782
15587,BingGuanqi,1,0.00012,168198,19.54014,860782
15588,Bing-ok,1,0.00012,168199,19.54026,860782
15589,binlab,1,0.00012,168200,19.54037,860782
15590,Binyamse,1,0.00012,168201,19.54049,860782
15591,biofool,1,0.00012,168202,19.54060,860782
15592,biosugar0,1,0.00012,168203,19.54072,860782
15593,bipolarbear54,1,0.00012,168204,19.54084,860782
15594,birdy81,1,0.00012,168205,19.54095,860782
15595,birenroy,1,0.00012,168206,19.54107,860782
15596,biswarup1290dass,1,0.00012,168207,19.54118,860782
15597,bitas-guoliang,1,0.00012,168208,19.54130,860782
15598,bit-cloner,1,0.00012,168209,19.54142,860782
15599,bitcodr,1,0.00012,168210,19.54153,860782
15600,bitflingr,1,0.00012,168211,19.54165,860782
15601,bitplex,1,0.00012,168212,19.54177,860782
15602,bitsofdave,1,0.00012,168213,19.54188,860782
15603,bittelc,1,0.00012,168214,19.54200,860782
15604,bittermandel,1,0.00012,168215,19.54211,860782
15605,bitti,1,0.00012,168216,19.54223,860782
15606,bivald,1,0.00012,168217,19.54235,860782
15607,biwenKey,1,0.00012,168218,19.54246,860782
15608,bjakubski,1,0.00012,168219,19.54258,860782
15609,bjaneshwar,1,0.00012,168220,19.54269,860782
15610,bjaworski3,1,0.00012,168221,19.54281,860782
15611,bjorngoossens,1,0.00012,168222,19.54293,860782
15612,bkanuka,1,0.00012,168223,19.54304,860782
15613,bkcsfi,1,0.00012,168224,19.54316,860782
15614,bklaubos,1,0.00012,168225,19.54328,860782
15615,bkumar2018,1,0.00012,168226,19.54339,860782
15616,bl1nk,1,0.00012,168227,19.54351,860782
15617,blabadi,1,0.00012,168228,19.54362,860782
15618,blackbaud-brandonstirnaman,1,0.00012,168229,19.54374,860782
15619,blackbird-47,1,0.00012,168230,19.54386,860782
15620,BlackCetha,1,0.00012,168231,19.54397,860782
15621,blackjid,1,0.00012,168232,19.54409,860782
15622,BlackMaria,1,0.00012,168233,19.54421,860782
15623,BlackRider97,1,0.00012,168234,19.54432,860782
15624,BlacksBart,1,0.00012,168235,19.54444,860782
15625,blackstorm,1,0.00012,168236,19.54455,860782
15626,BlackTX,1,0.00012,168237,19.54467,860782
15627,BladeWise,1,0.00012,168238,19.54479,860782
15628,blafasel42,1,0.00012,168239,19.54490,860782
15629,blafry,1,0.00012,168240,19.54502,860782
15630,blairham,1,0.00012,168241,19.54513,860782
15631,blairwheadon,1,0.00012,168242,19.54525,860782
15632,blake-newman,1,0.00012,168243,19.54537,860782
15633,blankhang,1,0.00012,168244,19.54548,860782
15634,blessedwithsins,1,0.00012,168245,19.54560,860782
15635,blingster7,1,0.00012,168246,19.54572,860782
15636,blockjon,1,0.00012,168247,19.54583,860782
15637,blocknonip,1,0.00012,168248,19.54595,860782
15638,Blowfisher,1,0.00012,168249,19.54606,860782
15639,blubberdiblub,1,0.00012,168250,19.54618,860782
15640,blublinsky,1,0.00012,168251,19.54630,860782
15641,bluddecke,1,0.00012,168252,19.54641,860782
15642,bluehawk27,1,0.00012,168253,19.54653,860782
15643,BlueSky-YJS,1,0.00012,168254,19.54664,860782
15644,bluestonesea,1,0.00012,168255,19.54676,860782
15645,blukhand,1,0.00012,168256,19.54688,860782
15646,blumfontein,1,0.00012,168257,19.54699,860782
15647,bm0,1,0.00012,168258,19.54711,860782
15648,bmacauley-reward,1,0.00012,168259,19.54723,860782
15649,bmarkowww,1,0.00012,168260,19.54734,860782
15650,bmartima,1,0.00012,168261,19.54746,860782
15651,bmcalary-atlassian,1,0.00012,168262,19.54757,860782
15652,bmckalla,1,0.00012,168263,19.54769,860782
15653,bmenasha,1,0.00012,168264,19.54781,860782
15654,bn0901,1,0.00012,168265,19.54792,860782
15655,bnason,1,0.00012,168266,19.54804,860782
15656,bng-github,1,0.00012,168267,19.54816,860782
15657,bnsblue,1,0.00012,168268,19.54827,860782
15658,bnusunny,1,0.00012,168269,19.54839,860782
15659,Bo98,1,0.00012,168270,19.54850,860782
15660,boatmisser,1,0.00012,168271,19.54862,860782
15661,Bob9098-source,1,0.00012,168272,19.54874,860782
15662,bobbiliraja,1,0.00012,168273,19.54885,860782
15663,bobdvb,1,0.00012,168274,19.54897,860782
15664,bobishere,1,0.00012,168275,19.54908,860782
15665,BobLiu2046,1,0.00012,168276,19.54920,860782
15666,bobpecor,1,0.00012,168277,19.54932,860782
15667,bocha-fanatic,1,0.00012,168278,19.54943,860782
15668,bodanc,1,0.00012,168279,19.54955,860782
15669,bodduv,1,0.00012,168280,19.54967,860782
15670,bodzio4749,1,0.00012,168281,19.54978,860782
15671,boenr1,1,0.00012,168282,19.54990,860782
15672,bogatuadrian,1,0.00012,168283,19.55001,860782
15673,BogdanMaier,1,0.00012,168284,19.55013,860782
15674,bogdanov1609,1,0.00012,168285,19.55025,860782
15675,bogdanpetrea,1,0.00012,168286,19.55036,860782
15676,bogdansolga,1,0.00012,168287,19.55048,860782
15677,bogossdu92,1,0.00012,168288,19.55059,860782
15678,BoKleynen,1,0.00012,168289,19.55071,860782
15679,bokysan,1,0.00012,168290,19.55083,860782
15680,bolind,1,0.00012,168291,19.55094,860782
15681,bollard,1,0.00012,168292,19.55106,860782
15682,BON4,1,0.00012,168293,19.55118,860782
15683,bond007007,1,0.00012,168294,19.55129,860782
15684,bonnieguo,1,0.00012,168295,19.55141,860782
15685,bonucki,1,0.00012,168296,19.55152,860782
15686,BookChan,1,0.00012,168297,19.55164,860782
15687,booleanbetrayal,1,0.00012,168298,19.55176,860782
15688,boom-mug,1,0.00012,168299,19.55187,860782
15689,boomshadow,1,0.00012,168300,19.55199,860782
15690,boonen,1,0.00012,168301,19.55210,860782
15691,booooh,1,0.00012,168302,19.55222,860782
15692,bordeuax,1,0.00012,168303,19.55234,860782
15693,bordunosp,1,0.00012,168304,19.55245,860782
15694,boreBoar,1,0.00012,168305,19.55257,860782
15695,borenstein,1,0.00012,168306,19.55269,860782
15696,borisgr04,1,0.00012,168307,19.55280,860782
15697,borlandor,1,0.00012,168308,19.55292,860782
15698,Born2Bake,1,0.00012,168309,19.55303,860782
15699,borrrden,1,0.00012,168310,19.55315,860782
15700,boskiv,1,0.00012,168311,19.55327,860782
15701,Botono,1,0.00012,168312,19.55338,860782
15702,boukandouramhamed,1,0.00012,168313,19.55350,860782
15703,Bouncey,1,0.00012,168314,19.55362,860782
15704,boundingboxes,1,0.00012,168315,19.55373,860782
15705,bountin,1,0.00012,168316,19.55385,860782
15706,BourgeoisBear,1,0.00012,168317,19.55396,860782
15707,boxofcrates,1,0.00012,168318,19.55408,860782
15708,bparinas,1,0.00012,168319,19.55420,860782
15709,Bpoe,1,0.00012,168320,19.55431,860782
15710,bpoudel1210,1,0.00012,168321,19.55443,860782
15711,bqguan,1,0.00012,168322,19.55454,860782
15712,bradbehle,1,0.00012,168323,19.55466,860782
15713,bradcypert,1,0.00012,168324,19.55478,860782
15714,BradenBorg,1,0.00012,168325,19.55489,860782
15715,bradfox2,1,0.00012,168326,19.55501,860782
15716,bradkyle,1,0.00012,168327,19.55513,860782
15717,bradsheppard,1,0.00012,168328,19.55524,860782
15718,bradw456,1,0.00012,168329,19.55536,860782
15719,bradwinfield,1,0.00012,168330,19.55547,860782
15720,brainbug89,1,0.00012,168331,19.55559,860782
15721,brambex,1,0.00012,168332,19.55571,860782
15722,BrandenCobb,1,0.00012,168333,19.55582,860782
15723,brandonbell,1,0.00012,168334,19.55594,860782
15724,brandonkrull,1,0.00012,168335,19.55605,860782
15725,brankomijuskovic,1,0.00012,168336,19.55617,860782
15726,braulio-balanza,1,0.00012,168337,19.55629,860782
15727,BraunreutherA,1,0.00012,168338,19.55640,860782
15728,bravinash82,1,0.00012,168339,19.55652,860782
15729,brayanjuls,1,0.00012,168340,19.55664,860782
15730,brec,1,0.00012,168341,19.55675,860782
15731,brempusz,1,0.00012,168342,19.55687,860782
15732,brendonrapp,1,0.00012,168343,19.55698,860782
15733,BrenemanR,1,0.00012,168344,19.55710,860782
15734,Brenk7,1,0.00012,168345,19.55722,860782
15735,brentwolfram,1,0.00012,168346,19.55733,860782
15736,brettmorien,1,0.00012,168347,19.55745,860782
15737,brewkode,1,0.00012,168348,19.55757,860782
15738,briananstett,1,0.00012,168349,19.55768,860782
15739,briancaseyprovidertrust,1,0.00012,168350,19.55780,860782
15740,briangordonmills,1,0.00012,168351,19.55791,860782
15741,BrianHuf,1,0.00012,168352,19.55803,860782
15742,brianmay,1,0.00012,168353,19.55815,860782
15743,brianpcurran,1,0.00012,168354,19.55826,860782
15744,briceio,1,0.00012,168355,19.55838,860782
15745,Bricon66,1,0.00012,168356,19.55849,860782
15746,Brightside56,1,0.00012,168357,19.55861,860782
15747,brijeshRHCA,1,0.00012,168358,19.55873,860782
15748,bristy,1,0.00012,168359,19.55884,860782
15749,brittocj,1,0.00012,168360,19.55896,860782
15750,brjlpz,1,0.00012,168361,19.55908,860782
15751,brnavneet,1,0.00012,168362,19.55919,860782
15752,brona90,1,0.00012,168363,19.55931,860782
15753,BrookRoberts,1,0.00012,168364,19.55942,860782
15754,brooksmtownsend,1,0.00012,168365,19.55954,860782
15755,brouberol,1,0.00012,168366,19.55966,860782
15756,brtduvally,1,0.00012,168367,19.55977,860782
15757,Bruce012356,1,0.00012,168368,19.55989,860782
15758,brucehorn,1,0.00012,168369,19.56000,860782
15759,brucelightyear,1,0.00012,168370,19.56012,860782
15760,Bruce-Qi,1,0.00012,168371,19.56024,860782
15761,BruiserT,1,0.00012,168372,19.56035,860782
15762,brunobertechini,1,0.00012,168373,19.56047,860782
15763,brunobuss,1,0.00012,168374,19.56059,860782
15764,brunorafa,1,0.00012,168375,19.56070,860782
15765,brunosantosfarfetch,1,0.00012,168376,19.56082,860782
15766,brvith,1,0.00012,168377,19.56093,860782
15767,bryan-croft,1,0.00012,168378,19.56105,860782
15768,bryanhuntesl,1,0.00012,168379,19.56117,860782
15769,bryantson,1,0.00012,168380,19.56128,860782
15770,bryceyang,1,0.00012,168381,19.56140,860782
15771,bryeung,1,0.00012,168382,19.56151,860782
15772,brylor,1,0.00012,168383,19.56163,860782
15773,brzyangg,1,0.00012,168384,19.56175,860782
15774,b-schlegel,1,0.00012,168385,19.56186,860782
15775,bslotbot,1,0.00012,168386,19.56198,860782
15776,B-Souty,1,0.00012,168387,19.56210,860782
15777,btnguyen2k,1,0.00012,168388,19.56221,860782
15778,btomasini,1,0.00012,168389,19.56233,860782
15779,btrappe,1,0.00012,168390,19.56244,860782
15780,btwiuse,1,0.00012,168391,19.56256,860782
15781,bu3ny,1,0.00012,168392,19.56268,860782
15782,bubble1975,1,0.00012,168393,19.56279,860782
15783,buch11,1,0.00012,168394,19.56291,860782
15784,buchongyu,1,0.00012,168395,19.56303,860782
15785,Budaksarawakgamer,1,0.00012,168396,19.56314,860782
15786,Budman17r,1,0.00012,168397,19.56326,860782
15787,buehlmann,1,0.00012,168398,19.56337,860782
15788,Buffer0x7cd,1,0.00012,168399,19.56349,860782
15789,bugall,1,0.00012,168400,19.56361,860782
15790,bugcy013,1,0.00012,168401,19.56372,860782
15791,build3r,1,0.00012,168402,19.56384,860782
15792,bumiga,1,0.00012,168403,19.56395,860782
15793,Bunnikins,1,0.00012,168404,19.56407,860782
15794,bunny07-tech,1,0.00012,168405,19.56419,860782
15795,burimkameri,1,0.00012,168406,19.56430,860782
15796,burner-account,1,0.00012,168407,19.56442,860782
15797,burvilc,1,0.00012,168408,19.56454,860782
15798,busser,1,0.00012,168409,19.56465,860782
15799,busunkim96,1,0.00012,168410,19.56477,860782
15800,buttairfly,1,0.00012,168411,19.56488,860782
15801,buzypi,1,0.00012,168412,19.56500,860782
15802,buzzedword,1,0.00012,168413,19.56512,860782
15803,bvboca,1,0.00012,168414,19.56523,860782
15804,bwolf,1,0.00012,168415,19.56535,860782
15805,by-kpv,1,0.00012,168416,19.56546,860782
15806,bykvaadm,1,0.00012,168417,19.56558,860782
15807,byronyi,1,0.00012,168418,19.56570,860782
15808,byroot,1,0.00012,168419,19.56581,860782
15809,bytemare,1,0.00012,168420,19.56593,860782
15810,bzcnsh,1,0.00012,168421,19.56605,860782
15811,bzeitler69,1,0.00012,168422,19.56616,860782
15812,bzumby,1,0.00012,168423,19.56628,860782
15813,c0da,1,0.00012,168424,19.56639,860782
15814,c0h1b4,1,0.00012,168425,19.56651,860782
15815,C6H6,1,0.00012,168426,19.56663,860782
15816,cabal-daniel,1,0.00012,168427,19.56674,860782
15817,cabrinoob,1,0.00012,168428,19.56686,860782
15818,cachemeoutside,1,0.00012,168429,19.56698,860782
15819,caddac,1,0.00012,168430,19.56709,860782
15820,cademarkegard,1,0.00012,168431,19.56721,860782
15821,caffeine-mgn,1,0.00012,168432,19.56732,860782
15822,cagriersen,1,0.00012,168433,19.56744,860782
15823,cah-ramindudeshapriya,1,0.00012,168434,19.56756,860782
15824,cai11745,1,0.00012,168435,19.56767,860782
15825,cainelli,1,0.00012,168436,19.56779,860782
15826,Caixiaomeng,1,0.00012,168437,19.56790,860782
15827,CalbeeMing0530,1,0.00012,168438,19.56802,860782
15828,calebpalmer,1,0.00012,168439,19.56814,860782
15829,callahan22,1,0.00012,168440,19.56825,860782
15830,callingsid,1,0.00012,168441,19.56837,860782
15831,callowaylc,1,0.00012,168442,19.56849,860782
15832,calmaa1,1,0.00012,168443,19.56860,860782
15833,camaeel,1,0.00012,168444,19.56872,860782
15834,camathieu,1,0.00012,168445,19.56883,860782
15835,cameronharp,1,0.00012,168446,19.56895,860782
15836,cameronpm,1,0.00012,168447,19.56907,860782
15837,camille-rodriguez,1,0.00012,168448,19.56918,860782
15838,camorra-skk,1,0.00012,168449,19.56930,860782
15839,campee,1,0.00012,168450,19.56941,860782
15840,campos-ddc,1,0.00012,168451,19.56953,860782
15841,cam-pypro,1,0.00012,168452,19.56965,860782
15842,candidature,1,0.00012,168453,19.56976,860782
15843,canerbis,1,0.00012,168454,19.56988,860782
15844,canghwan,1,0.00012,168455,19.57000,860782
15845,canon0415,1,0.00012,168456,19.57011,860782
15846,cantalupo555,1,0.00012,168457,19.57023,860782
15847,caodangtinh,1,0.00012,168458,19.57034,860782
15848,caolele,1,0.00012,168459,19.57046,860782
15849,capacman,1,0.00012,168460,19.57058,860782
15850,capcom923,1,0.00012,168461,19.57069,860782
15851,caphrim007,1,0.00012,168462,19.57081,860782
15852,Capitrium,1,0.00012,168463,19.57093,860782
15853,CaptainDaVinci,1,0.00012,168464,19.57104,860782
15854,CaptainKrby,1,0.00012,168465,19.57116,860782
15855,CaptAintHere,1,0.00012,168466,19.57127,860782
15856,CaptainTy,1,0.00012,168467,19.57139,860782
15857,captnbp,1,0.00012,168468,19.57151,860782
15858,capusta,1,0.00012,168469,19.57162,860782
15859,CAR6807,1,0.00012,168470,19.57174,860782
15860,carbonin,1,0.00012,168471,19.57185,860782
15861,Cardinalinux,1,0.00012,168472,19.57197,860782
15862,CarlHeinst,1,0.00012,168473,19.57209,860782
15863,carlioth,1,0.00012,168474,19.57220,860782
15864,carlmacdiarmada,1,0.00012,168475,19.57232,860782
15865,carlo-colombo,1,0.00012,168476,19.57244,860782
15866,carloreggiani,1,0.00012,168477,19.57255,860782
15867,carloscao0928,1,0.00012,168478,19.57267,860782
15868,CarlosLanderas,1,0.00012,168479,19.57278,860782
15869,carlosthe19916,1,0.00012,168480,19.57290,860782
15870,carlreid,1,0.00012,168481,19.57302,860782
15871,carlskii,1,0.00012,168482,19.57313,860782
15872,carlvine500,1,0.00012,168483,19.57325,860782
15873,carl-youngblood,1,0.00012,168484,19.57336,860782
15874,carmelid,1,0.00012,168485,19.57348,860782
15875,carmenlau,1,0.00012,168486,19.57360,860782
15876,carnei-ro,1,0.00012,168487,19.57371,860782
15877,caroldesenne,1,0.00012,168488,19.57383,860782
15878,carolfvb,1,0.00012,168489,19.57395,860782
15879,Carolin519,1,0.00012,168490,19.57406,860782
15880,carpemonf,1,0.00012,168491,19.57418,860782
15881,carrotop,1,0.00012,168492,19.57429,860782
15882,carvendy,1,0.00012,168493,19.57441,860782
15883,casidiablo,1,0.00012,168494,19.57453,860782
15884,casret,1,0.00012,168495,19.57464,860782
15885,cassador,1,0.00012,168496,19.57476,860782
15886,catac,1,0.00012,168497,19.57487,860782
15887,CatalinAdlerDF,1,0.00012,168498,19.57499,860782
15888,catern,1,0.00012,168499,19.57511,860782
15889,catirado,1,0.00012,168500,19.57522,860782
15890,catSIXe,1,0.00012,168501,19.57534,860782
15891,cavejay,1,0.00012,168502,19.57546,860782
15892,cbarbara-okta,1,0.00012,168503,19.57557,860782
15893,cbeaujoin,1,0.00012,168504,19.57569,860782
15894,cbeneke,1,0.00012,168505,19.57580,860782
15895,cbernet,1,0.00012,168506,19.57592,860782
15896,cblument,1,0.00012,168507,19.57604,860782
15897,cbrunnkvist,1,0.00012,168508,19.57615,860782
15898,cburza,1,0.00012,168509,19.57627,860782
15899,cchildress,1,0.00012,168510,19.57639,860782
15900,cclloyd,1,0.00012,168511,19.57650,860782
15901,ccmanito,1,0.00012,168512,19.57662,860782
15902,ccxex29,1,0.00012,168513,19.57673,860782
15903,cde0,1,0.00012,168514,19.57685,860782
15904,cdelashmutt-pivotal,1,0.00012,168515,19.57697,860782
15905,cdelguercio,1,0.00012,168516,19.57708,860782
15906,cdmikechen,1,0.00012,168517,19.57720,860782
15907,CebCloud,1,0.00012,168518,19.57731,860782
15908,Cedric-2020,1,0.00012,168519,19.57743,860782
15909,CelineVc,1,0.00012,168520,19.57755,860782
15910,cenfei,1,0.00012,168521,19.57766,860782
15911,Cephei,1,0.00012,168522,19.57778,860782
15912,cepheus1,1,0.00012,168523,19.57790,860782
15913,Cepxio,1,0.00012,168524,19.57801,860782
15914,cerberusv2px,1,0.00012,168525,19.57813,860782
15915,ceroloy,1,0.00012,168526,19.57824,860782
15916,CertainLach,1,0.00012,168527,19.57836,860782
15917,cferrera,1,0.00012,168528,19.57848,860782
15918,cfz,1,0.00012,168529,19.57859,860782
15919,cgd1,1,0.00012,168530,19.57871,860782
15920,cgebe,1,0.00012,168531,19.57882,860782
15921,cgxu519,1,0.00012,168532,19.57894,860782
15922,ch0mik,1,0.00012,168533,19.57906,860782
15923,CH3T,1,0.00012,168534,19.57917,860782
15924,chache35,1,0.00012,168535,19.57929,860782
15925,chadbr,1,0.00012,168536,19.57941,860782
15926,chaitan94,1,0.00012,168537,19.57952,860782
15927,chaitrachandrashekar,1,0.00012,168538,19.57964,860782
15928,chakilams,1,0.00012,168539,19.57975,860782
15929,chakrabandla,1,0.00012,168540,19.57987,860782
15930,chakreshkolluru,1,0.00012,168541,19.57999,860782
15931,chalitha1989,1,0.00012,168542,19.58010,860782
15932,chandra210893,1,0.00012,168543,19.58022,860782
15933,chandrabhShukla,1,0.00012,168544,19.58034,860782
15934,ChandranshuRao14,1,0.00012,168545,19.58045,860782
15935,chandrureddy,1,0.00012,168546,19.58057,860782
15936,ChangjunZhao,1,0.00012,168547,19.58068,860782
15937,changli6,1,0.00012,168548,19.58080,860782
15938,changsen-dev,1,0.00012,168549,19.58092,860782
15939,chankh,1,0.00012,168550,19.58103,860782
15940,channeladam,1,0.00012,168551,19.58115,860782
15941,chaochao3113,1,0.00012,168552,19.58126,860782
15942,chaos-panda,1,0.00012,168553,19.58138,860782
15943,chaoyebugao,1,0.00012,168554,19.58150,860782
15944,chaozgz,1,0.00012,168555,19.58161,860782
15945,charanreddy18-vk,1,0.00012,168556,19.58173,860782
15946,charbgr,1,0.00012,168557,19.58185,860782
15947,charlely,1,0.00012,168558,19.58196,860782
15948,charles-lebrun,1,0.00012,168559,19.58208,860782
15949,charles-woshicai,1,0.00012,168560,19.58219,860782
15950,charlesxu2000,1,0.00012,168561,19.58231,860782
15951,charlie6679,1,0.00012,168562,19.58243,860782
15952,CharlieBrownMx,1,0.00012,168563,19.58254,860782
15953,charlielito,1,0.00012,168564,19.58266,860782
15954,charlie-lk,1,0.00012,168565,19.58277,860782
15955,CharlieReitzel,1,0.00012,168566,19.58289,860782
15956,charlspjohn,1,0.00012,168567,19.58301,860782
15957,CharlyRipp,1,0.00012,168568,19.58312,860782
15958,chasebolt,1,0.00012,168569,19.58324,860782
15959,chase-si,1,0.00012,168570,19.58336,860782
15960,chasewalden,1,0.00012,168571,19.58347,860782
15961,chaudharyalka,1,0.00012,168572,19.58359,860782
15962,chauhan27101974,1,0.00012,168573,19.58370,860782
15963,ChazZeromus,1,0.00012,168574,19.58382,860782
15964,chEbba,1,0.00012,168575,19.58394,860782
15965,checorone,1,0.00012,168576,19.58405,860782
15966,CheesyFeet,1,0.00012,168577,19.58417,860782
15967,chelomontilla,1,0.00012,168578,19.58428,860782
15968,chenchenggen007,1,0.00012,168579,19.58440,860782
15969,chendf24,1,0.00012,168580,19.58452,860782
15970,cheng1li,1,0.00012,168581,19.58463,860782
15971,chengchaoyin,1,0.00012,168582,19.58475,860782
15972,chengyayu,1,0.00012,168583,19.58487,860782
15973,chengzhycn,1,0.00012,168584,19.58498,860782
15974,Cheniour10,1,0.00012,168585,19.58510,860782
15975,chenjpu,1,0.00012,168586,19.58521,860782
15976,chenk008,1,0.00012,168587,19.58533,860782
15977,chenqi0805,1,0.00012,168588,19.58545,860782
15978,chensheng0,1,0.00012,168589,19.58556,860782
15979,chenwng,1,0.00012,168590,19.58568,860782
15980,chenxyzl,1,0.00012,168591,19.58580,860782
15981,Chen-YiDA,1,0.00012,168592,19.58591,860782
15982,ChenZheOnePiece,1,0.00012,168593,19.58603,860782
15983,chenzhiguo,1,0.00012,168594,19.58614,860782
15984,chenzhijun,1,0.00012,168595,19.58626,860782
15985,chestarss,1,0.00012,168596,19.58638,860782
15986,chestercheng,1,0.00012,168597,19.58649,860782
15987,chesterlai,1,0.00012,168598,19.58661,860782
15988,chestermjr,1,0.00012,168599,19.58672,860782
15989,chf007,1,0.00012,168600,19.58684,860782
15990,Chickaloo,1,0.00012,168601,19.58696,860782
15991,chickenPopcorn,1,0.00012,168602,19.58707,860782
15992,chidiwilliams,1,0.00012,168603,19.58719,860782
15993,childe,1,0.00012,168604,19.58731,860782
15994,chilicat,1,0.00012,168605,19.58742,860782
15995,chilons,1,0.00012,168606,19.58754,860782
15996,chimeworld,1,0.00012,168607,19.58765,860782
15997,Chimney42,1,0.00012,168608,19.58777,860782
15998,chinaboy007,1,0.00012,168609,19.58789,860782
15999,chinvelski,1,0.00012,168610,19.58800,860782
16000,chiragggupta90,1,0.00012,168611,19.58812,860782
16001,chitranshi21,1,0.00012,168612,19.58823,860782
16002,chiyanking,1,0.00012,168613,19.58835,860782
16003,chmephisto,1,0.00012,168614,19.58847,860782
16004,chmit,1,0.00012,168615,19.58858,860782
16005,chnaveen112,1,0.00012,168616,19.58870,860782
16006,Cho1409,1,0.00012,168617,19.58882,860782
16007,choksifenil90,1,0.00012,168618,19.58893,860782
16008,chonbash,1,0.00012,168619,19.58905,860782
16009,chongkong,1,0.00012,168620,19.58916,860782
16010,choose27,1,0.00012,168621,19.58928,860782
16011,chqbook-devops,1,0.00012,168622,19.58940,860782
16012,chrber,1,0.00012,168623,19.58951,860782
16013,chrifey,1,0.00012,168624,19.58963,860782
16014,chris27git,1,0.00012,168625,19.58975,860782
16015,chrisbomar,1,0.00012,168626,19.58986,860782
16016,chris-brace,1,0.00012,168627,19.58998,860782
16017,ChrisChinchilla,1,0.00012,168628,19.59009,860782
16018,chrisdecker1201,1,0.00012,168629,19.59021,860782
16019,chrishatfield86,1,0.00012,168630,19.59033,860782
16020,chrishoerl,1,0.00012,168631,19.59044,860782
16021,chrisholly-skyuk,1,0.00012,168632,19.59056,860782
16022,chriskolenko,1,0.00012,168633,19.59067,860782
16023,ChrisLahaye,1,0.00012,168634,19.59079,860782
16024,chrisroat,1,0.00012,168635,19.59091,860782
16025,christian-2,1,0.00012,168636,19.59102,860782
16026,christian-oudard,1,0.00012,168637,19.59114,860782
16027,christian-vent,1,0.00012,168638,19.59126,860782
16028,christianwicke,1,0.00012,168639,19.59137,860782
16029,ChristinaCartagena,1,0.00012,168640,19.59149,860782
16030,christinaet,1,0.00012,168641,19.59160,860782
16031,christofhaerens,1,0.00012,168642,19.59172,860782
16032,ChrisTomAlx,1,0.00012,168643,19.59184,860782
16033,christopheblin,1,0.00012,168644,19.59195,860782
16034,christopher-wong,1,0.00012,168645,19.59207,860782
16035,Chromadream,1,0.00012,168646,19.59218,860782
16036,chronograph3r,1,0.00012,168647,19.59230,860782
16037,chrouzz,1,0.00012,168648,19.59242,860782
16038,chsatyap,1,0.00012,168649,19.59253,860782
16039,ChuckLinQ,1,0.00012,168650,19.59265,860782
16040,chuegel,1,0.00012,168651,19.59277,860782
16041,chukmunnlee,1,0.00012,168652,19.59288,860782
16042,ChumaA,1,0.00012,168653,19.59300,860782
16043,chuong-dao,1,0.00012,168654,19.59311,860782
16044,Chwetion,1,0.00012,168655,19.59323,860782
16045,ciberkleid,1,0.00012,168656,19.59335,860782
16046,Cicatrice,1,0.00012,168657,19.59346,860782
16047,cirulls,1,0.00012,168658,19.59358,860782
16048,ciyer,1,0.00012,168659,19.59370,860782
16049,cjb21sj,1,0.00012,168660,19.59381,860782
16050,cjbackman,1,0.00012,168661,19.59393,860782
16051,cjekin,1,0.00012,168662,19.59404,860782
16052,cjemison,1,0.00012,168663,19.59416,860782
16053,cjgibson,1,0.00012,168664,19.59428,860782
16054,cjl3080434008,1,0.00012,168665,19.59439,860782
16055,cjrpriest,1,0.00012,168666,19.59451,860782
16056,cjstetson,1,0.00012,168667,19.59462,860782
16057,cjyothi,1,0.00012,168668,19.59474,860782
16058,ckaushik,1,0.00012,168669,19.59486,860782
16059,cksajil,1,0.00012,168670,19.59497,860782
16060,clarklee92,1,0.00012,168671,19.59509,860782
16061,ClaudioMFreitas,1,0.00012,168672,19.59521,860782
16062,claudioscatoli,1,0.00012,168673,19.59532,860782
16063,claughinghouse,1,0.00012,168674,19.59544,860782
16064,claui,1,0.00012,168675,19.59555,860782
16065,claycooper,1,0.00012,168676,19.59567,860782
16066,ClementIV,1,0.00012,168677,19.59579,860782
16067,clenn,1,0.00012,168678,19.59590,860782
16068,cleverlight,1,0.00012,168679,19.59602,860782
16069,clhlc,1,0.00012,168680,19.59613,860782
16070,clhodapp,1,0.00012,168681,19.59625,860782
16071,clickatsachin,1,0.00012,168682,19.59637,860782
16072,cljk,1,0.00012,168683,19.59648,860782
16073,clook,1,0.00012,168684,19.59660,860782
16074,closetool,1,0.00012,168685,19.59672,860782
16075,cloud-arrow,1,0.00012,168686,19.59683,860782
16076,cloudcafetech,1,0.00012,168687,19.59695,860782
16077,cloudeyes,1,0.00012,168688,19.59706,860782
16078,cloudmaniac,1,0.00012,168689,19.59718,860782
16079,cloudpea,1,0.00012,168690,19.59730,860782
16080,cloudyuga,1,0.00012,168691,19.59741,860782
16081,cloutiertyler,1,0.00012,168692,19.59753,860782
16082,clu-osi,1,0.00012,168693,19.59764,860782
16083,clvx,1,0.00012,168694,19.59776,860782
16084,clydevassallo,1,0.00012,168695,19.59788,860782
16085,cm0s,1,0.00012,168696,19.59799,860782
16086,cmardini,1,0.00012,168697,19.59811,860782
16087,cmb69,1,0.00012,168698,19.59823,860782
16088,CMCDragonkai,1,0.00012,168699,19.59834,860782
16089,c-mcinerney,1,0.00012,168700,19.59846,860782
16090,cmdallas,1,0.00012,168701,19.59857,860782
16091,cmedley2,1,0.00012,168702,19.59869,860782
16092,cmouli84,1,0.00012,168703,19.59881,860782
16093,Cmpelon210,1,0.00012,168704,19.59892,860782
16094,cmpsoares91,1,0.00012,168705,19.59904,860782
16095,cmuchinsky,1,0.00012,168706,19.59916,860782
16096,cmxela,1,0.00012,168707,19.59927,860782
16097,Cna59,1,0.00012,168708,19.59939,860782
16098,cnelson,1,0.00012,168709,19.59950,860782
16099,CNG,1,0.00012,168710,19.59962,860782
16100,cnglen,1,0.00012,168711,19.59974,860782
16101,cnk8s,1,0.00012,168712,19.59985,860782
16102,cnlong,1,0.00012,168713,19.59997,860782
16103,cn-mayank,1,0.00012,168714,19.60008,860782
16104,cnnrznn,1,0.00012,168715,19.60020,860782
16105,CoaxVex,1,0.00012,168716,19.60032,860782
16106,cocoa-maemae,1,0.00012,168717,19.60043,860782
16107,cocodrino,1,0.00012,168718,19.60055,860782
16108,codapus-co,1,0.00012,168719,19.60067,860782
16109,Codasip,1,0.00012,168720,19.60078,860782
16110,codeagencybe,1,0.00012,168721,19.60090,860782
16111,codebyalokgupta,1,0.00012,168722,19.60101,860782
16112,codechaitu,1,0.00012,168723,19.60113,860782
16113,Code-Codex,1,0.00012,168724,19.60125,860782
16114,codemug,1,0.00012,168725,19.60136,860782
16115,CodeNinjaUG,1,0.00012,168726,19.60148,860782
16116,codepractisedemo,1,0.00012,168727,19.60159,860782
16117,coderaven,1,0.00012,168728,19.60171,860782
16118,CoderPraBhu,1,0.00012,168729,19.60183,860782
16119,Codes-Breaker,1,0.00012,168730,19.60194,860782
16120,codingninja-95,1,0.00012,168731,19.60206,860782
16121,CodingSpiderFox,1,0.00012,168732,19.60218,860782
16122,codmw44,1,0.00012,168733,19.60229,860782
16123,cody1115,1,0.00012,168734,19.60241,860782
16124,CodyGuo,1,0.00012,168735,19.60252,860782
16125,codyja,1,0.00012,168736,19.60264,860782
16126,codyl-stripe,1,0.00012,168737,19.60276,860782
16127,cofiiwu,1,0.00012,168738,19.60287,860782
16128,cohenuzi01,1,0.00012,168739,19.60299,860782
16129,cojocaru-dragos-alexandru,1,0.00012,168740,19.60311,860782
16130,colceagus,1,0.00012,168741,19.60322,860782
16131,colemast,1,0.00012,168742,19.60334,860782
16132,colin-higgins,1,0.00012,168743,19.60345,860782
16133,collinwright,1,0.00012,168744,19.60357,860782
16134,com30n,1,0.00012,168745,19.60369,860782
16135,coman3,1,0.00012,168746,19.60380,860782
16136,ComaToastUK,1,0.00012,168747,19.60392,860782
16137,comicfans,1,0.00012,168748,19.60403,860782
16138,computerphilosopher,1,0.00012,168749,19.60415,860782
16139,conan2x,1,0.00012,168750,19.60427,860782
16140,conanswp,1,0.00012,168751,19.60438,860782
16141,ConcurrencyPractitioner,1,0.00012,168752,19.60450,860782
16142,conet,1,0.00012,168753,19.60462,860782
16143,congaductq,1,0.00012,168754,19.60473,860782
16144,congcongke,1,0.00012,168755,19.60485,860782
16145,Congelli501,1,0.00012,168756,19.60496,860782
16146,connatix-cradulescu,1,0.00012,168757,19.60508,860782
16147,connernilsen,1,0.00012,168758,19.60520,860782
16148,connorlwilkes,1,0.00012,168759,19.60531,860782
16149,ConorEB,1,0.00012,168760,19.60543,860782
16150,ConorNevin,1,0.00012,168761,19.60554,860782
16151,conradf7,1,0.00012,168762,19.60566,860782
16152,conrallendale,1,0.00012,168763,19.60578,860782
16153,constantinpr,1,0.00012,168764,19.60589,860782
16154,coolamiy,1,0.00012,168765,19.60601,860782
16155,CoolDuke,1,0.00012,168766,19.60613,860782
16156,coolpalani,1,0.00012,168767,19.60624,860782
16157,CoopeyB,1,0.00012,168768,19.60636,860782
16158,coox,1,0.00012,168769,19.60647,860782
16159,copecopecope,1,0.00012,168770,19.60659,860782
16160,Corallus-Caninus,1,0.00012,168771,19.60671,860782
16161,corbanvilla,1,0.00012,168772,19.60682,860782
16162,corest,1,0.00012,168773,19.60694,860782
16163,CoreyLoose,1,0.00012,168774,19.60705,860782
16164,coro,1,0.00012,168775,19.60717,860782
16165,corpulent,1,0.00012,168776,19.60729,860782
16166,CorralPeltzer,1,0.00012,168777,19.60740,860782
16167,corverroos,1,0.00012,168778,19.60752,860782
16168,corybreed,1,0.00012,168779,19.60764,860782
16169,corymurphy,1,0.00012,168780,19.60775,860782
16170,coryrjohnson,1,0.00012,168781,19.60787,860782
16171,coryschwartz,1,0.00012,168782,19.60798,860782
16172,cosenmarco,1,0.00012,168783,19.60810,860782
16173,cosmin-mogos,1,0.00012,168784,19.60822,860782
16174,CosmoMyzrailGorynych,1,0.00012,168785,19.60833,860782
16175,covid2,1,0.00012,168786,19.60845,860782
16176,cpatil7,1,0.00012,168787,19.60857,860782
16177,cphang99,1,0.00012,168788,19.60868,860782
16178,cp-jennifer,1,0.00012,168789,19.60880,860782
16179,cppforlife,1,0.00012,168790,19.60891,860782
16180,cpranav,1,0.00012,168791,19.60903,860782
16181,CptBorg,1,0.00012,168792,19.60915,860782
16182,CptDaniel,1,0.00012,168793,19.60926,860782
16183,cpu100,1,0.00012,168794,19.60938,860782
16184,cpumanaz,1,0.00012,168795,19.60949,860782
16185,CPythoner,1,0.00012,168796,19.60961,860782
16186,cq-z,1,0.00012,168797,19.60973,860782
16187,cr1cr1,1,0.00012,168798,19.60984,860782
16188,cr4igo,1,0.00012,168799,19.60996,860782
16189,CrackerHax,1,0.00012,168800,19.61008,860782
16190,crak-mmarcoux,1,0.00012,168801,19.61019,860782
16191,crankbird,1,0.00012,168802,19.61031,860782
16192,CRASH-Tech,1,0.00012,168803,19.61042,860782
16193,crawdaddy18,1,0.00012,168804,19.61054,860782
16194,crawdell,1,0.00012,168805,19.61066,860782
16195,Crazybus,1,0.00012,168806,19.61077,860782
16196,CrazyCry,1,0.00012,168807,19.61089,860782
16197,cre8ivejp,1,0.00012,168808,19.61100,860782
16198,creatica-soft,1,0.00012,168809,19.61112,860782
16199,crflynn,1,0.00012,168810,19.61124,860782
16200,crfrase,1,0.00012,168811,19.61135,860782
16201,cr-gstirling,1,0.00012,168812,19.61147,860782
16202,crhntr,1,0.00012,168813,19.61159,860782
16203,cristianciutea,1,0.00012,168814,19.61170,860782
16204,CristianT,1,0.00012,168815,19.61182,860782
16205,crlane,1,0.00012,168816,19.61193,860782
16206,crookedstorm,1,0.00012,168817,19.61205,860782
16207,crpotter,1,0.00012,168818,19.61217,860782
16208,crq777,1,0.00012,168819,19.61228,860782
16209,crustafari,1,0.00012,168820,19.61240,860782
16210,c-ryan747,1,0.00012,168821,19.61252,860782
16211,CryBecase,1,0.00012,168822,19.61263,860782
16212,Cryptonewsmedia,1,0.00012,168823,19.61275,860782
16213,crytome1995,1,0.00012,168824,19.61286,860782
16214,csasfr,1,0.00012,168825,19.61298,860782
16215,cskinfill,1,0.00012,168826,19.61310,860782
16216,Cspellz,1,0.00012,168827,19.61321,860782
16217,Cst2989,1,0.00012,168828,19.61333,860782
16218,CsterKuroi,1,0.00012,168829,19.61344,860782
16219,ct1104,1,0.00012,168830,19.61356,860782
16220,ctaylor-bread,1,0.00012,168831,19.61368,860782
16221,ctclements,1,0.00012,168832,19.61379,860782
16222,cteicher-m,1,0.00012,168833,19.61391,860782
16223,ctoomey,1,0.00012,168834,19.61403,860782
16224,ctxrag,1,0.00012,168835,19.61414,860782
16225,cujeff09,1,0.00012,168836,19.61426,860782
16226,cukiernick,1,0.00012,168837,19.61437,860782
16227,Cultuzz-India,1,0.00012,168838,19.61449,860782
16228,cumirror,1,0.00012,168839,19.61461,860782
16229,cummy2019,1,0.00012,168840,19.61472,860782
16230,cupello,1,0.00012,168841,19.61484,860782
16231,cupen,1,0.00012,168842,19.61495,860782
16232,currycan,1,0.00012,168843,19.61507,860782
16233,cuviengchai,1,0.00012,168844,19.61519,860782
16234,cuzzo333,1,0.00012,168845,19.61530,860782
16235,cvandesande,1,0.00012,168846,19.61542,860782
16236,cviebig,1,0.00012,168847,19.61554,860782
16237,Cvimer,1,0.00012,168848,19.61565,860782
16238,cvmmojo,1,0.00012,168849,19.61577,860782
16239,cwchoe,1,0.00012,168850,19.61588,860782
16240,cweidinger,1,0.00012,168851,19.61600,860782
16241,cwells,1,0.00012,168852,19.61612,860782
16242,cw-niinuma,1,0.00012,168853,19.61623,860782
16243,cxhansen,1,0.00012,168854,19.61635,860782
16244,cy503328434,1,0.00012,168855,19.61647,860782
16245,cy6erskunk,1,0.00012,168856,19.61658,860782
16246,cyb3rfist,1,0.00012,168857,19.61670,860782
16247,CYBERBUGJR,1,0.00012,168858,19.61681,860782
16248,cybercorey,1,0.00012,168859,19.61693,860782
16249,cyberdak,1,0.00012,168860,19.61705,860782
16250,CyberHippo,1,0.00012,168861,19.61716,860782
16251,cyberjso,1,0.00012,168862,19.61728,860782
16252,CyberPoison,1,0.00012,168863,19.61739,860782
16253,cyberprodigy,1,0.00012,168864,19.61751,860782
16254,cybervagabond,1,0.00012,168865,19.61763,860782
16255,cyberzlo,1,0.00012,168866,19.61774,860782
16256,cyclamen,1,0.00012,168867,19.61786,860782
16257,cylewitruk,1,0.00012,168868,19.61798,860782
16258,cyplenochek,1,0.00012,168869,19.61809,860782
16259,Cyral,1,0.00012,168870,19.61821,860782
16260,cyt3ea,1,0.00012,168871,19.61832,860782
16261,czhen1992,1,0.00012,168872,19.61844,860782
16262,cz-it,1,0.00012,168873,19.61856,860782
16263,czunker,1,0.00012,168874,19.61867,860782
16264,d00medman,1,0.00012,168875,19.61879,860782
16265,d270624,1,0.00012,168876,19.61890,860782
16266,d2dyno,1,0.00012,168877,19.61902,860782
16267,d33d33,1,0.00012,168878,19.61914,860782
16268,d3vdr3y,1,0.00012,168879,19.61925,860782
16269,d47zm3,1,0.00012,168880,19.61937,860782
16270,d5h,1,0.00012,168881,19.61949,860782
16271,da77a,1,0.00012,168882,19.61960,860782
16272,daanflore,1,0.00012,168883,19.61972,860782
16273,daastek,1,0.00012,168884,19.61983,860782
16274,dacianmujdar,1,0.00012,168885,19.61995,860782
16275,dadapapapa,1,0.00012,168886,19.62007,860782
16276,dadav,1,0.00012,168887,19.62018,860782
16277,dadude999,1,0.00012,168888,19.62030,860782
16278,daduskacpokus,1,0.00012,168889,19.62041,860782
16279,daemur,1,0.00012,168890,19.62053,860782
16280,dafydd2277,1,0.00012,168891,19.62065,860782
16281,dagguh,1,0.00012,168892,19.62076,860782
16282,dagrayvid,1,0.00012,168893,19.62088,860782
16283,DahuK,1,0.00012,168894,19.62100,860782
16284,daian183,1,0.00012,168895,19.62111,860782
16285,daisuke-yoshimoto,1,0.00012,168896,19.62123,860782
16286,dajianderichang,1,0.00012,168897,19.62134,860782
16287,dakele123,1,0.00012,168898,19.62146,860782
16288,dal13002,1,0.00012,168899,19.62158,860782
16289,dalingjiuling,1,0.00012,168900,19.62169,860782
16290,daluca,1,0.00012,168901,19.62181,860782
16291,Daly123456,1,0.00012,168902,19.62193,860782
16292,Damarla499,1,0.00012,168903,19.62204,860782
16293,damianknopp,1,0.00012,168904,19.62216,860782
16294,damodhar22,1,0.00012,168905,19.62227,860782
16295,damon09273,1,0.00012,168906,19.62239,860782
16296,damonbarry,1,0.00012,168907,19.62251,860782
16297,DamonQuu,1,0.00012,168908,19.62262,860782
16298,damoon,1,0.00012,168909,19.62274,860782
16299,danbarr,1,0.00012,168910,19.62285,860782
16300,danccosta,1,0.00012,168911,19.62297,860782
16301,DancingFFFire,1,0.00012,168912,19.62309,860782
16302,dan-cummings1,1,0.00012,168913,19.62320,860782
16303,dandar3,1,0.00012,168914,19.62332,860782
16304,dandesousa,1,0.00012,168915,19.62344,860782
16305,Danfeng-Wang,1,0.00012,168916,19.62355,860782
16306,Dani1994Italy,1,0.00012,168917,19.62367,860782
16307,daniel198609,1,0.00012,168918,19.62378,860782
16308,danielcb,1,0.00012,168919,19.62390,860782
16309,daniele-sartiano,1,0.00012,168920,19.62402,860782
16310,daniel-esq,1,0.00012,168921,19.62413,860782
16311,danielkwinsor,1,0.00012,168922,19.62425,860782
16312,danielmitre,1,0.00012,168923,19.62436,860782
16313,danielnbalasoiu,1,0.00012,168924,19.62448,860782
16314,danielolabanji,1,0.00012,168925,19.62460,860782
16315,danielpsf,1,0.00012,168926,19.62471,860782
16316,danielsig727,1,0.00012,168927,19.62483,860782
16317,danieltanfh95,1,0.00012,168928,19.62495,860782
16318,danieltroger,1,0.00012,168929,19.62506,860782
16319,daniel-velinov,1,0.00012,168930,19.62518,860782
16320,Daniel-WWU-IT,1,0.00012,168931,19.62529,860782
16321,danigiac,1,0.00012,168932,19.62541,860782
16322,DaniGuardiola,1,0.00012,168933,19.62553,860782
16323,danihodovic,1,0.00012,168934,19.62564,860782
16324,daniloakamine,1,0.00012,168935,19.62576,860782
16325,danjonwilliams,1,0.00012,168936,19.62588,860782
16326,Dannieib,1,0.00012,168937,19.62599,860782
16327,DannyeB,1,0.00012,168938,19.62611,860782
16328,Danny-m08,1,0.00012,168939,19.62622,860782
16329,dannytimothy,1,0.00012,168940,19.62634,860782
16330,danoliver1,1,0.00012,168941,19.62646,860782
16331,danotorrey,1,0.00012,168942,19.62657,860782
16332,Danpiel,1,0.00012,168943,19.62669,860782
16333,danrobdean,1,0.00012,168944,19.62680,860782
16334,dansiviter,1,0.00012,168945,19.62692,860782
16335,danst3in,1,0.00012,168946,19.62704,860782
16336,dapseen,1,0.00012,168947,19.62715,860782
16337,darach,1,0.00012,168948,19.62727,860782
16338,dara-na,1,0.00012,168949,19.62739,860782
16339,darede-git,1,0.00012,168950,19.62750,860782
16340,darias1986,1,0.00012,168951,19.62762,860782
16341,dariuszbz,1,0.00012,168952,19.62773,860782
16342,darix,1,0.00012,168953,19.62785,860782
16343,darkdatter,1,0.00012,168954,19.62797,860782
16344,darknessp,1,0.00012,168955,19.62808,860782
16345,DarkSkyT9A,1,0.00012,168956,19.62820,860782
16346,Darkspirit,1,0.00012,168957,19.62831,860782
16347,darktanker89,1,0.00012,168958,19.62843,860782
16348,darleilopes,1,0.00012,168959,19.62855,860782
16349,darox,1,0.00012,168960,19.62866,860782
16350,darraghjones,1,0.00012,168961,19.62878,860782
16351,darrensu-ibm,1,0.00012,168962,19.62890,860782
16352,Darren-wh,1,0.00012,168963,19.62901,860782
16353,darshan-karia,1,0.00012,168964,19.62913,860782
16354,darshanparab,1,0.00012,168965,19.62924,860782
16355,Darshil11,1,0.00012,168966,19.62936,860782
16356,darthenik,1,0.00012,168967,19.62948,860782
16357,DarthSlider,1,0.00012,168968,19.62959,860782
16358,darth-veitcher,1,0.00012,168969,19.62971,860782
16359,DarwinSin,1,0.00012,168970,19.62982,860782
16360,daserge,1,0.00012,168971,19.62994,860782
16361,daseth,1,0.00012,168972,19.63006,860782
16362,dashingsat,1,0.00012,168973,19.63017,860782
16363,daskanu,1,0.00012,168974,19.63029,860782
16364,dasl-,1,0.00012,168975,19.63041,860782
16365,DASXCE,1,0.00012,168976,19.63052,860782
16366,datamuc,1,0.00012,168977,19.63064,860782
16367,datosh,1,0.00012,168978,19.63075,860782
16368,DaudMurtazaRind,1,0.00012,168979,19.63087,860782
16369,daudtacto,1,0.00012,168980,19.63099,860782
16370,daufinsyd,1,0.00012,168981,19.63110,860782
16371,daur88,1,0.00012,168982,19.63122,860782
16372,davdiv,1,0.00012,168983,19.63134,860782
16373,davdunc,1,0.00012,168984,19.63145,860782
16374,dave93cab,1,0.00012,168985,19.63157,860782
16375,davecaplinger,1,0.00012,168986,19.63168,860782
16376,davechallis,1,0.00012,168987,19.63180,860782
16377,davedotdev,1,0.00012,168988,19.63192,860782
16378,davejrt,1,0.00012,168989,19.63203,860782
16379,dave-meier,1,0.00012,168990,19.63215,860782
16380,DaveSlinn,1,0.00012,168991,19.63226,860782
16381,davesteinberg,1,0.00012,168992,19.63238,860782
16382,davetayls,1,0.00012,168993,19.63250,860782
16383,DaveWHarvey,1,0.00012,168994,19.63261,860782
16384,David1866,1,0.00012,168995,19.63273,860782
16385,davidandreoletti,1,0.00012,168996,19.63285,860782
16386,davidbIQ,1,0.00012,168997,19.63296,860782
16387,davidblondeau,1,0.00012,168998,19.63308,860782
16388,davidbonachera,1,0.00012,168999,19.63319,860782
16389,davidcarrera,1,0.00012,169000,19.63331,860782
16390,davidcorbin,1,0.00012,169001,19.63343,860782
16391,DavidDaskalo,1,0.00012,169002,19.63354,860782
16392,David-Development,1,0.00012,169003,19.63366,860782
16393,davidebersani,1,0.00012,169004,19.63377,860782
16394,davide-bolcioni,1,0.00012,169005,19.63389,860782
16395,davidegiunchi,1,0.00012,169006,19.63401,860782
16396,DavideVi,1,0.00012,169007,19.63412,860782
16397,davidfernandezm,1,0.00012,169008,19.63424,860782
16398,davidfetter,1,0.00012,169009,19.63436,860782
16399,david-geiger,1,0.00012,169010,19.63447,860782
16400,davidgengenbach,1,0.00012,169011,19.63459,860782
16401,DavidGereb,1,0.00012,169012,19.63470,860782
16402,davidghiurco,1,0.00012,169013,19.63482,860782
16403,david-in-perth,1,0.00012,169014,19.63494,860782
16404,davidjsherman,1,0.00012,169015,19.63505,860782
16405,davidkilliansc,1,0.00012,169016,19.63517,860782
16406,davidledev,1,0.00012,169017,19.63529,860782
16407,DavidLeeUX,1,0.00012,169018,19.63540,860782
16408,davidlenfesty,1,0.00012,169019,19.63552,860782
16409,davidmateos,1,0.00012,169020,19.63563,860782
16410,davidMcneil,1,0.00012,169021,19.63575,860782
16411,davidmitchell2019,1,0.00012,169022,19.63587,860782
16412,davidmontoyago,1,0.00012,169023,19.63598,860782
16413,davidnewhall,1,0.00012,169024,19.63610,860782
16414,Davidnovarro,1,0.00012,169025,19.63621,860782
16415,davidone,1,0.00012,169026,19.63633,860782
16416,davidrfreeman,1,0.00012,169027,19.63645,860782
16417,davidsmf,1,0.00012,169028,19.63656,860782
16418,davidstone,1,0.00012,169029,19.63668,860782
16419,davidtom,1,0.00012,169030,19.63680,860782
16420,davidwcarlson,1,0.00012,169031,19.63691,860782
16421,davidwindell,1,0.00012,169032,19.63703,860782
16422,davidxjohnson,1,0.00012,169033,19.63714,860782
16423,davinkevin,1,0.00012,169034,19.63726,860782
16424,davisjohndavis3,1,0.00012,169035,19.63738,860782
16425,davizucon,1,0.00012,169036,19.63749,860782
16426,davzucky,1,0.00012,169037,19.63761,860782
16427,daweim0,1,0.00012,169038,19.63772,860782
16428,dawidole,1,0.00012,169039,19.63784,860782
16429,dawidslowik,1,0.00012,169040,19.63796,860782
16430,daxwang,1,0.00012,169041,19.63807,860782
16431,daydrim,1,0.00012,169042,19.63819,860782
16432,dayyehm,1,0.00012,169043,19.63831,860782
16433,DazedDreamer,1,0.00012,169044,19.63842,860782
16434,dazinator,1,0.00012,169045,19.63854,860782
16435,dazza76,1,0.00012,169046,19.63865,860782
16436,dazza-codes,1,0.00012,169047,19.63877,860782
16437,dazzag24,1,0.00012,169048,19.63889,860782
16438,dazzbourgh,1,0.00012,169049,19.63900,860782
16439,dbamaster,1,0.00012,169050,19.63912,860782
16440,dbason,1,0.00012,169051,19.63924,860782
16441,dbeckham,1,0.00012,169052,19.63935,860782
16442,dboc,1,0.00012,169053,19.63947,860782
16443,dbspace,1,0.00012,169054,19.63958,860782
16444,dbwest,1,0.00012,169055,19.63970,860782
16445,dbwhddn10,1,0.00012,169056,19.63982,860782
16446,dcarney-stripe,1,0.00012,169057,19.63993,860782
16447,dcd000,1,0.00012,169058,19.64005,860782
16448,dchen05,1,0.00012,169059,19.64016,860782
16449,dconvers1979,1,0.00012,169060,19.64028,860782
16450,dcorbe,1,0.00012,169061,19.64040,860782
16451,dcrearer,1,0.00012,169062,19.64051,860782
16452,ddatsh,1,0.00012,169063,19.64063,860782
16453,ddavtian,1,0.00012,169064,19.64075,860782
16454,ddisqq,1,0.00012,169065,19.64086,860782
16455,DdMad,1,0.00012,169066,19.64098,860782
16456,ddobrijalowski,1,0.00012,169067,19.64109,860782
16457,ddonnen,1,0.00012,169068,19.64121,860782
16458,dds-sysu,1,0.00012,169069,19.64133,860782
16459,De1taE1even,1,0.00012,169070,19.64144,860782
16460,deafgoat,1,0.00012,169071,19.64156,860782
16461,dean2021,1,0.00012,169072,19.64167,860782
16462,deanwilson,1,0.00012,169073,19.64179,860782
16463,debfx,1,0.00012,169074,19.64191,860782
16464,debugleader,1,0.00012,169075,19.64202,860782
16465,debugmiller,1,0.00012,169076,19.64214,860782
16466,decentname,1,0.00012,169077,19.64226,860782
16467,deed02392,1,0.00012,169078,19.64237,860782
16468,deejvince,1,0.00012,169079,19.64249,860782
16469,deen13,1,0.00012,169080,19.64260,860782
16470,Deepak1100,1,0.00012,169081,19.64272,860782
16471,deepak2312,1,0.00012,169082,19.64284,860782
16472,deepak-auto,1,0.00012,169083,19.64295,860782
16473,DeepakYadav17,1,0.00012,169084,19.64307,860782
16474,deepankarmalhan,1,0.00012,169085,19.64318,860782
16475,deepankarsharma,1,0.00012,169086,19.64330,860782
16476,deepanverma19,1,0.00012,169087,19.64342,860782
16477,deepflame,1,0.00012,169088,19.64353,860782
16478,deepj,1,0.00012,169089,19.64365,860782
16479,deepk2u,1,0.00012,169090,19.64377,860782
16480,Deep-sys-star,1,0.00012,169091,19.64388,860782
16481,defrank,1,0.00012,169092,19.64400,860782
16482,degerrit,1,0.00012,169093,19.64411,860782
16483,Deimantas95,1,0.00012,169094,19.64423,860782
16484,Deiskos,1,0.00012,169095,19.64435,860782
16485,dejan9393,1,0.00012,169096,19.64446,860782
16486,DeJesusa2,1,0.00012,169097,19.64458,860782
16487,dejfh,1,0.00012,169098,19.64470,860782
16488,dekelev,1,0.00012,169099,19.64481,860782
16489,deleted,1,0.00012,169100,19.64493,860782
16490,Delorien84,1,0.00012,169101,19.64504,860782
16491,deltamualpha,1,0.00012,169102,19.64516,860782
16492,deltasquare4,1,0.00012,169103,19.64528,860782
16493,demistry,1,0.00012,169104,19.64539,860782
16494,demon999,1,0.00012,169105,19.64551,860782
16495,Demon-DK,1,0.00012,169106,19.64562,860782
16496,demonkoryu,1,0.00012,169107,19.64574,860782
16497,demostheneslld,1,0.00012,169108,19.64586,860782
16498,demurray,1,0.00012,169109,19.64597,860782
16499,dengqiangloveju,1,0.00012,169110,19.64609,860782
16500,DenisPalnitsky,1,0.00012,169111,19.64621,860782
16501,DenisVoloshin,1,0.00012,169112,19.64632,860782
16502,dennisdegreef,1,0.00012,169113,19.64644,860782
16503,DennisGlindhart,1,0.00012,169114,19.64655,860782
16504,Denusdv,1,0.00012,169115,19.64667,860782
16505,denyo,1,0.00012,169116,19.64679,860782
16506,depoyempoy,1,0.00012,169117,19.64690,860782
16507,derekrprice,1,0.00012,169118,19.64702,860782
16508,derekyle,1,0.00012,169119,19.64713,860782
16509,derori,1,0.00012,169120,19.64725,860782
16510,derSascha,1,0.00012,169121,19.64737,860782
16511,DerTiedemann,1,0.00012,169122,19.64748,860782
16512,desertfury,1,0.00012,169123,19.64760,860782
16513,Desh96,1,0.00012,169124,19.64772,860782
16514,detro,1,0.00012,169125,19.64783,860782
16515,Dev25,1,0.00012,169126,19.64795,860782
16516,Devang1991,1,0.00012,169127,19.64806,860782
16517,devarshigoswami,1,0.00012,169128,19.64818,860782
16518,dev-cr-ka,1,0.00012,169129,19.64830,860782
16519,devdattakulkarni,1,0.00012,169130,19.64841,860782
16520,Develoman,1,0.00012,169131,19.64853,860782
16521,deven7aq,1,0.00012,169132,19.64865,860782
16522,deveshkandpal24121990,1,0.00012,169133,19.64876,860782
16523,devfd,1,0.00012,169134,19.64888,860782
16524,devgibsonsp,1,0.00012,169135,19.64899,860782
16525,deviljoshi,1,0.00012,169136,19.64911,860782
16526,devinbost,1,0.00012,169137,19.64923,860782
16527,devin-fee-ah,1,0.00012,169138,19.64934,860782
16528,devinodaniel,1,0.00012,169139,19.64946,860782
16529,devinrsmith,1,0.00012,169140,19.64957,860782
16530,devlinyvonne,1,0.00012,169141,19.64969,860782
16531,devmarcomcentral,1,0.00012,169142,19.64981,860782
16532,devmohit-live,1,0.00012,169143,19.64992,860782
16533,devnall,1,0.00012,169144,19.65004,860782
16534,devnore,1,0.00012,169145,19.65016,860782
16535,dev-ops-biznet,1,0.00012,169146,19.65027,860782
16536,devops-invivoo,1,0.00012,169147,19.65039,860782
16537,devopsix,1,0.00012,169148,19.65050,860782
16538,devopskid,1,0.00012,169149,19.65062,860782
16539,devopstoday11,1,0.00012,169150,19.65074,860782
16540,devopswata,1,0.00012,169151,19.65085,860782
16541,devriesb,1,0.00012,169152,19.65097,860782
16542,devtech0101,1,0.00012,169153,19.65108,860782
16543,devteng,1,0.00012,169154,19.65120,860782
16544,devwinner-sek,1,0.00012,169155,19.65132,860782
16545,DewinGoh,1,0.00012,169156,19.65143,860782
16546,dex4er,1,0.00012,169157,19.65155,860782
16547,dexter-hwang,1,0.00012,169158,19.65167,860782
16548,dexterpuru,1,0.00012,169159,19.65178,860782
16549,deyanp,1,0.00012,169160,19.65190,860782
16550,dfad1ripe,1,0.00012,169161,19.65201,860782
16551,dfernandezm,1,0.00012,169162,19.65213,860782
16552,dfresh613,1,0.00012,169163,19.65225,860782
16553,dfsdevops,1,0.00012,169164,19.65236,860782
16554,dfurtado,1,0.00012,169165,19.65248,860782
16555,dgabrysch,1,0.00012,169166,19.65259,860782
16556,dgdevops,1,0.00012,169167,19.65271,860782
16557,dgethings,1,0.00012,169168,19.65283,860782
16558,Dgiordano33,1,0.00012,169169,19.65294,860782
16559,dgloeckner,1,0.00012,169170,19.65306,860782
16560,dhanaraj0,1,0.00012,169171,19.65318,860782
16561,DhanashriPalodkar,1,0.00012,169172,19.65329,860782
16562,dharmaanu12,1,0.00012,169173,19.65341,860782
16563,dharmveer18,1,0.00012,169174,19.65352,860782
16564,dhausauer-aapl,1,0.00012,169175,19.65364,860782
16565,dhayakawa-idcf,1,0.00012,169176,19.65376,860782
16566,dheerajkr126,1,0.00012,169177,19.65387,860782
16567,dheerujava,1,0.00012,169178,19.65399,860782
16568,dhenneke,1,0.00012,169179,19.65411,860782
16569,dholleran-lendico,1,0.00012,169180,19.65422,860782
16570,dhruvrnaik,1,0.00012,169181,19.65434,860782
16571,dhuesmann89,1,0.00012,169182,19.65445,860782
16572,diabloxenon,1,0.00012,169183,19.65457,860782
16573,Diaphteiros,1,0.00012,169184,19.65469,860782
16574,DiCanio,1,0.00012,169185,19.65480,860782
16575,DickChesterwood,1,0.00012,169186,19.65492,860782
16576,dick-nux,1,0.00012,169187,19.65503,860782
16577,didevlab,1,0.00012,169188,19.65515,860782
16578,didhd,1,0.00012,169189,19.65527,860782
16579,DidierHoarau,1,0.00012,169190,19.65538,860782
16580,didiplus,1,0.00012,169191,19.65550,860782
16581,diegoaraujopro,1,0.00012,169192,19.65562,860782
16582,diegosucaria,1,0.00012,169193,19.65573,860782
16583,diegoxro,1,0.00012,169194,19.65585,860782
16584,dienstfuchs,1,0.00012,169195,19.65596,860782
16585,dieucao,1,0.00012,169196,19.65608,860782
16586,digambar15,1,0.00012,169197,19.65620,860782
16587,diggnsaegg,1,0.00012,169198,19.65631,860782
16588,digitalkaoz,1,0.00012,169199,19.65643,860782
16589,dileepdevops,1,0.00012,169200,19.65654,860782
16590,dilipv21,1,0.00012,169201,19.65666,860782
16591,dimalo,1,0.00012,169202,19.65678,860782
16592,dimilov,1,0.00012,169203,19.65689,860782
16593,dimisjim,1,0.00012,169204,19.65701,860782
16594,dimon222,1,0.00012,169205,19.65713,860782
16595,dineshkumar181094,1,0.00012,169206,19.65724,860782
16596,dineshppatilgmi,1,0.00012,169207,19.65736,860782
16597,dinfer,1,0.00012,169208,19.65747,860782
16598,dingdayu,1,0.00012,169209,19.65759,860782
16599,DingGGu,1,0.00012,169210,19.65771,860782
16600,dinhanhhuy,1,0.00012,169211,19.65782,860782
16601,dinomiteX,1,0.00012,169212,19.65794,860782
16602,dinusha92,1,0.00012,169213,19.65806,860782
16603,diogonborges,1,0.00012,169214,19.65817,860782
16604,dipAch,1,0.00012,169215,19.65829,860782
16605,Dipenduroy,1,0.00012,169216,19.65840,860782
16606,dipshojol,1,0.00012,169217,19.65852,860782
16607,dirkbaum,1,0.00012,169218,19.65864,860782
16608,Dirrk,1,0.00012,169219,19.65875,860782
16609,discordiaZA,1,0.00012,169220,19.65887,860782
16610,dittos,1,0.00012,169221,19.65898,860782
16611,divyamamidi,1,0.00012,169222,19.65910,860782
16612,DixonDalmeida,1,0.00012,169223,19.65922,860782
16613,dizingof,1,0.00012,169224,19.65933,860782
16614,dizzy1021,1,0.00012,169225,19.65945,860782
16615,djablonski-moia,1,0.00012,169226,19.65957,860782
16616,djagannath-asapp,1,0.00012,169227,19.65968,860782
16617,djannot,1,0.00012,169228,19.65980,860782
16618,dj-arezki,1,0.00012,169229,19.65991,860782
16619,djc,1,0.00012,169230,19.66003,860782
16620,djg2018,1,0.00012,169231,19.66015,860782
16621,djgrubson,1,0.00012,169232,19.66026,860782
16622,djha736,1,0.00012,169233,19.66038,860782
16623,djm457,1,0.00012,169234,19.66049,860782
16624,djotanov,1,0.00012,169235,19.66061,860782
16625,djpadz,1,0.00012,169236,19.66073,860782
16626,djreed,1,0.00012,169237,19.66084,860782
16627,djvasquezvm,1,0.00012,169238,19.66096,860782
16628,dkatona,1,0.00012,169239,19.66108,860782
16629,dk-lockdown,1,0.00012,169240,19.66119,860782
16630,dkolepp,1,0.00012,169241,19.66131,860782
16631,dkonst13,1,0.00012,169242,19.66142,860782
16632,dkravetz,1,0.00012,169243,19.66154,860782
16633,dkrutsko,1,0.00012,169244,19.66166,860782
16634,dkutetsky,1,0.00012,169245,19.66177,860782
16635,dlakatos847,1,0.00012,169246,19.66189,860782
16636,dlangerenken,1,0.00012,169247,19.66201,860782
16637,dleumann,1,0.00012,169248,19.66212,860782
16638,dlinuxguy,1,0.00012,169249,19.66224,860782
16639,dliraf,1,0.00012,169250,19.66235,860782
16640,dloiko,1,0.00012,169251,19.66247,860782
16641,dlqwowo,1,0.00012,169252,19.66259,860782
16642,d-m,1,0.00012,169253,19.66270,860782
16643,dmadisetti,1,0.00012,169254,19.66282,860782
16644,dmars1972,1,0.00012,169255,19.66293,860782
16645,dmarsh19,1,0.00012,169256,19.66305,860782
16646,dmaterowski,1,0.00012,169257,19.66317,860782
16647,dmbarsukov,1,0.00012,169258,19.66328,860782
16648,dmitigr,1,0.00012,169259,19.66340,860782
16649,dmitri-lerko,1,0.00012,169260,19.66352,860782
16650,DmitrySergeyev,1,0.00012,169261,19.66363,860782
16651,dmittendorf,1,0.00012,169262,19.66375,860782
16652,DMN-Koushik,1,0.00012,169263,19.66386,860782
16653,dmolik,1,0.00012,169264,19.66398,860782
16654,dmourao,1,0.00012,169265,19.66410,860782
16655,dmpe,1,0.00012,169266,19.66421,860782
16656,dmslowmo,1,0.00012,169267,19.66433,860782
16657,DMXGuru,1,0.00012,169268,19.66444,860782
16658,dmytro-pryvedeniuk,1,0.00012,169269,19.66456,860782
16659,dmzkrsk,1,0.00012,169270,19.66468,860782
16660,dnasir,1,0.00012,169271,19.66479,860782
16661,dnd,1,0.00012,169272,19.66491,860782
16662,dnenkov,1,0.00012,169273,19.66503,860782
16663,dnl-wlf,1,0.00012,169274,19.66514,860782
16664,dns2utf8,1,0.00012,169275,19.66526,860782
16665,dobber,1,0.00012,169276,19.66537,860782
16666,docker98k,1,0.00012,169277,19.66549,860782
16667,docwho76,1,0.00012,169278,19.66561,860782
16668,DocX,1,0.00012,169279,19.66572,860782
16669,dodtsair,1,0.00012,169280,19.66584,860782
16670,doktormerlin,1,0.00012,169281,19.66595,860782
16671,DolevAlgam,1,0.00012,169282,19.66607,860782
16672,DominicRoyStang,1,0.00012,169283,19.66619,860782
16673,dominik-ba,1,0.00012,169284,19.66630,860782
16674,dominikzorgnotti,1,0.00012,169285,19.66642,860782
16675,DOMZE,1,0.00012,169286,19.66654,860782
16676,donaldh,1,0.00012,169287,19.66665,860782
16677,donataso,1,0.00012,169288,19.66677,860782
16678,don-code,1,0.00012,169289,19.66688,860782
16679,dongxijia,1,0.00012,169290,19.66700,860782
16680,Donis-,1,0.00012,169291,19.66712,860782
16681,donkon,1,0.00012,169292,19.66723,860782
16682,DonnieKim411,1,0.00012,169293,19.66735,860782
16683,donnybr2019,1,0.00012,169294,19.66747,860782
16684,donnyv12,1,0.00012,169295,19.66758,860782
16685,donpaul120,1,0.00012,169296,19.66770,860782
16686,donpinkster,1,0.00012,169297,19.66781,860782
16687,dontreboot,1,0.00012,169298,19.66793,860782
16688,doogie2510,1,0.00012,169299,19.66805,860782
16689,dooman87,1,0.00012,169300,19.66816,860782
16690,dorroddorrod,1,0.00012,169301,19.66828,860782
16691,Dotan1,1,0.00012,169302,19.66839,860782
16692,doubleungoodkitsune,1,0.00012,169303,19.66851,860782
16693,Doude,1,0.00012,169304,19.66863,860782
16694,doudoutinghua,1,0.00012,169305,19.66874,860782
16695,dougbertwashere,1,0.00012,169306,19.66886,860782
16696,douglas-gibbons-lark,1,0.00012,169307,19.66898,860782
16697,dovefi,1,0.00012,169308,19.66909,860782
16698,Download,1,0.00012,169309,19.66921,860782
16699,downlz,1,0.00012,169310,19.66932,860782
16700,downvoteit,1,0.00012,169311,19.66944,860782
16701,doy,1,0.00012,169312,19.66956,860782
16702,dpaclt,1,0.00012,169313,19.66967,860782
16703,dparv,1,0.00012,169314,19.66979,860782
16704,dpc,1,0.00012,169315,19.66990,860782
16705,DPD-30,1,0.00012,169316,19.67002,860782
16706,dpennell,1,0.00012,169317,19.67014,860782
16707,dpepper,1,0.00012,169318,19.67025,860782
16708,dpewsey,1,0.00012,169319,19.67037,860782
16709,dpiessens,1,0.00012,169320,19.67049,860782
16710,dpittner,1,0.00012,169321,19.67060,860782
16711,DPM97,1,0.00012,169322,19.67072,860782
16712,dr1s,1,0.00012,169323,19.67083,860782
16713,DracoBlue,1,0.00012,169324,19.67095,860782
16714,dragoangel,1,0.00012,169325,19.67107,860782
16715,dragonly,1,0.00012,169326,19.67118,860782
16716,Drakkai,1,0.00012,169327,19.67130,860782
16717,Drakulix,1,0.00012,169328,19.67142,860782
16718,drc-agasser,1,0.00012,169329,19.67153,860782
16719,drchilds,1,0.00012,169330,19.67165,860782
16720,drcrees,1,0.00012,169331,19.67176,860782
16721,DrDonoso,1,0.00012,169332,19.67188,860782
16722,drduan,1,0.00012,169333,19.67200,860782
16723,drduker,1,0.00012,169334,19.67211,860782
16724,dreamershl,1,0.00012,169335,19.67223,860782
16725,drewblas,1,0.00012,169336,19.67234,860782
16726,drewp,1,0.00012,169337,19.67246,860782
16727,drgnkpr,1,0.00012,169338,19.67258,860782
16728,DrHardReset,1,0.00012,169339,19.67269,860782
16729,driazati,1,0.00012,169340,19.67281,860782
16730,drizzd,1,0.00012,169341,19.67293,860782
16731,DrkDigglr,1,0.00012,169342,19.67304,860782
16732,drkhosla,1,0.00012,169343,19.67316,860782
16733,DrmagicE,1,0.00012,169344,19.67327,860782
16734,drminh2807,1,0.00012,169345,19.67339,860782
16735,drmy,1,0.00012,169346,19.67351,860782
16736,DrRibosome,1,0.00012,169347,19.67362,860782
16737,drshade,1,0.00012,169348,19.67374,860782
16738,drurenia,1,0.00012,169349,19.67385,860782
16739,dr-zeta,1,0.00012,169350,19.67397,860782
16740,dsalaza4,1,0.00012,169351,19.67409,860782
16741,dsatgithub,1,0.00012,169352,19.67420,860782
16742,dsavineau,1,0.00012,169353,19.67432,860782
16743,dsayan154,1,0.00012,169354,19.67444,860782
16744,dschniepp,1,0.00012,169355,19.67455,860782
16745,dshelygin,1,0.00012,169356,19.67467,860782
16746,dskatz,1,0.00012,169357,19.67478,860782
16747,dsnt02518,1,0.00012,169358,19.67490,860782
16748,dsouzat,1,0.00012,169359,19.67502,860782
16749,dspruell,1,0.00012,169360,19.67513,860782
16750,dst-91,1,0.00012,169361,19.67525,860782
16751,dstarosta,1,0.00012,169362,19.67536,860782
16752,dstathos,1,0.00012,169363,19.67548,860782
16753,dsupure,1,0.00012,169364,19.67560,860782
16754,dtestVC,1,0.00012,169365,19.67571,860782
16755,DTherHtun,1,0.00012,169366,19.67583,860782
16756,dtuite,1,0.00012,169367,19.67595,860782
16757,du86796922,1,0.00012,169368,19.67606,860782
16758,duanhaowei,1,0.00012,169369,19.67618,860782
16759,dubauski,1,0.00012,169370,19.67629,860782
16760,duc45,1,0.00012,169371,19.67641,860782
16761,ducminhnguyen,1,0.00012,169372,19.67653,860782
16762,dudadornelles,1,0.00012,169373,19.67664,860782
16763,du-do,1,0.00012,169374,19.67676,860782
16764,Dudssource,1,0.00012,169375,19.67688,860782
16765,duduwe,1,0.00012,169376,19.67699,860782
16766,duguhaotian,1,0.00012,169377,19.67711,860782
16767,duhruh,1,0.00012,169378,19.67722,860782
16768,dumbdonkey,1,0.00012,169379,19.67734,860782
16769,dumm223,1,0.00012,169380,19.67746,860782
16770,dungba88,1,0.00012,169381,19.67757,860782
16771,dunkymole,1,0.00012,169382,19.67769,860782
16772,dunn,1,0.00012,169383,19.67780,860782
16773,duonoid,1,0.00012,169384,19.67792,860782
16774,durera,1,0.00012,169385,19.67804,860782
16775,durkmurder,1,0.00012,169386,19.67815,860782
16776,duronrulez,1,0.00012,169387,19.67827,860782
16777,dustbort,1,0.00012,169388,19.67839,860782
16778,dustinmoris,1,0.00012,169389,19.67850,860782
16779,dustinneray,1,0.00012,169390,19.67862,860782
16780,duweihello,1,0.00012,169391,19.67873,860782
16781,duyanhui333,1,0.00012,169392,19.67885,860782
16782,dvtkrlbs,1,0.00012,169393,19.67897,860782
16783,dvzubarev,1,0.00012,169394,19.67908,860782
16784,dwctua,1,0.00012,169395,19.67920,860782
16785,dweineha,1,0.00012,169396,19.67931,860782
16786,dwhiteddsoft,1,0.00012,169397,19.67943,860782
16787,dwightbiddle-ef,1,0.00012,169398,19.67955,860782
16788,dwin,1,0.00012,169399,19.67966,860782
16789,dwmarshall,1,0.00012,169400,19.67978,860782
16790,dxlr8r,1,0.00012,169401,19.67990,860782
16791,dylandjian,1,0.00012,169402,19.68001,860782
16792,DylanLovesCoffee,1,0.00012,169403,19.68013,860782
16793,dylanyht,1,0.00012,169404,19.68024,860782
16794,dylmye,1,0.00012,169405,19.68036,860782
16795,dylwylie,1,0.00012,169406,19.68048,860782
16796,dyseo,1,0.00012,169407,19.68059,860782
16797,dyson,1,0.00012,169408,19.68071,860782
16798,dzello,1,0.00012,169409,19.68083,860782
16799,dzintars,1,0.00012,169410,19.68094,860782
16800,dzoellner,1,0.00012,169411,19.68106,860782
16801,dzynr,1,0.00012,169412,19.68117,860782
16802,e10101,1,0.00012,169413,19.68129,860782
16803,eaf-josephportello,1,0.00012,169414,19.68141,860782
16804,eagleboatblue,1,0.00012,169415,19.68152,860782
16805,eaglebush,1,0.00012,169416,19.68164,860782
16806,Eagle-One1,1,0.00012,169417,19.68175,860782
16807,eakurdyukov,1,0.00012,169418,19.68187,860782
16808,ealebed,1,0.00012,169419,19.68199,860782
16809,EAnddd,1,0.00012,169420,19.68210,860782
16810,Earthmark,1,0.00012,169421,19.68222,860782
16811,east4ming,1,0.00012,169422,19.68234,860782
16812,eastlunar,1,0.00012,169423,19.68245,860782
16813,easvera,1,0.00012,169424,19.68257,860782
16814,easyCZ,1,0.00012,169425,19.68268,860782
16815,easyfmxu,1,0.00012,169426,19.68280,860782
16816,ebarriosjr,1,0.00012,169427,19.68292,860782
16817,ebartz,1,0.00012,169428,19.68303,860782
16818,Ebenolt,1,0.00012,169429,19.68315,860782
16819,ebesson,1,0.00012,169430,19.68326,860782
16820,ecagiral,1,0.00012,169431,19.68338,860782
16821,eccles,1,0.00012,169432,19.68350,860782
16822,ecerulm,1,0.00012,169433,19.68361,860782
16823,echerniak,1,0.00012,169434,19.68373,860782
16824,econogit,1,0.00012,169435,19.68385,860782
16825,edavidj,1,0.00012,169436,19.68396,860782
16826,edawine,1,0.00012,169437,19.68408,860782
16827,eddebc,1,0.00012,169438,19.68419,860782
16828,eddmash,1,0.00012,169439,19.68431,860782
16829,eddy-curv,1,0.00012,169440,19.68443,860782
16830,edeNFed,1,0.00012,169441,19.68454,860782
16831,edergillian,1,0.00012,169442,19.68466,860782
16832,edgarcolque,1,0.00012,169443,19.68478,860782
16833,edgarjrg,1,0.00012,169444,19.68489,860782
16834,edidada,1,0.00012,169445,19.68501,860782
16835,edisinovcic,1,0.00012,169446,19.68512,860782
16836,edjohn1987,1,0.00012,169447,19.68524,860782
16837,edperry,1,0.00012,169448,19.68536,860782
16838,edshelton,1,0.00012,169449,19.68547,860782
16839,eduardomourar,1,0.00012,169450,19.68559,860782
16840,eduardoramirez,1,0.00012,169451,19.68570,860782
16841,eduardoroliveira,1,0.00012,169452,19.68582,860782
16842,EduardoVega,1,0.00012,169453,19.68594,860782
16843,Eduard-Voiculescu,1,0.00012,169454,19.68605,860782
16844,edvegas,1,0.00012,169455,19.68617,860782
16845,edw013,1,0.00012,169456,19.68629,860782
16846,edwardflo,1,0.00012,169457,19.68640,860782
16847,edwardmonteiro,1,0.00012,169458,19.68652,860782
16848,edwardmoon,1,0.00012,169459,19.68663,860782
16849,Edwardzcn,1,0.00012,169460,19.68675,860782
16850,edwin,1,0.00012,169461,19.68687,860782
16851,EdwinBetanc0urt,1,0.00012,169462,19.68698,860782
16852,Edwin-Luijten,1,0.00012,169463,19.68710,860782
16853,EdwinRobbins,1,0.00012,169464,19.68721,860782
16854,eeeeeta,1,0.00012,169465,19.68733,860782
16855,Eelis,1,0.00012,169466,19.68745,860782
16856,eest,1,0.00012,169467,19.68756,860782
16857,efistasija,1,0.00012,169468,19.68768,860782
16858,efiturri,1,0.00012,169469,19.68780,860782
16859,eflies,1,0.00012,169470,19.68791,860782
16860,efoxepstein,1,0.00012,169471,19.68803,860782
16861,efrat-lb,1,0.00012,169472,19.68814,860782
16862,efrost123,1,0.00012,169473,19.68826,860782
16863,egc-moldova,1,0.00012,169474,19.68838,860782
16864,egoisz,1,0.00012,169475,19.68849,860782
16865,EhrMike,1,0.00012,169476,19.68861,860782
16866,ehsan-developer,1,0.00012,169477,19.68872,860782
16867,eifelmicha,1,0.00012,169478,19.68884,860782
16868,Eifoen,1,0.00012,169479,19.68896,860782
16869,eihwaz-kob,1,0.00012,169480,19.68907,860782
16870,eino-makitalo,1,0.00012,169481,19.68919,860782
16871,einsone,1,0.00012,169482,19.68931,860782
16872,eisig,1,0.00012,169483,19.68942,860782
16873,ejemba,1,0.00012,169484,19.68954,860782
16874,EJKinger,1,0.00012,169485,19.68965,860782
16875,ekamdz,1,0.00012,169486,19.68977,860782
16876,ekelson-bcove,1,0.00012,169487,19.68989,860782
16877,eklee,1,0.00012,169488,19.69000,860782
16878,ekuusi,1,0.00012,169489,19.69012,860782
16879,eladitzhakian,1,0.00012,169490,19.69024,860782
16880,eladRabinovich,1,0.00012,169491,19.69035,860782
16881,eladtamary,1,0.00012,169492,19.69047,860782
16882,elcomtik,1,0.00012,169493,19.69058,860782
16883,eleni-salamani,1,0.00012,169494,19.69070,860782
16884,eleven26,1,0.00012,169495,19.69082,860782
16885,elftech,1,0.00012,169496,19.69093,860782
16886,eliaoggian,1,0.00012,169497,19.69105,860782
16887,Elias481,1,0.00012,169498,19.69116,860782
16888,eliecharra,1,0.00012,169499,19.69128,860782
16889,elieifrah,1,0.00012,169500,19.69140,860782
16890,elieser1101,1,0.00012,169501,19.69151,860782
16891,eli-halych,1,0.00012,169502,19.69163,860782
16892,EliHarper,1,0.00012,169503,19.69175,860782
16893,Elijen,1,0.00012,169504,19.69186,860782
16894,eliu,1,0.00012,169505,19.69198,860782
16895,eliw00d,1,0.00012,169506,19.69209,860782
16896,elixxx,1,0.00012,169507,19.69221,860782
16897,elkh510,1,0.00012,169508,19.69233,860782
16898,ellenemerson,1,0.00012,169509,19.69244,860782
16899,elliottb303,1,0.00012,169510,19.69256,860782
16900,elliottucker-swrve,1,0.00012,169511,19.69267,860782
16901,elluvium,1,0.00012,169512,19.69279,860782
16902,elmanytas,1,0.00012,169513,19.69291,860782
16903,elmundomusical2,1,0.00012,169514,19.69302,860782
16904,eloo,1,0.00012,169515,19.69314,860782
16905,eloucks,1,0.00012,169516,19.69326,860782
16906,elpablete,1,0.00012,169517,19.69337,860782
16907,elsbrock,1,0.00012,169518,19.69349,860782
16908,ELTEGANI,1,0.00012,169519,19.69360,860782
16909,Elturko22,1,0.00012,169520,19.69372,860782
16910,elucus,1,0.00012,169521,19.69384,860782
16911,ElvinYangGo,1,0.00012,169522,19.69395,860782
16912,emaante,1,0.00012,169523,19.69407,860782
16913,emad7105,1,0.00012,169524,19.69419,860782
16914,EmAlexander,1,0.00012,169525,19.69430,860782
16915,emamulandalib,1,0.00012,169526,19.69442,860782
16916,emansom,1,0.00012,169527,19.69453,860782
16917,emasyakin,1,0.00012,169528,19.69465,860782
16918,EmilFurniga,1,0.00012,169529,19.69477,860782
16919,Emiller88,1,0.00012,169530,19.69488,860782
16920,emillionchandra,1,0.00012,169531,19.69500,860782
16921,emmamartins,1,0.00012,169532,19.69511,860782
16922,EmmEff,1,0.00012,169533,19.69523,860782
16923,emmekappa,1,0.00012,169534,19.69535,860782
16924,Emold,1,0.00012,169535,19.69546,860782
16925,emre141,1,0.00012,169536,19.69558,860782
16926,emreyokur,1,0.00012,169537,19.69570,860782
16927,emyes,1,0.00012,169538,19.69581,860782
16928,encron,1,0.00012,169539,19.69593,860782
16929,endrigoshi,1,0.00012,169540,19.69604,860782
16930,endwall,1,0.00012,169541,19.69616,860782
16931,eneault,1,0.00012,169542,19.69628,860782
16932,EnergySRE,1,0.00012,169543,19.69639,860782
16933,eNettMattD,1,0.00012,169544,19.69651,860782
16934,EngAhmedMahmoud,1,0.00012,169545,19.69662,860782
16935,engelmav,1,0.00012,169546,19.69674,860782
16936,engineerakki,1,0.00012,169547,19.69686,860782
16937,enigmaticmahesh,1,0.00012,169548,19.69697,860782
16938,enkelprifti98,1,0.00012,169549,19.69709,860782
16939,enros73,1,0.00012,169550,19.69721,860782
16940,entasisj,1,0.00012,169551,19.69732,860782
16941,enumag,1,0.00012,169552,19.69744,860782
16942,EnziinSystem,1,0.00012,169553,19.69755,860782
16943,eoneal89,1,0.00012,169554,19.69767,860782
16944,eosfor,1,0.00012,169555,19.69779,860782
16945,epaaso,1,0.00012,169556,19.69790,860782
16946,EPinci,1,0.00012,169557,19.69802,860782
16947,EpiqSty,1,0.00012,169558,19.69813,860782
16948,epkugelmass,1,0.00012,169559,19.69825,860782
16949,eranchetz,1,0.00012,169560,19.69837,860782
16950,erdii,1,0.00012,169561,19.69848,860782
16951,ErezAlster,1,0.00012,169562,19.69860,860782
16952,erezgreenfeld,1,0.00012,169563,19.69872,860782
16953,erhan-,1,0.00012,169564,19.69883,860782
16954,erheron,1,0.00012,169565,19.69895,860782
16955,Eric-918,1,0.00012,169566,19.69906,860782
16956,EricCat,1,0.00012,169567,19.69918,860782
16957,erichiller,1,0.00012,169568,19.69930,860782
16958,ericmason,1,0.00012,169569,19.69941,860782
16959,EricMasonFa,1,0.00012,169570,19.69953,860782
16960,ericrdgz,1,0.00012,169571,19.69965,860782
16961,eric-sellers,1,0.00012,169572,19.69976,860782
16962,EricTendian,1,0.00012,169573,19.69988,860782
16963,eric-uct,1,0.00012,169574,19.69999,860782
16964,ericxiao251,1,0.00012,169575,19.70011,860782
16965,erikbgithub,1,0.00012,169576,19.70023,860782
16966,erikbozic,1,0.00012,169577,19.70034,860782
16967,erikmack,1,0.00012,169578,19.70046,860782
16968,erikrenberg,1,0.00012,169579,19.70057,860782
16969,ErikXu,1,0.00012,169580,19.70069,860782
16970,erkum,1,0.00012,169581,19.70081,860782
16971,ermajn,1,0.00012,169582,19.70092,860782
16972,ernado,1,0.00012,169583,19.70104,860782
16973,ernievd,1,0.00012,169584,19.70116,860782
16974,erolatreston,1,0.00012,169585,19.70127,860782
16975,Eros11on,1,0.00012,169586,19.70139,860782
16976,erpel,1,0.00012,169587,19.70150,860782
16977,error10,1,0.00012,169588,19.70162,860782
16978,erSitzt,1,0.00012,169589,19.70174,860782
16979,erthalion,1,0.00012,169590,19.70185,860782
16980,ErwinGeirnaert,1,0.00012,169591,19.70197,860782
16981,es1o,1,0.00012,169592,19.70208,860782
16982,esalaverria,1,0.00012,169593,19.70220,860782
16983,Esardes,1,0.00012,169594,19.70232,860782
16984,esc-ga,1,0.00012,169595,19.70243,860782
16985,eschrader,1,0.00012,169596,19.70255,860782
16986,escoffier,1,0.00012,169597,19.70267,860782
16987,escortnotice,1,0.00012,169598,19.70278,860782
16988,eserdinyo,1,0.00012,169599,19.70290,860782
16989,eshanks16,1,0.00012,169600,19.70301,860782
16990,eshutov,1,0.00012,169601,19.70313,860782
16991,eslam-cs,1,0.00012,169602,19.70325,860782
16992,esohakh,1,0.00012,169603,19.70336,860782
16993,Eson-Jia,1,0.00012,169604,19.70348,860782
16994,espears1,1,0.00012,169605,19.70360,860782
16995,essskkk,1,0.00012,169606,19.70371,860782
16996,est31,1,0.00012,169607,19.70383,860782
16997,estensen,1,0.00012,169608,19.70394,860782
16998,estimate123,1,0.00012,169609,19.70406,860782
16999,estolfo,1,0.00012,169610,19.70418,860782
17000,EtaySchur,1,0.00012,169611,19.70429,860782
17001,etcshad0vv,1,0.00012,169612,19.70441,860782
17002,Ethan-2017,1,0.00012,169613,19.70452,860782
17003,ethernoy,1,0.00012,169614,19.70464,860782
17004,ethicalaakash,1,0.00012,169615,19.70476,860782
17005,EtnaRyanK,1,0.00012,169616,19.70487,860782
17006,etrikp,1,0.00012,169617,19.70499,860782
17007,etrochim,1,0.00012,169618,19.70511,860782
17008,eugene-burachevskiy,1,0.00012,169619,19.70522,860782
17009,eugeniaguerrero,1,0.00012,169620,19.70534,860782
17010,euphoricrun,1,0.00012,169621,19.70545,860782
17011,Evacch,1,0.00012,169622,19.70557,860782
17012,evalizhangli,1,0.00012,169623,19.70569,860782
17013,EvanCarroll,1,0.00012,169624,19.70580,860782
17014,evandam,1,0.00012,169625,19.70592,860782
17015,evandeng2009,1,0.00012,169626,19.70603,860782
17016,evankicks,1,0.00012,169627,19.70615,860782
17017,evectis,1,0.00012,169628,19.70627,860782
17018,everett-lacey,1,0.00012,169629,19.70638,860782
17019,evertmulder,1,0.00012,169630,19.70650,860782
17020,EvertonSA,1,0.00012,169631,19.70662,860782
17021,EvgeniiR,1,0.00012,169632,19.70673,860782
17022,evgenmedia,1,0.00012,169633,19.70685,860782
17023,evgnomon,1,0.00012,169634,19.70696,860782
17024,evilr00t,1,0.00012,169635,19.70708,860782
17025,evmimagina,1,0.00012,169636,19.70720,860782
17026,evo-arni,1,0.00012,169637,19.70731,860782
17027,evoxmusic,1,0.00012,169638,19.70743,860782
17028,Evreke,1,0.00012,169639,19.70754,860782
17029,ewarwick,1,0.00012,169640,19.70766,860782
17030,ewjmulder,1,0.00012,169641,19.70778,860782
17031,ewolz3,1,0.00012,169642,19.70789,860782
17032,ewtang,1,0.00012,169643,19.70801,860782
17033,ewypych,1,0.00012,169644,19.70813,860782
17034,Exagone313,1,0.00012,169645,19.70824,860782
17035,exequielrafaela,1,0.00012,169646,19.70836,860782
17036,Ext3h,1,0.00012,169647,19.70847,860782
17037,Extant-1,1,0.00012,169648,19.70859,860782
17038,eyablokov,1,0.00012,169649,19.70871,860782
17039,EyalDay,1,0.00012,169650,19.70882,860782
17040,eyalengel-pagaya,1,0.00012,169651,19.70894,860782
17041,eyalleshem,1,0.00012,169652,19.70906,860782
17042,eyanez111,1,0.00012,169653,19.70917,860782
17043,eyanulis,1,0.00012,169654,19.70929,860782
17044,eydayan-dn,1,0.00012,169655,19.70940,860782
17045,ezeike,1,0.00012,169656,19.70952,860782
17046,ezgitek,1,0.00012,169657,19.70964,860782
17047,f0o,1,0.00012,169658,19.70975,860782
17048,fabien-sarcel,1,0.00012,169659,19.70987,860782
17049,fabioabreureis,1,0.00012,169660,19.70998,860782
17050,FabioAntunes,1,0.00012,169661,19.71010,860782
17051,FabioBentoLuiz,1,0.00012,169662,19.71022,860782
17052,fabiodcorreia,1,0.00012,169663,19.71033,860782
17053,fabquenneville,1,0.00012,169664,19.71045,860782
17054,fabricev,1,0.00012,169665,19.71057,860782
17055,fabstao,1,0.00012,169666,19.71068,860782
17056,fadycopty,1,0.00012,169667,19.71080,860782
17057,faern,1,0.00012,169668,19.71091,860782
17058,FaezeAzimi,1,0.00012,169669,19.71103,860782
17059,fahimghl,1,0.00012,169670,19.71115,860782
17060,fahman,1,0.00012,169671,19.71126,860782
17061,failytaler,1,0.00012,169672,19.71138,860782
17062,faith2god,1,0.00012,169673,19.71149,860782
17063,FaizHasan123,1,0.00012,169674,19.71161,860782
17064,fakegermano,1,0.00012,169675,19.71173,860782
17065,FakeJoe,1,0.00012,169676,19.71184,860782
17066,fakiestyle,1,0.00012,169677,19.71196,860782
17067,Falci,1,0.00012,169678,19.71208,860782
17068,falconindy,1,0.00012,169679,19.71219,860782
17069,fallard84,1,0.00012,169680,19.71231,860782
17070,fan41,1,0.00012,169681,19.71242,860782
17071,fancyerii,1,0.00012,169682,19.71254,860782
17072,FancyXun,1,0.00012,169683,19.71266,860782
17073,fandu139,1,0.00012,169684,19.71277,860782
17074,FanFansfan,1,0.00012,169685,19.71289,860782
17075,FANMixco,1,0.00012,169686,19.71301,860782
17076,fanqingxiang1122,1,0.00012,169687,19.71312,860782
17077,fantasy4z,1,0.00012,169688,19.71324,860782
17078,fanyl3,1,0.00012,169689,19.71335,860782
17079,fanyonghua19,1,0.00012,169690,19.71347,860782
17080,fanzhihai0215,1,0.00012,169691,19.71359,860782
17081,fara-nak,1,0.00012,169692,19.71370,860782
17082,farant,1,0.00012,169693,19.71382,860782
17083,farhank3389,1,0.00012,169694,19.71393,860782
17084,faris789,1,0.00012,169695,19.71405,860782
17085,farons,1,0.00012,169696,19.71417,860782
17086,Farouk19,1,0.00012,169697,19.71428,860782
17087,FatWrinkleZ,1,0.00012,169698,19.71440,860782
17088,FaustmannChr,1,0.00012,169699,19.71452,860782
17089,faxioman,1,0.00012,169700,19.71463,860782
17090,fbaier-fn,1,0.00012,169701,19.71475,860782
17091,fbalicchia,1,0.00012,169702,19.71486,860782
17092,fbattistella,1,0.00012,169703,19.71498,860782
17093,fbeauche,1,0.00012,169704,19.71510,860782
17094,fboranek,1,0.00012,169705,19.71521,860782
17095,fckbo,1,0.00012,169706,19.71533,860782
17096,fclerg,1,0.00012,169707,19.71544,860782
17097,fdbatista,1,0.00012,169708,19.71556,860782
17098,fdcgr,1,0.00012,169709,19.71568,860782
17099,FeaturedSpace,1,0.00012,169710,19.71579,860782
17100,Feder1co5oave,1,0.00012,169711,19.71591,860782
17101,federico-s,1,0.00012,169712,19.71603,860782
17102,Feeeenng,1,0.00012,169713,19.71614,860782
17103,fehergeri13,1,0.00012,169714,19.71626,860782
17104,feifeixiyu,1,0.00012,169715,19.71637,860782
17105,feilengcui008,1,0.00012,169716,19.71649,860782
17106,felipecassiors,1,0.00012,169717,19.71661,860782
17107,felipellrocha,1,0.00012,169718,19.71672,860782
17108,FelipeMiranda,1,0.00012,169719,19.71684,860782
17109,felipeschossler,1,0.00012,169720,19.71696,860782
17110,felix0080,1,0.00012,169721,19.71707,860782
17111,felix33333,1,0.00012,169722,19.71719,860782
17112,felixle236,1,0.00012,169723,19.71730,860782
17113,fellyns,1,0.00012,169724,19.71742,860782
17114,fengshaoxie,1,0.00012,169725,19.71754,860782
17115,fengyehong,1,0.00012,169726,19.71765,860782
17116,Feng-Yin,1,0.00012,169727,19.71777,860782
17117,fennellgb23,1,0.00012,169728,19.71788,860782
17118,ferenc0521,1,0.00012,169729,19.71800,860782
17119,fergusontom,1,0.00012,169730,19.71812,860782
17120,ferrandpaul,1,0.00012,169731,19.71823,860782
17121,Ferroman,1,0.00012,169732,19.71835,860782
17122,ferronsw,1,0.00012,169733,19.71847,860782
17123,fetzerch,1,0.00012,169734,19.71858,860782
17124,fezho,1,0.00012,169735,19.71870,860782
17125,Ffavicon,1,0.00012,169736,19.71881,860782
17126,ffjia,1,0.00012,169737,19.71893,860782
17127,fforloff,1,0.00012,169738,19.71905,860782
17128,fgsl,1,0.00012,169739,19.71916,860782
17129,fhaase2,1,0.00012,169740,19.71928,860782
17130,fhai,1,0.00012,169741,19.71939,860782
17131,fhopfensperger,1,0.00012,169742,19.71951,860782
17132,fidgi,1,0.00012,169743,19.71963,860782
17133,fifman,1,0.00012,169744,19.71974,860782
17134,fiibbb,1,0.00012,169745,19.71986,860782
17135,fillbit,1,0.00012,169746,19.71998,860782
17136,fimbulvetr,1,0.00012,169747,19.72009,860782
17137,fingolfi,1,0.00012,169748,19.72021,860782
17138,finnhvman,1,0.00012,169749,19.72032,860782
17139,finnje,1,0.00012,169750,19.72044,860782
17140,fire,1,0.00012,169751,19.72056,860782
17141,firefoxNX,1,0.00012,169752,19.72067,860782
17142,Firescar96,1,0.00012,169753,19.72079,860782
17143,firmboy,1,0.00012,169754,19.72090,860782
17144,fisher,1,0.00012,169755,19.72102,860782
17145,fishhead2zju,1,0.00012,169756,19.72114,860782
17146,Fitz7,1,0.00012,169757,19.72125,860782
17147,fjallot,1,0.00012,169758,19.72137,860782
17148,fjammes,1,0.00012,169759,19.72149,860782
17149,fjbreeze,1,0.00012,169760,19.72160,860782
17150,fkklx,1,0.00012,169761,19.72172,860782
17151,fkoehler,1,0.00012,169762,19.72183,860782
17152,Flamingo09,1,0.00012,169763,19.72195,860782
17153,flanets,1,0.00012,169764,19.72207,860782
17154,flavienbwk,1,0.00012,169765,19.72218,860782
17155,fleurer,1,0.00012,169766,19.72230,860782
17156,flexera-cnixon,1,0.00012,169767,19.72242,860782
17157,flo-02-mu,1,0.00012,169768,19.72253,860782
17158,floatliang,1,0.00012,169769,19.72265,860782
17159,Floeig,1,0.00012,169770,19.72276,860782
17160,FloLaco,1,0.00012,169771,19.72288,860782
17161,FlomoN,1,0.00012,169772,19.72300,860782
17162,florent-tails,1,0.00012,169773,19.72311,860782
17163,floriankammermann,1,0.00012,169774,19.72323,860782
17164,flourme,1,0.00012,169775,19.72334,860782
17165,fluo6,1,0.00012,169776,19.72346,860782
17166,flutt13,1,0.00012,169777,19.72358,860782
17167,Flux99,1,0.00012,169778,19.72369,860782
17168,flyanna,1,0.00012,169779,19.72381,860782
17169,flyerge,1,0.00012,169780,19.72393,860782
17170,flyinbutrs,1,0.00012,169781,19.72404,860782
17171,fmvilas,1,0.00012,169782,19.72416,860782
17172,fnp927,1,0.00012,169783,19.72427,860782
17173,foosinn,1,0.00012,169784,19.72439,860782
17174,foo-source,1,0.00012,169785,19.72451,860782
17175,fooSynaptic,1,0.00012,169786,19.72462,860782
17176,forbxy,1,0.00012,169787,19.72474,860782
17177,forestm,1,0.00012,169788,19.72485,860782
17178,forestsword,1,0.00012,169789,19.72497,860782
17179,foreverchaos,1,0.00012,169790,19.72509,860782
17180,forfin,1,0.00012,169791,19.72520,860782
17181,forgems,1,0.00012,169792,19.72532,860782
17182,forgo,1,0.00012,169793,19.72544,860782
17183,formanojhr,1,0.00012,169794,19.72555,860782
17184,for-mysql,1,0.00012,169795,19.72567,860782
17185,forsunwell,1,0.00012,169796,19.72578,860782
17186,fortek-123,1,0.00012,169797,19.72590,860782
17187,forumsheth,1,0.00012,169798,19.72602,860782
17188,fotex,1,0.00012,169799,19.72613,860782
17189,fowlmouth,1,0.00012,169800,19.72625,860782
17190,fox91,1,0.00012,169801,19.72637,860782
17191,foxel,1,0.00012,169802,19.72648,860782
17192,fr3fou,1,0.00012,169803,19.72660,860782
17193,fraczak,1,0.00012,169804,19.72671,860782
17194,fragfutter,1,0.00012,169805,19.72683,860782
17195,framegrace,1,0.00012,169806,19.72695,860782
17196,framled,1,0.00012,169807,19.72706,860782
17197,francesconi,1,0.00012,169808,19.72718,860782
17198,francis-du,1,0.00012,169809,19.72729,860782
17199,francisfsjiang,1,0.00012,169810,19.72741,860782
17200,franckleveque,1,0.00012,169811,19.72753,860782
17201,FrancoisZhang,1,0.00012,169812,19.72764,860782
17202,frankang,1,0.00012,169813,19.72776,860782
17203,frank-carnovale,1,0.00012,169814,19.72788,860782
17204,frankcgq105,1,0.00012,169815,19.72799,860782
17205,FrankGiesecke,1,0.00012,169816,19.72811,860782
17206,Frankiechan,1,0.00012,169817,19.72822,860782
17207,FrankLee33,1,0.00012,169818,19.72834,860782
17208,franklin216,1,0.00012,169819,19.72846,860782
17209,franklymrshankley,1,0.00012,169820,19.72857,860782
17210,franpog859,1,0.00012,169821,19.72869,860782
17211,fransguelinckx,1,0.00012,169822,19.72880,860782
17212,franviera92,1,0.00012,169823,19.72892,860782
17213,franzmueller,1,0.00012,169824,19.72904,860782
17214,frayer,1,0.00012,169825,19.72915,860782
17215,freak82,1,0.00012,169826,19.72927,860782
17216,fred01,1,0.00012,169827,19.72939,860782
17217,fred214,1,0.00012,169828,19.72950,860782
17218,fredalxin,1,0.00012,169829,19.72962,860782
17219,freddGO,1,0.00012,169830,19.72973,860782
17220,FredericLeroy,1,0.00012,169831,19.72985,860782
17221,fredericrous,1,0.00012,169832,19.72997,860782
17222,frederiksf,1,0.00012,169833,19.73008,860782
17223,fredhaug,1,0.00012,169834,19.73020,860782
17224,frediethomas,1,0.00012,169835,19.73031,860782
17225,FredM,1,0.00012,169836,19.73043,860782
17226,FredOliveiraSantos,1,0.00012,169837,19.73055,860782
17227,freeben09,1,0.00012,169838,19.73066,860782
17228,freelancerlucas,1,0.00012,169839,19.73078,860782
17229,freesaber,1,0.00012,169840,19.73090,860782
17230,freesia-fy,1,0.00012,169841,19.73101,860782
17231,fregdee,1,0.00012,169842,19.73113,860782
17232,freym,1,0.00012,169843,19.73124,860782
17233,fribourgpierre,1,0.00012,169844,19.73136,860782
17234,frizzr,1,0.00012,169845,19.73148,860782
17235,froismo,1,0.00012,169846,19.73159,860782
17236,FrostBytesf,1,0.00012,169847,19.73171,860782
17237,frostebite,1,0.00012,169848,19.73183,860782
17238,frostmar,1,0.00012,169849,19.73194,860782
17239,FrugalGuy,1,0.00012,169850,19.73206,860782
17240,f-ruta,1,0.00012,169851,19.73217,860782
17241,fsadykov,1,0.00012,169852,19.73229,860782
17242,fsilletti,1,0.00012,169853,19.73241,860782
17243,fsimmend,1,0.00012,169854,19.73252,860782
17244,ftcreator,1,0.00012,169855,19.73264,860782
17245,fubar,1,0.00012,169856,19.73275,860782
17246,fuemoshi,1,0.00012,169857,19.73287,860782
17247,fuerzastudio,1,0.00012,169858,19.73299,860782
17248,fullkomnun,1,0.00012,169859,19.73310,860782
17249,full-stack-pirates,1,0.00012,169860,19.73322,860782
17250,funding-invoice-admin,1,0.00012,169861,19.73334,860782
17251,fungusakafungus,1,0.00012,169862,19.73345,860782
17252,funkeyfreak,1,0.00012,169863,19.73357,860782
17253,Funnelll,1,0.00012,169864,19.73368,860782
17254,FunWithCode-hub,1,0.00012,169865,19.73380,860782
17255,funzie19,1,0.00012,169866,19.73392,860782
17256,Furragen,1,0.00012,169867,19.73403,860782
17257,FusionX-AWS-POC,1,0.00012,169868,19.73415,860782
17258,futaii,1,0.00012,169869,19.73426,860782
17259,futare,1,0.00012,169870,19.73438,860782
17260,future-cyborg,1,0.00012,169871,19.73450,860782
17261,Futurefangyuan,1,0.00012,169872,19.73461,860782
17262,futurekill,1,0.00012,169873,19.73473,860782
17263,fvillain,1,0.00012,169874,19.73485,860782
17264,fweep,1,0.00012,169875,19.73496,860782
17265,fwerner,1,0.00012,169876,19.73508,860782
17266,FWiesner,1,0.00012,169877,19.73519,860782
17267,fxkr,1,0.00012,169878,19.73531,860782
17268,fxl0206,1,0.00012,169879,19.73543,860782
17269,fyatzeck,1,0.00012,169880,19.73554,860782
17270,fyery-chen,1,0.00012,169881,19.73566,860782
17271,Fyko,1,0.00012,169882,19.73578,860782
17272,g00nix,1,0.00012,169883,19.73589,860782
17273,g10f,1,0.00012,169884,19.73601,860782
17274,g3kr,1,0.00012,169885,19.73612,860782
17275,gabidrg,1,0.00012,169886,19.73624,860782
17276,gabortpubs,1,0.00012,169887,19.73636,860782
17277,gabricar,1,0.00012,169888,19.73647,860782
17278,gabrielamartinezatwizeline,1,0.00012,169889,19.73659,860782
17279,gabrielbahniuk,1,0.00012,169890,19.73670,860782
17280,gabrielgrant,1,0.00012,169891,19.73682,860782
17281,gabroo,1,0.00012,169892,19.73694,860782
17282,gacalheiros,1,0.00012,169893,19.73705,860782
17283,gaddamas,1,0.00012,169894,19.73717,860782
17284,gae123,1,0.00012,169895,19.73729,860782
17285,gaetanars,1,0.00012,169896,19.73740,860782
17286,Gaff,1,0.00012,169897,19.73752,860782
17287,GagandeepGupta,1,0.00012,169898,19.73763,860782
17288,gaghan430,1,0.00012,169899,19.73775,860782
17289,gaizeror,1,0.00012,169900,19.73787,860782
17290,gajanankulkarni09,1,0.00012,169901,19.73798,860782
17291,gajdot,1,0.00012,169902,19.73810,860782
17292,galakt,1,0.00012,169903,19.73821,860782
17293,galen211,1,0.00012,169904,19.73833,860782
17294,Gal-Haimov,1,0.00012,169905,19.73845,860782
17295,galicantensoft,1,0.00012,169906,19.73856,860782
17296,Galileo1,1,0.00012,169907,19.73868,860782
17297,galindus,1,0.00012,169908,19.73880,860782
17298,galo,1,0.00012,169909,19.73891,860782
17299,gamefundas,1,0.00012,169910,19.73903,860782
17300,gameiro83,1,0.00012,169911,19.73914,860782
17301,gamelife1314,1,0.00012,169912,19.73926,860782
17302,gamer22026,1,0.00012,169913,19.73938,860782
17303,gamggi,1,0.00012,169914,19.73949,860782
17304,ganadara135,1,0.00012,169915,19.73961,860782
17305,gandhirajan,1,0.00012,169916,19.73973,860782
17306,ganeshgowtham,1,0.00012,169917,19.73984,860782
17307,ganesh-k13,1,0.00012,169918,19.73996,860782
17308,ganeshs4,1,0.00012,169919,19.74007,860782
17309,GangaramD,1,0.00012,169920,19.74019,860782
17310,gangavarapusatwik,1,0.00012,169921,19.74031,860782
17311,ganpatagarwal,1,0.00012,169922,19.74042,860782
17312,ganto,1,0.00012,169923,19.74054,860782
17313,gaoshuai2020,1,0.00012,169924,19.74065,860782
17314,GarageDeveloper,1,0.00012,169925,19.74077,860782
17315,garaghav,1,0.00012,169926,19.74089,860782
17316,garbageslam,1,0.00012,169927,19.74100,860782
17317,garciaolais,1,0.00012,169928,19.74112,860782
17318,garethmorris78,1,0.00012,169929,19.74124,860782
17319,gargabhay1999,1,0.00012,169930,19.74135,860782
17320,garimakemwal,1,0.00012,169931,19.74147,860782
17321,garloff,1,0.00012,169932,19.74158,860782
17322,garmes-gdev,1,0.00012,169933,19.74170,860782
17323,garrett,1,0.00012,169934,19.74182,860782
17324,GaruGaru,1,0.00012,169935,19.74193,860782
17325,garvincasimir,1,0.00012,169936,19.74205,860782
17326,gary0121,1,0.00012,169937,19.74216,860782
17327,garyarobinson-uleska,1,0.00012,169938,19.74228,860782
17328,garybaines,1,0.00012,169939,19.74240,860782
17329,GaryBissland,1,0.00012,169940,19.74251,860782
17330,garyedwards,1,0.00012,169941,19.74263,860782
17331,garzdin,1,0.00012,169942,19.74275,860782
17332,gasxia,1,0.00012,169943,19.74286,860782
17333,gatici,1,0.00012,169944,19.74298,860782
17334,gaurav16694,1,0.00012,169945,19.74309,860782
17335,Gaurav7296,1,0.00012,169946,19.74321,860782
17336,GauravAsthana1,1,0.00012,169947,19.74333,860782
17337,gauravkhare,1,0.00012,169948,19.74344,860782
17338,gauravkohli,1,0.00012,169949,19.74356,860782
17339,gauravpatel2016,1,0.00012,169950,19.74367,860782
17340,Gautami007,1,0.00012,169951,19.74379,860782
17341,gavincabbage,1,0.00012,169952,19.74391,860782
17342,gavin-db,1,0.00012,169953,19.74402,860782
17343,gavinyue,1,0.00012,169954,19.74414,860782
17344,gavrilfb,1,0.00012,169955,19.74426,860782
17345,gawarz,1,0.00012,169956,19.74437,860782
17346,gayatri-sa,1,0.00012,169957,19.74449,860782
17347,gbamqzkdyg,1,0.00012,169958,19.74460,860782
17348,gbintz,1,0.00012,169959,19.74472,860782
17349,g-braeunlich,1,0.00012,169960,19.74484,860782
17350,gcapizzi,1,0.00012,169961,19.74495,860782
17351,gcoombe,1,0.00012,169962,19.74507,860782
17352,gdesio75,1,0.00012,169963,19.74519,860782
17353,gdhuper,1,0.00012,169964,19.74530,860782
17354,gdimitropoulos,1,0.00012,169965,19.74542,860782
17355,gdtiti,1,0.00012,169966,19.74553,860782
17356,gdurandvadas,1,0.00012,169967,19.74565,860782
17357,geceba,1,0.00012,169968,19.74577,860782
17358,geekbleek,1,0.00012,169969,19.74588,860782
17359,geetrawat,1,0.00012,169970,19.74600,860782
17360,GeirGrusom,1,0.00012,169971,19.74611,860782
17361,GElkayam,1,0.00012,169972,19.74623,860782
17362,Gemakk,1,0.00012,169973,19.74635,860782
17363,geneliu,1,0.00012,169974,19.74646,860782
17364,generals-space,1,0.00012,169975,19.74658,860782
17365,genericgithubuser,1,0.00012,169976,19.74670,860782
17366,genialmaniac,1,0.00012,169977,19.74681,860782
17367,gentoox,1,0.00012,169978,19.74693,860782
17368,geoberle,1,0.00012,169979,19.74704,860782
17369,geoffcline,1,0.00012,169980,19.74716,860782
17370,geoffjukes,1,0.00012,169981,19.74728,860782
17371,GeoffMahugu,1,0.00012,169982,19.74739,860782
17372,georgebrianb,1,0.00012,169983,19.74751,860782
17373,georgeclaghorn,1,0.00012,169984,19.74762,860782
17374,GeorgeGedox,1,0.00012,169985,19.74774,860782
17375,georgelee1,1,0.00012,169986,19.74786,860782
17376,george-miller,1,0.00012,169987,19.74797,860782
17377,georgepaoli,1,0.00012,169988,19.74809,860782
17378,GeorgeSen,1,0.00012,169989,19.74821,860782
17379,georgesvachulay,1,0.00012,169990,19.74832,860782
17380,GeorgeTsagk,1,0.00012,169991,19.74844,860782
17381,georgifarashev,1,0.00012,169992,19.74855,860782
17382,geosmart,1,0.00012,169993,19.74867,860782
17383,geotransformer,1,0.00012,169994,19.74879,860782
17384,gerardba,1,0.00012,169995,19.74890,860782
17385,gerasym,1,0.00012,169996,19.74902,860782
17386,gerhard,1,0.00012,169997,19.74914,860782
17387,germaino,1,0.00012,169998,19.74925,860782
17388,Gerromie,1,0.00012,169999,19.74937,860782
17389,gerrywastaken,1,0.00012,170000,19.74948,860782
17390,gersonmdesouza,1,0.00012,170001,19.74960,860782
17391,gertd,1,0.00012,170002,19.74972,860782
17392,GertjanBijl,1,0.00012,170003,19.74983,860782
17393,GetchaDEAGLE,1,0.00012,170004,19.74995,860782
17394,geun,1,0.00012,170005,19.75006,860782
17395,gevorg15,1,0.00012,170006,19.75018,860782
17396,Gfeuillen,1,0.00012,170007,19.75030,860782
17397,gfrntz,1,0.00012,170008,19.75041,860782
17398,ggavrilov,1,0.00012,170009,19.75053,860782
17399,gggeek,1,0.00012,170010,19.75065,860782
17400,gggin,1,0.00012,170011,19.75076,860782
17401,ggilley,1,0.00012,170012,19.75088,860782
17402,ggmaresca,1,0.00012,170013,19.75099,860782
17403,ghahramani,1,0.00012,170014,19.75111,860782
17404,ghareesh,1,0.00012,170015,19.75123,860782
17405,ghasemikasra39,1,0.00012,170016,19.75134,860782
17406,ghb-1234,1,0.00012,170017,19.75146,860782
17407,GH-Djeff,1,0.00012,170018,19.75157,860782
17408,ghorpade84,1,0.00012,170019,19.75169,860782
17409,ghostcodersmn,1,0.00012,170020,19.75181,860782
17410,Ghosted-droid,1,0.00012,170021,19.75192,860782
17411,GiancarloRegis,1,0.00012,170022,19.75204,860782
17412,gieldb,1,0.00012,170023,19.75216,860782
17413,giftDad,1,0.00012,170024,19.75227,860782
17414,gigglegrig,1,0.00012,170025,19.75239,860782
17415,Gikkman,1,0.00012,170026,19.75250,860782
17416,gilbahat,1,0.00012,170027,19.75262,860782
17417,gillbee,1,0.00012,170028,19.75274,860782
17418,gilrodar,1,0.00012,170029,19.75285,860782
17419,giltayar,1,0.00012,170030,19.75297,860782
17420,gimenesandril84,1,0.00012,170031,19.75308,860782
17421,gimmely,1,0.00012,170032,19.75320,860782
17422,gioamato,1,0.00012,170033,19.75332,860782
17423,giordyb,1,0.00012,170034,19.75343,860782
17424,giotab,1,0.00012,170035,19.75355,860782
17425,giovannirco,1,0.00012,170036,19.75367,860782
17426,giowe,1,0.00012,170037,19.75378,860782
17427,girirajthara,1,0.00012,170038,19.75390,860782
17428,git-hemant,1,0.00012,170039,19.75401,860782
17429,github4es,1,0.00012,170040,19.75413,860782
17430,GitHubxsy,1,0.00012,170041,19.75425,860782
17431,gitizenme,1,0.00012,170042,19.75436,860782
17432,git-josip,1,0.00012,170043,19.75448,860782
17433,git-pchauhan,1,0.00012,170044,19.75460,860782
17434,gitqlt,1,0.00012,170045,19.75471,860782
17435,gitsto,1,0.00012,170046,19.75483,860782
17436,gittygoo,1,0.00012,170047,19.75494,860782
17437,gitvenkatibm,1,0.00012,170048,19.75506,860782
17438,gitwithsean,1,0.00012,170049,19.75518,860782
17439,giulianob,1,0.00012,170050,19.75529,860782
17440,giuscri,1,0.00012,170051,19.75541,860782
17441,gizero,1,0.00012,170052,19.75552,860782
17442,gjergjk71,1,0.00012,170053,19.75564,860782
17443,gjermystreeva,1,0.00012,170054,19.75576,860782
17444,gjf20,1,0.00012,170055,19.75587,860782
17445,gjiuyi,1,0.00012,170056,19.75599,860782
17446,gkiran292,1,0.00012,170057,19.75611,860782
17447,GladiusK,1,0.00012,170058,19.75622,860782
17448,gladmo,1,0.00012,170059,19.75634,860782
17449,glafir,1,0.00012,170060,19.75645,860782
17450,glarwood,1,0.00012,170061,19.75657,860782
17451,glasswalk3r,1,0.00012,170062,19.75669,860782
17452,glavoie,1,0.00012,170063,19.75680,860782
17453,glebarez,1,0.00012,170064,19.75692,860782
17454,glebovmaksim,1,0.00012,170065,19.75703,860782
17455,glenjamin,1,0.00012,170066,19.75715,860782
17456,glennpratt,1,0.00012,170067,19.75727,860782
17457,glenraynor,1,0.00012,170068,19.75738,860782
17458,glesperance,1,0.00012,170069,19.75750,860782
17459,glindsell,1,0.00012,170070,19.75762,860782
17460,glindstedt,1,0.00012,170071,19.75773,860782
17461,glupo,1,0.00012,170072,19.75785,860782
17462,gmale,1,0.00012,170073,19.75796,860782
17463,gmarco,1,0.00012,170074,19.75808,860782
17464,gmarkley-VI,1,0.00012,170075,19.75820,860782
17465,gmatev,1,0.00012,170076,19.75831,860782
17466,gmcruz,1,0.00012,170077,19.75843,860782
17467,gmd20,1,0.00012,170078,19.75855,860782
17468,gmesserman,1,0.00012,170079,19.75866,860782
17469,gmherb,1,0.00012,170080,19.75878,860782
17470,gmi7x,1,0.00012,170081,19.75889,860782
17471,gmishkin,1,0.00012,170082,19.75901,860782
17472,gmorse-gd,1,0.00012,170083,19.75913,860782
17473,gmpetrov,1,0.00012,170084,19.75924,860782
17474,gmspinheiro,1,0.00012,170085,19.75936,860782
17475,gnanderson,1,0.00012,170086,19.75947,860782
17476,gnarled-cipher,1,0.00012,170087,19.75959,860782
17477,gncchand,1,0.00012,170088,19.75971,860782
17478,gnieto,1,0.00012,170089,19.75982,860782
17479,gnoyuy,1,0.00012,170090,19.75994,860782
17480,gnurik,1,0.00012,170091,19.76006,860782
17481,gnydick,1,0.00012,170092,19.76017,860782
17482,goal86sg,1,0.00012,170093,19.76029,860782
17483,goddini91,1,0.00012,170094,19.76040,860782
17484,GodHaoNB,1,0.00012,170095,19.76052,860782
17485,godocean,1,0.00012,170096,19.76064,860782
17486,Godtide,1,0.00012,170097,19.76075,860782
17487,goebi,1,0.00012,170098,19.76087,860782
17488,Goend,1,0.00012,170099,19.76098,860782
17489,gogineni99,1,0.00012,170100,19.76110,860782
17490,gogrisohil,1,0.00012,170101,19.76122,860782
17491,gojoy,1,0.00012,170102,19.76133,860782
17492,gojud,1,0.00012,170103,19.76145,860782
17493,GokcerBelgusen,1,0.00012,170104,19.76157,860782
17494,gokcesurenkok,1,0.00012,170105,19.76168,860782
17495,gokhandincer,1,0.00012,170106,19.76180,860782
17496,goku321,1,0.00012,170107,19.76191,860782
17497,gokulsood,1,0.00012,170108,19.76203,860782
17498,goldengit,1,0.00012,170109,19.76215,860782
17499,Goldenstarc,1,0.00012,170110,19.76226,860782
17500,goldfish-fish,1,0.00012,170111,19.76238,860782
17501,golimer,1,0.00012,170112,19.76250,860782
17502,golx,1,0.00012,170113,19.76261,860782
17503,gondaz,1,0.00012,170114,19.76273,860782
17504,GoNextGroup,1,0.00012,170115,19.76284,860782
17505,gonzabt3,1,0.00012,170116,19.76296,860782
17506,goober,1,0.00012,170117,19.76308,860782
17507,goodskillprogramer,1,0.00012,170118,19.76319,860782
17508,goolzerg,1,0.00012,170119,19.76331,860782
17509,goooogs,1,0.00012,170120,19.76342,860782
17510,gopalakrishna-ch,1,0.00012,170121,19.76354,860782
17511,gopiextrahop,1,0.00012,170122,19.76366,860782
17512,Gopilagadapati,1,0.00012,170123,19.76377,860782
17513,gopinatht,1,0.00012,170124,19.76389,860782
17514,gopisaba,1,0.00012,170125,19.76401,860782
17515,gor181,1,0.00012,170126,19.76412,860782
17516,goran-rumin,1,0.00012,170127,19.76424,860782
17517,gordalina,1,0.00012,170128,19.76435,860782
17518,GordinMaxim,1,0.00012,170129,19.76447,860782
17519,Gordonby,1,0.00012,170130,19.76459,860782
17520,gordonlukch,1,0.00012,170131,19.76470,860782
17521,gordon-rennie,1,0.00012,170132,19.76482,860782
17522,gorishagh,1,0.00012,170133,19.76493,860782
17523,gorkemozlu,1,0.00012,170134,19.76505,860782
17524,GOrtiz07,1,0.00012,170135,19.76517,860782
17525,go-udy,1,0.00012,170136,19.76528,860782
17526,goushuai,1,0.00012,170137,19.76540,860782
17527,gouterelo,1,0.00012,170138,19.76552,860782
17528,govindkailas,1,0.00012,170139,19.76563,860782
17529,gowxw,1,0.00012,170140,19.76575,860782
17530,goyertp,1,0.00012,170141,19.76586,860782
17531,g-pavlov,1,0.00012,170142,19.76598,860782
17532,gpolicante,1,0.00012,170143,19.76610,860782
17533,gpontesss,1,0.00012,170144,19.76621,860782
17534,gpra,1,0.00012,170145,19.76633,860782
17535,gprakriya,1,0.00012,170146,19.76644,860782
17536,gprossliner,1,0.00012,170147,19.76656,860782
17537,gq17,1,0.00012,170148,19.76668,860782
17538,GRACE4LOVE,1,0.00012,170149,19.76679,860782
17539,GRACEFATIMA1,1,0.00012,170150,19.76691,860782
17540,GrahamCampbell,1,0.00012,170151,19.76703,860782
17541,grahamjenson,1,0.00012,170152,19.76714,860782
17542,grahampfau,1,0.00012,170153,19.76726,860782
17543,graillus,1,0.00012,170154,19.76737,860782
17544,grantbeattie,1,0.00012,170155,19.76749,860782
17545,grant-zietsman,1,0.00012,170156,19.76761,860782
17546,gravcat,1,0.00012,170157,19.76772,860782
17547,gravis,1,0.00012,170158,19.76784,860782
17548,grazius,1,0.00012,170159,19.76796,860782
17549,GreatThan365,1,0.00012,170160,19.76807,860782
17550,gred7,1,0.00012,170161,19.76819,860782
17551,GreenhazelStudio,1,0.00012,170162,19.76830,860782
17552,greenkiwi,1,0.00012,170163,19.76842,860782
17553,greensky00,1,0.00012,170164,19.76854,860782
17554,gregbarkerdcsg,1,0.00012,170165,19.76865,860782
17555,gregfajen,1,0.00012,170166,19.76877,860782
17556,greglanthier,1,0.00012,170167,19.76888,860782
17557,gregleb,1,0.00012,170168,19.76900,860782
17558,gregnebu,1,0.00012,170169,19.76912,860782
17559,GregoryVds,1,0.00012,170170,19.76923,860782
17560,gregov,1,0.00012,170171,19.76935,860782
17561,GregOwen,1,0.00012,170172,19.76947,860782
17562,gregswift,1,0.00012,170173,19.76958,860782
17563,greyman-hh,1,0.00012,170174,19.76970,860782
17564,greysteil,1,0.00012,170175,19.76981,860782
17565,greywolve,1,0.00012,170176,19.76993,860782
17566,griffin,1,0.00012,170177,19.77005,860782
17567,griffincollege,1,0.00012,170178,19.77016,860782
17568,grimmmyshini,1,0.00012,170179,19.77028,860782
17569,grmhay,1,0.00012,170180,19.77039,860782
17570,gronono,1,0.00012,170181,19.77051,860782
17571,GrooveCS,1,0.00012,170182,19.77063,860782
17572,groundnuty,1,0.00012,170183,19.77074,860782
17573,Grounz,1,0.00012,170184,19.77086,860782
17574,growitbr,1,0.00012,170185,19.77098,860782
17575,grubbins,1,0.00012,170186,19.77109,860782
17576,GRuuuuu,1,0.00012,170187,19.77121,860782
17577,grzegorz-mirek,1,0.00012,170188,19.77132,860782
17578,gsalamin,1,0.00012,170189,19.77144,860782
17579,gscott187,1,0.00012,170190,19.77156,860782
17580,gseshagirirao,1,0.00012,170191,19.77167,860782
17581,gsmeets,1,0.00012,170192,19.77179,860782
17582,gsolomin,1,0.00012,170193,19.77191,860782
17583,GT16,1,0.00012,170194,19.77202,860782
17584,gtskaushik,1,0.00012,170195,19.77214,860782
17585,gu111gu,1,0.00012,170196,19.77225,860782
17586,guanwei,1,0.00012,170197,19.77237,860782
17587,guaxinim,1,0.00012,170198,19.77249,860782
17588,guesslin,1,0.00012,170199,19.77260,860782
17589,guidtz,1,0.00012,170200,19.77272,860782
17590,guihao-liang,1,0.00012,170201,19.77283,860782
17591,guilaps82,1,0.00012,170202,19.77295,860782
17592,guillaumedossantos,1,0.00012,170203,19.77307,860782
17593,GuillaumeMiralles,1,0.00012,170204,19.77318,860782
17594,gulshan1040,1,0.00012,170205,19.77330,860782
17595,guneemwelloeux,1,0.00012,170206,19.77342,860782
17596,gunturaf,1,0.00012,170207,19.77353,860782
17597,Guohao1020,1,0.00012,170208,19.77365,860782
17598,guoyiang,1,0.00012,170209,19.77376,860782
17599,Guoyoyo,1,0.00012,170210,19.77388,860782
17600,gupta-alok,1,0.00012,170211,19.77400,860782
17601,gupta-lakshay,1,0.00012,170212,19.77411,860782
17602,guptapranjal9587,1,0.00012,170213,19.77423,860782
17603,gureedo,1,0.00012,170214,19.77434,860782
17604,GureevLeonid,1,0.00012,170215,19.77446,860782
17605,gurukashyap,1,0.00012,170216,19.77458,860782
17606,guruprasadgvmf,1,0.00012,170217,19.77469,860782
17607,Guruveer,1,0.00012,170218,19.77481,860782
17608,gutta-percha,1,0.00012,170219,19.77493,860782
17609,guyarb,1,0.00012,170220,19.77504,860782
17610,GuyCarmy,1,0.00012,170221,19.77516,860782
17611,guyelia,1,0.00012,170222,19.77527,860782
17612,guyguy333,1,0.00012,170223,19.77539,860782
17613,guylabs,1,0.00012,170224,19.77551,860782
17614,guylain,1,0.00012,170225,19.77562,860782
17615,GuyPaddock,1,0.00012,170226,19.77574,860782
17616,guyrotem,1,0.00012,170227,19.77585,860782
17617,gwohletz,1,0.00012,170228,19.77597,860782
17618,gxglls,1,0.00012,170229,19.77609,860782
17619,gxm651182644,1,0.00012,170230,19.77620,860782
17620,gyakovlev,1,0.00012,170231,19.77632,860782
17621,gyalowitzdtlr,1,0.00012,170232,19.77644,860782
17622,gy-bit,1,0.00012,170233,19.77655,860782
17623,gymlt,1,0.00012,170234,19.77667,860782
17624,GypsyCosmonaut,1,0.00012,170235,19.77678,860782
17625,gzg1984,1,0.00012,170236,19.77690,860782
17626,gzur,1,0.00012,170237,19.77702,860782
17627,h353617145,1,0.00012,170238,19.77713,860782
17628,h3adache,1,0.00012,170239,19.77725,860782
17629,h3c-open,1,0.00012,170240,19.77737,860782
17630,h3z,1,0.00012,170241,19.77748,860782
17631,HA07Z7XE,1,0.00012,170242,19.77760,860782
17632,haani-niyaz,1,0.00012,170243,19.77771,860782
17633,habeebshk,1,0.00012,170244,19.77783,860782
17634,habibridho,1,0.00012,170245,19.77795,860782
17635,habtom-wmichael,1,0.00012,170246,19.77806,860782
17636,hack3r3d,1,0.00012,170247,19.77818,860782
17637,hackaholic,1,0.00012,170248,19.77829,860782
17638,hacktmz,1,0.00012,170249,19.77841,860782
17639,HackToHell,1,0.00012,170250,19.77853,860782
17640,hactar,1,0.00012,170251,19.77864,860782
17641,hadifarnoud,1,0.00012,170252,19.77876,860782
17642,hadoop835,1,0.00012,170253,19.77888,860782
17643,hadrian625,1,0.00012,170254,19.77899,860782
17644,hadri-oussama,1,0.00012,170255,19.77911,860782
17645,hafizalfaza,1,0.00012,170256,19.77922,860782
17646,hafsaasaleem,1,0.00012,170257,19.77934,860782
17647,haghabozorgi,1,0.00012,170258,19.77946,860782
17648,haifzhu,1,0.00012,170259,19.77957,860782
17649,haijeploeg,1,0.00012,170260,19.77969,860782
17650,haikuoliu,1,0.00012,170261,19.77980,860782
17651,haine-amine,1,0.00012,170262,19.77992,860782
17652,haizaar,1,0.00012,170263,19.78004,860782
17653,hajina,1,0.00012,170264,19.78015,860782
17654,hak33m16,1,0.00012,170265,19.78027,860782
17655,hakanozanlagan,1,0.00012,170266,19.78039,860782
17656,hale2bopp,1,0.00012,170267,19.78050,860782
17657,halilkaya,1,0.00012,170268,19.78062,860782
17658,haljin,1,0.00012,170269,19.78073,860782
17659,halversonea,1,0.00012,170270,19.78085,860782
17660,hamishforbes,1,0.00012,170271,19.78097,860782
17661,hanalice,1,0.00012,170272,19.78108,860782
17662,hangxie,1,0.00012,170273,19.78120,860782
17663,hannes-angst,1,0.00012,170274,19.78132,860782
17664,Hanzy1996,1,0.00012,170275,19.78143,860782
17665,haochencheng,1,0.00012,170276,19.78155,860782
17666,HaojunRen,1,0.00012,170277,19.78166,860782
17667,haoranong,1,0.00012,170278,19.78178,860782
17668,happy2048,1,0.00012,170279,19.78190,860782
17669,happykayy,1,0.00012,170280,19.78201,860782
17670,haq204,1,0.00012,170281,19.78213,860782
17671,hariharanrbn,1,0.00012,170282,19.78224,860782
17672,HarinadhD,1,0.00012,170283,19.78236,860782
17673,harish-singh01,1,0.00012,170284,19.78248,860782
17674,harisrini,1,0.00012,170285,19.78259,860782
17675,hariyada,1,0.00012,170286,19.78271,860782
17676,harkayal,1,0.00012,170287,19.78283,860782
17677,harmonyharmo,1,0.00012,170288,19.78294,860782
17678,HaroldMua,1,0.00012,170289,19.78306,860782
17679,HaroldTemple,1,0.00012,170290,19.78317,860782
17680,HarryAtMove,1,0.00012,170291,19.78329,860782
17681,harrybin815,1,0.00012,170292,19.78341,860782
17682,harrypintous,1,0.00012,170293,19.78352,860782
17683,HarrySpyrou,1,0.00012,170294,19.78364,860782
17684,HarryWeppner,1,0.00012,170295,19.78375,860782
17685,harsh151028,1,0.00012,170296,19.78387,860782
17686,harsh-2519,1,0.00012,170297,19.78399,860782
17687,harshaltiwariACN,1,0.00012,170298,19.78410,860782
17688,harshsharma22,1,0.00012,170299,19.78422,860782
17689,harshsingh1002,1,0.00012,170300,19.78434,860782
17690,hartfordfive,1,0.00012,170301,19.78445,860782
17691,hasanovkhalid,1,0.00012,170302,19.78457,860782
17692,HasBert,1,0.00012,170303,19.78468,860782
17693,hasc,1,0.00012,170304,19.78480,860782
17694,hashikami,1,0.00012,170305,19.78492,860782
17695,hashimyousaf,1,0.00012,170306,19.78503,860782
17696,hashlash,1,0.00012,170307,19.78515,860782
17697,hashwing,1,0.00012,170308,19.78527,860782
17698,hasibh64,1,0.00012,170309,19.78538,860782
17699,hasimyerlikaya,1,0.00012,170310,19.78550,860782
17700,hasinthaindrajee,1,0.00012,170311,19.78561,860782
17701,hassankhan98,1,0.00012,170312,19.78573,860782
17702,HassanOuda,1,0.00012,170313,19.78585,860782
17703,hassanzia32,1,0.00012,170314,19.78596,860782
17704,hasssammalik,1,0.00012,170315,19.78608,860782
17705,hatembendahmen,1,0.00012,170316,19.78619,860782
17706,hatemosphere,1,0.00012,170317,19.78631,860782
17707,hatosbarbosa,1,0.00012,170318,19.78643,860782
17708,Havilland,1,0.00012,170319,19.78654,860782
17709,hayesgm,1,0.00012,170320,19.78666,860782
17710,haymh,1,0.00012,170321,19.78678,860782
17711,hbarrington,1,0.00012,170322,19.78689,860782
17712,hbel,1,0.00012,170323,19.78701,860782
17713,hbohuang,1,0.00012,170324,19.78712,860782
17714,hbouissoumer,1,0.00012,170325,19.78724,860782
17715,hbowron,1,0.00012,170326,19.78736,860782
17716,hbuttguavus,1,0.00012,170327,19.78747,860782
17717,hby07,1,0.00012,170328,19.78759,860782
17718,hc1990011110,1,0.00012,170329,19.78770,860782
17719,hcbraun,1,0.00012,170330,19.78782,860782
17720,hc-codersatlas,1,0.00012,170331,19.78794,860782
17721,hcoona,1,0.00012,170332,19.78805,860782
17722,hdifilwy,1,0.00012,170333,19.78817,860782
17723,hdonnay,1,0.00012,170334,19.78829,860782
17724,headwhacker,1,0.00012,170335,19.78840,860782
17725,heangratha,1,0.00012,170336,19.78852,860782
17726,heaven4us,1,0.00012,170337,19.78863,860782
17727,heavenkiller2018,1,0.00012,170338,19.78875,860782
17728,hebersonaguiar,1,0.00012,170339,19.78887,860782
17729,heftig,1,0.00012,170340,19.78898,860782
17730,hegwin,1,0.00012,170341,19.78910,860782
17731,heigumjo,1,0.00012,170342,19.78921,860782
17732,HeikoScholtes,1,0.00012,170343,19.78933,860782
17733,heikowissmann,1,0.00012,170344,19.78945,860782
17734,heitorrbarros,1,0.00012,170345,19.78956,860782
17735,Hejianxiong,1,0.00012,170346,19.78968,860782
17736,heldic,1,0.00012,170347,19.78980,860782
17737,Helenmichel,1,0.00012,170348,19.78991,860782
17738,hellofuturecyj,1,0.00012,170349,19.79003,860782
17739,hellojukay,1,0.00012,170350,19.79014,860782
17740,Hellovolcanoofficial,1,0.00012,170351,19.79026,860782
17741,hellozhe,1,0.00012,170352,19.79038,860782
17742,Helmut-Onna,1,0.00012,170353,19.79049,860782
17743,HemanthMudalaiah,1,0.00012,170354,19.79061,860782
17744,Hemantkumar-Chigadani,1,0.00012,170355,19.79073,860782
17745,hemathkumar,1,0.00012,170356,19.79084,860782
17746,Hendrik-H,1,0.00012,170357,19.79096,860782
17747,henkjan,1,0.00012,170358,19.79107,860782
17748,hennna,1,0.00012,170359,19.79119,860782
17749,HenriBeck,1,0.00012,170360,19.79131,860782
17750,henribru,1,0.00012,170361,19.79142,860782
17751,HenryGP,1,0.00012,170362,19.79154,860782
17752,Henry-hexijun,1,0.00012,170363,19.79165,860782
17753,heprotecbuthealsoattac,1,0.00012,170364,19.79177,860782
17754,hercax,1,0.00012,170365,19.79189,860782
17755,herikwebb,1,0.00012,170366,19.79200,860782
17756,hermes85pl,1,0.00012,170367,19.79212,860782
17757,Hermi999,1,0.00012,170368,19.79224,860782
17758,hesamwls,1,0.00012,170369,19.79235,860782
17759,HeshamAboElMagd,1,0.00012,170370,19.79247,860782
17760,Hessu1337,1,0.00012,170371,19.79258,860782
17761,hetpats,1,0.00012,170372,19.79270,860782
17762,heushreck,1,0.00012,170373,19.79282,860782
17763,Heusini,1,0.00012,170374,19.79293,860782
17764,hev,1,0.00012,170375,19.79305,860782
17765,HexF,1,0.00012,170376,19.79316,860782
17766,heylix,1,0.00012,170377,19.79328,860782
17767,heyymonth,1,0.00012,170378,19.79340,860782
17768,HFeilx,1,0.00012,170379,19.79351,860782
17769,hferinga,1,0.00012,170380,19.79363,860782
17770,hgaglani,1,0.00012,170381,19.79375,860782
17771,hhy5861,1,0.00012,170382,19.79386,860782
17772,Hichem-BenJeddi,1,0.00012,170383,19.79398,860782
17773,HidenoriMatsubayashi,1,0.00012,170384,19.79409,860782
17774,hieuteve,1,0.00012,170385,19.79421,860782
17775,Hiieu,1,0.00012,170386,19.79433,860782
17776,hijerusalem,1,0.00012,170387,19.79444,860782
17777,hikkyu,1,0.00012,170388,19.79456,860782
17778,hilafish,1,0.00012,170389,19.79468,860782
17779,himani93,1,0.00012,170390,19.79479,860782
17780,Himanshuxone,1,0.00012,170391,19.79491,860782
17781,himbeles,1,0.00012,170392,19.79502,860782
17782,himslm01,1,0.00012,170393,19.79514,860782
17783,hingstarne,1,0.00012,170394,19.79526,860782
17784,hinyinlam-pivotal,1,0.00012,170395,19.79537,860782
17785,hirako2000,1,0.00012,170396,19.79549,860782
17786,hiramf,1,0.00012,170397,19.79560,860782
17787,HirazawaUi,1,0.00012,170398,19.79572,860782
17788,hiren1771,1,0.00012,170399,19.79584,860782
17789,HirendraKoche,1,0.00012,170400,19.79595,860782
17790,hirenshah05,1,0.00012,170401,19.79607,860782
17791,HiroC222,1,0.00012,170402,19.79619,860782
17792,HisokaHous,1,0.00012,170403,19.79630,860782
17793,Hitesh-Agrawal,1,0.00012,170404,19.79642,860782
17794,hiteshghia-splunk,1,0.00012,170405,19.79653,860782
17795,hiteshsharmacrw,1,0.00012,170406,19.79665,860782
17796,hiteshsp,1,0.00012,170407,19.79677,860782
17797,hjfeng1988,1,0.00012,170408,19.79688,860782
17798,hjwilson1956,1,0.00012,170409,19.79700,860782
17799,hjwp,1,0.00012,170410,19.79711,860782
17800,hk1313,1,0.00012,170411,19.79723,860782
17801,hkloudou,1,0.00012,170412,19.79735,860782
17802,hkrutzer,1,0.00012,170413,19.79746,860782
17803,hladik-dan,1,0.00012,170414,19.79758,860782
17804,hlhl040,1,0.00012,170415,19.79770,860782
17805,HM0mar,1,0.00012,170416,19.79781,860782
17806,hmonteiro,1,0.00012,170417,19.79793,860782
17807,hmsvigle,1,0.00012,170418,19.79804,860782
17808,hnataraj,1,0.00012,170419,19.79816,860782
17809,hobbitlzy,1,0.00012,170420,19.79828,860782
17810,hochuenw-dd,1,0.00012,170421,19.79839,860782
17811,hodglem,1,0.00012,170422,19.79851,860782
17812,hof,1,0.00012,170423,19.79862,860782
17813,hoffoo,1,0.00012,170424,19.79874,860782
17814,hojerst,1,0.00012,170425,19.79886,860782
17815,HoJinKind,1,0.00012,170426,19.79897,860782
17816,holdenk,1,0.00012,170427,19.79909,860782
17817,holinnn,1,0.00012,170428,19.79921,860782
17818,holoGDM,1,0.00012,170429,19.79932,860782
17819,holyevyl,1,0.00012,170430,19.79944,860782
17820,homeles,1,0.00012,170431,19.79955,860782
17821,honeybajaj,1,0.00012,170432,19.79967,860782
17822,HongjiangHuang,1,0.00012,170433,19.79979,860782
17823,hongymagic,1,0.00012,170434,19.79990,860782
17824,honzaweb,1,0.00012,170435,19.80002,860782
17825,hoonahn,1,0.00012,170436,19.80014,860782
17826,hopper-signifyd,1,0.00012,170437,19.80025,860782
17827,horakmar,1,0.00012,170438,19.80037,860782
17828,horihel,1,0.00012,170439,19.80048,860782
17829,horjulf,1,0.00012,170440,19.80060,860782
17830,horovits1,1,0.00012,170441,19.80072,860782
17831,horse315,1,0.00012,170442,19.80083,860782
17832,hoshposh,1,0.00012,170443,19.80095,860782
17833,Houlistonm,1,0.00012,170444,19.80106,860782
17834,houruiming1,1,0.00012,170445,19.80118,860782
17835,houstar,1,0.00012,170446,19.80130,860782
17836,houston88,1,0.00012,170447,19.80141,860782
17837,howardjones,1,0.00012,170448,19.80153,860782
17838,howardshaw,1,0.00012,170449,19.80165,860782
17839,howelt-sec,1,0.00012,170450,19.80176,860782
17840,howieyuen,1,0.00012,170451,19.80188,860782
17841,HowToMeetLadies,1,0.00012,170452,19.80199,860782
17842,hpapazov,1,0.00012,170453,19.80211,860782
17843,hp-caoy,1,0.00012,170454,19.80223,860782
17844,hphsu,1,0.00012,170455,19.80234,860782
17845,hpxue13,1,0.00012,170456,19.80246,860782
17846,hq6,1,0.00012,170457,19.80257,860782
17847,hrak,1,0.00012,170458,19.80269,860782
17848,hrbasic,1,0.00012,170459,19.80281,860782
17849,hridayeshpawar,1,0.00012,170460,19.80292,860782
17850,hritvi,1,0.00012,170461,19.80304,860782
17851,hrivera-ntap,1,0.00012,170462,19.80316,860782
17852,HryhoriiDidenko,1,0.00012,170463,19.80327,860782
17853,hsalem7,1,0.00012,170464,19.80339,860782
17854,hscspring,1,0.00012,170465,19.80350,860782
17855,hsezhiyan,1,0.00012,170466,19.80362,860782
17856,hsivakum,1,0.00012,170467,19.80374,860782
17857,hsjalilian,1,0.00012,170468,19.80385,860782
17858,hsldymq,1,0.00012,170469,19.80397,860782
17859,hsw48,1,0.00012,170470,19.80409,860782
17860,hsy3418,1,0.00012,170471,19.80420,860782
17861,htfy96,1,0.00012,170472,19.80432,860782
17862,htplbc,1,0.00012,170473,19.80443,860782
17863,http403,1,0.00012,170474,19.80455,860782
17864,hua6,1,0.00012,170475,19.80467,860782
17865,huahang,1,0.00012,170476,19.80478,860782
17866,huan,1,0.00012,170477,19.80490,860782
17867,huangliequan,1,0.00012,170478,19.80501,860782
17868,huangwei0413,1,0.00012,170479,19.80513,860782
17869,huangyajie-Git,1,0.00012,170480,19.80525,860782
17870,huangyanhong,1,0.00012,170481,19.80536,860782
17871,huangyanjuner,1,0.00012,170482,19.80548,860782
17872,hubgit,1,0.00012,170483,19.80560,860782
17873,hudongdong129,1,0.00012,170484,19.80571,860782
17874,HuGanghui,1,0.00012,170485,19.80583,860782
17875,hughobrien,1,0.00012,170486,19.80594,860782
17876,hugo19941994,1,0.00012,170487,19.80606,860782
17877,hugo2017,1,0.00012,170488,19.80618,860782
17878,hugobgranja,1,0.00012,170489,19.80629,860782
17879,hugoboos,1,0.00012,170490,19.80641,860782
17880,hugocortes,1,0.00012,170491,19.80652,860782
17881,hugocosme,1,0.00012,170492,19.80664,860782
17882,hugohyliang,1,0.00012,170493,19.80676,860782
17883,hugomcfonseca,1,0.00012,170494,19.80687,860782
17884,HugoS99,1,0.00012,170495,19.80699,860782
17885,Huihuihh,1,0.00012,170496,19.80711,860782
17886,huimxu,1,0.00012,170497,19.80722,860782
17887,huiwq1990,1,0.00012,170498,19.80734,860782
17888,hui-zheng,1,0.00012,170499,19.80745,860782
17889,hukaixuan,1,0.00012,170500,19.80757,860782
17890,humantargetjoe,1,0.00012,170501,19.80769,860782
17891,humbleengineer,1,0.00012,170502,19.80780,860782
17892,humblefool007,1,0.00012,170503,19.80792,860782
17893,HunterLarco,1,0.00012,170504,19.80804,860782
17894,hupangpang,1,0.00012,170505,19.80815,860782
17895,hussnainjav3d,1,0.00012,170506,19.80827,860782
17896,hutemai,1,0.00012,170507,19.80838,860782
17897,huy-nguyen,1,0.00012,170508,19.80850,860782
17898,huytn1219,1,0.00012,170509,19.80862,860782
17899,hvancamp,1,0.00012,170510,19.80873,860782
17900,hvoigt,1,0.00012,170511,19.80885,860782
17901,hwaastad,1,0.00012,170512,19.80896,860782
17902,hxzhao527,1,0.00012,170513,19.80908,860782
17903,hy670,1,0.00012,170514,19.80920,860782
17904,hyeonjae,1,0.00012,170515,19.80931,860782
17905,hynespm,1,0.00012,170516,19.80943,860782
17906,hyperbolist,1,0.00012,170517,19.80955,860782
17907,hyprnick,1,0.00012,170518,19.80966,860782
17908,hyserver,1,0.00012,170519,19.80978,860782
17909,hyt05,1,0.00012,170520,19.80989,860782
17910,hyungryuk,1,0.00012,170521,19.81001,860782
17911,hyunrealshadow,1,0.00012,170522,19.81013,860782
17912,Hywfred,1,0.00012,170523,19.81024,860782
17913,hzjnet,1,0.00012,170524,19.81036,860782
17914,hzproe,1,0.00012,170525,19.81047,860782
17915,i0x71,1,0.00012,170526,19.81059,860782
17916,i1men,1,0.00012,170527,19.81071,860782
17917,i5okie,1,0.00012,170528,19.81082,860782
17918,iagomelanias,1,0.00012,170529,19.81094,860782
17919,iainbryson,1,0.00012,170530,19.81106,860782
17920,iakanoe,1,0.00012,170531,19.81117,860782
17921,iamcippino,1,0.00012,170532,19.81129,860782
17922,iamgoangle,1,0.00012,170533,19.81140,860782
17923,iamjxb,1,0.00012,170534,19.81152,860782
17924,iamnoah,1,0.00012,170535,19.81164,860782
17925,iamperson347,1,0.00012,170536,19.81175,860782
17926,iampeters,1,0.00012,170537,19.81187,860782
17927,ian-bitovi,1,0.00012,170538,19.81198,860782
17928,ianmuscat,1,0.00012,170539,19.81210,860782
17929,iantbutler01,1,0.00012,170540,19.81222,860782
17930,ibanerjee83,1,0.00012,170541,19.81233,860782
17931,ibattat,1,0.00012,170542,19.81245,860782
17932,ibrahiminui,1,0.00012,170543,19.81257,860782
17933,ibrokethecloud,1,0.00012,170544,19.81268,860782
17934,icefluo,1,0.00012,170545,19.81280,860782
17935,ice-github,1,0.00012,170546,19.81291,860782
17936,icehehehe,1,0.00012,170547,19.81303,860782
17937,iceman739,1,0.00012,170548,19.81315,860782
17938,ichizero,1,0.00012,170549,19.81326,860782
17939,icnocop,1,0.00012,170550,19.81338,860782
17940,icoloma,1,0.00012,170551,19.81350,860782
17941,iconoeugen,1,0.00012,170552,19.81361,860782
17942,icpenguins,1,0.00012,170553,19.81373,860782
17943,idanbenyair,1,0.00012,170554,19.81384,860782
17944,IdanE,1,0.00012,170555,19.81396,860782
17945,idealism-xxm,1,0.00012,170556,19.81408,860782
17946,identw,1,0.00012,170557,19.81419,860782
17947,idm-kiyoshi,1,0.00012,170558,19.81431,860782
17948,idob111,1,0.00012,170559,19.81442,860782
17949,idobry,1,0.00012,170560,19.81454,860782
17950,ido-namely,1,0.00012,170561,19.81466,860782
17951,idonca,1,0.00012,170562,19.81477,860782
17952,idsvandermolen,1,0.00012,170563,19.81489,860782
17953,iershovnsk,1,0.00012,170564,19.81501,860782
17954,ifalex,1,0.00012,170565,19.81512,860782
17955,ifaridi79,1,0.00012,170566,19.81524,860782
17956,ifqthenp,1,0.00012,170567,19.81535,860782
17957,iFreeon,1,0.00012,170568,19.81547,860782
17958,iftvio,1,0.00012,170569,19.81559,860782
17959,igitcode,1,0.00012,170570,19.81570,860782
17960,iglv,1,0.00012,170571,19.81582,860782
17961,igoratencompass,1,0.00012,170572,19.81593,860782
17962,igorcezar,1,0.00012,170573,19.81605,860782
17963,IgorOrsag,1,0.00012,170574,19.81617,860782
17964,igrybkov,1,0.00012,170575,19.81628,860782
17965,iguoyr,1,0.00012,170576,19.81640,860782
17966,ihelmer07,1,0.00012,170577,19.81652,860782
17967,iicky,1,0.00012,170578,19.81663,860782
17968,iilyak,1,0.00012,170579,19.81675,860782
17969,iinikolaev,1,0.00012,170580,19.81686,860782
17970,iiro,1,0.00012,170581,19.81698,860782
17971,ikaccc,1,0.00012,170582,19.81710,860782
17972,ikaustubhk,1,0.00012,170583,19.81721,860782
17973,ikecao,1,0.00012,170584,19.81733,860782
17974,IkiM0no,1,0.00012,170585,19.81745,860782
17975,ilansh,1,0.00012,170586,19.81756,860782
17976,ilhaan,1,0.00012,170587,19.81768,860782
17977,IliaGershenzon,1,0.00012,170588,19.81779,860782
17978,ilie-pandaciuc,1,0.00012,170589,19.81791,860782
17979,illum8,1,0.00012,170590,19.81803,860782
17980,IllusionaryX,1,0.00012,170591,19.81814,860782
17981,ilovemilk,1,0.00012,170592,19.81826,860782
17982,ilovemysillybanana,1,0.00012,170593,19.81837,860782
17983,ilyashtrikul,1,0.00012,170594,19.81849,860782
17984,Ilyes512,1,0.00012,170595,19.81861,860782
17985,ilyesAj,1,0.00012,170596,19.81872,860782
17986,im7mortal,1,0.00012,170597,19.81884,860782
17987,imabhinav,1,0.00012,170598,19.81896,860782
17988,imacks,1,0.00012,170599,19.81907,860782
17989,iMacX,1,0.00012,170600,19.81919,860782
17990,imalandu,1,0.00012,170601,19.81930,860782
17991,imatasic,1,0.00012,170602,19.81942,860782
17992,imbhuvnesh,1,0.00012,170603,19.81954,860782
17993,im-bravo,1,0.00012,170604,19.81965,860782
17994,imesimone,1,0.00012,170605,19.81977,860782
17995,ImIOImI,1,0.00012,170606,19.81988,860782
17996,imitbn,1,0.00012,170607,19.82000,860782
17997,imjasam,1,0.00012,170608,19.82012,860782
17998,implr,1,0.00012,170609,19.82023,860782
17999,imranansari,1,0.00012,170610,19.82035,860782
18000,imrishav,1,0.00012,170611,19.82047,860782
18001,imskr,1,0.00012,170612,19.82058,860782
18002,imunic,1,0.00012,170613,19.82070,860782
18003,imzahahs,1,0.00012,170614,19.82081,860782
18004,inajob,1,0.00012,170615,19.82093,860782
18005,inarayana,1,0.00012,170616,19.82105,860782
18006,InbarRose,1,0.00012,170617,19.82116,860782
18007,inceptio-jingzhao,1,0.00012,170618,19.82128,860782
18008,inceptiona7,1,0.00012,170619,19.82139,860782
18009,indavarapuaneesh,1,0.00012,170620,19.82151,860782
18010,inesplc,1,0.00012,170621,19.82163,860782
18011,infa-msoundar,1,0.00012,170622,19.82174,860782
18012,infa-vmannam,1,0.00012,170623,19.82186,860782
18013,inful,1,0.00012,170624,19.82198,860782
18014,IngCr3at1on,1,0.00012,170625,19.82209,860782
18015,inikolaev,1,0.00012,170626,19.82221,860782
18016,init6tech,1,0.00012,170627,19.82232,860782
18017,initd,1,0.00012,170628,19.82244,860782
18018,inos123,1,0.00012,170629,19.82256,860782
18019,insanitywholesale,1,0.00012,170630,19.82267,860782
18020,insertjokehere,1,0.00012,170631,19.82279,860782
18021,insider89,1,0.00012,170632,19.82291,860782
18022,inspur007,1,0.00012,170633,19.82302,860782
18023,inspuradmin,1,0.00012,170634,19.82314,860782
18024,insta-code1,1,0.00012,170635,19.82325,860782
18025,intellix,1,0.00012,170636,19.82337,860782
18026,inter169,1,0.00012,170637,19.82349,860782
18027,Internauta1972,1,0.00012,170638,19.82360,860782
18028,inventionstore,1,0.00012,170639,19.82372,860782
18029,InvictusMB,1,0.00012,170640,19.82383,860782
18030,invince,1,0.00012,170641,19.82395,860782
18031,iNviNho,1,0.00012,170642,19.82407,860782
18032,ioagel,1,0.00012,170643,19.82418,860782
18033,ioanc,1,0.00012,170644,19.82430,860782
18034,ioluwayo,1,0.00012,170645,19.82442,860782
18035,ioMatrix,1,0.00012,170646,19.82453,860782
18036,ioricloud,1,0.00012,170647,19.82465,860782
18037,IpaliboWhyte,1,0.00012,170648,19.82476,860782
18038,ipodfans,1,0.00012,170649,19.82488,860782
18039,ipolonsk,1,0.00012,170650,19.82500,860782
18040,ipyker,1,0.00012,170651,19.82511,860782
18041,iqbalhusen,1,0.00012,170652,19.82523,860782
18042,iqoyyiml,1,0.00012,170653,19.82534,860782
18043,ira-gordin-sap,1,0.00012,170654,19.82546,860782
18044,irishshagua,1,0.00012,170655,19.82558,860782
18045,IRobL,1,0.00012,170656,19.82569,860782
18046,iRON5,1,0.00012,170657,19.82581,860782
18047,IronCore864,1,0.00012,170658,19.82593,860782
18048,iron-sam,1,0.00012,170659,19.82604,860782
18049,ironslob,1,0.00012,170660,19.82616,860782
18050,irraz,1,0.00012,170661,19.82627,860782
18051,iru-dev,1,0.00012,170662,19.82639,860782
18052,irupasingh,1,0.00012,170663,19.82651,860782
18053,isaiah-coleman,1,0.00012,170664,19.82662,860782
18054,Isa-rentacs,1,0.00012,170665,19.82674,860782
18055,isca0,1,0.00012,170666,19.82686,860782
18056,iscander,1,0.00012,170667,19.82697,860782
18057,iscongyang,1,0.00012,170668,19.82709,860782
18058,ishakhari,1,0.00012,170669,19.82720,860782
18059,Ishiihara,1,0.00012,170670,19.82732,860782
18060,isliqian,1,0.00012,170671,19.82744,860782
18061,Ismail-Ham,1,0.00012,170672,19.82755,860782
18062,ismizelal,1,0.00012,170673,19.82767,860782
18063,Isnor,1,0.00012,170674,19.82778,860782
18064,Isuama,1,0.00012,170675,19.82790,860782
18065,itaimalek,1,0.00012,170676,19.82802,860782
18066,itaimirin,1,0.00012,170677,19.82813,860782
18067,italolelis,1,0.00012,170678,19.82825,860782
18068,itatabitovski,1,0.00012,170679,19.82837,860782
18069,iTaybb,1,0.00012,170680,19.82848,860782
18070,itfabrik,1,0.00012,170681,19.82860,860782
18071,ITJamie,1,0.00012,170682,19.82871,860782
18072,itldo,1,0.00012,170683,19.82883,860782
18073,itmandy,1,0.00012,170684,19.82895,860782
18074,itsrajivbansal,1,0.00012,170685,19.82906,860782
18075,itsSaad,1,0.00012,170686,19.82918,860782
18076,iuliandym,1,0.00012,170687,19.82929,860782
18077,iuv,1,0.00012,170688,19.82941,860782
18078,ivadoncheva,1,0.00012,170689,19.82953,860782
18079,ivan046,1,0.00012,170690,19.82964,860782
18080,ivanamat,1,0.00012,170691,19.82976,860782
18081,IvanBasic-TomTom,1,0.00012,170692,19.82988,860782
18082,Ivanbmstu,1,0.00012,170693,19.82999,860782
18083,IvanBoyko,1,0.00012,170694,19.83011,860782
18084,ivan-caspeta-by,1,0.00012,170695,19.83022,860782
18085,IvanJosipovic,1,0.00012,170696,19.83034,860782
18086,ivanlunardi,1,0.00012,170697,19.83046,860782
18087,ivanov-aleksander,1,0.00012,170698,19.83057,860782
18088,ivanovUA,1,0.00012,170699,19.83069,860782
18089,ivanpang1996,1,0.00012,170700,19.83081,860782
18090,ivanpedersen,1,0.00012,170701,19.83092,860782
18091,ivanrezic-maistra,1,0.00012,170702,19.83104,860782
18092,ivan-sukhomlyn,1,0.00012,170703,19.83115,860782
18093,Ivan-Zhu,1,0.00012,170704,19.83127,860782
18094,iven,1,0.00012,170705,19.83139,860782
18095,ivishnevs,1,0.00012,170706,19.83150,860782
18096,ivkos,1,0.00012,170707,19.83162,860782
18097,ivog1,1,0.00012,170708,19.83173,860782
18098,ivoribeiro,1,0.00012,170709,19.83185,860782
18099,ivorscott,1,0.00012,170710,19.83197,860782
18100,iwannay,1,0.00012,170711,19.83208,860782
18101,iwita,1,0.00012,170712,19.83220,860782
18102,IzabellaRaulin,1,0.00012,170713,19.83232,860782
18103,IzekChen,1,0.00012,170714,19.83243,860782
18104,izkuru,1,0.00012,170715,19.83255,860782
18105,Izopi4a,1,0.00012,170716,19.83266,860782
18106,j0057,1,0.00012,170717,19.83278,860782
18107,j16sdiz,1,0.00012,170718,19.83290,860782
18108,ja0nz,1,0.00012,170719,19.83301,860782
18109,jaaant,1,0.00012,170720,19.83313,860782
18110,jaankoi,1,0.00012,170721,19.83324,860782
18111,JaapHaitsma,1,0.00012,170722,19.83336,860782
18112,jabolina,1,0.00012,170723,19.83348,860782
18113,jabouchleih,1,0.00012,170724,19.83359,860782
18114,jabrena,1,0.00012,170725,19.83371,860782
18115,jace-ys,1,0.00012,170726,19.83383,860782
18116,Jack47,1,0.00012,170727,19.83394,860782
18117,jack85811,1,0.00012,170728,19.83406,860782
18118,JackGzj,1,0.00012,170729,19.83417,860782
18119,JackieLiu1789,1,0.00012,170730,19.83429,860782
18120,jackieluc,1,0.00012,170731,19.83441,860782
18121,jackielyc,1,0.00012,170732,19.83452,860782
18122,Jack-Kingdom,1,0.00012,170733,19.83464,860782
18123,jacklauritsen,1,0.00012,170734,19.83475,860782
18124,jacklmjie,1,0.00012,170735,19.83487,860782
18125,jackmuskopf,1,0.00012,170736,19.83499,860782
18126,jackonan,1,0.00012,170737,19.83510,860782
18127,jackpot51,1,0.00012,170738,19.83522,860782
18128,JackTiber,1,0.00012,170739,19.83534,860782
18129,Jacob310,1,0.00012,170740,19.83545,860782
18130,Jacob366,1,0.00012,170741,19.83557,860782
18131,Jacob-Matchuny,1,0.00012,170742,19.83568,860782
18132,jacobreid,1,0.00012,170743,19.83580,860782
18133,jacques414,1,0.00012,170744,19.83592,860782
18134,jadabisamra,1,0.00012,170745,19.83603,860782
18135,jadiy,1,0.00012,170746,19.83615,860782
18136,jae-63,1,0.00012,170747,19.83627,860782
18137,jaemyunlee,1,0.00012,170748,19.83638,860782
18138,jahlinxjah,1,0.00012,170749,19.83650,860782
18139,jaideepr97,1,0.00012,170750,19.83661,860782
18140,JaikumarKrishna,1,0.00012,170751,19.83673,860782
18141,jaineitisha13,1,0.00012,170752,19.83685,860782
18142,jajjg,1,0.00012,170753,19.83696,860782
18143,Jakeler,1,0.00012,170754,19.83708,860782
18144,jakeleventhal,1,0.00012,170755,19.83719,860782
18145,jakethedogg,1,0.00012,170756,19.83731,860782
18146,jakewins,1,0.00012,170757,19.83743,860782
18147,jakobjs,1,0.00012,170758,19.83754,860782
18148,jakovistuk,1,0.00012,170759,19.83766,860782
18149,jakubrauch,1,0.00012,170760,19.83778,860782
18150,jalavosus,1,0.00012,170761,19.83789,860782
18151,jalberti,1,0.00012,170762,19.83801,860782
18152,jambajaar,1,0.00012,170763,19.83812,860782
18153,jameel23,1,0.00012,170764,19.83824,860782
18154,JamelB83,1,0.00012,170765,19.83836,860782
18155,jamengual,1,0.00012,170766,19.83847,860782
18156,James4Deutschland,1,0.00012,170767,19.83859,860782
18157,james-ct,1,0.00012,170768,19.83870,860782
18158,JamesDowning,1,0.00012,170769,19.83882,860782
18159,james-jra,1,0.00012,170770,19.83894,860782
18160,james-mathiesen,1,0.00012,170771,19.83905,860782
18161,james-mcgoodwin,1,0.00012,170772,19.83917,860782
18162,James-QiuHaoran,1,0.00012,170773,19.83929,860782
18163,jamesraby,1,0.00012,170774,19.83940,860782
18164,jamesrgrinter,1,0.00012,170775,19.83952,860782
18165,james-song,1,0.00012,170776,19.83963,860782
18166,james-thomson,1,0.00012,170777,19.83975,860782
18167,jameswynn,1,0.00012,170778,19.83987,860782
18168,jamezp,1,0.00012,170779,19.83998,860782
18169,jamie-pate,1,0.00012,170780,19.84010,860782
18170,jamiewri,1,0.00012,170781,19.84022,860782
18171,jammerful,1,0.00012,170782,19.84033,860782
18172,Jammicus,1,0.00012,170783,19.84045,860782
18173,Jamsek-m,1,0.00012,170784,19.84056,860782
18174,jamshid,1,0.00012,170785,19.84068,860782
18175,jan4984,1,0.00012,170786,19.84080,860782
18176,Janaka-Steph,1,0.00012,170787,19.84091,860782
18177,Jancis,1,0.00012,170788,19.84103,860782
18178,jandevdev,1,0.00012,170789,19.84114,860782
18179,jandubois,1,0.00012,170790,19.84126,860782
18180,janehojy,1,0.00012,170791,19.84138,860782
18181,janekmichalik,1,0.00012,170792,19.84149,860782
18182,janekwonner,1,0.00012,170793,19.84161,860782
18183,JanetSch,1,0.00012,170794,19.84173,860782
18184,JanFeld,1,0.00012,170795,19.84184,860782
18185,janhoy,1,0.00012,170796,19.84196,860782
18186,janilsongomesmendes,1,0.00012,170797,19.84207,860782
18187,janiskemper,1,0.00012,170798,19.84219,860782
18188,JanJannos,1,0.00012,170799,19.84231,860782
18189,jankit02,1,0.00012,170800,19.84242,860782
18190,jankosecki,1,0.00012,170801,19.84254,860782
18191,jannis-a,1,0.00012,170802,19.84265,860782
18192,janschauta,1,0.00012,170803,19.84277,860782
18193,jansmets,1,0.00012,170804,19.84289,860782
18194,jansony1,1,0.00012,170805,19.84300,860782
18195,JanuaryThomas,1,0.00012,170806,19.84312,860782
18196,Japeth,1,0.00012,170807,19.84324,860782
18197,jaraws,1,0.00012,170808,19.84335,860782
18198,jared2501,1,0.00012,170809,19.84347,860782
18199,jared-gs,1,0.00012,170810,19.84358,860782
18200,jarednielsen,1,0.00012,170811,19.84370,860782
18201,JarenGlover,1,0.00012,170812,19.84382,860782
18202,jaretclifton,1,0.00012,170813,19.84393,860782
18203,jarfil,1,0.00012,170814,19.84405,860782
18204,jarnfast,1,0.00012,170815,19.84416,860782
18205,jarrett-ccg,1,0.00012,170816,19.84428,860782
18206,jarrydlee,1,0.00012,170817,19.84440,860782
18207,jaskirat8,1,0.00012,170818,19.84451,860782
18208,jaskiratr,1,0.00012,170819,19.84463,860782
18209,Jasminetyt,1,0.00012,170820,19.84475,860782
18210,Jason-2020,1,0.00012,170821,19.84486,860782
18211,jasondemps1,1,0.00012,170822,19.84498,860782
18212,jasongol,1,0.00012,170823,19.84509,860782
18213,JasonHao123,1,0.00012,170824,19.84521,860782
18214,jasonheffner,1,0.00012,170825,19.84533,860782
18215,Jason-ikhokha,1,0.00012,170826,19.84544,860782
18216,jasonmimick,1,0.00012,170827,19.84556,860782
18217,jasonquick,1,0.00012,170828,19.84568,860782
18218,jasonraimondi,1,0.00012,170829,19.84579,860782
18219,Jasopaum,1,0.00012,170830,19.84591,860782
18220,jaspervdj,1,0.00012,170831,19.84602,860782
18221,Jasvinder-aulakh,1,0.00012,170832,19.84614,860782
18222,jaswantdhayalxebia,1,0.00012,170833,19.84626,860782
18223,jatinder10884,1,0.00012,170834,19.84637,860782
18224,javachen,1,0.00012,170835,19.84649,860782
18225,JavadAbedi,1,0.00012,170836,19.84660,860782
18226,javad-hajiani,1,0.00012,170837,19.84672,860782
18227,javaidrauf,1,0.00012,170838,19.84684,860782
18228,javalc6,1,0.00012,170839,19.84695,860782
18229,javendo,1,0.00012,170840,19.84707,860782
18230,javib51,1,0.00012,170841,19.84719,860782
18231,javiercn,1,0.00012,170842,19.84730,860782
18232,JavierSegui,1,0.00012,170843,19.84742,860782
18233,Jawshua,1,0.00012,170844,19.84753,860782
18234,Jay0774,1,0.00012,170845,19.84765,860782
18235,jayaise,1,0.00012,170846,19.84777,860782
18236,JayakumarB,1,0.00012,170847,19.84788,860782
18237,jayant12489,1,0.00012,170848,19.84800,860782
18238,jayawasthi,1,0.00012,170849,19.84811,860782
18239,jaybirdshain,1,0.00012,170850,19.84823,860782
18240,jayeshd7,1,0.00012,170851,19.84835,860782
18241,Jay-Funk,1,0.00012,170852,19.84846,860782
18242,jaynesb,1,0.00012,170853,19.84858,860782
18243,jay-owen,1,0.00012,170854,19.84870,860782
18244,jaystile,1,0.00012,170855,19.84881,860782
18245,jayv,1,0.00012,170856,19.84893,860782
18246,jazoom,1,0.00012,170857,19.84904,860782
18247,jbanety,1,0.00012,170858,19.84916,860782
18248,jbbarquero,1,0.00012,170859,19.84928,860782
18249,jbbarth,1,0.00012,170860,19.84939,860782
18250,jbg,1,0.00012,170861,19.84951,860782
18251,JBodkin-LH,1,0.00012,170862,19.84963,860782
18252,jboero,1,0.00012,170863,19.84974,860782
18253,jboeshart,1,0.00012,170864,19.84986,860782
18254,jbogp,1,0.00012,170865,19.84997,860782
18255,jbresciani,1,0.00012,170866,19.85009,860782
18256,jbrokamp,1,0.00012,170867,19.85021,860782
18257,jbrouwers,1,0.00012,170868,19.85032,860782
18258,jburandt,1,0.00012,170869,19.85044,860782
18259,jbviout,1,0.00012,170870,19.85055,860782
18260,jcampaner,1,0.00012,170871,19.85067,860782
18261,jcardoso-bv,1,0.00012,170872,19.85079,860782
18262,jchomat,1,0.00012,170873,19.85090,860782
18263,jchraibi,1,0.00012,170874,19.85102,860782
18264,jclanoe,1,0.00012,170875,19.85114,860782
18265,jcleira,1,0.00012,170876,19.85125,860782
18266,jclosure,1,0.00012,170877,19.85137,860782
18267,jclusso,1,0.00012,170878,19.85148,860782
18268,jclynny,1,0.00012,170879,19.85160,860782
18269,j-coll,1,0.00012,170880,19.85172,860782
18270,jcstanaway,1,0.00012,170881,19.85183,860782
18271,jcwinchell,1,0.00012,170882,19.85195,860782
18272,jd0x,1,0.00012,170883,19.85206,860782
18273,jdamata,1,0.00012,170884,19.85218,860782
18274,jdamour98,1,0.00012,170885,19.85230,860782
18275,Jdban,1,0.00012,170886,19.85241,860782
18276,j-denner,1,0.00012,170887,19.85253,860782
18277,jdeppeATsoprasteria,1,0.00012,170888,19.85265,860782
18278,jdevalk2,1,0.00012,170889,19.85276,860782
18279,jdkealy,1,0.00012,170890,19.85288,860782
18280,jdkhong,1,0.00012,170891,19.85299,860782
18281,jdobes,1,0.00012,170892,19.85311,860782
18282,jdrouet,1,0.00012,170893,19.85323,860782
18283,jeanfrancoislarente,1,0.00012,170894,19.85334,860782
18284,jeanmachuca,1,0.00012,170895,19.85346,860782
18285,Jean-MarcS,1,0.00012,170896,19.85358,860782
18286,jecacs,1,0.00012,170897,19.85369,860782
18287,JeckiC,1,0.00012,170898,19.85381,860782
18288,jedisom,1,0.00012,170899,19.85392,860782
18289,jedlix-techops,1,0.00012,170900,19.85404,860782
18290,jedrecord,1,0.00012,170901,19.85416,860782
18291,jedrp,1,0.00012,170902,19.85427,860782
18292,jeesmon,1,0.00012,170903,19.85439,860782
18293,jeevavenkataraman,1,0.00012,170904,19.85450,860782
18294,jeeyshe,1,0.00012,170905,19.85462,860782
18295,jef,1,0.00012,170906,19.85474,860782
18296,JefClaes,1,0.00012,170907,19.85485,860782
18297,jeffallen,1,0.00012,170908,19.85497,860782
18298,jeffbehl,1,0.00012,170909,19.85509,860782
18299,jeffhoffman13,1,0.00012,170910,19.85520,860782
18300,jeff-mccoy,1,0.00012,170911,19.85532,860782
18301,jeffmontagna,1,0.00012,170912,19.85543,860782
18302,jeffnai-github,1,0.00012,170913,19.85555,860782
18303,jeffspahr,1,0.00012,170914,19.85567,860782
18304,jeffwalsh,1,0.00012,170915,19.85578,860782
18305,jeffzoch,1,0.00012,170916,19.85590,860782
18306,jefimm,1,0.00012,170917,19.85601,860782
18307,jeisen,1,0.00012,170918,19.85613,860782
18308,jekakm,1,0.00012,170919,19.85625,860782
18309,jemc,1,0.00012,170920,19.85636,860782
18310,jenniferwang0709,1,0.00012,170921,19.85648,860782
18311,JennyLawrance,1,0.00012,170922,19.85660,860782
18312,JennyLi90,1,0.00012,170923,19.85671,860782
18313,jenstroeger,1,0.00012,170924,19.85683,860782
18314,jeonggyuchoi,1,0.00012,170925,19.85694,860782
18315,jered-miller,1,0.00012,170926,19.85706,860782
18316,jeremyhermann,1,0.00012,170927,19.85718,860782
18317,JeremyJeanson,1,0.00012,170928,19.85729,860782
18318,JeremyProffitt,1,0.00012,170929,19.85741,860782
18319,jeroenbrouwer,1,0.00012,170930,19.85752,860782
18320,jeroenjacobs79,1,0.00012,170931,19.85764,860782
18321,jerolimov,1,0.00012,170932,19.85776,860782
18322,jeromv,1,0.00012,170933,19.85787,860782
18323,jerryjren,1,0.00012,170934,19.85799,860782
18324,jerry-sc,1,0.00012,170935,19.85811,860782
18325,JerrySunWRS,1,0.00012,170936,19.85822,860782
18326,jerry-yuan,1,0.00012,170937,19.85834,860782
18327,Jerryzhao-z,1,0.00012,170938,19.85845,860782
18328,jesher,1,0.00012,170939,19.85857,860782
18329,jessemillar,1,0.00012,170940,19.85869,860782
18330,jessicaodish,1,0.00012,170941,19.85880,860782
18331,jess-sheneberger,1,0.00012,170942,19.85892,860782
18332,JesusGoVar,1,0.00012,170943,19.85904,860782
18333,JesusJones92,1,0.00012,170944,19.85915,860782
18334,JESWINKNINAN,1,0.00012,170945,19.85927,860782
18335,jetxu,1,0.00012,170946,19.85938,860782
18336,jeus,1,0.00012,170947,19.85950,860782
18337,Jevi06,1,0.00012,170948,19.85962,860782
18338,jewelcai,1,0.00012,170949,19.85973,860782
18339,jewelt,1,0.00012,170950,19.85985,860782
18340,jewzaam,1,0.00012,170951,19.85996,860782
18341,jfjcn,1,0.00012,170952,19.86008,860782
18342,jflamy,1,0.00012,170953,19.86020,860782
18343,jfrancisco0,1,0.00012,170954,19.86031,860782
18344,jfruge,1,0.00012,170955,19.86043,860782
18345,jfyne,1,0.00012,170956,19.86055,860782
18346,jgn-epp,1,0.00012,170957,19.86066,860782
18347,jgoldfar,1,0.00012,170958,19.86078,860782
18348,jgornowich,1,0.00012,170959,19.86089,860782
18349,jgournet,1,0.00012,170960,19.86101,860782
18350,jgray1206,1,0.00012,170961,19.86113,860782
18351,jgriff,1,0.00012,170962,19.86124,860782
18352,jgworks,1,0.00012,170963,19.86136,860782
18353,jhc0025,1,0.00012,170964,19.86147,860782
18354,jhegyi,1,0.00012,170965,19.86159,860782
18355,jhgoodwin,1,0.00012,170966,19.86171,860782
18356,jhmnieuwenhuis,1,0.00012,170967,19.86182,860782
18357,jhonnyx82,1,0.00012,170968,19.86194,860782
18358,Jhovanni,1,0.00012,170969,19.86206,860782
18359,JiaDong007,1,0.00012,170970,19.86217,860782
18360,jiaji2006,1,0.00012,170971,19.86229,860782
18361,jiakuanATF,1,0.00012,170972,19.86240,860782
18362,JiaminZhu,1,0.00012,170973,19.86252,860782
18363,jianchengfeng,1,0.00012,170974,19.86264,860782
18364,jianglin1008,1,0.00012,170975,19.86275,860782
18365,jiangsiYang,1,0.00012,170976,19.86287,860782
18366,jianjuns,1,0.00012,170977,19.86299,860782
18367,JianmingXia,1,0.00012,170978,19.86310,860782
18368,jiaozg22,1,0.00012,170979,19.86322,860782
18369,jiaqi,1,0.00012,170980,19.86333,860782
18370,jiaqiluo,1,0.00012,170981,19.86345,860782
18371,Jiasm,1,0.00012,170982,19.86357,860782
18372,Jiaweizdev,1,0.00012,170983,19.86368,860782
18373,jiayushe,1,0.00012,170984,19.86380,860782
18374,jidalong,1,0.00012,170985,19.86391,860782
18375,jierYang,1,0.00012,170986,19.86403,860782
18376,jieya-ms,1,0.00012,170987,19.86415,860782
18377,jihaojie,1,0.00012,170988,19.86426,860782
18378,jijeesh,1,0.00012,170989,19.86438,860782
18379,jijiwawa,1,0.00012,170990,19.86450,860782
18380,jimcasteleiro,1,0.00012,170991,19.86461,860782
18381,jimdevops19,1,0.00012,170992,19.86473,860782
18382,JimHagan,1,0.00012,170993,19.86484,860782
18383,jimmarino,1,0.00012,170994,19.86496,860782
18384,jimmy30,1,0.00012,170995,19.86508,860782
18385,jimmywku,1,0.00012,170996,19.86519,860782
18386,jimoosciuc,1,0.00012,170997,19.86531,860782
18387,jimsgreen,1,0.00012,170998,19.86542,860782
18388,jimvandervoort,1,0.00012,170999,19.86554,860782
18389,jindov,1,0.00012,171000,19.86566,860782
18390,Jingru,1,0.00012,171001,19.86577,860782
18391,JingruiLea,1,0.00012,171002,19.86589,860782
18392,jinjie2088,1,0.00012,171003,19.86601,860782
18393,jinlxz,1,0.00012,171004,19.86612,860782
18394,jinnzy,1,0.00012,171005,19.86624,860782
18395,jinoj,1,0.00012,171006,19.86635,860782
18396,jinyyy666,1,0.00012,171007,19.86647,860782
18397,jinzishuai,1,0.00012,171008,19.86659,860782
18398,jiphex,1,0.00012,171009,19.86670,860782
18399,jiridanek,1,0.00012,171010,19.86682,860782
18400,jiri-kral86,1,0.00012,171011,19.86693,860782
18401,jitendar-singh,1,0.00012,171012,19.86705,860782
18402,jitendrawas33,1,0.00012,171013,19.86717,860782
18403,jithendra89,1,0.00012,171014,19.86728,860782
18404,jjang16,1,0.00012,171015,19.86740,860782
18405,jjayeshgohil,1,0.00012,171016,19.86752,860782
18406,jjbubudi,1,0.00012,171017,19.86763,860782
18407,jjburr,1,0.00012,171018,19.86775,860782
18408,jkawamoto,1,0.00012,171019,19.86786,860782
18409,jkbuster,1,0.00012,171020,19.86798,860782
18410,JKerwood,1,0.00012,171021,19.86810,860782
18411,jkftiger348,1,0.00012,171022,19.86821,860782
18412,jkieley,1,0.00012,171023,19.86833,860782
18413,jkim-codecademy,1,0.00012,171024,19.86845,860782
18414,jkozlick,1,0.00012,171025,19.86856,860782
18415,jkugler,1,0.00012,171026,19.86868,860782
18416,jlao,1,0.00012,171027,19.86879,860782
18417,jlaws,1,0.00012,171028,19.86891,860782
18418,jlcrow,1,0.00012,171029,19.86903,860782
18419,jlevertov,1,0.00012,171030,19.86914,860782
18420,jlewis42lines,1,0.00012,171031,19.86926,860782
18421,jlforester,1,0.00012,171032,19.86937,860782
18422,jlr52,1,0.00012,171033,19.86949,860782
18423,jls-tschanzc,1,0.00012,171034,19.86961,860782
18424,jmajoor,1,0.00012,171035,19.86972,860782
18425,jmakinen-ncc,1,0.00012,171036,19.86984,860782
18426,jmcdaniel-bc,1,0.00012,171037,19.86996,860782
18427,jmcnevin,1,0.00012,171038,19.87007,860782
18428,jmcoreymv,1,0.00012,171039,19.87019,860782
18429,jmhbnz,1,0.00012,171040,19.87030,860782
18430,jmjoy,1,0.00012,171041,19.87042,860782
18431,jmmaloney4,1,0.00012,171042,19.87054,860782
18432,jmontgomery-jc,1,0.00012,171043,19.87065,860782
18433,jmorcar,1,0.00012,171044,19.87077,860782
18434,jmorgan415,1,0.00012,171045,19.87088,860782
18435,jmpavlec,1,0.00012,171046,19.87100,860782
18436,jmreid,1,0.00012,171047,19.87112,860782
18437,jmril-srcclr,1,0.00012,171048,19.87123,860782
18438,jmturwy,1,0.00012,171049,19.87135,860782
18439,jmunyeneh,1,0.00012,171050,19.87147,860782
18440,jmwaniki,1,0.00012,171051,19.87158,860782
18441,jnadler,1,0.00012,171052,19.87170,860782
18442,jnovick,1,0.00012,171053,19.87181,860782
18443,jnsvd,1,0.00012,171054,19.87193,860782
18444,jnvilo,1,0.00012,171055,19.87205,860782
18445,joanayma,1,0.00012,171056,19.87216,860782
18446,joaobrittoneto,1,0.00012,171057,19.87228,860782
18447,jobevers,1,0.00012,171058,19.87240,860782
18448,JochenGuck,1,0.00012,171059,19.87251,860782
18449,jodeev,1,0.00012,171060,19.87263,860782
18450,jodok,1,0.00012,171061,19.87274,860782
18451,joeczucha,1,0.00012,171062,19.87286,860782
18452,JoeHegarty,1,0.00012,171063,19.87298,860782
18453,joeldeteves,1,0.00012,171064,19.87309,860782
18454,JoelHenn,1,0.00012,171065,19.87321,860782
18455,JoelKle,1,0.00012,171066,19.87332,860782
18456,JoelOtter,1,0.00012,171067,19.87344,860782
18457,JoelPM,1,0.00012,171068,19.87356,860782
18458,joelrebel,1,0.00012,171069,19.87367,860782
18459,joelrozen,1,0.00012,171070,19.87379,860782
18460,JoelStuart,1,0.00012,171071,19.87391,860782
18461,joemiao-exos,1,0.00012,171072,19.87402,860782
18462,joergbattermann,1,0.00012,171073,19.87414,860782
18463,joeschram,1,0.00012,171074,19.87425,860782
18464,joe-sfx,1,0.00012,171075,19.87437,860782
18465,JoeStaines,1,0.00012,171076,19.87449,860782
18466,JoeStill,1,0.00012,171077,19.87460,860782
18467,joeystevens00,1,0.00012,171078,19.87472,860782
18468,joezwlin,1,0.00012,171079,19.87483,860782
18469,johanatan,1,0.00012,171080,19.87495,860782
18470,johannes-riecken-dunnhumby,1,0.00012,171081,19.87507,860782
18471,Johannestegner,1,0.00012,171082,19.87518,860782
18472,johanstokking,1,0.00012,171083,19.87530,860782
18473,john01dav,1,0.00012,171084,19.87542,860782
18474,John-Athan,1,0.00012,171085,19.87553,860782
18475,johnbigley,1,0.00012,171086,19.87565,860782
18476,johnbywater,1,0.00012,171087,19.87576,860782
18477,johnc219,1,0.00012,171088,19.87588,860782
18478,johnceloria,1,0.00012,171089,19.87600,860782
18479,johndoe123441,1,0.00012,171090,19.87611,860782
18480,JohnGarbutt,1,0.00012,171091,19.87623,860782
18481,johnkazmerzak,1,0.00012,171092,19.87634,860782
18482,johnksv,1,0.00012,171093,19.87646,860782
18483,johnlindholm,1,0.00012,171094,19.87658,860782
18484,johnlolis,1,0.00012,171095,19.87669,860782
18485,johnmarkwayve,1,0.00012,171096,19.87681,860782
18486,johnmay1,1,0.00012,171097,19.87693,860782
18487,JohnnyElvis,1,0.00012,171098,19.87704,860782
18488,JohnOnTheWeb,1,0.00012,171099,19.87716,860782
18489,John-Oula,1,0.00012,171100,19.87727,860782
18490,johnpitralon,1,0.00012,171101,19.87739,860782
18491,johnr84,1,0.00012,171102,19.87751,860782
18492,JohnShahawy,1,0.00012,171103,19.87762,860782
18493,johnsmartco,1,0.00012,171104,19.87774,860782
18494,johnyannj,1,0.00012,171105,19.87786,860782
18495,joivo,1,0.00012,171106,19.87797,860782
18496,jolmg,1,0.00012,171107,19.87809,860782
18497,jonahzheng,1,0.00012,171108,19.87820,860782
18498,JonasChengAsus,1,0.00012,171109,19.87832,860782
18499,JonasDoe,1,0.00012,171110,19.87844,860782
18500,jonas-lindmark,1,0.00012,171111,19.87855,860782
18501,jonasscherer,1,0.00012,171112,19.87867,860782
18502,jonathancolby-olx,1,0.00012,171113,19.87878,860782
18503,jonathanmarston,1,0.00012,171114,19.87890,860782
18504,jonathanmccracken,1,0.00012,171115,19.87902,860782
18505,JonathanParrilla,1,0.00012,171116,19.87913,860782
18506,JonathanRRogers,1,0.00012,171117,19.87925,860782
18507,jonathanunderwood,1,0.00012,171118,19.87937,860782
18508,jonathanwalker,1,0.00012,171119,19.87948,860782
18509,joncnet,1,0.00012,171120,19.87960,860782
18510,joneshf-cn,1,0.00012,171121,19.87971,860782
18511,joni7777,1,0.00012,171122,19.87983,860782
18512,jonm-bb,1,0.00012,171123,19.87995,860782
18513,jonmeacham,1,0.00012,171124,19.88006,860782
18514,jonniespratley,1,0.00012,171125,19.88018,860782
18515,JonnyWaffles,1,0.00012,171126,19.88029,860782
18516,joostschriek,1,0.00012,171127,19.88041,860782
18517,jordanburke,1,0.00012,171128,19.88053,860782
18518,JordiCano,1,0.00012,171129,19.88064,860782
18519,Jordy24,1,0.00012,171130,19.88076,860782
18520,jorge-gasca,1,0.00012,171131,19.88088,860782
18521,JorgeGuerrero-dev,1,0.00012,171132,19.88099,860782
18522,JorgenRingen,1,0.00012,171133,19.88111,860782
18523,jorihardman,1,0.00012,171134,19.88122,860782
18524,jorik,1,0.00012,171135,19.88134,860782
18525,jorisdejosselin,1,0.00012,171136,19.88146,860782
18526,josdirksen,1,0.00012,171137,19.88157,860782
18527,josealmeida-vf,1,0.00012,171138,19.88169,860782
18528,josemanule4114,1,0.00012,171139,19.88181,860782
18529,josemigallas,1,0.00012,171140,19.88192,860782
18530,josephborg07,1,0.00012,171141,19.88204,860782
18531,josephdubeau,1,0.00012,171142,19.88215,860782
18532,josephflynch,1,0.00012,171143,19.88227,860782
18533,josephharrington,1,0.00012,171144,19.88239,860782
18534,josephreynolds,1,0.00012,171145,19.88250,860782
18535,josephspurrier,1,0.00012,171146,19.88262,860782
18536,Josepy,1,0.00012,171147,19.88273,860782
18537,josh626,1,0.00012,171148,19.88285,860782
18538,Josh-a-e,1,0.00012,171149,19.88297,860782
18539,joshcarp,1,0.00012,171150,19.88308,860782
18540,JoshHull-Wellsky,1,0.00012,171151,19.88320,860782
18541,josh-reed,1,0.00012,171152,19.88332,860782
18542,joshreic-db,1,0.00012,171153,19.88343,860782
18543,Joshscorp,1,0.00012,171154,19.88355,860782
18544,joshua-bone,1,0.00012,171155,19.88366,860782
18545,joshua-hester,1,0.00012,171156,19.88378,860782
18546,JoshuaSmeda,1,0.00012,171157,19.88390,860782
18547,josiahlaivins,1,0.00012,171158,19.88401,860782
18548,josiahruddell,1,0.00012,171159,19.88413,860782
18549,josiahsams,1,0.00012,171160,19.88424,860782
18550,josiemundi,1,0.00012,171161,19.88436,860782
18551,jossef,1,0.00012,171162,19.88448,860782
18552,joulaud,1,0.00012,171163,19.88459,860782
18553,JoupainMD,1,0.00012,171164,19.88471,860782
18554,JoveYu,1,0.00012,171165,19.88483,860782
18555,joyciep,1,0.00012,171166,19.88494,860782
18556,jozseffarago,1,0.00012,171167,19.88506,860782
18557,jpatters,1,0.00012,171168,19.88517,860782
18558,jpbalarini,1,0.00012,171169,19.88529,860782
18559,jpc204,1,0.00012,171170,19.88541,860782
18560,jpearsonmv,1,0.00012,171171,19.88552,860782
18561,JPedroSilveira,1,0.00012,171172,19.88564,860782
18562,jpenekusu,1,0.00012,171173,19.88576,860782
18563,jpepin,1,0.00012,171174,19.88587,860782
18564,jperl,1,0.00012,171175,19.88599,860782
18565,jpermar,1,0.00012,171176,19.88610,860782
18566,jphgardner,1,0.00012,171177,19.88622,860782
18567,jpirelli,1,0.00012,171178,19.88634,860782
18568,jpke,1,0.00012,171179,19.88645,860782
18569,jpower432,1,0.00012,171180,19.88657,860782
18570,jpvillalobos,1,0.00012,171181,19.88668,860782
18571,jpvosloo,1,0.00012,171182,19.88680,860782
18572,jquenel,1,0.00012,171183,19.88692,860782
18573,jquinnet,1,0.00012,171184,19.88703,860782
18574,jrab66,1,0.00012,171185,19.88715,860782
18575,jragland-cerity,1,0.00012,171186,19.88727,860782
18576,jrasanen,1,0.00012,171187,19.88738,860782
18577,jrcasso,1,0.00012,171188,19.88750,860782
18578,jreading,1,0.00012,171189,19.88761,860782
18579,jrefior,1,0.00012,171190,19.88773,860782
18580,jrgwv,1,0.00012,171191,19.88785,860782
18581,jrhee17,1,0.00012,171192,19.88796,860782
18582,jriehl,1,0.00012,171193,19.88808,860782
18583,jrozentur,1,0.00012,171194,19.88819,860782
18584,jrsalgado,1,0.00012,171195,19.88831,860782
18585,jruano03,1,0.00012,171196,19.88843,860782
18586,jsalatiel,1,0.00012,171197,19.88854,860782
18587,jsalgado78,1,0.00012,171198,19.88866,860782
18588,jschintag,1,0.00012,171199,19.88878,860782
18589,jschluchter,1,0.00012,171200,19.88889,860782
18590,JSchwehn,1,0.00012,171201,19.88901,860782
18591,jsdevalx,1,0.00012,171202,19.88912,860782
18592,jseriff,1,0.00012,171203,19.88924,860782
18593,jshrack-ssi,1,0.00012,171204,19.88936,860782
18594,jsihota,1,0.00012,171205,19.88947,860782
18595,jsiobj,1,0.00012,171206,19.88959,860782
18596,jsjain,1,0.00012,171207,19.88970,860782
18597,jsonbruce,1,0.00012,171208,19.88982,860782
18598,jsonmp-k8,1,0.00012,171209,19.88994,860782
18599,jspawar,1,0.00012,171210,19.89005,860782
18600,jspc,1,0.00012,171211,19.89017,860782
18601,jsporna,1,0.00012,171212,19.89029,860782
18602,jsrz,1,0.00012,171213,19.89040,860782
18603,jstafford5380,1,0.00012,171214,19.89052,860782
18604,jstewart612,1,0.00012,171215,19.89063,860782
18605,jswirl,1,0.00012,171216,19.89075,860782
18606,jtakakura,1,0.00012,171217,19.89087,860782
18607,jtlz2,1,0.00012,171218,19.89098,860782
18608,jtmcdole,1,0.00012,171219,19.89110,860782
18609,JTOne123,1,0.00012,171220,19.89122,860782
18610,juan-chan,1,0.00012,171221,19.89133,860782
18611,juanluisrp,1,0.00012,171222,19.89145,860782
18612,juan-martinez-hernandez,1,0.00012,171223,19.89156,860782
18613,juanpmarin,1,0.00012,171224,19.89168,860782
18614,juan-vg,1,0.00012,171225,19.89180,860782
18615,jubeergon,1,0.00012,171226,19.89191,860782
18616,juergen-walter,1,0.00012,171227,19.89203,860782
18617,Juggcode,1,0.00012,171228,19.89214,860782
18618,jugggao,1,0.00012,171229,19.89226,860782
18619,juhaku,1,0.00012,171230,19.89238,860782
18620,jujoramos,1,0.00012,171231,19.89249,860782
18621,juju4,1,0.00012,171232,19.89261,860782
18622,Jukka-A,1,0.00012,171233,19.89273,860782
18623,jukvalim,1,0.00012,171234,19.89284,860782
18624,julia0x00f,1,0.00012,171235,19.89296,860782
18625,julianguinard,1,0.00012,171236,19.89307,860782
18626,juliasimon,1,0.00012,171237,19.89319,860782
18627,juliendangers,1,0.00012,171238,19.89331,860782
18628,julio-solides,1,0.00012,171239,19.89342,860782
18629,JuliusTZM,1,0.00012,171240,19.89354,860782
18630,jullianoacqio,1,0.00012,171241,19.89365,860782
18631,Julyne,1,0.00012,171242,19.89377,860782
18632,jumble,1,0.00012,171243,19.89389,860782
18633,junhuangli,1,0.00012,171244,19.89400,860782
18634,junhwong,1,0.00012,171245,19.89412,860782
18635,junojuno90,1,0.00012,171246,19.89424,860782
18636,juno-yu,1,0.00012,171247,19.89435,860782
18637,junze-amz,1,0.00012,171248,19.89447,860782
18638,juriad,1,0.00012,171249,19.89458,860782
18639,just4est,1,0.00012,171250,19.89470,860782
18640,justcallmekoko,1,0.00012,171251,19.89482,860782
18641,justheuristic,1,0.00012,171252,19.89493,860782
18642,Justin2997,1,0.00012,171253,19.89505,860782
18643,justinfx,1,0.00012,171254,19.89517,860782
18644,justinGML,1,0.00012,171255,19.89528,860782
18645,justinrcs,1,0.00012,171256,19.89540,860782
18646,juulderuysscher,1,0.00012,171257,19.89551,860782
18647,jvaidyan,1,0.00012,171258,19.89563,860782
18648,JvalantPatel-MS,1,0.00012,171259,19.89575,860782
18649,jvandy83,1,0.00012,171260,19.89586,860782
18650,jverkoey,1,0.00012,171261,19.89598,860782
18651,jvnn,1,0.00012,171262,19.89609,860782
18652,jvshahid,1,0.00012,171263,19.89621,860782
18653,jwatte,1,0.00012,171264,19.89633,860782
18654,jwebb49,1,0.00012,171265,19.89644,860782
18655,jwhb,1,0.00012,171266,19.89656,860782
18656,jwitko,1,0.00012,171267,19.89668,860782
18657,jwlai,1,0.00012,171268,19.89679,860782
18658,jwldk,1,0.00012,171269,19.89691,860782
18659,jwm,1,0.00012,171270,19.89702,860782
18660,jwomble,1,0.00012,171271,19.89714,860782
18661,jwongz,1,0.00012,171272,19.89726,860782
18662,jwulf,1,0.00012,171273,19.89737,860782
18663,jwvictor,1,0.00012,171274,19.89749,860782
18664,jxyy,1,0.00012,171275,19.89760,860782
18665,jyipks,1,0.00012,171276,19.89772,860782
18666,jyyeom,1,0.00012,171277,19.89784,860782
18667,jzbyers,1,0.00012,171278,19.89795,860782
18668,jzhn,1,0.00012,171279,19.89807,860782
18669,jzskca,1,0.00012,171280,19.89819,860782
18670,jzyeezy,1,0.00012,171281,19.89830,860782
18671,k1rk,1,0.00012,171282,19.89842,860782
18672,k3daevin,1,0.00012,171283,19.89853,860782
18673,k3nny0ne,1,0.00012,171284,19.89865,860782
18674,k4ch0,1,0.00012,171285,19.89877,860782
18675,k8s42,1,0.00012,171286,19.89888,860782
18676,k8-scalar,1,0.00012,171287,19.89900,860782
18677,k8vance88,1,0.00012,171288,19.89911,860782
18678,kabaluyot,1,0.00012,171289,19.89923,860782
18679,kabutz,1,0.00012,171290,19.89935,860782
18680,kaceo,1,0.00012,171291,19.89946,860782
18681,kadzu,1,0.00012,171292,19.89958,860782
18682,kag0,1,0.00012,171293,19.89970,860782
18683,kahayes,1,0.00012,171294,19.89981,860782
18684,kaidotdev,1,0.00012,171295,19.89993,860782
18685,kainoaseto,1,0.00012,171296,19.90004,860782
18686,kainwei,1,0.00012,171297,19.90016,860782
18687,kaiomatico,1,0.00012,171298,19.90028,860782
18688,Kai-Richardson,1,0.00012,171299,19.90039,860782
18689,kaishah,1,0.00012,171300,19.90051,860782
18690,kajal241199,1,0.00012,171301,19.90063,860782
18691,kaka987,1,0.00012,171302,19.90074,860782
18692,kakarotta-silller,1,0.00012,171303,19.90086,860782
18693,kalid117658,1,0.00012,171304,19.90097,860782
18694,kally788,1,0.00012,171305,19.90109,860782
18695,kalyaganov,1,0.00012,171306,19.90121,860782
18696,kam1kaze,1,0.00012,171307,19.90132,860782
18697,kamal94,1,0.00012,171308,19.90144,860782
18698,KamalAman,1,0.00012,171309,19.90155,860782
18699,Kamaroth92,1,0.00012,171310,19.90167,860782
18700,kamazee,1,0.00012,171311,19.90179,860782
18701,kamikaze139,1,0.00012,171312,19.90190,860782
18702,KamilBabayev,1,0.00012,171313,19.90202,860782
18703,kamiljsokolowski,1,0.00012,171314,19.90214,860782
18704,KamilSwiech,1,0.00012,171315,19.90225,860782
18705,kamyuentse,1,0.00012,171316,19.90237,860782
18706,kandy,1,0.00012,171317,19.90248,860782
18707,KangKornel,1,0.00012,171318,19.90260,860782
18708,kanishka-azimi,1,0.00012,171319,19.90272,860782
18709,kanistha,1,0.00012,171320,19.90283,860782
18710,kanouken,1,0.00012,171321,19.90295,860782
18711,KansaiUser,1,0.00012,171322,19.90306,860782
18712,Kanshar,1,0.00012,171323,19.90318,860782
18713,Kanshiroron,1,0.00012,171324,19.90330,860782
18714,kaos,1,0.00012,171325,19.90341,860782
18715,Kapil9711,1,0.00012,171326,19.90353,860782
18716,kapil-saratkar,1,0.00012,171327,19.90365,860782
18717,kapilsharma432001,1,0.00012,171328,19.90376,860782
18718,kapooklovely,1,0.00012,171329,19.90388,860782
18719,karan-kapoor90,1,0.00012,171330,19.90399,860782
18720,karan-kaushik,1,0.00012,171331,19.90411,860782
18721,karasirakesh86,1,0.00012,171332,19.90423,860782
18722,KardiffInker,1,0.00012,171333,19.90434,860782
18723,karhub90,1,0.00012,171334,19.90446,860782
18724,karibertils,1,0.00012,171335,19.90458,860782
18725,karimhm,1,0.00012,171336,19.90469,860782
18726,karnveerayush,1,0.00012,171337,19.90481,860782
18727,karstland,1,0.00012,171338,19.90492,860782
18728,kartheekmunaga,1,0.00012,171339,19.90504,860782
18729,karthikraobr,1,0.00012,171340,19.90516,860782
18730,Karukas,1,0.00012,171341,19.90527,860782
18731,kasriniv,1,0.00012,171342,19.90539,860782
18732,kasterma,1,0.00012,171343,19.90550,860782
18733,kasturinarra,1,0.00012,171344,19.90562,860782
18734,kasvith,1,0.00012,171345,19.90574,860782
18735,katchinskiy1,1,0.00012,171346,19.90585,860782
18736,Katheesh,1,0.00012,171347,19.90597,860782
18737,katiewasnothere,1,0.00012,171348,19.90609,860782
18738,katjur,1,0.00012,171349,19.90620,860782
18739,katlimruiz,1,0.00012,171350,19.90632,860782
18740,katmai,1,0.00012,171351,19.90643,860782
18741,katpagavalli,1,0.00012,171352,19.90655,860782
18742,kauedg,1,0.00012,171353,19.90667,860782
18743,kaungsoe,1,0.00012,171354,19.90678,860782
18744,kaushalyap,1,0.00012,171355,19.90690,860782
18745,kautkata,1,0.00012,171356,19.90701,860782
18746,kaxap,1,0.00012,171357,19.90713,860782
18747,kaxil,1,0.00012,171358,19.90725,860782
18748,kazimsarikaya,1,0.00012,171359,19.90736,860782
18749,kazuhitoyokoi,1,0.00012,171360,19.90748,860782
18750,kazvictor,1,0.00012,171361,19.90760,860782
18751,kbakk,1,0.00012,171362,19.90771,860782
18752,kbbqiu,1,0.00012,171363,19.90783,860782
18753,kbokarius,1,0.00012,171364,19.90794,860782
18754,kbrown,1,0.00012,171365,19.90806,860782
18755,kbsivacse,1,0.00012,171366,19.90818,860782
18756,kbsquared,1,0.00012,171367,19.90829,860782
18757,kcdevops46,1,0.00012,171368,19.90841,860782
18758,kchaber,1,0.00012,171369,19.90853,860782
18759,kclinden,1,0.00012,171370,19.90864,860782
18760,kcns008,1,0.00012,171371,19.90876,860782
18761,kconwayinvision,1,0.00012,171372,19.90887,860782
18762,kcq,1,0.00012,171373,19.90899,860782
18763,kcsplcompusoft,1,0.00012,171374,19.90911,860782
18764,kdorosh,1,0.00012,171375,19.90922,860782
18765,keegan-lillo,1,0.00012,171376,19.90934,860782
18766,keisuke-maesako,1,0.00012,171377,19.90945,860782
18767,kellengreen,1,0.00012,171378,19.90957,860782
18768,KellerKnebel,1,0.00012,171379,19.90969,860782
18769,KellyGriffin,1,0.00012,171380,19.90980,860782
18770,kellysan,1,0.00012,171381,19.90992,860782
18771,kelpisland,1,0.00012,171382,19.91004,860782
18772,kelsin,1,0.00012,171383,19.91015,860782
18773,kelvin-yue-scmp,1,0.00012,171384,19.91027,860782
18774,kenjapkowalczyk,1,0.00012,171385,19.91038,860782
18775,kenke7,1,0.00012,171386,19.91050,860782
18776,kennedyalexander,1,0.00012,171387,19.91062,860782
18777,kenschneider18,1,0.00012,171388,19.91073,860782
18778,kenske,1,0.00012,171389,19.91085,860782
18779,kentonbmax,1,0.00012,171390,19.91096,860782
18780,kerenskybr,1,0.00012,171391,19.91108,860782
18781,KernCheh,1,0.00012,171392,19.91120,860782
18782,kertak90,1,0.00012,171393,19.91131,860782
18783,kesavan96,1,0.00012,171394,19.91143,860782
18784,kesavkolla,1,0.00012,171395,19.91155,860782
18785,Kesudan,1,0.00012,171396,19.91166,860782
18786,Kevin-Bannier,1,0.00012,171397,19.91178,860782
18787,kevingosse,1,0.00012,171398,19.91189,860782
18788,kevin-hanselman,1,0.00012,171399,19.91201,860782
18789,kevinj-z,1,0.00012,171400,19.91213,860782
18790,kevin-lindsay-1,1,0.00012,171401,19.91224,860782
18791,kevinlmadison,1,0.00012,171402,19.91236,860782
18792,kevinmichaelchen,1,0.00012,171403,19.91247,860782
18793,kevin-pro,1,0.00012,171404,19.91259,860782
18794,kevin-shelaga,1,0.00012,171405,19.91271,860782
18795,KevinSheridan,1,0.00012,171406,19.91282,860782
18796,kevinyaoxm,1,0.00012,171407,19.91294,860782
18797,KeyOfSpectator,1,0.00012,171408,19.91306,860782
18798,KeyToon9,1,0.00012,171409,19.91317,860782
18799,keyurdg,1,0.00012,171410,19.91329,860782
18800,kfyharukz,1,0.00012,171411,19.91340,860782
18801,kgignatyev,1,0.00012,171412,19.91352,860782
18802,kg-ops,1,0.00012,171413,19.91364,860782
18803,kgreed,1,0.00012,171414,19.91375,860782
18804,kgriffiths,1,0.00012,171415,19.91387,860782
18805,khadka-prakash,1,0.00012,171416,19.91399,860782
18806,khaledavarteq,1,0.00012,171417,19.91410,860782
18807,khalilgharbaoui,1,0.00012,171418,19.91422,860782
18808,Khamphai,1,0.00012,171419,19.91433,860782
18809,KhandelwalA,1,0.00012,171420,19.91445,860782
18810,khanhtc1202,1,0.00012,171421,19.91457,860782
18811,khantilpatel,1,0.00012,171422,19.91468,860782
18812,kharf,1,0.00012,171423,19.91480,860782
18813,kharmabum,1,0.00012,171424,19.91491,860782
18814,khawajaAtteeq,1,0.00012,171425,19.91503,860782
18815,Khawandjean,1,0.00012,171426,19.91515,860782
18816,khayyamsaleem,1,0.00012,171427,19.91526,860782
18817,kheengz,1,0.00012,171428,19.91538,860782
18818,khemarachuon,1,0.00012,171429,19.91550,860782
18819,khewling,1,0.00012,171430,19.91561,860782
18820,khoutz182,1,0.00012,171431,19.91573,860782
18821,kHRISl33t,1,0.00012,171432,19.91584,860782
18822,khsabhishek,1,0.00012,171433,19.91596,860782
18823,khsahaji,1,0.00012,171434,19.91608,860782
18824,khurlic-springlabs,1,0.00012,171435,19.91619,860782
18825,khusseini,1,0.00012,171436,19.91631,860782
18826,kibala145,1,0.00012,171437,19.91642,860782
18827,kidnan1991,1,0.00012,171438,19.91654,860782
18828,kienct89,1,0.00012,171439,19.91666,860782
18829,kierankelleher,1,0.00012,171440,19.91677,860782
18830,kieronlangdon,1,0.00012,171441,19.91689,860782
18831,kijinpark,1,0.00012,171442,19.91701,860782
18832,kikicarbonell,1,0.00012,171443,19.91712,860782
18833,kikogolk,1,0.00012,171444,19.91724,860782
18834,killme2008,1,0.00012,171445,19.91735,860782
18835,kimbell,1,0.00012,171446,19.91747,860782
18836,KimJiAh,1,0.00012,171447,19.91759,860782
18837,kinderyj,1,0.00012,171448,19.91770,860782
18838,kindule,1,0.00012,171449,19.91782,860782
18839,KingDacker,1,0.00012,171450,19.91794,860782
18840,kingdevnl,1,0.00012,171451,19.91805,860782
18841,kingfai,1,0.00012,171452,19.91817,860782
18842,kingfeiyu1,1,0.00012,171453,19.91828,860782
18843,kingkazzy28,1,0.00012,171454,19.91840,860782
18844,kingthai,1,0.00012,171455,19.91852,860782
18845,kiran009,1,0.00012,171456,19.91863,860782
18846,KiranCS-17,1,0.00012,171457,19.91875,860782
18847,kiransmartclean,1,0.00012,171458,19.91886,860782
18848,kirbyzhou,1,0.00012,171459,19.91898,860782
18849,kireledan,1,0.00012,171460,19.91910,860782
18850,kirintwn,1,0.00012,171461,19.91921,860782
18851,kirkre,1,0.00012,171462,19.91933,860782
18852,kiros-sc,1,0.00012,171463,19.91945,860782
18853,kirtiapte,1,0.00012,171464,19.91956,860782
18854,kisahm,1,0.00012,171465,19.91968,860782
18855,kishansagathiya,1,0.00012,171466,19.91979,860782
18856,kishore3us,1,0.00012,171467,19.91991,860782
18857,kishorejm,1,0.00012,171468,19.92003,860782
18858,kislitsyn,1,0.00012,171469,19.92014,860782
18859,kistofer,1,0.00012,171470,19.92026,860782
18860,kitttsu,1,0.00012,171471,19.92037,860782
18861,kityun,1,0.00012,171472,19.92049,860782
18862,kiwi1969,1,0.00012,171473,19.92061,860782
18863,kjellaso,1,0.00012,171474,19.92072,860782
18864,kjordy,1,0.00012,171475,19.92084,860782
18865,kjpianeta,1,0.00012,171476,19.92096,860782
18866,kjroger94,1,0.00012,171477,19.92107,860782
18867,kkcclok,1,0.00012,171478,19.92119,860782
18868,kkcmadhu,1,0.00012,171479,19.92130,860782
18869,kkfinkkfin,1,0.00012,171480,19.92142,860782
18870,kkkarthik,1,0.00012,171481,19.92154,860782
18871,kkmathigir,1,0.00012,171482,19.92165,860782
18872,kkorada,1,0.00012,171483,19.92177,860782
18873,kkothapelly,1,0.00012,171484,19.92188,860782
18874,kkourtchikov,1,0.00012,171485,19.92200,860782
18875,kkovachev,1,0.00012,171486,19.92212,860782
18876,kkwell,1,0.00012,171487,19.92223,860782
18877,kkzz8888,1,0.00012,171488,19.92235,860782
18878,klatek,1,0.00012,171489,19.92247,860782
18879,klaus1534,1,0.00012,171490,19.92258,860782
18880,klauu25,1,0.00012,171491,19.92270,860782
18881,klevermonicker,1,0.00012,171492,19.92281,860782
18882,kleysonr,1,0.00012,171493,19.92293,860782
18883,klicki,1,0.00012,171494,19.92305,860782
18884,klimksh,1,0.00012,171495,19.92316,860782
18885,klin111,1,0.00012,171496,19.92328,860782
18886,klingaladinne,1,0.00012,171497,19.92340,860782
18887,klingenm,1,0.00012,171498,19.92351,860782
18888,klkyy2020,1,0.00012,171499,19.92363,860782
18889,klolos,1,0.00012,171500,19.92374,860782
18890,kloudd,1,0.00012,171501,19.92386,860782
18891,kluevandrew,1,0.00012,171502,19.92398,860782
18892,klutchell,1,0.00012,171503,19.92409,860782
18893,klzsysy,1,0.00012,171504,19.92421,860782
18894,KM612,1,0.00012,171505,19.92432,860782
18895,kmajic,1,0.00012,171506,19.92444,860782
18896,kmorning,1,0.00012,171507,19.92456,860782
18897,kmp59,1,0.00012,171508,19.92467,860782
18898,kmturley,1,0.00012,171509,19.92479,860782
18899,knewcomerRH,1,0.00012,171510,19.92491,860782
18900,knewter,1,0.00012,171511,19.92502,860782
18901,knfoo,1,0.00012,171512,19.92514,860782
18902,KnifeyMoloko,1,0.00012,171513,19.92525,860782
18903,knight622,1,0.00012,171514,19.92537,860782
18904,knightyau,1,0.00012,171515,19.92549,860782
18905,Knkvyas,1,0.00012,171516,19.92560,860782
18906,Knowledge91,1,0.00012,171517,19.92572,860782
18907,knuesel,1,0.00012,171518,19.92583,860782
18908,ko4ura,1,0.00012,171519,19.92595,860782
18909,koalp,1,0.00012,171520,19.92607,860782
18910,kobe860219,1,0.00012,171521,19.92618,860782
18911,kobeHub,1,0.00012,171522,19.92630,860782
18912,kochetovd,1,0.00012,171523,19.92642,860782
18913,kochsoft,1,0.00012,171524,19.92653,860782
18914,kodeninja,1,0.00012,171525,19.92665,860782
18915,kody-abe,1,0.00012,171526,19.92676,860782
18916,koflTS,1,0.00012,171527,19.92688,860782
18917,KoichiSenada,1,0.00012,171528,19.92700,860782
18918,kokizzu,1,0.00012,171529,19.92711,860782
18919,kolbe,1,0.00012,171530,19.92723,860782
18920,kolinko-ant,1,0.00012,171531,19.92735,860782
18921,komoo1,1,0.00012,171532,19.92746,860782
18922,komuw,1,0.00012,171533,19.92758,860782
18923,kondalonline,1,0.00012,171534,19.92769,860782
18924,konduktor4ik,1,0.00012,171535,19.92781,860782
18925,konghui,1,0.00012,171536,19.92793,860782
18926,kongkongk,1,0.00012,171537,19.92804,860782
18927,KongSteve,1,0.00012,171538,19.92816,860782
18928,konradlykowski,1,0.00012,171539,19.92827,860782
18929,konradreiche,1,0.00012,171540,19.92839,860782
18930,konstantin-kornienko,1,0.00012,171541,19.92851,860782
18931,konste,1,0.00012,171542,19.92862,860782
18932,koomalkc,1,0.00012,171543,19.92874,860782
18933,koper89,1,0.00012,171544,19.92886,860782
18934,koperko,1,0.00012,171545,19.92897,860782
18935,koraysels,1,0.00012,171546,19.92909,860782
18936,Koriit,1,0.00012,171547,19.92920,860782
18937,korivikeerthi,1,0.00012,171548,19.92932,860782
18938,Korsani,1,0.00012,171549,19.92944,860782
18939,Koshti1907,1,0.00012,171550,19.92955,860782
18940,KOSSOKO,1,0.00012,171551,19.92967,860782
18941,kousik93,1,0.00012,171552,19.92978,860782
18942,kovalev94,1,0.00012,171553,19.92990,860782
18943,kovalyukm,1,0.00012,171554,19.93002,860782
18944,koyakei,1,0.00012,171555,19.93013,860782
18945,kozell,1,0.00012,171556,19.93025,860782
18946,kozelok,1,0.00012,171557,19.93037,860782
18947,kpanus,1,0.00012,171558,19.93048,860782
18948,kpbasu,1,0.00012,171559,19.93060,860782
18949,kprasad99,1,0.00012,171560,19.93071,860782
18950,kPsarakis,1,0.00012,171561,19.93083,860782
18951,kpsrinivas,1,0.00012,171562,19.93095,860782
18952,krady21,1,0.00012,171563,19.93106,860782
18953,krakazyabra,1,0.00012,171564,19.93118,860782
18954,krampton20,1,0.00012,171565,19.93130,860782
18955,KreatifSolution,1,0.00012,171566,19.93141,860782
18956,krisai,1,0.00012,171567,19.93153,860782
18957,krisclarkdev,1,0.00012,171568,19.93164,860782
18958,KrisJohnstone,1,0.00012,171569,19.93176,860782
18959,krotovic,1,0.00012,171570,19.93188,860782
18960,krunching,1,0.00012,171571,19.93199,860782
18961,krushik,1,0.00012,171572,19.93211,860782
18962,KrustyHack,1,0.00012,171573,19.93222,860782
18963,krylatij,1,0.00012,171574,19.93234,860782
18964,krystan,1,0.00012,171575,19.93246,860782
18965,krystiannowak,1,0.00012,171576,19.93257,860782
18966,ksaminat,1,0.00012,171577,19.93269,860782
18967,ksanchez15,1,0.00012,171578,19.93281,860782
18968,KsanterX,1,0.00012,171579,19.93292,860782
18969,kshcherban,1,0.00012,171580,19.93304,860782
18970,KSiig,1,0.00012,171581,19.93315,860782
18971,ksnithya,1,0.00012,171582,19.93327,860782
18972,kstenerud,1,0.00012,171583,19.93339,860782
18973,ksummersill,1,0.00012,171584,19.93350,860782
18974,ktjooho,1,0.00012,171585,19.93362,860782
18975,ktreese,1,0.00012,171586,19.93373,860782
18976,kuaiwenwu,1,0.00012,171587,19.93385,860782
18977,kubbo,1,0.00012,171588,19.93397,860782
18978,kubermates,1,0.00012,171589,19.93408,860782
18979,kuberxy,1,0.00012,171590,19.93420,860782
18980,kuc,1,0.00012,171591,19.93432,860782
18981,kuiwang02,1,0.00012,171592,19.93443,860782
18982,kuldeep14327,1,0.00012,171593,19.93455,860782
18983,kuldeeps88,1,0.00012,171594,19.93466,860782
18984,KumarGajavalli,1,0.00012,171595,19.93478,860782
18985,kumarks1122,1,0.00012,171596,19.93490,860782
18986,kumar-mayadata,1,0.00012,171597,19.93501,860782
18987,kumarnitesh2000,1,0.00012,171598,19.93513,860782
18988,kunalgarg187,1,0.00012,171599,19.93524,860782
18989,KungWanyi,1,0.00012,171600,19.93536,860782
18990,kurczynski,1,0.00012,171601,19.93548,860782
18991,kureuil,1,0.00012,171602,19.93559,860782
18992,KurKestutis,1,0.00012,171603,19.93571,860782
18993,kvalev,1,0.00012,171604,19.93583,860782
18994,kv-gits,1,0.00012,171605,19.93594,860782
18995,K-Visscher,1,0.00012,171606,19.93606,860782
18996,kw2019ltd,1,0.00012,171607,19.93617,860782
18997,kwill4026,1,0.00012,171608,19.93629,860782
18998,kwizzn,1,0.00012,171609,19.93641,860782
18999,kwsorensen,1,0.00012,171610,19.93652,860782
19000,k-y,1,0.00012,171611,19.93664,860782
19001,kycheng,1,0.00012,171612,19.93676,860782
19002,kyle29,1,0.00012,171613,19.93687,860782
19003,kylefleming,1,0.00012,171614,19.93699,860782
19004,kylepw,1,0.00012,171615,19.93710,860782
19005,kylerisse,1,0.00012,171616,19.93722,860782
19006,Kyle-sandeman-mrdfood,1,0.00012,171617,19.93734,860782
19007,kyleterry,1,0.00012,171618,19.93745,860782
19008,kylezs,1,0.00012,171619,19.93757,860782
19009,kymcaris,1,0.00012,171620,19.93768,860782
19010,kyohwang,1,0.00012,171621,19.93780,860782
19011,kyopark2014,1,0.00012,171622,19.93792,860782
19012,Kyrluckechuck,1,0.00012,171623,19.93803,860782
19013,KyteProject,1,0.00012,171624,19.93815,860782
19014,ky-to,1,0.00012,171625,19.93827,860782
19015,kz12123,1,0.00012,171626,19.93838,860782
19016,l3omtz,1,0.00012,171627,19.93850,860782
19017,Labbs,1,0.00012,171628,19.93861,860782
19018,lachee10,1,0.00012,171629,19.93873,860782
19019,lachie-white,1,0.00012,171630,19.93885,860782
19020,lachlanmunro,1,0.00012,171631,19.93896,860782
19021,lachlan-roberts,1,0.00012,171632,19.93908,860782
19022,lackstein,1,0.00012,171633,19.93919,860782
19023,laevilgenius,1,0.00012,171634,19.93931,860782
19024,lagess,1,0.00012,171635,19.93943,860782
19025,laidinidis,1,0.00012,171636,19.93954,860782
19026,lakgan,1,0.00012,171637,19.93966,860782
19027,Lakshmisowmya,1,0.00012,171638,19.93978,860782
19028,lalinsky,1,0.00012,171639,19.93989,860782
19029,lamLeX,1,0.00012,171640,19.94001,860782
19030,lampnick,1,0.00012,171641,19.94012,860782
19031,LAnastasiia,1,0.00012,171642,19.94024,860782
19032,lancez77,1,0.00012,171643,19.94036,860782
19033,Lancger,1,0.00012,171644,19.94047,860782
19034,lanez,1,0.00012,171645,19.94059,860782
19035,langesven,1,0.00012,171646,19.94071,860782
19036,lanru2001,1,0.00012,171647,19.94082,860782
19037,lanyyyy,1,0.00012,171648,19.94094,860782
19038,laobaitou,1,0.00012,171649,19.94105,860782
19039,laoyao-ch,1,0.00012,171650,19.94117,860782
19040,laplasz,1,0.00012,171651,19.94129,860782
19041,laradji,1,0.00012,171652,19.94140,860782
19042,larenelg,1,0.00012,171653,19.94152,860782
19043,larosek,1,0.00012,171654,19.94163,860782
19044,Larry1314,1,0.00012,171655,19.94175,860782
19045,larrywax,1,0.00012,171656,19.94187,860782
19046,LarsAC,1,0.00012,171657,19.94198,860782
19047,larsclaussen,1,0.00012,171658,19.94210,860782
19048,larsderidder,1,0.00012,171659,19.94222,860782
19049,lars-nielsen,1,0.00012,171660,19.94233,860782
19050,larsrnielsen,1,0.00012,171661,19.94245,860782
19051,larswirzenius,1,0.00012,171662,19.94256,860782
19052,lassegaardsholt,1,0.00012,171663,19.94268,860782
19053,latermonk,1,0.00012,171664,19.94280,860782
19054,latrommi-downloader,1,0.00012,171665,19.94291,860782
19055,lauatic,1,0.00012,171666,19.94303,860782
19056,lauer,1,0.00012,171667,19.94314,860782
19057,laundry-96,1,0.00012,171668,19.94326,860782
19058,laupow,1,0.00012,171669,19.94338,860782
19059,laurentgrangeau,1,0.00012,171670,19.94349,860782
19060,laurentiuspurba,1,0.00012,171671,19.94361,860782
19061,laurfx,1,0.00012,171672,19.94373,860782
19062,laurosn,1,0.00012,171673,19.94384,860782
19063,laurybueno,1,0.00012,171674,19.94396,860782
19064,lavasana,1,0.00012,171675,19.94407,860782
19065,lavleenn,1,0.00012,171676,19.94419,860782
19066,law53,1,0.00012,171677,19.94431,860782
19067,law-lee,1,0.00012,171678,19.94442,860782
19068,Lawliet-Chan,1,0.00012,171679,19.94454,860782
19069,lawrencejones,1,0.00012,171680,19.94465,860782
19070,laxmanlax,1,0.00012,171681,19.94477,860782
19071,laxmihub,1,0.00012,171682,19.94489,860782
19072,LaysDragon,1,0.00012,171683,19.94500,860782
19073,lazyfrosch,1,0.00012,171684,19.94512,860782
19074,lazyprogram,1,0.00012,171685,19.94524,860782
19075,lbeeon,1,0.00012,171686,19.94535,860782
19076,lbf19881016,1,0.00012,171687,19.94547,860782
19077,LB-J,1,0.00012,171688,19.94558,860782
19078,lbjarre,1,0.00012,171689,19.94570,860782
19079,lbs-rodrigo,1,0.00012,171690,19.94582,860782
19080,lcaballero,1,0.00012,171691,19.94593,860782
19081,lcabancla,1,0.00012,171692,19.94605,860782
19082,lcontini,1,0.00012,171693,19.94617,860782
19083,lcotonea,1,0.00012,171694,19.94628,860782
19084,LCvijovic09,1,0.00012,171695,19.94640,860782
19085,ldadams,1,0.00012,171696,19.94651,860782
19086,lday0321,1,0.00012,171697,19.94663,860782
19087,ldbecker,1,0.00012,171698,19.94675,860782
19088,ldco2016,1,0.00012,171699,19.94686,860782
19089,ldeng-ustc,1,0.00012,171700,19.94698,860782
19090,ldipaolaIT,1,0.00012,171701,19.94709,860782
19091,ldurandadomia,1,0.00012,171702,19.94721,860782
19092,Le0nlck,1,0.00012,171703,19.94733,860782
19093,leaf-ces,1,0.00012,171704,19.94744,860782
19094,leahneukirchen,1,0.00012,171705,19.94756,860782
19095,leandroandrade87,1,0.00012,171706,19.94768,860782
19096,leandro-manifesto,1,0.00012,171707,19.94779,860782
19097,LeankitJSmith,1,0.00012,171708,19.94791,860782
19098,Leanneknott51,1,0.00012,171709,19.94802,860782
19099,Learnfr,1,0.00012,171710,19.94814,860782
19100,LearnKen,1,0.00012,171711,19.94826,860782
19101,lechuk47,1,0.00012,171712,19.94837,860782
19102,Lechus,1,0.00012,171713,19.94849,860782
19103,lee5i3,1,0.00012,171714,19.94860,860782
19104,leeadh,1,0.00012,171715,19.94872,860782
19105,leefaus,1,0.00012,171716,19.94884,860782
19106,leefbiant,1,0.00012,171717,19.94895,860782
19107,lefeverd,1,0.00012,171718,19.94907,860782
19108,le-garden-fox,1,0.00012,171719,19.94919,860782
19109,Legym,1,0.00012,171720,19.94930,860782
19110,LEI,1,0.00012,171721,19.94942,860782
19111,leifnel,1,0.00012,171722,19.94953,860782
19112,lekaf974,1,0.00012,171723,19.94965,860782
19113,lemkepf,1,0.00012,171724,19.94977,860782
19114,lemonit-eric-mao,1,0.00012,171725,19.94988,860782
19115,lentus,1,0.00012,171726,19.95000,860782
19116,lenye,1,0.00012,171727,19.95012,860782
19117,Leo7654,1,0.00012,171728,19.95023,860782
19118,leo8a,1,0.00012,171729,19.95035,860782
19119,leoamp,1,0.00012,171730,19.95046,860782
19120,leo-buneev,1,0.00012,171731,19.95058,860782
19121,leodamasceno,1,0.00012,171732,19.95070,860782
19122,leoddias,1,0.00012,171733,19.95081,860782
19123,leolid1m,1,0.00012,171734,19.95093,860782
19124,leon0204,1,0.00012,171735,19.95104,860782
19125,leongwq,1,0.00012,171736,19.95116,860782
19126,leonjalfon1,1,0.00012,171737,19.95128,860782
19127,LeonYanghaha,1,0.00012,171738,19.95139,860782
19128,leoppro,1,0.00012,171739,19.95151,860782
19129,LeoSkyeer,1,0.00012,171740,19.95163,860782
19130,leovigna,1,0.00012,171741,19.95174,860782
19131,leowucn,1,0.00012,171742,19.95186,860782
19132,LeoYang90,1,0.00012,171743,19.95197,860782
19133,lespea,1,0.00012,171744,19.95209,860782
19134,lev-kuznetsov,1,0.00012,171745,19.95221,860782
19135,Levvy055,1,0.00012,171746,19.95232,860782
19136,levydori,1,0.00012,171747,19.95244,860782
19137,lewijw,1,0.00012,171748,19.95255,860782
19138,lewislbr,1,0.00012,171749,19.95267,860782
19139,lewismc,1,0.00012,171750,19.95279,860782
19140,lex-erik,1,0.00012,171751,19.95290,860782
19141,lfillmore,1,0.00012,171752,19.95302,860782
19142,lfstm,1,0.00012,171753,19.95314,860782
19143,lfts,1,0.00012,171754,19.95325,860782
19144,lgebhardt,1,0.00012,171755,19.95337,860782
19145,lgelfan,1,0.00012,171756,19.95348,860782
19146,lgillot-lamure-ledger,1,0.00012,171757,19.95360,860782
19147,lhaussknecht,1,0.00012,171758,19.95372,860782
19148,lhmoraes,1,0.00012,171759,19.95383,860782
19149,lhtlp1997,1,0.00012,171760,19.95395,860782
19150,LiamMorrow,1,0.00012,171761,19.95407,860782
19151,liangfangyin,1,0.00012,171762,19.95418,860782
19152,liangjsbfy,1,0.00012,171763,19.95430,860782
19153,LIANGQI0811,1,0.00012,171764,19.95441,860782
19154,liaojh1998,1,0.00012,171765,19.95453,860782
19155,libardolara,1,0.00012,171766,19.95465,860782
19156,liboyue23,1,0.00012,171767,19.95476,860782
19157,liclac,1,0.00012,171768,19.95488,860782
19158,lidengjia1,1,0.00012,171769,19.95499,860782
19159,lidorg-dev,1,0.00012,171770,19.95511,860782
19160,lienharc,1,0.00012,171771,19.95523,860782
19161,life123,1,0.00012,171772,19.95534,860782
19162,life1347,1,0.00012,171773,19.95546,860782
19163,liger1978,1,0.00012,171774,19.95558,860782
19164,ligh0721,1,0.00012,171775,19.95569,860782
19165,LighthouseJ,1,0.00012,171776,19.95581,860782
19166,lightnet328,1,0.00012,171777,19.95592,860782
19167,lightning130,1,0.00012,171778,19.95604,860782
19168,lightsaway,1,0.00012,171779,19.95616,860782
19169,lightyear15,1,0.00012,171780,19.95627,860782
19170,lihonosov,1,0.00012,171781,19.95639,860782
19171,lihuixian001,1,0.00012,171782,19.95650,860782
19172,lijinchao,1,0.00012,171783,19.95662,860782
19173,likaiwen123,1,0.00012,171784,19.95674,860782
19174,lileitongxue,1,0.00012,171785,19.95685,860782
19175,lilinji,1,0.00012,171786,19.95697,860782
19176,lilleswing,1,0.00012,171787,19.95709,860782
19177,limberger,1,0.00012,171788,19.95720,860782
19178,limecheng,1,0.00012,171789,19.95732,860782
19179,limod,1,0.00012,171790,19.95743,860782
19180,linax101,1,0.00012,171791,19.95755,860782
19181,linchong,1,0.00012,171792,19.95767,860782
19182,Lincon-Freitas,1,0.00012,171793,19.95778,860782
19183,linde,1,0.00012,171794,19.95790,860782
19184,lindlof,1,0.00012,171795,19.95801,860782
19185,Line38,1,0.00012,171796,19.95813,860782
19186,linenlin01,1,0.00012,171797,19.95825,860782
19187,LinghanX,1,0.00012,171798,19.95836,860782
19188,linkt,1,0.00012,171799,19.95848,860782
19189,linkxzhou,1,0.00012,171800,19.95860,860782
19190,Linutux,1,0.00012,171801,19.95871,860782
19191,linuxfan84,1,0.00012,171802,19.95883,860782
19192,Linxi-brave,1,0.00012,171803,19.95894,860782
19193,linyinli,1,0.00012,171804,19.95906,860782
19194,liopalacios,1,0.00012,171805,19.95918,860782
19195,lioramilbaum,1,0.00012,171806,19.95929,860782
19196,liorhasson,1,0.00012,171807,19.95941,860782
19197,liorschwimmer,1,0.00012,171808,19.95953,860782
19198,liozzazhang,1,0.00012,171809,19.95964,860782
19199,lipangeng,1,0.00012,171810,19.95976,860782
19200,LipingSun,1,0.00012,171811,19.95987,860782
19201,lipore,1,0.00012,171812,19.95999,860782
19202,liqweed,1,0.00012,171813,19.96011,860782
19203,Liraim,1,0.00012,171814,19.96022,860782
19204,LiranBri,1,0.00012,171815,19.96034,860782
19205,Lirt,1,0.00012,171816,19.96045,860782
19206,LisaFournet8,1,0.00012,171817,19.96057,860782
19207,lishinho,1,0.00012,171818,19.96069,860782
19208,liskl,1,0.00012,171819,19.96080,860782
19209,listenerri,1,0.00012,171820,19.96092,860782
19210,litao20102546,1,0.00012,171821,19.96104,860782
19211,litaobowl,1,0.00012,171822,19.96115,860782
19212,littlebenlittle,1,0.00012,171823,19.96127,860782
19213,LittleChimera,1,0.00012,171824,19.96138,860782
19214,little-guy-lxr,1,0.00012,171825,19.96150,860782
19215,littlehome-eugene,1,0.00012,171826,19.96162,860782
19216,littlejiajia322,1,0.00012,171827,19.96173,860782
19217,liu6488,1,0.00012,171828,19.96185,860782
19218,Liudapeng,1,0.00012,171829,19.96196,860782
19219,liudechi7,1,0.00012,171830,19.96208,860782
19220,liudonggang,1,0.00012,171831,19.96220,860782
19221,liuerfire,1,0.00012,171832,19.96231,860782
19222,liuhao2050,1,0.00012,171833,19.96243,860782
19223,liuht777,1,0.00012,171834,19.96255,860782
19224,liurui-1,1,0.00012,171835,19.96266,860782
19225,liushenf,1,0.00012,171836,19.96278,860782
19226,liusi123,1,0.00012,171837,19.96289,860782
19227,liuweidadada,1,0.00012,171838,19.96301,860782
19228,liuwh08,1,0.00012,171839,19.96313,860782
19229,liuxunorg,1,0.00012,171840,19.96324,860782
19230,liuyk0109,1,0.00012,171841,19.96336,860782
19231,liuyuewen91,1,0.00012,171842,19.96348,860782
19232,lixuefeng2,1,0.00012,171843,19.96359,860782
19233,liyaka,1,0.00012,171844,19.96371,860782
19234,Liyeshe,1,0.00012,171845,19.96382,860782
19235,liyiheng,1,0.00012,171846,19.96394,860782
19236,liyk1024,1,0.00012,171847,19.96406,860782
19237,liza-mae,1,0.00012,171848,19.96417,860782
19238,lizfeed,1,0.00012,171849,19.96429,860782
19239,lizhichao,1,0.00012,171850,19.96440,860782
19240,ljcremer,1,0.00012,171851,19.96452,860782
19241,ljeromets,1,0.00012,171852,19.96464,860782
19242,ljfreelancer88,1,0.00012,171853,19.96475,860782
19243,ljodal,1,0.00012,171854,19.96487,860782
19244,ljun51,1,0.00012,171855,19.96499,860782
19245,lk153,1,0.00012,171856,19.96510,860782
19246,lkamal,1,0.00012,171857,19.96522,860782
19247,lkburns,1,0.00012,171858,19.96533,860782
19248,LKI,1,0.00012,171859,19.96545,860782
19249,lkxsoul,1,0.00012,171860,19.96557,860782
19250,llamalinly,1,0.00012,171861,19.96568,860782
19251,llamasoft,1,0.00012,171862,19.96580,860782
19252,llsn,1,0.00012,171863,19.96591,860782
19253,llussy,1,0.00012,171864,19.96603,860782
19254,L-maple,1,0.00012,171865,19.96615,860782
19255,lmdkfs,1,0.00012,171866,19.96626,860782
19256,lmjennings44094,1,0.00012,171867,19.96638,860782
19257,lmmmml,1,0.00012,171868,19.96650,860782
19258,lmorais,1,0.00012,171869,19.96661,860782
19259,Lmraza98,1,0.00012,171870,19.96673,860782
19260,lmserrano,1,0.00012,171871,19.96684,860782
19261,lmsurpre,1,0.00012,171872,19.96696,860782
19262,lnguyen2341,1,0.00012,171873,19.96708,860782
19263,lnikolenko,1,0.00012,171874,19.96719,860782
19264,lnto3408,1,0.00012,171875,19.96731,860782
19265,loadingkang,1,0.00012,171876,19.96742,860782
19266,loafoe,1,0.00012,171877,19.96754,860782
19267,LobsterMan,1,0.00012,171878,19.96766,860782
19268,lockercho,1,0.00012,171879,19.96777,860782
19269,LockLi,1,0.00012,171880,19.96789,860782
19270,Locus99,1,0.00012,171881,19.96801,860782
19271,log0ymxm,1,0.00012,171882,19.96812,860782
19272,logan2211,1,0.00012,171883,19.96824,860782
19273,logicethos,1,0.00012,171884,19.96835,860782
19274,logosty,1,0.00012,171885,19.96847,860782
19275,LohithChanda,1,0.00012,171886,19.96859,860782
19276,loint,1,0.00012,171887,19.96870,860782
19277,lokiwins,1,0.00012,171888,19.96882,860782
19278,lonesysadmin,1,0.00012,171889,19.96894,860782
19279,LongDuncan,1,0.00012,171890,19.96905,860782
19280,LongMarch7,1,0.00012,171891,19.96917,860782
19281,longren,1,0.00012,171892,19.96928,860782
19282,lonial,1,0.00012,171893,19.96940,860782
19283,LoofahBu,1,0.00012,171894,19.96952,860782
19284,lopsided98,1,0.00012,171895,19.96963,860782
19285,lordfrimpong,1,0.00012,171896,19.96975,860782
19286,lordofgore,1,0.00012,171897,19.96986,860782
19287,loren-osborn,1,0.00012,171898,19.96998,860782
19288,lorf,1,0.00012,171899,19.97010,860782
19289,lorna8899,1,0.00012,171900,19.97021,860782
19290,LorrieS,1,0.00012,171901,19.97033,860782
19291,loszer,1,0.00012,171902,19.97045,860782
19292,LotusMD,1,0.00012,171903,19.97056,860782
19293,louielong,1,0.00012,171904,19.97068,860782
19294,LouisCAD,1,0.00012,171905,19.97079,860782
19295,lovecandy126,1,0.00012,171906,19.97091,860782
19296,lovesuper,1,0.00012,171907,19.97103,860782
19297,loveyang2012,1,0.00012,171908,19.97114,860782
19298,lovingcodesk,1,0.00012,171909,19.97126,860782
19299,Lovnx,1,0.00012,171910,19.97137,860782
19300,lowerzero,1,0.00012,171911,19.97149,860782
19301,loyd,1,0.00012,171912,19.97161,860782
19302,LozanoMatheus,1,0.00012,171913,19.97172,860782
19303,LP0101,1,0.00012,171914,19.97184,860782
19304,lpcman,1,0.00012,171915,19.97196,860782
19305,lpszBar,1,0.00012,171916,19.97207,860782
19306,lpzdvd-packlink,1,0.00012,171917,19.97219,860782
19307,lrevnic,1,0.00012,171918,19.97230,860782
19308,lrivera-verimatrix,1,0.00012,171919,19.97242,860782
19309,lrndevops,1,0.00012,171920,19.97254,860782
19310,lsamayoa,1,0.00012,171921,19.97265,860782
19311,lsampras,1,0.00012,171922,19.97277,860782
19312,lsc21,1,0.00012,171923,19.97289,860782
19313,lsferreira42,1,0.00012,171924,19.97300,860782
19314,lsk8867485,1,0.00012,171925,19.97312,860782
19315,lsylusiyao,1,0.00012,171926,19.97323,860782
19316,lt-bbergen,1,0.00012,171927,19.97335,860782
19317,ltutar,1,0.00012,171928,19.97347,860782
19318,LU438374318,1,0.00012,171929,19.97358,860782
19319,luben,1,0.00012,171930,19.97370,860782
19320,luca-esse,1,0.00012,171931,19.97381,860782
19321,lucasces,1,0.00012,171932,19.97393,860782
19322,lucas-dehandschutter,1,0.00012,171933,19.97405,860782
19323,lucasilverentand,1,0.00012,171934,19.97416,860782
19324,lucaslg26,1,0.00012,171935,19.97428,860782
19325,lucasmacosta,1,0.00012,171936,19.97440,860782
19326,lucassha,1,0.00012,171937,19.97451,860782
19327,lucendio,1,0.00012,171938,19.97463,860782
19328,lucian521,1,0.00012,171939,19.97474,860782
19329,luciferhs,1,0.00012,171940,19.97486,860782
19330,LucioFranco,1,0.00012,171941,19.97498,860782
19331,lucioveloso,1,0.00012,171942,19.97509,860782
19332,lucky125111,1,0.00012,171943,19.97521,860782
19333,ludydoo,1,0.00012,171944,19.97532,860782
19334,lufia,1,0.00012,171945,19.97544,860782
19335,Luisa223,1,0.00012,171946,19.97556,860782
19336,luisescobar89,1,0.00012,171947,19.97567,860782
19337,luisgulo,1,0.00012,171948,19.97579,860782
19338,luizgustavoss,1,0.00012,171949,19.97591,860782
19339,luizsfer,1,0.00012,171950,19.97602,860782
19340,lujia-zhang,1,0.00012,171951,19.97614,860782
19341,lukas-e,1,0.00012,171952,19.97625,860782
19342,lukasfrank,1,0.00012,171953,19.97637,860782
19343,lukasluecke,1,0.00012,171954,19.97649,860782
19344,lukasz-pyrzyk,1,0.00012,171955,19.97660,860782
19345,lukatera,1,0.00012,171956,19.97672,860782
19346,lukczarnota,1,0.00012,171957,19.97684,860782
19347,lukegb,1,0.00012,171958,19.97695,860782
19348,LukeHickling,1,0.00012,171959,19.97707,860782
19349,lukekhamilton,1,0.00012,171960,19.97718,860782
19350,lukemassa,1,0.00012,171961,19.97730,860782
19351,Lukkie,1,0.00012,171962,19.97742,860782
19352,lukos,1,0.00012,171963,19.97753,860782
19353,lukoyanov,1,0.00012,171964,19.97765,860782
19354,lunarfs,1,0.00012,171965,19.97776,860782
19355,lunighty,1,0.00012,171966,19.97788,860782
19356,lunmatu101,1,0.00012,171967,19.97800,860782
19357,luo964973791,1,0.00012,171968,19.97811,860782
19358,luobintianya,1,0.00012,171969,19.97823,860782
19359,luryus,1,0.00012,171970,19.97835,860782
19360,lusterally,1,0.00012,171971,19.97846,860782
19361,lutierigb,1,0.00012,171972,19.97858,860782
19362,luto,1,0.00012,171973,19.97869,860782
19363,Luwdo,1,0.00012,171974,19.97881,860782
19364,luxarasis4,1,0.00012,171975,19.97893,860782
19365,luxmeter,1,0.00012,171976,19.97904,860782
19366,LvBay,1,0.00012,171977,19.97916,860782
19367,lvincel,1,0.00012,171978,19.97927,860782
19368,lvyishan,1,0.00012,171979,19.97939,860782
19369,lw8008,1,0.00012,171980,19.97951,860782
19370,lweberru,1,0.00012,171981,19.97962,860782
19371,lwong-cloud,1,0.00012,171982,19.97974,860782
19372,lxShaDoWxl,1,0.00012,171983,19.97986,860782
19373,ly123-liu,1,0.00012,171984,19.97997,860782
19374,LykinsN,1,0.00012,171985,19.98009,860782
19375,lylex,1,0.00012,171986,19.98020,860782
19376,lynch0227,1,0.00012,171987,19.98032,860782
19377,lynk-coder,1,0.00012,171988,19.98044,860782
19378,Lynskylate,1,0.00012,171989,19.98055,860782
19379,lyschoening,1,0.00012,171990,19.98067,860782
19380,lzaldivarkt,1,0.00012,171991,19.98078,860782
19381,lzhecheng,1,0.00012,171992,19.98090,860782
19382,lzmhhh123,1,0.00012,171993,19.98102,860782
19383,Lzqbest,1,0.00012,171994,19.98113,860782
19384,lzt-pro,1,0.00012,171995,19.98125,860782
19385,m0se,1,0.00012,171996,19.98137,860782
19386,m10316008,1,0.00012,171997,19.98148,860782
19387,m33m33k,1,0.00012,171998,19.98160,860782
19388,M3t0r,1,0.00012,171999,19.98171,860782
19389,m3y,1,0.00012,172000,19.98183,860782
19390,m4ldonado,1,0.00012,172001,19.98195,860782
19391,m934030039,1,0.00012,172002,19.98206,860782
19392,m9a,1,0.00012,172003,19.98218,860782
19393,MA357151,1,0.00012,172004,19.98230,860782
19394,maaikez,1,0.00012,172005,19.98241,860782
19395,maayanyosef,1,0.00012,172006,19.98253,860782
19396,mac-abdon,1,0.00012,172007,19.98264,860782
19397,macdi,1,0.00012,172008,19.98276,860782
19398,macgyver603,1,0.00012,172009,19.98288,860782
19399,maciejj04,1,0.00012,172010,19.98299,860782
19400,mackyin,1,0.00012,172011,19.98311,860782
19401,MacNale,1,0.00012,172012,19.98322,860782
19402,macros,1,0.00012,172013,19.98334,860782
19403,madeindjs,1,0.00012,172014,19.98346,860782
19404,Madhu-cherukuri,1,0.00012,172015,19.98357,860782
19405,Madhucherukuru,1,0.00012,172016,19.98369,860782
19406,MadhuriDev,1,0.00012,172017,19.98381,860782
19407,madhurnawandar,1,0.00012,172018,19.98392,860782
19408,madsonic,1,0.00012,172019,19.98404,860782
19409,Madvinking,1,0.00012,172020,19.98415,860782
19410,MaerF0x0,1,0.00012,172021,19.98427,860782
19411,maestrus,1,0.00012,172022,19.98439,860782
19412,maganvill,1,0.00012,172023,19.98450,860782
19413,MaGaoju,1,0.00012,172024,19.98462,860782
19414,maged,1,0.00012,172025,19.98473,860782
19415,maggieliu,1,0.00012,172026,19.98485,860782
19416,magick93,1,0.00012,172027,19.98497,860782
19417,magikid,1,0.00012,172028,19.98508,860782
19418,MagikLau,1,0.00012,172029,19.98520,860782
19419,maglun2,1,0.00012,172030,19.98532,860782
19420,magnologan,1,0.00012,172031,19.98543,860782
19421,magnusaxelqvist,1,0.00012,172032,19.98555,860782
19422,ma-groundspeed,1,0.00012,172033,19.98566,860782
19423,maguohao2018,1,0.00012,172034,19.98578,860782
19424,Maham19,1,0.00012,172035,19.98590,860782
19425,mahboobEs,1,0.00012,172036,19.98601,860782
19426,mahe8h,1,0.00012,172037,19.98613,860782
19427,MaheshGPai,1,0.00012,172038,19.98625,860782
19428,maheshp,1,0.00012,172039,19.98636,860782
19429,mahmoudcb,1,0.00012,172040,19.98648,860782
19430,mahmoudhas,1,0.00012,172041,19.98659,860782
19431,mahpatil,1,0.00012,172042,19.98671,860782
19432,mahsoud,1,0.00012,172043,19.98683,860782
19433,maiconbaumx,1,0.00012,172044,19.98694,860782
19434,mailtoraja18,1,0.00012,172045,19.98706,860782
19435,maintux,1,0.00012,172046,19.98717,860782
19436,maireanu,1,0.00012,172047,19.98729,860782
19437,maitrungduc1410,1,0.00012,172048,19.98741,860782
19438,majames,1,0.00012,172049,19.98752,860782
19439,majewsky,1,0.00012,172050,19.98764,860782
19440,major7x,1,0.00012,172051,19.98776,860782
19441,MajorBreakfast,1,0.00012,172052,19.98787,860782
19442,mak-454,1,0.00012,172053,19.98799,860782
19443,makdmi,1,0.00012,172054,19.98810,860782
19444,makeshrao,1,0.00012,172055,19.98822,860782
19445,makhijamanish,1,0.00012,172056,19.98834,860782
19446,makkarpov,1,0.00012,172057,19.98845,860782
19447,makmanalp,1,0.00012,172058,19.98857,860782
19448,maksim-paskal,1,0.00012,172059,19.98868,860782
19449,MaksymDolgykh,1,0.00012,172060,19.98880,860782
19450,malachibazar,1,0.00012,172061,19.98892,860782
19451,malawskim,1,0.00012,172062,19.98903,860782
19452,malept,1,0.00012,172063,19.98915,860782
19453,malferov,1,0.00012,172064,19.98927,860782
19454,malgun-gothic,1,0.00012,172065,19.98938,860782
19455,mali-conductor,1,0.00012,172066,19.98950,860782
19456,malkia,1,0.00012,172067,19.98961,860782
19457,malloth,1,0.00012,172068,19.98973,860782
19458,malmi,1,0.00012,172069,19.98985,860782
19459,malmor,1,0.00012,172070,19.98996,860782
19460,maltegrosse,1,0.00012,172071,19.99008,860782
19461,mambalex,1,0.00012,172072,19.99019,860782
19462,mambax,1,0.00012,172073,19.99031,860782
19463,mamboitaliano21,1,0.00012,172074,19.99043,860782
19464,mampfes,1,0.00012,172075,19.99054,860782
19465,man4red,1,0.00012,172076,19.99066,860782
19466,ManAnRuck,1,0.00012,172077,19.99078,860782
19467,ManCon,1,0.00012,172078,19.99089,860782
19468,mandarenmanman,1,0.00012,172079,19.99101,860782
19469,mandava999,1,0.00012,172080,19.99112,860782
19470,mandee8865,1,0.00012,172081,19.99124,860782
19471,mandeep9888,1,0.00012,172082,19.99136,860782
19472,mandyqcx,1,0.00012,172083,19.99147,860782
19473,manfontan,1,0.00012,172084,19.99159,860782
19474,mangermaier,1,0.00012,172085,19.99171,860782
19475,Mangga-web,1,0.00012,172086,19.99182,860782
19476,mangoleaf,1,0.00012,172087,19.99194,860782
19477,manhhiep92,1,0.00012,172088,19.99205,860782
19478,mani0070,1,0.00012,172089,19.99217,860782
19479,manicole,1,0.00012,172090,19.99229,860782
19480,Manikandan-Raj,1,0.00012,172091,19.99240,860782
19481,manishadagale,1,0.00012,172092,19.99252,860782
19482,manisha-tanwar,1,0.00012,172093,19.99263,860782
19483,manju369,1,0.00012,172094,19.99275,860782
19484,Manjunath34,1,0.00012,172095,19.99287,860782
19485,manlme,1,0.00012,172096,19.99298,860782
19486,manmeet326,1,0.00012,172097,19.99310,860782
19487,manneharikrishna,1,0.00012,172098,19.99322,860782
19488,manno,1,0.00012,172099,19.99333,860782
19489,manodupont,1,0.00012,172100,19.99345,860782
19490,manogarsubramaniyam,1,0.00012,172101,19.99356,860782
19491,manohar9999,1,0.00012,172102,19.99368,860782
19492,manojnirania,1,0.00012,172103,19.99380,860782
19493,manojunnam1438,1,0.00012,172104,19.99391,860782
19494,ManoMarks,1,0.00012,172105,19.99403,860782
19495,manpatel3107,1,0.00012,172106,19.99414,860782
19496,mansurali901,1,0.00012,172107,19.99426,860782
19497,mantasmatelis,1,0.00012,172108,19.99438,860782
19498,mantas-sidlauskas,1,0.00012,172109,19.99449,860782
19499,manuelcoppotelli,1,0.00012,172110,19.99461,860782
19500,ManuelKugelmann,1,0.00012,172111,19.99473,860782
19501,manu-st,1,0.00012,172112,19.99484,860782
19502,manutenfruits,1,0.00012,172113,19.99496,860782
19503,manzsolutions-lpreis,1,0.00012,172114,19.99507,860782
19504,maokofan,1,0.00012,172115,19.99519,860782
19505,maonoam,1,0.00012,172116,19.99531,860782
19506,mapa82,1,0.00012,172117,19.99542,860782
19507,marado00,1,0.00012,172118,19.99554,860782
19508,marascha,1,0.00012,172119,19.99566,860782
19509,marbortechie,1,0.00012,172120,19.99577,860782
19510,marcboivin,1,0.00012,172121,19.99589,860782
19511,marcbrandner,1,0.00012,172122,19.99600,860782
19512,marcelolima,1,0.00012,172123,19.99612,860782
19513,marcelomanchester,1,0.00012,172124,19.99624,860782
19514,marcel-st,1,0.00012,172125,19.99635,860782
19515,marcin54321,1,0.00012,172126,19.99647,860782
19516,marcjimz,1,0.00012,172127,19.99658,860782
19517,marcoamarelo,1,0.00012,172128,19.99670,860782
19518,marco-porru,1,0.00012,172129,19.99682,860782
19519,MarcoR83,1,0.00012,172130,19.99693,860782
19520,marcoshuck,1,0.00012,172131,19.99705,860782
19521,marcosmcp,1,0.00012,172132,19.99717,860782
19522,marcosrachid,1,0.00012,172133,19.99728,860782
19523,marcphilipp,1,0.00012,172134,19.99740,860782
19524,marcpret,1,0.00012,172135,19.99751,860782
19525,marcsauter,1,0.00012,172136,19.99763,860782
19526,marcusdahlstein,1,0.00012,172137,19.99775,860782
19527,marcusschmidt,1,0.00012,172138,19.99786,860782
19528,marefr,1,0.00012,172139,19.99798,860782
19529,MarekPokornyOva,1,0.00012,172140,19.99809,860782
19530,Marf54,1,0.00012,172141,19.99821,860782
19531,margau,1,0.00012,172142,19.99833,860782
19532,mariana-mendes,1,0.00012,172143,19.99844,860782
19533,marianhromiak,1,0.00012,172144,19.99856,860782
19534,marianoao,1,0.00012,172145,19.99868,860782
19535,marianoarga,1,0.00012,172146,19.99879,860782
19536,mariarolbiecka,1,0.00012,172147,19.99891,860782
19537,marijenk,1,0.00012,172148,19.99902,860782
19538,marinetteman2,1,0.00012,172149,19.99914,860782
19539,mario19911,1,0.00012,172150,19.99926,860782
19540,mariogruizdiaz,1,0.00012,172151,19.99937,860782
19541,mariojacobo,1,0.00012,172152,19.99949,860782
19542,mariom-consultec,1,0.00012,172153,19.99961,860782
19543,mark-5,1,0.00012,172154,19.99972,860782
19544,markbdsouza,1,0.00012,172155,19.99984,860782
19545,markdoerr,1,0.00012,172156,19.99995,860782
19546,MarkDong614,1,0.00012,172157,20.00007,860782
19547,markedwards77,1,0.00012,172158,20.00019,860782
19548,markitoxs,1,0.00012,172159,20.00030,860782
19549,mark-jordanovic-lewis,1,0.00012,172160,20.00042,860782
19550,marklester,1,0.00012,172161,20.00053,860782
19551,markmaas,1,0.00012,172162,20.00065,860782
19552,markmclaren,1,0.00012,172163,20.00077,860782
19553,marko-espi,1,0.00012,172164,20.00088,860782
19554,markofferman,1,0.00012,172165,20.00100,860782
19555,MarkPare,1,0.00012,172166,20.00112,860782
19556,markruler,1,0.00012,172167,20.00123,860782
19557,markthebault,1,0.00012,172168,20.00135,860782
19558,MarkusAGSchmidt,1,0.00012,172169,20.00146,860782
19559,MarkusH,1,0.00012,172170,20.00158,860782
19560,MarkusTiede,1,0.00012,172171,20.00170,860782
19561,markymo5115,1,0.00012,172172,20.00181,860782
19562,markzemburg,1,0.00012,172173,20.00193,860782
19563,marnel007,1,0.00012,172174,20.00204,860782
19564,marnovo,1,0.00012,172175,20.00216,860782
19565,marqc,1,0.00012,172176,20.00228,860782
19566,marsbear,1,0.00012,172177,20.00239,860782
19567,MarsWarrior,1,0.00012,172178,20.00251,860782
19568,mart3051,1,0.00012,172179,20.00263,860782
19569,martbrooks,1,0.00012,172180,20.00274,860782
19570,martijnvanderwoud,1,0.00012,172181,20.00286,860782
19571,martin20140408,1,0.00012,172182,20.00297,860782
19572,Martinay,1,0.00012,172183,20.00309,860782
19573,martincyruswolfenbarger,1,0.00012,172184,20.00321,860782
19574,martindahlswe,1,0.00012,172185,20.00332,860782
19575,martinDDe,1,0.00012,172186,20.00344,860782
19576,martinfar,1,0.00012,172187,20.00355,860782
19577,Martin-Hogge,1,0.00012,172188,20.00367,860782
19578,martinmalek,1,0.00012,172189,20.00379,860782
19579,martinreus-form3,1,0.00012,172190,20.00390,860782
19580,martinscholz83,1,0.00012,172191,20.00402,860782
19581,MartinSoto,1,0.00012,172192,20.00414,860782
19582,martint17r,1,0.00012,172193,20.00425,860782
19583,martonsz,1,0.00012,172194,20.00437,860782
19584,martyhill,1,0.00012,172195,20.00448,860782
19585,martykuentzel,1,0.00012,172196,20.00460,860782
19586,marunachalam,1,0.00012,172197,20.00472,860782
19587,marvelTracker,1,0.00012,172198,20.00483,860782
19588,marwamemni,1,0.00012,172199,20.00495,860782
19589,MarynaTkachukRing,1,0.00012,172200,20.00507,860782
19590,marziman,1,0.00012,172201,20.00518,860782
19591,mash1t,1,0.00012,172202,20.00530,860782
19592,MasiumDev,1,0.00012,172203,20.00541,860782
19593,maskayman,1,0.00012,172204,20.00553,860782
19594,Mason-Chou,1,0.00012,172205,20.00565,860782
19595,masonhensley,1,0.00012,172206,20.00576,860782
19596,masontin,1,0.00012,172207,20.00588,860782
19597,mate-szalai,1,0.00012,172208,20.00599,860782
19598,matetukacs,1,0.00012,172209,20.00611,860782
19599,MateusAmin,1,0.00012,172210,20.00623,860782
19600,MateusHenriqueOliveira,1,0.00012,172211,20.00634,860782
19601,mateusht-ciandt,1,0.00012,172212,20.00646,860782
19602,mathewprokos,1,0.00012,172213,20.00658,860782
19603,MathiasGr,1,0.00012,172214,20.00669,860782
19604,mathijs81,1,0.00012,172215,20.00681,860782
19605,mati865,1,0.00012,172216,20.00692,860782
19606,matinats,1,0.00012,172217,20.00704,860782
19607,MatisiekPL,1,0.00012,172218,20.00716,860782
19608,matlegit,1,0.00012,172219,20.00727,860782
19609,matt1484,1,0.00012,172220,20.00739,860782
19610,matt2000,1,0.00012,172221,20.00750,860782
19611,mattb290,1,0.00012,172222,20.00762,860782
19612,mattboardman,1,0.00012,172223,20.00774,860782
19613,matt-coppola,1,0.00012,172224,20.00785,860782
19614,mattdkerr,1,0.00012,172225,20.00797,860782
19615,mattgugu,1,0.00012,172226,20.00809,860782
19616,mattharrigan,1,0.00012,172227,20.00820,860782
19617,matthewbrahms,1,0.00012,172228,20.00832,860782
19618,matthew-fong,1,0.00012,172229,20.00843,860782
19619,matthewhembree,1,0.00012,172230,20.00855,860782
19620,matthewige,1,0.00012,172231,20.00867,860782
19621,matthewmueller,1,0.00012,172232,20.00878,860782
19622,MatthewT123,1,0.00012,172233,20.00890,860782
19623,matthiaslein,1,0.00012,172234,20.00902,860782
19624,matthiasmutam,1,0.00012,172235,20.00913,860782
19625,matthiaswenz,1,0.00012,172236,20.00925,860782
19626,matt-hutchins,1,0.00012,172237,20.00936,860782
19627,mattilindstrom,1,0.00012,172238,20.00948,860782
19628,matt-lethargic,1,0.00012,172239,20.00960,860782
19629,mattmahoneyrh,1,0.00012,172240,20.00971,860782
19630,mattmceuen,1,0.00012,172241,20.00983,860782
19631,matt-palmer-tfs,1,0.00012,172242,20.00994,860782
19632,mattqm,1,0.00012,172243,20.01006,860782
19633,mattrapa,1,0.00012,172244,20.01018,860782
19634,mattroell,1,0.00012,172245,20.01029,860782
19635,mattsawyer77,1,0.00012,172246,20.01041,860782
19636,mattshin,1,0.00012,172247,20.01053,860782
19637,mattupstate,1,0.00012,172248,20.01064,860782
19638,mattus,1,0.00012,172249,20.01076,860782
19639,mauriciopoppe,1,0.00012,172250,20.01087,860782
19640,mauriziovitale,1,0.00012,172251,20.01099,860782
19641,mauro-dellachiesa,1,0.00012,172252,20.01111,860782
19642,maurya-m,1,0.00012,172253,20.01122,860782
19643,Mauttaram,1,0.00012,172254,20.01134,860782
19644,maverickmetro,1,0.00012,172255,20.01145,860782
19645,max0ne,1,0.00012,172256,20.01157,860782
19646,max10rogerio,1,0.00012,172257,20.01169,860782
19647,max27149,1,0.00012,172258,20.01180,860782
19648,max-allan-surevine,1,0.00012,172259,20.01192,860782
19649,maxandersen,1,0.00012,172260,20.01204,860782
19650,maxbraun,1,0.00012,172261,20.01215,860782
19651,maxbrodin,1,0.00012,172262,20.01227,860782
19652,max-gotlib,1,0.00012,172263,20.01238,860782
19653,maxiloEmmmm,1,0.00012,172264,20.01250,860782
19654,MaximAxelrod,1,0.00012,172265,20.01262,860782
19655,MaximeBernard,1,0.00012,172266,20.01273,860782
19656,MaximF,1,0.00012,172267,20.01285,860782
19657,maximgrigorov,1,0.00012,172268,20.01296,860782
19658,maximmi,1,0.00012,172269,20.01308,860782
19659,maximus1108,1,0.00012,172270,20.01320,860782
19660,max-koehler,1,0.00012,172271,20.01331,860782
19661,maxmeyer,1,0.00012,172272,20.01343,860782
19662,max-nderitu,1,0.00012,172273,20.01355,860782
19663,maxromanovsky,1,0.00012,172274,20.01366,860782
19664,maxucheng0,1,0.00012,172275,20.01378,860782
19665,maxweisspoker,1,0.00012,172276,20.01389,860782
19666,Maxwell1987,1,0.00012,172277,20.01401,860782
19667,mayankcpdixit,1,0.00012,172278,20.01413,860782
19668,mayankparekh,1,0.00012,172279,20.01424,860782
19669,mayquanxi,1,0.00012,172280,20.01436,860782
19670,mayrbenjamin92,1,0.00012,172281,20.01448,860782
19671,maysamyabandeh,1,0.00012,172282,20.01459,860782
19672,mayurkumar09,1,0.00012,172283,20.01471,860782
19673,mayur-oci,1,0.00012,172284,20.01482,860782
19674,mbarbero,1,0.00012,172285,20.01494,860782
19675,mbbernstein,1,0.00012,172286,20.01506,860782
19676,mbcolson,1,0.00012,172287,20.01517,860782
19677,mbelchin,1,0.00012,172288,20.01529,860782
19678,mbellgb,1,0.00012,172289,20.01540,860782
19679,mbevc1,1,0.00012,172290,20.01552,860782
19680,mbornoz,1,0.00012,172291,20.01564,860782
19681,mbtamuli,1,0.00012,172292,20.01575,860782
19682,mburke-rockstar,1,0.00012,172293,20.01587,860782
19683,mcajkovs,1,0.00012,172294,20.01599,860782
19684,mcardinalupgrade,1,0.00012,172295,20.01610,860782
19685,mcgizmo,1,0.00012,172296,20.01622,860782
19686,mchtech,1,0.00012,172297,20.01633,860782
19687,mckornfield,1,0.00012,172298,20.01645,860782
19688,mckunkel,1,0.00012,172299,20.01657,860782
19689,mcmcghee,1,0.00012,172300,20.01668,860782
19690,mcmx,1,0.00012,172301,20.01680,860782
19691,mcobzarenco,1,0.00012,172302,20.01691,860782
19692,md2119,1,0.00012,172303,20.01703,860782
19693,mdanielolsson,1,0.00012,172304,20.01715,860782
19694,mdanzinger,1,0.00012,172305,20.01726,860782
19695,mdarii,1,0.00012,172306,20.01738,860782
19696,mdavid626,1,0.00012,172307,20.01750,860782
19697,mdberman54321,1,0.00012,172308,20.01761,860782
19698,mdblr,1,0.00012,172309,20.01773,860782
19699,mdemille,1,0.00012,172310,20.01784,860782
19700,mdevasar,1,0.00012,172311,20.01796,860782
19701,m-dinesh-kumar,1,0.00012,172312,20.01808,860782
19702,mdkent,1,0.00012,172313,20.01819,860782
19703,mdogan,1,0.00012,172314,20.01831,860782
19704,mdz,1,0.00012,172315,20.01843,860782
19705,meareindel,1,0.00012,172316,20.01854,860782
19706,mebest100,1,0.00012,172317,20.01866,860782
19707,mechtron,1,0.00012,172318,20.01877,860782
19708,MedAnd,1,0.00012,172319,20.01889,860782
19709,medaoutir,1,0.00012,172320,20.01901,860782
19710,medhasn,1,0.00012,172321,20.01912,860782
19711,mediocrematt,1,0.00012,172322,20.01924,860782
19712,MeenaAlfons,1,0.00012,172323,20.01935,860782
19713,meezaan,1,0.00012,172324,20.01947,860782
19714,mefilt,1,0.00012,172325,20.01959,860782
19715,megarocks,1,0.00012,172326,20.01970,860782
19716,megavenik,1,0.00012,172327,20.01982,860782
19717,mehercharan,1,0.00012,172328,20.01994,860782
19718,mehmetanbaki,1,0.00012,172329,20.02005,860782
19719,mehmetbicak,1,0.00012,172330,20.02017,860782
19720,mehyedes,1,0.00012,172331,20.02028,860782
19721,meilel,1,0.00012,172332,20.02040,860782
19722,MeirSolvo,1,0.00012,172333,20.02052,860782
19723,meirzee,1,0.00012,172334,20.02063,860782
19724,melalj,1,0.00012,172335,20.02075,860782
19725,melkosoft,1,0.00012,172336,20.02086,860782
19726,mellonedain,1,0.00012,172337,20.02098,860782
19727,melotusme,1,0.00012,172338,20.02110,860782
19728,melvio,1,0.00012,172339,20.02121,860782
19729,memark,1,0.00012,172340,20.02133,860782
19730,memboc,1,0.00012,172341,20.02145,860782
19731,memo42,1,0.00012,172342,20.02156,860782
19732,memonfaheem,1,0.00012,172343,20.02168,860782
19733,memorais,1,0.00012,172344,20.02179,860782
19734,memorygardener,1,0.00012,172345,20.02191,860782
19735,menems,1,0.00012,172346,20.02203,860782
19736,menghao11,1,0.00012,172347,20.02214,860782
19737,mengxianghu-kkk,1,0.00012,172348,20.02226,860782
19738,menishmueli,1,0.00012,172349,20.02238,860782
19739,Mentat420,1,0.00012,172350,20.02249,860782
19740,meodemsao,1,0.00012,172351,20.02261,860782
19741,MEOWMEOW114,1,0.00012,172352,20.02272,860782
19742,mepeccin,1,0.00012,172353,20.02284,860782
19743,meraymond2,1,0.00012,172354,20.02296,860782
19744,merctom,1,0.00012,172355,20.02307,860782
19745,mercuriete,1,0.00012,172356,20.02319,860782
19746,mercury77,1,0.00012,172357,20.02330,860782
19747,merlante,1,0.00012,172358,20.02342,860782
19748,Merlyn2020,1,0.00012,172359,20.02354,860782
19749,Merovius,1,0.00012,172360,20.02365,860782
19750,mertloo,1,0.00012,172361,20.02377,860782
19751,Mervey0324,1,0.00012,172362,20.02389,860782
19752,meshok0,1,0.00012,172363,20.02400,860782
19753,messiahUA,1,0.00012,172364,20.02412,860782
19754,metacubed,1,0.00012,172365,20.02423,860782
19755,metaldart,1,0.00012,172366,20.02435,860782
19756,mezz,1,0.00012,172367,20.02447,860782
19757,mfc19,1,0.00012,172368,20.02458,860782
19758,mfcastellani,1,0.00012,172369,20.02470,860782
19759,mfcrocker,1,0.00012,172370,20.02481,860782
19760,mfechner,1,0.00012,172371,20.02493,860782
19761,mf-lit,1,0.00012,172372,20.02505,860782
19762,mfriedman1-chwy,1,0.00012,172373,20.02516,860782
19763,mgalesloot,1,0.00012,172374,20.02528,860782
19764,mgier,1,0.00012,172375,20.02540,860782
19765,mglidden,1,0.00012,172376,20.02551,860782
19766,mgoerens,1,0.00012,172377,20.02563,860782
19767,mgrecar,1,0.00012,172378,20.02574,860782
19768,mgs4332,1,0.00012,172379,20.02586,860782
19769,mguthmuller,1,0.00012,172380,20.02598,860782
19770,mhaideibm,1,0.00012,172381,20.02609,860782
19771,mhajas,1,0.00012,172382,20.02621,860782
19772,mhamilton723,1,0.00012,172383,20.02632,860782
19773,mharini,1,0.00012,172384,20.02644,860782
19774,mheffner,1,0.00012,172385,20.02656,860782
19775,mhewedy,1,0.00012,172386,20.02667,860782
19776,mhristache,1,0.00012,172387,20.02679,860782
19777,mhsh64,1,0.00012,172388,20.02691,860782
19778,mhudson-bw,1,0.00012,172389,20.02702,860782
19779,MiaoRachelYu,1,0.00012,172390,20.02714,860782
19780,MicahRam,1,0.00012,172391,20.02725,860782
19781,MicDeDuiwel,1,0.00012,172392,20.02737,860782
19782,micemuni,1,0.00012,172393,20.02749,860782
19783,michael1589,1,0.00012,172394,20.02760,860782
19784,Michael69out,1,0.00012,172395,20.02772,860782
19785,michaelandrepearce,1,0.00012,172396,20.02784,860782
19786,michaelbeckersgit,1,0.00012,172397,20.02795,860782
19787,Michaelborsellino,1,0.00012,172398,20.02807,860782
19788,michael-bowen-sc,1,0.00012,172399,20.02818,860782
19789,michaelcourcy,1,0.00012,172400,20.02830,860782
19790,michaeldallen,1,0.00012,172401,20.02842,860782
19791,Michael-F-Bryan,1,0.00012,172402,20.02853,860782
19792,michaelfward,1,0.00012,172403,20.02865,860782
19793,michaeljmarshall,1,0.00012,172404,20.02876,860782
19794,michaelk3k,1,0.00012,172405,20.02888,860782
19795,michaelkoro,1,0.00012,172406,20.02900,860782
19796,michaelkrupp,1,0.00012,172407,20.02911,860782
19797,michaelmohamed,1,0.00012,172408,20.02923,860782
19798,michael-todorovic,1,0.00012,172409,20.02935,860782
19799,michaelwinser,1,0.00012,172410,20.02946,860782
19800,michael-wirth,1,0.00012,172411,20.02958,860782
19801,MichalGuzieniuk,1,0.00012,172412,20.02969,860782
19802,michalmisiewicz,1,0.00012,172413,20.02981,860782
19803,MichalMonko,1,0.00012,172414,20.02993,860782
19804,michelcameroon,1,0.00012,172415,20.03004,860782
19805,michelsen,1,0.00012,172416,20.03016,860782
19806,michidk,1,0.00012,172417,20.03027,860782
19807,michimartini,1,0.00012,172418,20.03039,860782
19808,michkrom,1,0.00012,172419,20.03051,860782
19809,micos76,1,0.00012,172420,20.03062,860782
19810,micwiec,1,0.00012,172421,20.03074,860782
19811,micxer,1,0.00012,172422,20.03086,860782
19812,midacts,1,0.00012,172423,20.03097,860782
19813,midcontinentcontrols,1,0.00012,172424,20.03109,860782
19814,mightymarty,1,0.00012,172425,20.03120,860782
19815,miguescri,1,0.00012,172426,20.03132,860782
19816,mihaialexandrescu,1,0.00012,172427,20.03144,860782
19817,mihaimyh,1,0.00012,172428,20.03155,860782
19818,mihalycsokas,1,0.00012,172429,20.03167,860782
19819,mihiransup,1,0.00012,172430,20.03179,860782
19820,mijailr,1,0.00012,172431,20.03190,860782
19821,mika018,1,0.00012,172432,20.03202,860782
19822,mikador,1,0.00012,172433,20.03213,860782
19823,MikaelUrankar,1,0.00012,172434,20.03225,860782
19824,mikael-vertikal,1,0.00012,172435,20.03237,860782
19825,mikalai-t,1,0.00012,172436,20.03248,860782
19826,mikart143,1,0.00012,172437,20.03260,860782
19827,Mikedu1988,1,0.00012,172438,20.03271,860782
19828,MikeEdgar,1,0.00012,172439,20.03283,860782
19829,mikefang426,1,0.00012,172440,20.03295,860782
19830,mikefomichev,1,0.00012,172441,20.03306,860782
19831,mikeharrisonlt,1,0.00012,172442,20.03318,860782
19832,mikehuston,1,0.00012,172443,20.03330,860782
19833,mikerain,1,0.00012,172444,20.03341,860782
19834,MikeSchlosser16,1,0.00012,172445,20.03353,860782
19835,mikeskali,1,0.00012,172446,20.03364,860782
19836,mikesmitty,1,0.00012,172447,20.03376,860782
19837,mikevel,1,0.00012,172448,20.03388,860782
19838,mikexu1976,1,0.00012,172449,20.03399,860782
19839,mikeyrcamp,1,0.00012,172450,20.03411,860782
19840,MikeZappa87,1,0.00012,172451,20.03422,860782
19841,mikhailian,1,0.00012,172452,20.03434,860782
19842,mikhailkrotov-42crunch,1,0.00012,172453,20.03446,860782
19843,Mikhail-msft,1,0.00012,172454,20.03457,860782
19844,MikkCZ,1,0.00012,172455,20.03469,860782
19845,miklezzzz,1,0.00012,172456,20.03481,860782
19846,mikolajmorawski,1,0.00012,172457,20.03492,860782
19847,milanholub,1,0.00012,172458,20.03504,860782
19848,milankamboya,1,0.00012,172459,20.03515,860782
19849,milanshergill,1,0.00012,172460,20.03527,860782
19850,milikicn,1,0.00012,172461,20.03539,860782
19851,milindchawre,1,0.00012,172462,20.03550,860782
19852,miljkovicivan,1,0.00012,172463,20.03562,860782
19853,milosbackonja,1,0.00012,172464,20.03573,860782
19854,milosjanda,1,0.00012,172465,20.03585,860782
19855,MilosSimic,1,0.00012,172466,20.03597,860782
19856,miloszkowal,1,0.00012,172467,20.03608,860782
19857,MilovdZee,1,0.00012,172468,20.03620,860782
19858,Milozpp,1,0.00012,172469,20.03632,860782
19859,miltieIV2,1,0.00012,172470,20.03643,860782
19860,minamijoyo,1,0.00012,172471,20.03655,860782
19861,mindcrime,1,0.00012,172472,20.03666,860782
19862,mindthegab,1,0.00012,172473,20.03678,860782
19863,ming535,1,0.00012,172474,20.03690,860782
19864,mingen-pan,1,0.00012,172475,20.03701,860782
19865,mingjliu9,1,0.00012,172476,20.03713,860782
19866,mingliangguo,1,0.00012,172477,20.03725,860782
19867,mingqishao,1,0.00012,172478,20.03736,860782
19868,minhdtb,1,0.00012,172479,20.03748,860782
19869,minherz,1,0.00012,172480,20.03759,860782
19870,minorbug,1,0.00012,172481,20.03771,860782
19871,Minorli,1,0.00012,172482,20.03783,860782
19872,minwoox,1,0.00012,172483,20.03794,860782
19873,minzhang28,1,0.00012,172484,20.03806,860782
19874,mio-g,1,0.00012,172485,20.03817,860782
19875,mipnw,1,0.00012,172486,20.03829,860782
19876,miquelbar,1,0.00012,172487,20.03841,860782
19877,mira20,1,0.00012,172488,20.03852,860782
19878,miraculixx,1,0.00012,172489,20.03864,860782
19879,miradnanali,1,0.00012,172490,20.03876,860782
19880,mircea-pop,1,0.00012,172491,20.03887,860782
19881,mirecl,1,0.00012,172492,20.03899,860782
19882,mischapedia,1,0.00012,172493,20.03910,860782
19883,mishraomp,1,0.00012,172494,20.03922,860782
19884,Mishuni,1,0.00012,172495,20.03934,860782
19885,misiek303,1,0.00012,172496,20.03945,860782
19886,misko566,1,0.00012,172497,20.03957,860782
19887,MisLink,1,0.00012,172498,20.03968,860782
19888,miso-belica,1,0.00012,172499,20.03980,860782
19889,mister0825,1,0.00012,172500,20.03992,860782
19890,misterstrickland,1,0.00012,172501,20.04003,860782
19891,mitchellrj,1,0.00012,172502,20.04015,860782
19892,mitchnenn,1,0.00012,172503,20.04027,860782
19893,Mitdd9707,1,0.00012,172504,20.04038,860782
19894,mithleshmeghwal,1,0.00012,172505,20.04050,860782
19895,Mithu-123,1,0.00012,172506,20.04061,860782
19896,miticojo,1,0.00012,172507,20.04073,860782
19897,mitloshuk,1,0.00012,172508,20.04085,860782
19898,mitom,1,0.00012,172509,20.04096,860782
19899,Mitrofanov,1,0.00012,172510,20.04108,860782
19900,mitter1989,1,0.00012,172511,20.04120,860782
19901,mitunmbj,1,0.00012,172512,20.04131,860782
19902,Miu98,1,0.00012,172513,20.04143,860782
19903,miwgmail,1,0.00012,172514,20.04154,860782
19904,miyucy,1,0.00012,172515,20.04166,860782
19905,mizantrop2397,1,0.00012,172516,20.04178,860782
19906,mizunos,1,0.00012,172517,20.04189,860782
19907,mjkowalski,1,0.00012,172518,20.04201,860782
19908,mjooz,1,0.00012,172519,20.04212,860782
19909,mjsabby,1,0.00012,172520,20.04224,860782
19910,mjungsbluth,1,0.00012,172521,20.04236,860782
19911,mkaur87,1,0.00012,172522,20.04247,860782
19912,mkellycs,1,0.00012,172523,20.04259,860782
19913,mkenne11,1,0.00012,172524,20.04271,860782
19914,mkhq,1,0.00012,172525,20.04282,860782
19915,mkoertgen,1,0.00012,172526,20.04294,860782
19916,mkryva,1,0.00012,172527,20.04305,860782
19917,mksmsrgnk,1,0.00012,172528,20.04317,860782
19918,mkt-mohit,1,0.00012,172529,20.04329,860782
19919,mkubaczyk,1,0.00012,172530,20.04340,860782
19920,mkuhl,1,0.00012,172531,20.04352,860782
19921,mkur-ops,1,0.00012,172532,20.04363,860782
19922,ML99bug,1,0.00012,172533,20.04375,860782
19923,mladedav,1,0.00012,172534,20.04387,860782
19924,mlazowik,1,0.00012,172535,20.04398,860782
19925,mlboy,1,0.00012,172536,20.04410,860782
19926,Mldhun,1,0.00012,172537,20.04422,860782
19927,mlhere,1,0.00012,172538,20.04433,860782
19928,mlopez-eb,1,0.00012,172539,20.04445,860782
19929,mluds,1,0.00012,172540,20.04456,860782
19930,mm304321141,1,0.00012,172541,20.04468,860782
19931,mmaggiolo,1,0.00012,172542,20.04480,860782
19932,mmallet-digipok,1,0.00012,172543,20.04491,860782
19933,mmccord-mdbuyline,1,0.00012,172544,20.04503,860782
19934,mmckane,1,0.00012,172545,20.04514,860782
19935,mmiklavc,1,0.00012,172546,20.04526,860782
19936,mmimica,1,0.00012,172547,20.04538,860782
19937,mmnelemane,1,0.00012,172548,20.04549,860782
19938,mmoench,1,0.00012,172549,20.04561,860782
19939,mmontes11,1,0.00012,172550,20.04573,860782
19940,mmoriarity-stripe,1,0.00012,172551,20.04584,860782
19941,mmshaikh88,1,0.00012,172552,20.04596,860782
19942,mnach,1,0.00012,172553,20.04607,860782
19943,mnns,1,0.00012,172554,20.04619,860782
19944,mo4islona,1,0.00012,172555,20.04631,860782
19945,mobidyc,1,0.00012,172556,20.04642,860782
19946,mobilego,1,0.00012,172557,20.04654,860782
19947,MoBlockbuster,1,0.00012,172558,20.04666,860782
19948,Modelizer,1,0.00012,172559,20.04677,860782
19949,mo-ghorbani,1,0.00012,172560,20.04689,860782
19950,mogoman,1,0.00012,172561,20.04700,860782
19951,moh-abk,1,0.00012,172562,20.04712,860782
19952,mohahmed13,1,0.00012,172563,20.04724,860782
19953,mohamadrezafn97,1,0.00012,172564,20.04735,860782
19954,MohamedAdel-magalix,1,0.00012,172565,20.04747,860782
19955,Mohanedy98,1,0.00012,172566,20.04758,860782
19956,mohansethu1983,1,0.00012,172567,20.04770,860782
19957,mohansoundar,1,0.00012,172568,20.04782,860782
19958,Mohjive,1,0.00012,172569,20.04793,860782
19959,mohnishkodnani,1,0.00012,172570,20.04805,860782
19960,mohsinhijazee,1,0.00012,172571,20.04817,860782
19961,mohsinniveus,1,0.00012,172572,20.04828,860782
19962,Mokon,1,0.00012,172573,20.04840,860782
19963,molardsouvenirs,1,0.00012,172574,20.04851,860782
19964,MollyGu-CN,1,0.00012,172575,20.04863,860782
19965,moltzaum,1,0.00012,172576,20.04875,860782
19966,momiji,1,0.00012,172577,20.04886,860782
19967,momkeller,1,0.00012,172578,20.04898,860782
19968,mommyslab,1,0.00012,172579,20.04909,860782
19969,momoYB,1,0.00012,172580,20.04921,860782
19970,monaShe520,1,0.00012,172581,20.04933,860782
19971,monganai,1,0.00012,172582,20.04944,860782
19972,moni-pandey,1,0.00012,172583,20.04956,860782
19973,Monpoke,1,0.00012,172584,20.04968,860782
19974,monsterxx03,1,0.00012,172585,20.04979,860782
19975,mony123456,1,0.00012,172586,20.04991,860782
19976,moonshine-fish,1,0.00012,172587,20.05002,860782
19977,moonspirit,1,0.00012,172588,20.05014,860782
19978,mor300,1,0.00012,172589,20.05026,860782
19979,mor-anshuman,1,0.00012,172590,20.05037,860782
19980,morganwalker,1,0.00012,172591,20.05049,860782
19981,morind,1,0.00012,172592,20.05061,860782
19982,Mornster061,1,0.00012,172593,20.05072,860782
19983,morrishopkins,1,0.00012,172594,20.05084,860782
19984,morr-mc,1,0.00012,172595,20.05095,860782
19985,mortenbirkelund,1,0.00012,172596,20.05107,860782
19986,mortensorensen,1,0.00012,172597,20.05119,860782
19987,MortezaHosseini,1,0.00012,172598,20.05130,860782
19988,MortlMcCrisis,1,0.00012,172599,20.05142,860782
19989,mortyac,1,0.00012,172600,20.05153,860782
19990,MorZaroor,1,0.00012,172601,20.05165,860782
19991,mosesleansystems,1,0.00012,172602,20.05177,860782
19992,mosespx,1,0.00012,172603,20.05188,860782
19993,mosfet1kg,1,0.00012,172604,20.05200,860782
19994,moshebeeri,1,0.00012,172605,20.05212,860782
19995,moshinde,1,0.00012,172606,20.05223,860782
19996,mostlyAtNight,1,0.00012,172607,20.05235,860782
19997,motyla,1,0.00012,172608,20.05246,860782
19998,moubctez,1,0.00012,172609,20.05258,860782
19999,moudis,1,0.00012,172610,20.05270,860782
20000,mouliveera,1,0.00012,172611,20.05281,860782
20001,MouseRider,1,0.00012,172612,20.05293,860782
20002,moustafa-mneimneih,1,0.00012,172613,20.05304,860782
20003,mouzfun,1,0.00012,172614,20.05316,860782
20004,movinglightspeed,1,0.00012,172615,20.05328,860782
20005,moweiraul,1,0.00012,172616,20.05339,860782
20006,mowings,1,0.00012,172617,20.05351,860782
20007,mp3monster,1,0.00012,172618,20.05363,860782
20008,mpatters72,1,0.00012,172619,20.05374,860782
20009,mpechner,1,0.00012,172620,20.05386,860782
20010,mperochon,1,0.00012,172621,20.05397,860782
20011,mprice64,1,0.00012,172622,20.05409,860782
20012,mquisto8,1,0.00012,172623,20.05421,860782
20013,mrajashree,1,0.00012,172624,20.05432,860782
20014,mraliagha,1,0.00012,172625,20.05444,860782
20015,mrandrewdh,1,0.00012,172626,20.05456,860782
20016,mrangta,1,0.00012,172627,20.05467,860782
20017,MrApe,1,0.00012,172628,20.05479,860782
20018,mrbenosborne,1,0.00012,172629,20.05490,860782
20019,mrdavidaylward,1,0.00012,172630,20.05502,860782
20020,MrDienns,1,0.00012,172631,20.05514,860782
20021,mrdima,1,0.00012,172632,20.05525,860782
20022,mrdulin,1,0.00012,172633,20.05537,860782
20023,mre,1,0.00012,172634,20.05548,860782
20024,mr-feek,1,0.00012,172635,20.05560,860782
20025,mrgoonie,1,0.00012,172636,20.05572,860782
20026,mrhockeymonkey,1,0.00012,172637,20.05583,860782
20027,mridulgain,1,0.00012,172638,20.05595,860782
20028,mritzmann94,1,0.00012,172639,20.05607,860782
20029,MrJacek,1,0.00012,172640,20.05618,860782
20030,MrJoy,1,0.00012,172641,20.05630,860782
20031,mrkcmo,1,0.00012,172642,20.05641,860782
20032,mrliptontea,1,0.00012,172643,20.05653,860782
20033,mrmarcsmith,1,0.00012,172644,20.05665,860782
20034,mrmartan,1,0.00012,172645,20.05676,860782
20035,mrmassis,1,0.00012,172646,20.05688,860782
20036,mrmeku,1,0.00012,172647,20.05699,860782
20037,mrobinson513,1,0.00012,172648,20.05711,860782
20038,MrOffline77,1,0.00012,172649,20.05723,860782
20039,mroland91,1,0.00012,172650,20.05734,860782
20040,MrRightSol,1,0.00012,172651,20.05746,860782
20041,mr-smithers-excellent,1,0.00012,172652,20.05758,860782
20042,mr-tech,1,0.00012,172653,20.05769,860782
20043,mrtshoot,1,0.00012,172654,20.05781,860782
20044,mrturkmen06,1,0.00012,172655,20.05792,860782
20045,mrturkmencom,1,0.00012,172656,20.05804,860782
20046,mrunix1998,1,0.00012,172657,20.05816,860782
20047,mrvamsidhar,1,0.00012,172658,20.05827,860782
20048,mrvrbabu,1,0.00012,172659,20.05839,860782
20049,mrWinston,1,0.00012,172660,20.05850,860782
20050,Mr-Wouter,1,0.00012,172661,20.05862,860782
20051,mrysavy,1,0.00012,172662,20.05874,860782
20052,mrzdvig,1,0.00012,172663,20.05885,860782
20053,msaavedra91,1,0.00012,172664,20.05897,860782
20054,msadofschi,1,0.00012,172665,20.05909,860782
20055,msalaslo,1,0.00012,172666,20.05920,860782
20056,msarbi,1,0.00012,172667,20.05932,860782
20057,msaspence,1,0.00012,172668,20.05943,860782
20058,msaurabhee,1,0.00012,172669,20.05955,860782
20059,msawka,1,0.00012,172670,20.05967,860782
20060,MSayib,1,0.00012,172671,20.05978,860782
20061,mschiessl,1,0.00012,172672,20.05990,860782
20062,mschweiker,1,0.00012,172673,20.06002,860782
20063,mscolnick,1,0.00012,172674,20.06013,860782
20064,mscreenie,1,0.00012,172675,20.06025,860782
20065,msemik,1,0.00012,172676,20.06036,860782
20066,msepehr,1,0.00012,172677,20.06048,860782
20067,msftnadavbh,1,0.00012,172678,20.06060,860782
20068,mshahmoradi,1,0.00012,172679,20.06071,860782
20069,mshamota-nr,1,0.00012,172680,20.06083,860782
20070,msheldyakov,1,0.00012,172681,20.06094,860782
20071,msjingli,1,0.00012,172682,20.06106,860782
20072,MSLaguana,1,0.00012,172683,20.06118,860782
20073,msldn,1,0.00012,172684,20.06129,860782
20074,ms-lolo,1,0.00012,172685,20.06141,860782
20075,msm-code,1,0.00012,172686,20.06153,860782
20076,msmygit,1,0.00012,172687,20.06164,860782
20077,msoderberg,1,0.00012,172688,20.06176,860782
20078,mspinelli,1,0.00012,172689,20.06187,860782
20079,msshroff,1,0.00012,172690,20.06199,860782
20080,mstair,1,0.00012,172691,20.06211,860782
20081,mstarostik,1,0.00012,172692,20.06222,860782
20082,mstumpfx,1,0.00012,172693,20.06234,860782
20083,mszygenda,1,0.00012,172694,20.06245,860782
20084,mtardy,1,0.00012,172695,20.06257,860782
20085,mtchllbrrn,1,0.00012,172696,20.06269,860782
20086,mtneug,1,0.00012,172697,20.06280,860782
20087,mt-rahul,1,0.00012,172698,20.06292,860782
20088,mtttcgcg,1,0.00012,172699,20.06304,860782
20089,muba00,1,0.00012,172700,20.06315,860782
20090,mubeennakade,1,0.00012,172701,20.06327,860782
20091,muc,1,0.00012,172702,20.06338,860782
20092,muhammad-fahad2068,1,0.00012,172703,20.06350,860782
20093,Muhammad-Hamza-Majeed,1,0.00012,172704,20.06362,860782
20094,muhammadrizwan316,1,0.00012,172705,20.06373,860782
20095,muhanadali100,1,0.00012,172706,20.06385,860782
20096,mujgancihan,1,0.00012,172707,20.06397,860782
20097,MukeshBaskaran94,1,0.00012,172708,20.06408,860782
20098,mukesh-dua,1,0.00012,172709,20.06420,860782
20099,mukgupta,1,0.00012,172710,20.06431,860782
20100,MukulMaheshwari,1,0.00012,172711,20.06443,860782
20101,mulka,1,0.00012,172712,20.06455,860782
20102,mullgundmath,1,0.00012,172713,20.06466,860782
20103,mumushuiding,1,0.00012,172714,20.06478,860782
20104,munwar24,1,0.00012,172715,20.06489,860782
20105,muradheydarov,1,0.00012,172716,20.06501,860782
20106,murali198,1,0.00012,172717,20.06513,860782
20107,muralindia,1,0.00012,172718,20.06524,860782
20108,muratcankarakurt,1,0.00012,172719,20.06536,860782
20109,muratzorer,1,0.00012,172720,20.06548,860782
20110,murcagr,1,0.00012,172721,20.06559,860782
20111,murki,1,0.00012,172722,20.06571,860782
20112,murphyke,1,0.00012,172723,20.06582,860782
20113,muscovitebob,1,0.00012,172724,20.06594,860782
20114,mushdavtyan,1,0.00012,172725,20.06606,860782
20115,mustafaAnwar2020,1,0.00012,172726,20.06617,860782
20116,mustela,1,0.00012,172727,20.06629,860782
20117,muthuveerappan,1,0.00012,172728,20.06640,860782
20118,muyuefei,1,0.00012,172729,20.06652,860782
20119,muzzah,1,0.00012,172730,20.06664,860782
20120,mvaldes14,1,0.00012,172731,20.06675,860782
20121,mvaldesdeleon,1,0.00012,172732,20.06687,860782
20122,mvandewouw,1,0.00012,172733,20.06699,860782
20123,mvanholsteijn,1,0.00012,172734,20.06710,860782
20124,mvdpoel,1,0.00012,172735,20.06722,860782
20125,mverleg,1,0.00012,172736,20.06733,860782
20126,mvernimmen,1,0.00012,172737,20.06745,860782
20127,mvijftigschild,1,0.00012,172738,20.06757,860782
20128,mvpmvh,1,0.00012,172739,20.06768,860782
20129,MVR5991,1,0.00012,172740,20.06780,860782
20130,mwandaxm,1,0.00012,172741,20.06791,860782
20131,mwcd,1,0.00012,172742,20.06803,860782
20132,mwennrich,1,0.00012,172743,20.06815,860782
20133,mwiede,1,0.00012,172744,20.06826,860782
20134,mwmahlberg,1,0.00012,172745,20.06838,860782
20135,mwolffalonso,1,0.00012,172746,20.06850,860782
20136,mw-poly,1,0.00012,172747,20.06861,860782
20137,mxdlx,1,0.00012,172748,20.06873,860782
20138,mxs162630,1,0.00012,172749,20.06884,860782
20139,Myatu,1,0.00012,172750,20.06896,860782
20140,MyDigitalLife,1,0.00012,172751,20.06908,860782
20141,myechuri,1,0.00012,172752,20.06919,860782
20142,myers,1,0.00012,172753,20.06931,860782
20143,mygit676,1,0.00012,172754,20.06943,860782
20144,mykhailoguk,1,0.00012,172755,20.06954,860782
20145,mynameisneo7,1,0.00012,172756,20.06966,860782
20146,myoss,1,0.00012,172757,20.06977,860782
20147,mysiki,1,0.00012,172758,20.06989,860782
20148,myspotontheweb,1,0.00012,172759,20.07001,860782
20149,mytototo,1,0.00012,172760,20.07012,860782
20150,myuseridbws,1,0.00012,172761,20.07024,860782
20151,mywkaa,1,0.00012,172762,20.07035,860782
20152,myzhongguo,1,0.00012,172763,20.07047,860782
20153,mziyabo,1,0.00012,172764,20.07059,860782
20154,n1330,1,0.00012,172765,20.07070,860782
20155,n-able-consulting,1,0.00012,172766,20.07082,860782
20156,nacc,1,0.00012,172767,20.07094,860782
20157,nadar,1,0.00012,172768,20.07105,860782
20158,nadav-lavy-exa,1,0.00012,172769,20.07117,860782
20159,nadme92,1,0.00012,172770,20.07128,860782
20160,NagarajGoud,1,0.00012,172771,20.07140,860782
20161,nagesh1332,1,0.00012,172772,20.07152,860782
20162,nagpalnitin0110,1,0.00012,172773,20.07163,860782
20163,naguait85,1,0.00012,172774,20.07175,860782
20164,nagyclaudiu83,1,0.00012,172775,20.07186,860782
20165,NahaliY,1,0.00012,172776,20.07198,860782
20166,naheedakhtar,1,0.00012,172777,20.07210,860782
20167,NahisWayard,1,0.00012,172778,20.07221,860782
20168,nakfour,1,0.00012,172779,20.07233,860782
20169,namangit,1,0.00012,172780,20.07245,860782
20170,name1e5s,1,0.00012,172781,20.07256,860782
20171,namepenyo,1,0.00012,172782,20.07268,860782
20172,nan008,1,0.00012,172783,20.07279,860782
20173,nandra,1,0.00012,172784,20.07291,860782
20174,Nanduyana,1,0.00012,172785,20.07303,860782
20175,nangcuc,1,0.00012,172786,20.07314,860782
20176,NanheKumar,1,0.00012,172787,20.07326,860782
20177,nani2ratna,1,0.00012,172788,20.07338,860782
20178,NanQiL,1,0.00012,172789,20.07349,860782
20179,Nanue1,1,0.00012,172790,20.07361,860782
20180,nan-xiong,1,0.00012,172791,20.07372,860782
20181,naomiyang,1,0.00012,172792,20.07384,860782
20182,nappy,1,0.00012,172793,20.07396,860782
20183,naptarkz,1,0.00012,172794,20.07407,860782
20184,narahari92,1,0.00012,172795,20.07419,860782
20185,narasimhamurthyk3,1,0.00012,172796,20.07430,860782
20186,NarendranathPanda,1,0.00012,172797,20.07442,860782
20187,nareshadoni1,1,0.00012,172798,20.07454,860782
20188,narmadha956,1,0.00012,172799,20.07465,860782
20189,nashpaz123,1,0.00012,172800,20.07477,860782
20190,nasiriamini,1,0.00012,172801,20.07489,860782
20191,naszley93,1,0.00012,172802,20.07500,860782
20192,natanielmendes,1,0.00012,172803,20.07512,860782
20193,natanoelk,1,0.00012,172804,20.07523,860782
20194,NatarajanR,1,0.00012,172805,20.07535,860782
20195,nate-marshall,1,0.00012,172806,20.07547,860782
20196,natemoseman,1,0.00012,172807,20.07558,860782
20197,natewalck,1,0.00012,172808,20.07570,860782
20198,nathanawmk,1,0.00012,172809,20.07581,860782
20199,nathan-clark,1,0.00012,172810,20.07593,860782
20200,nathanleyton,1,0.00012,172811,20.07605,860782
20201,Nathan-Okolita-Aimtheory,1,0.00012,172812,20.07616,860782
20202,nathantran,1,0.00012,172813,20.07628,860782
20203,nathanweatherly,1,0.00012,172814,20.07640,860782
20204,nathanwong91,1,0.00012,172815,20.07651,860782
20205,naude-r,1,0.00012,172816,20.07663,860782
20206,navalta3030,1,0.00012,172817,20.07674,860782
20207,navarro-chamberlain,1,0.00012,172818,20.07686,860782
20208,navdeepblock8,1,0.00012,172819,20.07698,860782
20209,naveeng68,1,0.00012,172820,20.07709,860782
20210,navidei,1,0.00012,172821,20.07721,860782
20211,NavidK0,1,0.00012,172822,20.07733,860782
20212,navinag,1,0.00012,172823,20.07744,860782
20213,navndn,1,0.00012,172824,20.07756,860782
20214,Navodar22,1,0.00012,172825,20.07767,860782
20215,naxaamulya,1,0.00012,172826,20.07779,860782
20216,nayan32biswas,1,0.00012,172827,20.07791,860782
20217,nbigaouette,1,0.00012,172828,20.07802,860782
20218,nboukeffa,1,0.00012,172829,20.07814,860782
20219,ncadou,1,0.00012,172830,20.07825,860782
20220,ncaidin,1,0.00012,172831,20.07837,860782
20221,ncc1701j,1,0.00012,172832,20.07849,860782
20222,ncmans,1,0.00012,172833,20.07860,860782
20223,Nctllnty,1,0.00012,172834,20.07872,860782
20224,nd2014-public,1,0.00012,172835,20.07884,860782
20225,ndavidson-pulse,1,0.00012,172836,20.07895,860782
20226,ndemeshchenko,1,0.00012,172837,20.07907,860782
20227,ndimitry,1,0.00012,172838,20.07918,860782
20228,ndjhartman,1,0.00012,172839,20.07930,860782
20229,ndon55555,1,0.00012,172840,20.07942,860782
20230,ndubbala,1,0.00012,172841,20.07953,860782
20231,ne1llee,1,0.00012,172842,20.07965,860782
20232,nealflux,1,0.00012,172843,20.07976,860782
20233,nearbody,1,0.00012,172844,20.07988,860782
20234,nebffa,1,0.00012,172845,20.08000,860782
20235,nebojsa-prodana,1,0.00012,172846,20.08011,860782
20236,necdet,1,0.00012,172847,20.08023,860782
20237,neehakompala,1,0.00012,172848,20.08035,860782
20238,neena,1,0.00012,172849,20.08046,860782
20239,neerdoc,1,0.00012,172850,20.08058,860782
20240,NeethJose,1,0.00012,172851,20.08069,860782
20241,neha1196,1,0.00012,172852,20.08081,860782
20242,Nehad84,1,0.00012,172853,20.08093,860782
20243,nehap4,1,0.00012,172854,20.08104,860782
20244,NehaSachan,1,0.00012,172855,20.08116,860782
20245,neha-viswanathan,1,0.00012,172856,20.08127,860782
20246,neicunlideyu,1,0.00012,172857,20.08139,860782
20247,neighbour-oldhuang,1,0.00012,172858,20.08151,860782
20248,neildcruz,1,0.00012,172859,20.08162,860782
20249,neilmfrench,1,0.00012,172860,20.08174,860782
20250,Nek0trkstr,1,0.00012,172861,20.08186,860782
20251,NekoTashi,1,0.00012,172862,20.08197,860782
20252,nektro,1,0.00012,172863,20.08209,860782
20253,nela,1,0.00012,172864,20.08220,860782
20254,NelsonJeppesen,1,0.00012,172865,20.08232,860782
20255,nelsonspbr,1,0.00012,172866,20.08244,860782
20256,nelsonyaccuzzi,1,0.00012,172867,20.08255,860782
20257,nemith,1,0.00012,172868,20.08267,860782
20258,nemmeviu,1,0.00012,172869,20.08279,860782
20259,nenell12211,1,0.00012,172870,20.08290,860782
20260,neno-k,1,0.00012,172871,20.08302,860782
20261,neo502721,1,0.00012,172872,20.08313,860782
20262,neoakris,1,0.00012,172873,20.08325,860782
20263,Neonox31,1,0.00012,172874,20.08337,860782
20264,neowulf,1,0.00012,172875,20.08348,860782
20265,nervouscat,1,0.00012,172876,20.08360,860782
20266,ness2u,1,0.00012,172877,20.08371,860782
20267,netaskd,1,0.00012,172878,20.08383,860782
20268,NetGH,1,0.00012,172879,20.08395,860782
20269,netguino,1,0.00012,172880,20.08406,860782
20270,netinfo03,1,0.00012,172881,20.08418,860782
20271,networkandcode,1,0.00012,172882,20.08430,860782
20272,networkimprov,1,0.00012,172883,20.08441,860782
20273,neuronist,1,0.00012,172884,20.08453,860782
20274,Neurrone,1,0.00012,172885,20.08464,860782
20275,neutrongenious,1,0.00012,172886,20.08476,860782
20276,neverexists,1,0.00012,172887,20.08488,860782
20277,nevermosby,1,0.00012,172888,20.08499,860782
20278,Nevon,1,0.00012,172889,20.08511,860782
20279,nevosial,1,0.00012,172890,20.08522,860782
20280,new2helm,1,0.00012,172891,20.08534,860782
20281,newctech,1,0.00012,172892,20.08546,860782
20282,NEWgaofeng,1,0.00012,172893,20.08557,860782
20283,newlife,1,0.00012,172894,20.08569,860782
20284,newtonjose,1,0.00012,172895,20.08581,860782
20285,newusersss,1,0.00012,172896,20.08592,860782
20286,nextsux,1,0.00012,172897,20.08604,860782
20287,nextvary,1,0.00012,172898,20.08615,860782
20288,nezed,1,0.00012,172899,20.08627,860782
20289,nezha2017,1,0.00012,172900,20.08639,860782
20290,nfp007,1,0.00012,172901,20.08650,860782
20291,nfsp3k,1,0.00012,172902,20.08662,860782
20292,ngaya-ll,1,0.00012,172903,20.08674,860782
20293,ngealy,1,0.00012,172904,20.08685,860782
20294,ngerstle-cognite,1,0.00012,172905,20.08697,860782
20295,nghiepvo,1,0.00012,172906,20.08708,860782
20296,Ngpriddy,1,0.00012,172907,20.08720,860782
20297,n-g-s,1,0.00012,172908,20.08732,860782
20298,nguyenhoaibao,1,0.00012,172909,20.08743,860782
20299,nhannamsiu,1,0.00012,172910,20.08755,860782
20300,nhartner,1,0.00012,172911,20.08766,860782
20301,nhoughto,1,0.00012,172912,20.08778,860782
20302,niark567,1,0.00012,172913,20.08790,860782
20303,nic-hima,1,0.00012,172914,20.08801,860782
20304,nicholasrobertm,1,0.00012,172915,20.08813,860782
20305,Nick-Bishop-042020,1,0.00012,172916,20.08825,860782
20306,nickbullock,1,0.00012,172917,20.08836,860782
20307,nickchap,1,0.00012,172918,20.08848,860782
20308,NICK-DUAN,1,0.00012,172919,20.08859,860782
20309,NickEAVE,1,0.00012,172920,20.08871,860782
20310,Nick-Harvey,1,0.00012,172921,20.08883,860782
20311,nickhiggs,1,0.00012,172922,20.08894,860782
20312,nick-ivanov-ibm,1,0.00012,172923,20.08906,860782
20313,nick-jones,1,0.00012,172924,20.08917,860782
20314,nickmy9729,1,0.00012,172925,20.08929,860782
20315,nicknickel,1,0.00012,172926,20.08941,860782
20316,nicksbrandon,1,0.00012,172927,20.08952,860782
20317,nickyfoster,1,0.00012,172928,20.08964,860782
20318,nicofuccella,1,0.00012,172929,20.08976,860782
20319,nicolaschaillan,1,0.00012,172930,20.08987,860782
20320,nicolasmanic,1,0.00012,172931,20.08999,860782
20321,NicolasMilligan,1,0.00012,172932,20.09010,860782
20322,NicolasPA,1,0.00012,172933,20.09022,860782
20323,NicolasReyDotNet,1,0.00012,172934,20.09034,860782
20324,nicoleheard,1,0.00012,172935,20.09045,860782
20325,nicon89,1,0.00012,172936,20.09057,860782
20326,niconavarrete,1,0.00012,172937,20.09068,860782
20327,nicowilliams,1,0.00012,172938,20.09080,860782
20328,Nicwalle,1,0.00012,172939,20.09092,860782
20329,niejar,1,0.00012,172940,20.09103,860782
20330,NielsDWG,1,0.00012,172941,20.09115,860782
20331,nigh8w0lf,1,0.00012,172942,20.09127,860782
20332,nightmouse,1,0.00012,172943,20.09138,860782
20333,Nightrider0098,1,0.00012,172944,20.09150,860782
20334,nijave,1,0.00012,172945,20.09161,860782
20335,nikars,1,0.00012,172946,20.09173,860782
20336,nikashitsa,1,0.00012,172947,20.09185,860782
20337,nike38rus,1,0.00012,172948,20.09196,860782
20338,nikitaarora2995,1,0.00012,172949,20.09208,860782
20339,nikitapecasa,1,0.00012,172950,20.09220,860782
20340,nikkirs,1,0.00012,172951,20.09231,860782
20341,nikkoura,1,0.00012,172952,20.09243,860782
20342,niklasember,1,0.00012,172953,20.09254,860782
20343,nikmd23,1,0.00012,172954,20.09266,860782
20344,Nik-Novak,1,0.00012,172955,20.09278,860782
20345,nikola-milikic,1,0.00012,172956,20.09289,860782
20346,nikolay-te,1,0.00012,172957,20.09301,860782
20347,NikolayUvarov,1,0.00012,172958,20.09312,860782
20348,nikooo777,1,0.00012,172959,20.09324,860782
20349,nikosep,1,0.00012,172960,20.09336,860782
20350,nikovacevic,1,0.00012,172961,20.09347,860782
20351,niladrih,1,0.00012,172962,20.09359,860782
20352,nileshbhadana,1,0.00012,172963,20.09371,860782
20353,nilideal,1,0.00012,172964,20.09382,860782
20354,nilsmeyer,1,0.00012,172965,20.09394,860782
20355,Nilsty,1,0.00012,172966,20.09405,860782
20356,nimamahmoudi,1,0.00012,172967,20.09417,860782
20357,nimbusventures,1,0.00012,172968,20.09429,860782
20358,nimda7,1,0.00012,172969,20.09440,860782
20359,nimdaconficker,1,0.00012,172970,20.09452,860782
20360,nimish,1,0.00012,172971,20.09463,860782
20361,nimmichele,1,0.00012,172972,20.09475,860782
20362,nimrod-becker,1,0.00012,172973,20.09487,860782
20363,nimrodf1,1,0.00012,172974,20.09498,860782
20364,nineinchnick,1,0.00012,172975,20.09510,860782
20365,ning1875,1,0.00012,172976,20.09522,860782
20366,ningyougang,1,0.00012,172977,20.09533,860782
20367,ninijay,1,0.00012,172978,20.09545,860782
20368,ninjajazza,1,0.00012,172979,20.09556,860782
20369,NinjaPanda91,1,0.00012,172980,20.09568,860782
20370,niorg,1,0.00012,172981,20.09580,860782
20371,nipunchawla-bc,1,0.00012,172982,20.09591,860782
20372,nirajsonawane,1,0.00012,172983,20.09603,860782
20373,niranjanreddy48,1,0.00012,172984,20.09615,860782
20374,nirarg,1,0.00012,172985,20.09626,860782
20375,niroowns,1,0.00012,172986,20.09638,860782
20376,nirvanagit,1,0.00012,172987,20.09649,860782
20377,nishanperera,1,0.00012,172988,20.09661,860782
20378,NishanthLawrence,1,0.00012,172989,20.09673,860782
20379,nishantydv97,1,0.00012,172990,20.09684,860782
20380,Nit2879,1,0.00012,172991,20.09696,860782
20381,niteshagrawalgmail,1,0.00012,172992,20.09707,860782
20382,nitesh-kumar-sharma,1,0.00012,172993,20.09719,860782
20383,NithinKumarJonnala,1,0.00012,172994,20.09731,860782
20384,Nithisha-BR,1,0.00012,172995,20.09742,860782
20385,nittugeorge,1,0.00012,172996,20.09754,860782
20386,nivak47,1,0.00012,172997,20.09766,860782
20387,NiveditaKumari14,1,0.00012,172998,20.09777,860782
20388,niyaozhushuma,1,0.00012,172999,20.09789,860782
20389,njbrake,1,0.00012,173000,20.09800,860782
20390,njeans,1,0.00012,173001,20.09812,860782
20391,N-lucky,1,0.00012,173002,20.09824,860782
20392,nmathew,1,0.00012,173003,20.09835,860782
20393,nmiodice,1,0.00012,173004,20.09847,860782
20394,nnanda2016,1,0.00012,173005,20.09858,860782
20395,nnmccaughley,1,0.00012,173006,20.09870,860782
20396,no1melman,1,0.00012,173007,20.09882,860782
20397,noahjd,1,0.00012,173008,20.09893,860782
20398,noamt,1,0.00012,173009,20.09905,860782
20399,nobodyiam,1,0.00012,173010,20.09917,860782
20400,NobodysNightmare,1,0.00012,173011,20.09928,860782
20401,nobusue,1,0.00012,173012,20.09940,860782
20402,nocraza,1,0.00012,173013,20.09951,860782
20403,nodeav,1,0.00012,173014,20.09963,860782
20404,n-oden,1,0.00012,173015,20.09975,860782
20405,nodje,1,0.00012,173016,20.09986,860782
20406,noguilty4you,1,0.00012,173017,20.09998,860782
20407,NoizeMe,1,0.00012,173018,20.10010,860782
20408,nolanrsherman,1,0.00012,173019,20.10021,860782
20409,nollimahere,1,0.00012,173020,20.10033,860782
20410,nolte,1,0.00012,173021,20.10044,860782
20411,nomecks,1,0.00012,173022,20.10056,860782
20412,non7top,1,0.00012,173023,20.10068,860782
20413,nonai,1,0.00012,173024,20.10079,860782
20414,NoneGG,1,0.00012,173025,20.10091,860782
20415,norbertwnuk,1,0.00012,173026,20.10102,860782
20416,NordenF,1,0.00012,173027,20.10114,860782
20417,noreentry,1,0.00012,173028,20.10126,860782
20418,noreff,1,0.00012,173029,20.10137,860782
20419,norganna,1,0.00012,173030,20.10149,860782
20420,Norman0406,1,0.00012,173031,20.10161,860782
20421,normanschlatter,1,0.00012,173032,20.10172,860782
20422,NorthFuture,1,0.00012,173033,20.10184,860782
20423,northlander,1,0.00012,173034,20.10195,860782
20424,notandy,1,0.00012,173035,20.10207,860782
20425,Notdeath,1,0.00012,173036,20.10219,860782
20426,notetook,1,0.00012,173037,20.10230,860782
20427,notiqq,1,0.00012,173038,20.10242,860782
20428,notnoop,1,0.00012,173039,20.10253,860782
20429,notras,1,0.00012,173040,20.10265,860782
20430,nous23,1,0.00012,173041,20.10277,860782
20431,NovaHe,1,0.00012,173042,20.10288,860782
20432,Noveen,1,0.00012,173043,20.10300,860782
20433,novi,1,0.00012,173044,20.10312,860782
20434,novonilc,1,0.00012,173045,20.10323,860782
20435,nowfox,1,0.00012,173046,20.10335,860782
20436,np300,1,0.00012,173047,20.10346,860782
20437,nperiwal,1,0.00012,173048,20.10358,860782
20438,nplusp,1,0.00012,173049,20.10370,860782
20439,nrailgun,1,0.00012,173050,20.10381,860782
20440,nsettipa,1,0.00012,173051,20.10393,860782
20441,nsg,1,0.00012,173052,20.10404,860782
20442,nsinha5,1,0.00012,173053,20.10416,860782
20443,nsinkov,1,0.00012,173054,20.10428,860782
20444,nsr-py,1,0.00012,173055,20.10439,860782
20445,nssachin,1,0.00012,173056,20.10451,860782
20446,nstandif,1,0.00012,173057,20.10463,860782
20447,nsteinmetz,1,0.00012,173058,20.10474,860782
20448,nstjelja,1,0.00012,173059,20.10486,860782
20449,ntdef,1,0.00012,173060,20.10497,860782
20450,ntdetect,1,0.00012,173061,20.10509,860782
20451,nthienan,1,0.00012,173062,20.10521,860782
20452,ntmartin,1,0.00012,173063,20.10532,860782
20453,ntsipes,1,0.00012,173064,20.10544,860782
20454,ntwalibas,1,0.00012,173065,20.10556,860782
20455,ntx-ben,1,0.00012,173066,20.10567,860782
20456,nuhamind2,1,0.00012,173067,20.10579,860782
20457,nukru,1,0.00012,173068,20.10590,860782
20458,nullck,1,0.00012,173069,20.10602,860782
20459,nupplaphil,1,0.00012,173070,20.10614,860782
20460,Nurlan199206,1,0.00012,173071,20.10625,860782
20461,nuved,1,0.00012,173072,20.10637,860782
20462,nvcnvn,1,0.00012,173073,20.10648,860782
20463,nvidiagithub,1,0.00012,173074,20.10660,860782
20464,Nvious1,1,0.00012,173075,20.10672,860782
20465,nvoskuilen,1,0.00012,173076,20.10683,860782
20466,nwber,1,0.00012,173077,20.10695,860782
20467,nWhitehill,1,0.00012,173078,20.10707,860782
20468,nwoodmsft,1,0.00012,173079,20.10718,860782
20469,nwsparks,1,0.00012,173080,20.10730,860782
20470,nxexox,1,0.00012,173081,20.10741,860782
20471,nyuday,1,0.00012,173082,20.10753,860782
20472,nyxi,1,0.00012,173083,20.10765,860782
20473,n-zeed,1,0.00012,173084,20.10776,860782
20474,nzjustin,1,0.00012,173085,20.10788,860782
20475,nzncngz,1,0.00012,173086,20.10799,860782
20476,nzupan,1,0.00012,173087,20.10811,860782
20477,oahcran,1,0.00012,173088,20.10823,860782
20478,oaicstef,1,0.00012,173089,20.10834,860782
20479,oazmon,1,0.00012,173090,20.10846,860782
20480,OBenned,1,0.00012,173091,20.10858,860782
20481,obfuscurity,1,0.00012,173092,20.10869,860782
20482,oblogic7,1,0.00012,173093,20.10881,860782
20483,obmar68,1,0.00012,173094,20.10892,860782
20484,obohovyk,1,0.00012,173095,20.10904,860782
20485,obohrer,1,0.00012,173096,20.10916,860782
20486,obrienrobert,1,0.00012,173097,20.10927,860782
20487,obscurerichard,1,0.00012,173098,20.10939,860782
20488,obsider,1,0.00012,173099,20.10951,860782
20489,occupytheweb,1,0.00012,173100,20.10962,860782
20490,ocdi,1,0.00012,173101,20.10974,860782
20491,oceaneLonneux,1,0.00012,173102,20.10985,860782
20492,octanolab,1,0.00012,173103,20.10997,860782
20493,OctavioCore,1,0.00012,173104,20.11009,860782
20494,Octogonapus,1,0.00012,173105,20.11020,860782
20495,octplane,1,0.00012,173106,20.11032,860782
20496,odensc,1,0.00012,173107,20.11043,860782
20497,odg0318,1,0.00012,173108,20.11055,860782
20498,odinsy,1,0.00012,173109,20.11067,860782
20499,oengel,1,0.00012,173110,20.11078,860782
20500,OferPRTZ,1,0.00012,173111,20.11090,860782
20501,offlinejke,1,0.00012,173112,20.11102,860782
20502,ofiryy,1,0.00012,173113,20.11113,860782
20503,oganga,1,0.00012,173114,20.11125,860782
20504,ogbofjnr,1,0.00012,173115,20.11136,860782
20505,ogerasymenko,1,0.00012,173116,20.11148,860782
20506,Oghenebrume50,1,0.00012,173117,20.11160,860782
20507,ogolberg,1,0.00012,173118,20.11171,860782
20508,oguzyildiz1991,1,0.00012,173119,20.11183,860782
20509,ohadschn,1,0.00012,173120,20.11194,860782
20510,ohauer,1,0.00012,173121,20.11206,860782
20511,OhBonsai,1,0.00012,173122,20.11218,860782
20512,ohmytel,1,0.00012,173123,20.11229,860782
20513,oiricaud,1,0.00012,173124,20.11241,860782
20514,okdas,1,0.00012,173125,20.11253,860782
20515,Okhwan,1,0.00012,173126,20.11264,860782
20516,OKNoah,1,0.00012,173127,20.11276,860782
20517,OktaySavdi,1,0.00012,173128,20.11287,860782
20518,okue,1,0.00012,173129,20.11299,860782
20519,OKyHb,1,0.00012,173130,20.11311,860782
20520,olaf-meyer,1,0.00012,173131,20.11322,860782
20521,olddanmer,1,0.00012,173132,20.11334,860782
20522,olegburov,1,0.00012,173133,20.11345,860782
20523,oleg-filiutsich,1,0.00012,173134,20.11357,860782
20524,OleksandrMykytenko,1,0.00012,173135,20.11369,860782
20525,olganicegirl,1,0.00012,173136,20.11380,860782
20526,oliveirafilipe,1,0.00012,173137,20.11392,860782
20527,OliverTw1st,1,0.00012,173138,20.11404,860782
20528,ollydixon,1,0.00012,173139,20.11415,860782
20529,OluOwolabi,1,0.00012,173140,20.11427,860782
20530,omallo,1,0.00012,173141,20.11438,860782
20531,oman-kumar,1,0.00012,173142,20.11450,860782
20532,Omar-V2,1,0.00012,173143,20.11462,860782
20533,omerfsen,1,0.00012,173144,20.11473,860782
20534,omerxx,1,0.00012,173145,20.11485,860782
20535,omesser,1,0.00012,173146,20.11497,860782
20536,ominidx,1,0.00012,173147,20.11508,860782
20537,ommehaz,1,0.00012,173148,20.11520,860782
20538,Omniscience619,1,0.00012,173149,20.11531,860782
20539,onanying,1,0.00012,173150,20.11543,860782
20540,ondravondra,1,0.00012,173151,20.11555,860782
20541,ondronix,1,0.00012,173152,20.11566,860782
20542,onecer,1,0.00012,173153,20.11578,860782
20543,OneCodeMonkey,1,0.00012,173154,20.11589,860782
20544,onisac-K,1,0.00012,173155,20.11601,860782
20545,onixie,1,0.00012,173156,20.11613,860782
20546,onkarbhat,1,0.00012,173157,20.11624,860782
20547,onkarganjewar,1,0.00012,173158,20.11636,860782
20548,onrylmz,1,0.00012,173159,20.11648,860782
20549,onzo-dyk,1,0.00012,173160,20.11659,860782
20550,onzo-mateuszzakarczemny,1,0.00012,173161,20.11671,860782
20551,ooneko,1,0.00012,173162,20.11682,860782
20552,opdude,1,0.00012,173163,20.11694,860782
20553,openbioinfo,1,0.00012,173164,20.11706,860782
20554,opensourcebear,1,0.00012,173165,20.11717,860782
20555,operations999,1,0.00012,173166,20.11729,860782
20556,oponder,1,0.00012,173167,20.11740,860782
20557,opswfit,1,0.00012,173168,20.11752,860782
20558,opsxcq,1,0.00012,173169,20.11764,860782
20559,optiman,1,0.00012,173170,20.11775,860782
20560,OpusMeum,1,0.00012,173171,20.11787,860782
20561,Orabig,1,0.00012,173172,20.11799,860782
20562,orangehaired,1,0.00012,173173,20.11810,860782
20563,orangejuice,1,0.00012,173174,20.11822,860782
20564,orcnz,1,0.00012,173175,20.11833,860782
20565,organ2,1,0.00012,173176,20.11845,860782
20566,OriBenHur-Any,1,0.00012,173177,20.11857,860782
20567,orifito,1,0.00012,173178,20.11868,860782
20568,OriKerer,1,0.00012,173179,20.11880,860782
20569,ori-stoliar,1,0.00012,173180,20.11892,860782
20570,orkunkaraduman,1,0.00012,173181,20.11903,860782
20571,orlangure,1,0.00012,173182,20.11915,860782
20572,orondon,1,0.00012,173183,20.11926,860782
20573,oronge,1,0.00012,173184,20.11938,860782
20574,orthoxerox,1,0.00012,173185,20.11950,860782
20575,ortiga88,1,0.00012,173186,20.11961,860782
20576,os,1,0.00012,173187,20.11973,860782
20577,osgigeek,1,0.00012,173188,20.11984,860782
20578,oshamin,1,0.00012,173189,20.11996,860782
20579,Oshiumi,1,0.00012,173190,20.12008,860782
20580,osma,1,0.00012,173191,20.12019,860782
20581,ossie-git,1,0.00012,173192,20.12031,860782
20582,ostackbrian,1,0.00012,173193,20.12043,860782
20583,ostmike,1,0.00012,173194,20.12054,860782
20584,ota-akira,1,0.00012,173195,20.12066,860782
20585,otoolep,1,0.00012,173196,20.12077,860782
20586,Otto404,1,0.00012,173197,20.12089,860782
20587,ottomata,1,0.00012,173198,20.12101,860782
20588,ouchengle,1,0.00012,173199,20.12112,860782
20589,OuSatoru,1,0.00012,173200,20.12124,860782
20590,outi85,1,0.00012,173201,20.12135,860782
20591,ouyangluwei,1,0.00012,173202,20.12147,860782
20592,overdrive3000,1,0.00012,173203,20.12159,860782
20593,ovidiuf,1,0.00012,173204,20.12170,860782
20594,oweise,1,0.00012,173205,20.12182,860782
20595,Owen-Cummings,1,0.00012,173206,20.12194,860782
20596,OwenDelahoy,1,0.00012,173207,20.12205,860782
20597,owengo,1,0.00012,173208,20.12217,860782
20598,owenson,1,0.00012,173209,20.12228,860782
20599,owensuls,1,0.00012,173210,20.12240,860782
20600,owulveryck,1,0.00012,173211,20.12252,860782
20601,oxalide-mp-tech,1,0.00012,173212,20.12263,860782
20602,oxtbuilder,1,0.00012,173213,20.12275,860782
20603,oyemeLife,1,0.00012,173214,20.12287,860782
20604,p0pr0ck5,1,0.00012,173215,20.12298,860782
20605,P3tronius,1,0.00012,173216,20.12310,860782
20606,p4654545,1,0.00012,173217,20.12321,860782
20607,P6rguVyrst,1,0.00012,173218,20.12333,860782
20608,pa1611mu,1,0.00012,173219,20.12345,860782
20609,paavan98pm,1,0.00012,173220,20.12356,860782
20610,paawan01,1,0.00012,173221,20.12368,860782
20611,pablogamboa,1,0.00012,173222,20.12379,860782
20612,pablolibo,1,0.00012,173223,20.12391,860782
20613,pablosistemas,1,0.00012,173224,20.12403,860782
20614,pabrahamsson,1,0.00012,173225,20.12414,860782
20615,paburgos,1,0.00012,173226,20.12426,860782
20616,pacogomez,1,0.00012,173227,20.12438,860782
20617,Pactionly,1,0.00012,173228,20.12449,860782
20618,PA-Devol,1,0.00012,173229,20.12461,860782
20619,padhidipika,1,0.00012,173230,20.12472,860782
20620,padma27,1,0.00012,173231,20.12484,860782
20621,padmeshgit,1,0.00012,173232,20.12496,860782
20622,Paetan,1,0.00012,173233,20.12507,860782
20623,paihu,1,0.00012,173234,20.12519,860782
20624,pajowu,1,0.00012,173235,20.12530,860782
20625,pake2070,1,0.00012,173236,20.12542,860782
20626,palacerteupgrade,1,0.00012,173237,20.12554,860782
20627,pal-dinesh23,1,0.00012,173238,20.12565,860782
20628,paleg,1,0.00012,173239,20.12577,860782
20629,pallavimitra,1,0.00012,173240,20.12589,860782
20630,pallavisingh-13,1,0.00012,173241,20.12600,860782
20631,palm93,1,0.00012,173242,20.12612,860782
20632,PanAeon,1,0.00012,173243,20.12623,860782
20633,panchn-n,1,0.00012,173244,20.12635,860782
20634,pandey-adarsh147,1,0.00012,173245,20.12647,860782
20635,pandorasNox,1,0.00012,173246,20.12658,860782
20636,pandres95,1,0.00012,173247,20.12670,860782
20637,Panghu98,1,0.00012,173248,20.12681,860782
20638,pankajakhade,1,0.00012,173249,20.12693,860782
20639,pankaj-akhade,1,0.00012,173250,20.12705,860782
20640,pankaj-dahiya,1,0.00012,173251,20.12716,860782
20641,pankaj-OD,1,0.00012,173252,20.12728,860782
20642,panqingfeng,1,0.00012,173253,20.12740,860782
20643,paphillon,1,0.00012,173254,20.12751,860782
20644,papi83dm,1,0.00012,173255,20.12763,860782
20645,pappasam,1,0.00012,173256,20.12774,860782
20646,paps82,1,0.00012,173257,20.12786,860782
20647,paracetamol32,1,0.00012,173258,20.12798,860782
20648,Parad0X,1,0.00012,173259,20.12809,860782
20649,paraglade,1,0.00012,173260,20.12821,860782
20650,parente,1,0.00012,173261,20.12833,860782
20651,ParFlesh,1,0.00012,173262,20.12844,860782
20652,pariminaresh,1,0.00012,173263,20.12856,860782
20653,parisgo,1,0.00012,173264,20.12867,860782
20654,parkergordonio,1,0.00012,173265,20.12879,860782
20655,Parkhyom,1,0.00012,173266,20.12891,860782
20656,parmar-gaurav,1,0.00012,173267,20.12902,860782
20657,parmen789,1,0.00012,173268,20.12914,860782
20658,parthasl,1,0.00012,173269,20.12925,860782
20659,parthpower,1,0.00012,173270,20.12937,860782
20660,parth-thakkar,1,0.00012,173271,20.12949,860782
20661,Parwinderjit16061986,1,0.00012,173272,20.12960,860782
20662,pascalhofmann,1,0.00012,173273,20.12972,860782
20663,pashakopot,1,0.00012,173274,20.12984,860782
20664,pashau,1,0.00012,173275,20.12995,860782
20665,patagonaa,1,0.00012,173276,20.13007,860782
20666,pathania29,1,0.00012,173277,20.13018,860782
20667,PatHoo,1,0.00012,173278,20.13030,860782
20668,patilpravin557,1,0.00012,173279,20.13042,860782
20669,patrakov,1,0.00012,173280,20.13053,860782
20670,patrick-armitage,1,0.00012,173281,20.13065,860782
20671,PatrickGoRaft,1,0.00012,173282,20.13076,860782
20672,Patricol,1,0.00012,173283,20.13088,860782
20673,patsadow2,1,0.00012,173284,20.13100,860782
20674,patsmitty,1,0.00012,173285,20.13111,860782
20675,pattrickrice,1,0.00012,173286,20.13123,860782
20676,paulcosma,1,0.00012,173287,20.13135,860782
20677,paulcreasey,1,0.00012,173288,20.13146,860782
20678,pauljamm,1,0.00012,173289,20.13158,860782
20679,pauljohanneskraft,1,0.00012,173290,20.13169,860782
20680,paul-mesnilgrente,1,0.00012,173291,20.13181,860782
20681,paulmiller3000,1,0.00012,173292,20.13193,860782
20682,pauln,1,0.00012,173293,20.13204,860782
20683,pauloboss,1,0.00012,173294,20.13216,860782
20684,paulsd2020,1,0.00012,173295,20.13228,860782
20685,paul-theorem,1,0.00012,173296,20.13239,860782
20686,paulversion,1,0.00012,173297,20.13251,860782
20687,paulwfield,1,0.00012,173298,20.13262,860782
20688,pavanbadugu,1,0.00012,173299,20.13274,860782
20689,PavanRaga,1,0.00012,173300,20.13286,860782
20690,pavel1269,1,0.00012,173301,20.13297,860782
20691,pavelkalinnikov,1,0.00012,173302,20.13309,860782
20692,pavel-khritonenko,1,0.00012,173303,20.13320,860782
20693,pavelkokush,1,0.00012,173304,20.13332,860782
20694,pavel-pimenov,1,0.00012,173305,20.13344,860782
20695,PavelYarysh,1,0.00012,173306,20.13355,860782
20696,pavelzamyatin,1,0.00012,173307,20.13367,860782
20697,pavin,1,0.00012,173308,20.13379,860782
20698,pavlospt,1,0.00012,173309,20.13390,860782
20699,PavloZabudskyi,1,0.00012,173310,20.13402,860782
20700,Pavs1605,1,0.00012,173311,20.13413,860782
20701,pawanyoda,1,0.00012,173312,20.13425,860782
20702,paxal78,1,0.00012,173313,20.13437,860782
20703,pax-awitt,1,0.00012,173314,20.13448,860782
20704,PayalSasmal10,1,0.00012,173315,20.13460,860782
20705,paymog,1,0.00012,173316,20.13471,860782
20706,pazarr,1,0.00012,173317,20.13483,860782
20707,Pbabbar7,1,0.00012,173318,20.13495,860782
20708,pbaezab,1,0.00012,173319,20.13506,860782
20709,pbaitule,1,0.00012,173320,20.13518,860782
20710,pbar1,1,0.00012,173321,20.13530,860782
20711,pbeaumontQc,1,0.00012,173322,20.13541,860782
20712,pbebbo,1,0.00012,173323,20.13553,860782
20713,pbloigu,1,0.00012,173324,20.13564,860782
20714,pbonito,1,0.00012,173325,20.13576,860782
20715,pbronneberg,1,0.00012,173326,20.13588,860782
20716,pceuropa,1,0.00012,173327,20.13599,860782
20717,pcgeek86,1,0.00012,173328,20.13611,860782
20718,pchmielecki87,1,0.00012,173329,20.13622,860782
20719,pcjeffmac,1,0.00012,173330,20.13634,860782
20720,pc-kdholakia,1,0.00012,173331,20.13646,860782
20721,pc-mreeves,1,0.00012,173332,20.13657,860782
20722,pdefreitas,1,0.00012,173333,20.13669,860782
20723,pdevrien,1,0.00012,173334,20.13681,860782
20724,pdisciascio,1,0.00012,173335,20.13692,860782
20725,pdkkid,1,0.00012,173336,20.13704,860782
20726,peakerli,1,0.00012,173337,20.13715,860782
20727,peddicnu,1,0.00012,173338,20.13727,860782
20728,pedrobertao,1,0.00012,173339,20.13739,860782
20729,pedrohmuniz,1,0.00012,173340,20.13750,860782
20730,PedroJurado,1,0.00012,173341,20.13762,860782
20731,pedromiranda17,1,0.00012,173342,20.13774,860782
20732,pedrosousagrilo,1,0.00012,173343,20.13785,860782
20733,peeet,1,0.00012,173344,20.13797,860782
20734,PelayoMarinas,1,0.00012,173345,20.13808,860782
20735,Pelrauns,1,0.00012,173346,20.13820,860782
20736,pencilkill,1,0.00012,173347,20.13832,860782
20737,peng09,1,0.00012,173348,20.13843,860782
20738,penglongli,1,0.00012,173349,20.13855,860782
20739,penguin205,1,0.00012,173350,20.13866,860782
20740,pengzai170,1,0.00012,173351,20.13878,860782
20741,penkong,1,0.00012,173352,20.13890,860782
20742,Penny20181222,1,0.00012,173353,20.13901,860782
20743,pennycheng2018,1,0.00012,173354,20.13913,860782
20744,perfectworks,1,0.00012,173355,20.13925,860782
20745,PerilousApricot,1,0.00012,173356,20.13936,860782
20746,perljusback,1,0.00012,173357,20.13948,860782
20747,permanzh,1,0.00012,173358,20.13959,860782
20748,perosb,1,0.00012,173359,20.13971,860782
20749,perrefe,1,0.00012,173360,20.13983,860782
20750,PerseveranceJing,1,0.00012,173361,20.13994,860782
20751,perumalla-giridhar,1,0.00012,173362,20.14006,860782
20752,petdance,1,0.00012,173363,20.14017,860782
20753,petebuffon,1,0.00012,173364,20.14029,860782
20754,petedavis,1,0.00012,173365,20.14041,860782
20755,petemounce,1,0.00012,173366,20.14052,860782
20756,peter05010402,1,0.00012,173367,20.14064,860782
20757,Peter9042,1,0.00012,173368,20.14076,860782
20758,PeterGerrard,1,0.00012,173369,20.14087,860782
20759,petergood,1,0.00012,173370,20.14099,860782
20760,peterldowns,1,0.00012,173371,20.14110,860782
20761,peteroyle,1,0.00012,173372,20.14122,860782
20762,peter-poki,1,0.00012,173373,20.14134,860782
20763,petersaints,1,0.00012,173374,20.14145,860782
20764,petertsu,1,0.00012,173375,20.14157,860782
20765,Peterwangyyy,1,0.00012,173376,20.14169,860782
20766,peteryhwong,1,0.00012,173377,20.14180,860782
20767,petro-matic,1,0.00012,173378,20.14192,860782
20768,PetruRitivoiu,1,0.00012,173379,20.14203,860782
20769,PFacheris,1,0.00012,173380,20.14215,860782
20770,pfyod,1,0.00012,173381,20.14227,860782
20771,pg942665,1,0.00012,173382,20.14238,860782
20772,PGDream,1,0.00012,173383,20.14250,860782
20773,pgodfrin,1,0.00012,173384,20.14261,860782
20774,pgoga,1,0.00012,173385,20.14273,860782
20775,pguinardco,1,0.00012,173386,20.14285,860782
20776,pgvirtuoso,1,0.00012,173387,20.14296,860782
20777,Ph0rse,1,0.00012,173388,20.14308,860782
20778,phachon,1,0.00012,173389,20.14320,860782
20779,PHameete,1,0.00012,173390,20.14331,860782
20780,phamnhuvu-dev,1,0.00012,173391,20.14343,860782
20781,phantomcraft,1,0.00012,173392,20.14354,860782
20782,Phasip,1,0.00012,173393,20.14366,860782
20783,phaus,1,0.00012,173394,20.14378,860782
20784,phaze-,1,0.00012,173395,20.14389,860782
20785,phbelitz,1,0.00012,173396,20.14401,860782
20786,pheely,1,0.00012,173397,20.14412,860782
20787,Phelan164,1,0.00012,173398,20.14424,860782
20788,PhenomingZ,1,0.00012,173399,20.14436,860782
20789,philicious,1,0.00012,173400,20.14447,860782
20790,philios33,1,0.00012,173401,20.14459,860782
20791,philipp-bananaware,1,0.00012,173402,20.14471,860782
20792,philippevidal80,1,0.00012,173403,20.14482,860782
20793,PhilippeVienne,1,0.00012,173404,20.14494,860782
20794,philippgille,1,0.00012,173405,20.14505,860782
20795,philipp-hb,1,0.00012,173406,20.14517,860782
20796,philkuz,1,0.00012,173407,20.14529,860782
20797,Phillels,1,0.00012,173408,20.14540,860782
20798,phillewis,1,0.00012,173409,20.14552,860782
20799,phirivie,1,0.00012,173410,20.14564,860782
20800,phoenix-bjoern,1,0.00012,173411,20.14575,860782
20801,phoenixwp,1,0.00012,173412,20.14587,860782
20802,phoewass,1,0.00012,173413,20.14598,860782
20803,phomein,1,0.00012,173414,20.14610,860782
20804,ph-One,1,0.00012,173415,20.14622,860782
20805,phosae,1,0.00012,173416,20.14633,860782
20806,phr3nzii,1,0.00012,173417,20.14645,860782
20807,phua-actech,1,0.00012,173418,20.14656,860782
20808,phuoc-thanh,1,0.00012,173419,20.14668,860782
20809,phzietsman,1,0.00012,173420,20.14680,860782
20810,piahoo,1,0.00012,173421,20.14691,860782
20811,piaic65617,1,0.00012,173422,20.14703,860782
20812,piaoairy219,1,0.00012,173423,20.14715,860782
20813,picaso,1,0.00012,173424,20.14726,860782
20814,picassio,1,0.00012,173425,20.14738,860782
20815,PidgeyBE,1,0.00012,173426,20.14749,860782
20816,piengeng,1,0.00012,173427,20.14761,860782
20817,piepmatz,1,0.00012,173428,20.14773,860782
20818,piercetrey-figure,1,0.00012,173429,20.14784,860782
20819,PierreKelbert,1,0.00012,173430,20.14796,860782
20820,pierremahot,1,0.00012,173431,20.14807,860782
20821,PierreNowak,1,0.00012,173432,20.14819,860782
20822,PierrickVoulet,1,0.00012,173433,20.14831,860782
20823,Pieter-Auqkwa,1,0.00012,173434,20.14842,860782
20824,Pihu1998,1,0.00012,173435,20.14854,860782
20825,pikapika2020,1,0.00012,173436,20.14866,860782
20826,pikeas,1,0.00012,173437,20.14877,860782
20827,pilou-,1,0.00012,173438,20.14889,860782
20828,ping-localhost,1,0.00012,173439,20.14900,860782
20829,pingoleon108,1,0.00012,173440,20.14912,860782
20830,pingood,1,0.00012,173441,20.14924,860782
20831,pio2pio,1,0.00012,173442,20.14935,860782
20832,PiotrKowalski93,1,0.00012,173443,20.14947,860782
20833,PiotrKozimor,1,0.00012,173444,20.14958,860782
20834,piotrkrokowski,1,0.00012,173445,20.14970,860782
20835,piotrmaslanka,1,0.00012,173446,20.14982,860782
20836,piotrmsc,1,0.00012,173447,20.14993,860782
20837,piotron,1,0.00012,173448,20.15005,860782
20838,pipe01,1,0.00012,173449,20.15017,860782
20839,pipe0482,1,0.00012,173450,20.15028,860782
20840,pipoe2h,1,0.00012,173451,20.15040,860782
20841,pit,1,0.00012,173452,20.15051,860782
20842,Pithikos,1,0.00012,173453,20.15063,860782
20843,pitscher,1,0.00012,173454,20.15075,860782
20844,Pivert,1,0.00012,173455,20.15086,860782
20845,pivotal-yang-jiang,1,0.00012,173456,20.15098,860782
20846,pixalynx,1,0.00012,173457,20.15110,860782
20847,pixelrazor,1,0.00012,173458,20.15121,860782
20848,PixelRobots,1,0.00012,173459,20.15133,860782
20849,pixime,1,0.00012,173460,20.15144,860782
20850,piyu8787,1,0.00012,173461,20.15156,860782
20851,piyushcom,1,0.00012,173462,20.15168,860782
20852,piyushnigam,1,0.00012,173463,20.15179,860782
20853,piyush-sh,1,0.00012,173464,20.15191,860782
20854,piyush-Shrivastava,1,0.00012,173465,20.15202,860782
20855,pja-kit,1,0.00012,173466,20.15214,860782
20856,pjediny,1,0.00012,173467,20.15226,860782
20857,pjo256,1,0.00012,173468,20.15237,860782
20858,pjxiao,1,0.00012,173469,20.15249,860782
20859,PKalhara,1,0.00012,173470,20.15261,860782
20860,pkalincat,1,0.00012,173471,20.15272,860782
20861,pkarrot,1,0.00012,173472,20.15284,860782
20862,pkartch,1,0.00012,173473,20.15295,860782
20863,pkdas,1,0.00012,173474,20.15307,860782
20864,pkelleratwork,1,0.00012,173475,20.15319,860782
20865,pkrrsimtian,1,0.00012,173476,20.15330,860782
20866,pkwarren,1,0.00012,173477,20.15342,860782
20867,playerla,1,0.00012,173478,20.15353,860782
20868,plazma-prizma,1,0.00012,173479,20.15365,860782
20869,plinkable,1,0.00012,173480,20.15377,860782
20870,pliutak-nih,1,0.00012,173481,20.15388,860782
20871,plucked,1,0.00012,173482,20.15400,860782
20872,plusices,1,0.00012,173483,20.15412,860782
20873,pmalek-sumo,1,0.00012,173484,20.15423,860782
20874,pmarques,1,0.00012,173485,20.15435,860782
20875,pmarreck,1,0.00012,173486,20.15446,860782
20876,pmartin-lvmh,1,0.00012,173487,20.15458,860782
20877,pmbibe,1,0.00012,173488,20.15470,860782
20878,pm-energid,1,0.00012,173489,20.15481,860782
20879,pmghong,1,0.00012,173490,20.15493,860782
20880,pmmalinov01,1,0.00012,173491,20.15505,860782
20881,pnaguno,1,0.00012,173492,20.15516,860782
20882,pnbrown,1,0.00012,173493,20.15528,860782
20883,pniederlag,1,0.00012,173494,20.15539,860782
20884,po3rin,1,0.00012,173495,20.15551,860782
20885,pocman,1,0.00012,173496,20.15563,860782
20886,podshumok,1,0.00012,173497,20.15574,860782
20887,PoeBlu,1,0.00012,173498,20.15586,860782
20888,pog2g,1,0.00012,173499,20.15597,860782
20889,pojntfx,1,0.00012,173500,20.15609,860782
20890,polachz,1,0.00012,173501,20.15621,860782
20891,polakams,1,0.00012,173502,20.15632,860782
20892,polanjir,1,0.00012,173503,20.15644,860782
20893,polaroi8d,1,0.00012,173504,20.15656,860782
20894,poliander,1,0.00012,173505,20.15667,860782
20895,polly-want-a-kraken,1,0.00012,173506,20.15679,860782
20896,polyaxon-team,1,0.00012,173507,20.15690,860782
20897,pom11,1,0.00012,173508,20.15702,860782
20898,pommelinho,1,0.00012,173509,20.15714,860782
20899,poochwashere,1,0.00012,173510,20.15725,860782
20900,Poorunga,1,0.00012,173511,20.15737,860782
20901,popakatepepel,1,0.00012,173512,20.15748,860782
20902,popcornylu,1,0.00012,173513,20.15760,860782
20903,popovicu,1,0.00012,173514,20.15772,860782
20904,popsikle,1,0.00012,173515,20.15783,860782
20905,portal7,1,0.00012,173516,20.15795,860782
20906,porter-dev,1,0.00012,173517,20.15807,860782
20907,potsbo,1,0.00012,173518,20.15818,860782
20908,povesteam,1,0.00012,173519,20.15830,860782
20909,pow-devops2020,1,0.00012,173520,20.15841,860782
20910,poweic,1,0.00012,173521,20.15853,860782
20911,Powie,1,0.00012,173522,20.15865,860782
20912,ppabc,1,0.00012,173523,20.15876,860782
20913,ppadevski,1,0.00012,173524,20.15888,860782
20914,ppanero,1,0.00012,173525,20.15899,860782
20915,ppapasani1,1,0.00012,173526,20.15911,860782
20916,pparihar,1,0.00012,173527,20.15923,860782
20917,pprenz,1,0.00012,173528,20.15934,860782
20918,ppulse,1,0.00012,173529,20.15946,860782
20919,pquentin,1,0.00012,173530,20.15958,860782
20920,prabhakar-oracle,1,0.00012,173531,20.15969,860782
20921,prabhatnagpal,1,0.00012,173532,20.15981,860782
20922,prachidamle,1,0.00012,173533,20.15992,860782
20923,pradeepmodukuri,1,0.00012,173534,20.16004,860782
20924,pradeep-upadhyay,1,0.00012,173535,20.16016,860782
20925,prafull11,1,0.00012,173536,20.16027,860782
20926,PragueJoker,1,0.00012,173537,20.16039,860782
20927,prajnak,1,0.00012,173538,20.16051,860782
20928,prakashkl88,1,0.00012,173539,20.16062,860782
20929,pramod0310,1,0.00012,173540,20.16074,860782
20930,pramodkp295,1,0.00012,173541,20.16085,860782
20931,pramodsharma62,1,0.00012,173542,20.16097,860782
20932,pranas,1,0.00012,173543,20.16109,860782
20933,pranavkm,1,0.00012,173544,20.16120,860782
20934,pranay-lonkar,1,0.00012,173545,20.16132,860782
20935,praneshshzl,1,0.00012,173546,20.16143,860782
20936,Pranjal-sopho,1,0.00012,173547,20.16155,860782
20937,prasant123,1,0.00012,173548,20.16167,860782
20938,prashantcsutar,1,0.00012,173549,20.16178,860782
20939,Prashantsaini25,1,0.00012,173550,20.16190,860782
20940,prasvats,1,0.00012,173551,20.16202,860782
20941,pratap6t6,1,0.00012,173552,20.16213,860782
20942,prateek1203,1,0.00012,173553,20.16225,860782
20943,prateeksahu,1,0.00012,173554,20.16236,860782
20944,prathak07,1,0.00012,173555,20.16248,860782
20945,prathameshd9,1,0.00012,173556,20.16260,860782
20946,pratham-m,1,0.00012,173557,20.16271,860782
20947,pratik11jain,1,0.00012,173558,20.16283,860782
20948,pratik-brex,1,0.00012,173559,20.16294,860782
20949,pratik-sinha,1,0.00012,173560,20.16306,860782
20950,praveen0106,1,0.00012,173561,20.16318,860782
20951,praveenvp07,1,0.00012,173562,20.16329,860782
20952,pravindamodaran,1,0.00012,173563,20.16341,860782
20953,PravinRanjan10,1,0.00012,173564,20.16353,860782
20954,pravinyo,1,0.00012,173565,20.16364,860782
20955,prbprbprb,1,0.00012,173566,20.16376,860782
20956,prcastro,1,0.00012,173567,20.16387,860782
20957,prco5,1,0.00012,173568,20.16399,860782
20958,preddy727,1,0.00012,173569,20.16411,860782
20959,PreetSangha,1,0.00012,173570,20.16422,860782
20960,Preisschild,1,0.00012,173571,20.16434,860782
20961,premkritin,1,0.00012,173572,20.16446,860782
20962,prerit3105,1,0.00012,173573,20.16457,860782
20963,presidenten,1,0.00012,173574,20.16469,860782
20964,preved911,1,0.00012,173575,20.16480,860782
20965,prezhdarov,1,0.00012,173576,20.16492,860782
20966,PrimeTimeTran,1,0.00012,173577,20.16504,860782
20967,Priyash08,1,0.00012,173578,20.16515,860782
20968,PriyaVasudevan,1,0.00012,173579,20.16527,860782
20969,priyendra,1,0.00012,173580,20.16538,860782
20970,prodanlabs,1,0.00012,173581,20.16550,860782
20971,Prodyte,1,0.00012,173582,20.16562,860782
20972,proegssilb,1,0.00012,173583,20.16573,860782
20973,progapandist,1,0.00012,173584,20.16585,860782
20974,prokher,1,0.00012,173585,20.16597,860782
20975,promasu,1,0.00012,173586,20.16608,860782
20976,prominatedk,1,0.00012,173587,20.16620,860782
20977,prosnekov,1,0.00012,173588,20.16631,860782
20978,prosunh,1,0.00012,173589,20.16643,860782
20979,ProteanCode,1,0.00012,173590,20.16655,860782
20980,protzi,1,0.00012,173591,20.16666,860782
20981,proxy2008,1,0.00012,173592,20.16678,860782
20982,Pruthvi08,1,0.00012,173593,20.16689,860782
20983,prvn040890,1,0.00012,173594,20.16701,860782
20984,Ps3ud-0nym,1,0.00012,173595,20.16713,860782
20985,psanders,1,0.00012,173596,20.16724,860782
20986,PSauerborn,1,0.00012,173597,20.16736,860782
20987,Pscheidl,1,0.00012,173598,20.16748,860782
20988,pschmitt,1,0.00012,173599,20.16759,860782
20989,pseonghoon,1,0.00012,173600,20.16771,860782
20990,pshemk,1,0.00012,173601,20.16782,860782
20991,Psidium,1,0.00012,173602,20.16794,860782
20992,psionikangel,1,0.00012,173603,20.16806,860782
20993,pskaarup,1,0.00012,173604,20.16817,860782
20994,pskopek,1,0.00012,173605,20.16829,860782
20995,pslobo,1,0.00012,173606,20.16841,860782
20996,PSNRigner,1,0.00012,173607,20.16852,860782
20997,pstackle,1,0.00012,173608,20.16864,860782
20998,psychonetic,1,0.00012,173609,20.16875,860782
20999,psy-q,1,0.00012,173610,20.16887,860782
21000,pthalasta,1,0.00012,173611,20.16899,860782
21001,ptlashan,1,0.00012,173612,20.16910,860782
21002,ptrhck,1,0.00012,173613,20.16922,860782
21003,ptribble,1,0.00012,173614,20.16933,860782
21004,publinchi,1,0.00012,173615,20.16945,860782
21005,puchake,1,0.00012,173616,20.16957,860782
21006,puckettgw,1,0.00012,173617,20.16968,860782
21007,pukkaone,1,0.00012,173618,20.16980,860782
21008,pulord,1,0.00012,173619,20.16992,860782
21009,puncha,1,0.00012,173620,20.17003,860782
21010,Puneeth-n,1,0.00012,173621,20.17015,860782
21011,PuntoDiGoccia,1,0.00012,173622,20.17026,860782
21012,punycode,1,0.00012,173623,20.17038,860782
21013,Pure-AdamuKaapan,1,0.00012,173624,20.17050,860782
21014,pusherman,1,0.00012,173625,20.17061,860782
21015,pushkarv,1,0.00012,173626,20.17073,860782
21016,pvautee,1,0.00012,173627,20.17084,860782
21017,pvgbabu,1,0.00012,173628,20.17096,860782
21018,PVince81,1,0.00012,173629,20.17108,860782
21019,pvm30,1,0.00012,173630,20.17119,860782
21020,pwais,1,0.00012,173631,20.17131,860782
21021,pwhissell,1,0.00012,173632,20.17143,860782
21022,pwithams,1,0.00012,173633,20.17154,860782
21023,PyAgni,1,0.00012,173634,20.17166,860782
21024,pyang55,1,0.00012,173635,20.17177,860782
21025,pyr0hu,1,0.00012,173636,20.17189,860782
21026,pyramation,1,0.00012,173637,20.17201,860782
21027,pyrho,1,0.00012,173638,20.17212,860782
21028,pythops,1,0.00012,173639,20.17224,860782
21029,pzbiegiel,1,0.00012,173640,20.17235,860782
21030,pzoxiuv,1,0.00012,173641,20.17247,860782
21031,qbarrand,1,0.00012,173642,20.17259,860782
21032,qbaze,1,0.00012,173643,20.17270,860782
21033,qfny88,1,0.00012,173644,20.17282,860782
21034,qiang93,1,0.00012,173645,20.17294,860782
21035,qiangshui,1,0.00012,173646,20.17305,860782
21036,qihandeng2,1,0.00012,173647,20.17317,860782
21037,qingfengfenga,1,0.00012,173648,20.17328,860782
21038,qingyunha,1,0.00012,173649,20.17340,860782
21039,qinshuang1998,1,0.00012,173650,20.17352,860782
21040,qiuhongshuai,1,0.00012,173651,20.17363,860782
21041,qiuhui,1,0.00012,173652,20.17375,860782
21042,qixiaobo,1,0.00012,173653,20.17387,860782
21043,qixie1,1,0.00012,173654,20.17398,860782
21044,qiyongxiao,1,0.00012,173655,20.17410,860782
21045,qiyuehan,1,0.00012,173656,20.17421,860782
21046,qjayforever25,1,0.00012,173657,20.17433,860782
21047,QkiZMR,1,0.00012,173658,20.17445,860782
21048,qlu02,1,0.00012,173659,20.17456,860782
21049,qq282485068,1,0.00012,173660,20.17468,860782
21050,qtvspa,1,0.00012,173661,20.17479,860782
21051,Quang-OLLI,1,0.00012,173662,20.17491,860782
21052,Quantas,1,0.00012,173663,20.17503,860782
21053,qube222pl,1,0.00012,173664,20.17514,860782
21054,quckly,1,0.00012,173665,20.17526,860782
21055,quequiere,1,0.00012,173666,20.17538,860782
21056,quercy,1,0.00012,173667,20.17549,860782
21057,quickbooks2018,1,0.00012,173668,20.17561,860782
21058,quintush,1,0.00012,173669,20.17572,860782
21059,qukichin,1,0.00012,173670,20.17584,860782
21060,quoimec,1,0.00012,173671,20.17596,860782
21061,qurname2,1,0.00012,173672,20.17607,860782
21062,QusayHe,1,0.00012,173673,20.17619,860782
21063,qwerty10110,1,0.00012,173674,20.17630,860782
21064,qwfys,1,0.00012,173675,20.17642,860782
21065,qwzhou89,1,0.00012,173676,20.17654,860782
21066,r0039,1,0.00012,173677,20.17665,860782
21067,r0bnet,1,0.00012,173678,20.17677,860782
21068,r0bobo,1,0.00012,173679,20.17689,860782
21069,r0naldt,1,0.00012,173680,20.17700,860782
21070,r1cebank,1,0.00012,173681,20.17712,860782
21071,r3dlight,1,0.00012,173682,20.17723,860782
21072,r3dsm0k3,1,0.00012,173683,20.17735,860782
21073,r3econ,1,0.00012,173684,20.17747,860782
21074,r4ym0n,1,0.00012,173685,20.17758,860782
21075,r8474,1,0.00012,173686,20.17770,860782
21076,R8s6,1,0.00012,173687,20.17782,860782
21077,ra257020,1,0.00012,173688,20.17793,860782
21078,raajavel,1,0.00012,173689,20.17805,860782
21079,raarceoml,1,0.00012,173690,20.17816,860782
21080,RabbidDog,1,0.00012,173691,20.17828,860782
21081,rabejens,1,0.00012,173692,20.17840,860782
21082,rabenhorst,1,0.00012,173693,20.17851,860782
21083,rabidsloth,1,0.00012,173694,20.17863,860782
21084,racerxdl,1,0.00012,173695,20.17874,860782
21085,rach-sharp,1,0.00012,173696,20.17886,860782
21086,RadekC85,1,0.00012,173697,20.17898,860782
21087,radekkut,1,0.00012,173698,20.17909,860782
21088,radinv,1,0.00012,173699,20.17921,860782
21089,radoye,1,0.00012,173700,20.17933,860782
21090,radum,1,0.00012,173701,20.17944,860782
21091,radunh,1,0.00012,173702,20.17956,860782
21092,rafaeldasilva,1,0.00012,173703,20.17967,860782
21093,rafaelsilvaa10,1,0.00012,173704,20.17979,860782
21094,rafaelsisweb,1,0.00012,173705,20.17991,860782
21095,rafaleon15,1,0.00012,173706,20.18002,860782
21096,RafalMaleska,1,0.00012,173707,20.18014,860782
21097,RafatKhandaker,1,0.00012,173708,20.18025,860782
21098,raffis,1,0.00012,173709,20.18037,860782
21099,raffraffraff,1,0.00012,173710,20.18049,860782
21100,raghurampai,1,0.00012,173711,20.18060,860782
21101,ragrawal-humana,1,0.00012,173712,20.18072,860782
21102,ragy-deepbiome,1,0.00012,173713,20.18084,860782
21103,rahamath18,1,0.00012,173714,20.18095,860782
21104,rahilb,1,0.00012,173715,20.18107,860782
21105,rahmansyed,1,0.00012,173716,20.18118,860782
21106,rahulbats,1,0.00012,173717,20.18130,860782
21107,rahuldhir,1,0.00012,173718,20.18142,860782
21108,rahuldivgan,1,0.00012,173719,20.18153,860782
21109,rahulk7494,1,0.00012,173720,20.18165,860782
21110,rahulkadukar,1,0.00012,173721,20.18176,860782
21111,rahullenkala,1,0.00012,173722,20.18188,860782
21112,RahulNishad,1,0.00012,173723,20.18200,860782
21113,RahulRatan07,1,0.00012,173724,20.18211,860782
21114,RahulRathodGitHub,1,0.00012,173725,20.18223,860782
21115,rahultaing,1,0.00012,173726,20.18235,860782
21116,rahulyadav130,1,0.00012,173727,20.18246,860782
21117,rahulyadav170923,1,0.00012,173728,20.18258,860782
21118,raiaan12,1,0.00012,173729,20.18269,860782
21119,raimundogomes,1,0.00012,173730,20.18281,860782
21120,rainbowjose,1,0.00012,173731,20.18293,860782
21121,rainerillichmann,1,0.00012,173732,20.18304,860782
21122,rainerschoe,1,0.00012,173733,20.18316,860782
21123,rainmanh,1,0.00012,173734,20.18328,860782
21124,raitucarp,1,0.00012,173735,20.18339,860782
21125,raiviskrumins,1,0.00012,173736,20.18351,860782
21126,raj1rana,1,0.00012,173737,20.18362,860782
21127,rajaishwary,1,0.00012,173738,20.18374,860782
21128,rajat-pe,1,0.00012,173739,20.18386,860782
21129,rajeeshckr,1,0.00012,173740,20.18397,860782
21130,rajeshdannina,1,0.00012,173741,20.18409,860782
21131,rajeshg007,1,0.00012,173742,20.18420,860782
21132,rajeshkudaka,1,0.00012,173743,20.18432,860782
21133,rajeshneo,1,0.00012,173744,20.18444,860782
21134,rajetta,1,0.00012,173745,20.18455,860782
21135,rajish,1,0.00012,173746,20.18467,860782
21136,rajivchirania,1,0.00012,173747,20.18479,860782
21137,rajjar123456,1,0.00012,173748,20.18490,860782
21138,rajmondx,1,0.00012,173749,20.18502,860782
21139,rajneeshbajaj,1,0.00012,173750,20.18513,860782
21140,rajraulo,1,0.00012,173751,20.18525,860782
21141,rajurh,1,0.00012,173752,20.18537,860782
21142,rajvaibhavdubey,1,0.00012,173753,20.18548,860782
21143,rakeshkarnati1,1,0.00012,173754,20.18560,860782
21144,rakeshvanga,1,0.00012,173755,20.18571,860782
21145,Raki-cmd,1,0.00012,173756,20.18583,860782
21146,rakovets,1,0.00012,173757,20.18595,860782
21147,ralgozino,1,0.00012,173758,20.18606,860782
21148,ralphbuk,1,0.00012,173759,20.18618,860782
21149,Rama000777,1,0.00012,173760,20.18630,860782
21150,rama-arun,1,0.00012,173761,20.18641,860782
21151,ramapalani,1,0.00012,173762,20.18653,860782
21152,ramarkandasamy,1,0.00012,173763,20.18664,860782
21153,ramasa,1,0.00012,173764,20.18676,860782
21154,ramdesh,1,0.00012,173765,20.18688,860782
21155,rameshneela,1,0.00012,173766,20.18699,860782
21156,Rami-Y,1,0.00012,173767,20.18711,860782
21157,ramk2020,1,0.00012,173768,20.18723,860782
21158,RammusXu,1,0.00012,173769,20.18734,860782
21159,ramoncabrera,1,0.00012,173770,20.18746,860782
21160,ramrengaswamy,1,0.00012,173771,20.18757,860782
21161,RamXX,1,0.00012,173772,20.18769,860782
21162,ranajit-jana,1,0.00012,173773,20.18781,860782
21163,ranajoy-paul,1,0.00012,173774,20.18792,860782
21164,Rancheroo,1,0.00012,173775,20.18804,860782
21165,ranchersvet,1,0.00012,173776,20.18815,860782
21166,random1st,1,0.00012,173777,20.18827,860782
21167,randomstate42,1,0.00012,173778,20.18839,860782
21168,randrewy,1,0.00012,173779,20.18850,860782
21169,ranjanprj,1,0.00012,173780,20.18862,860782
21170,raoofnaushad,1,0.00012,173781,20.18874,860782
21171,raphaelauv,1,0.00012,173782,20.18885,860782
21172,raphaelzoellner,1,0.00012,173783,20.18897,860782
21173,rarrarrarr,1,0.00012,173784,20.18908,860782
21174,ras0219,1,0.00012,173785,20.18920,860782
21175,rasebo,1,0.00012,173786,20.18932,860782
21176,rashad,1,0.00012,173787,20.18943,860782
21177,rashmip22,1,0.00012,173788,20.18955,860782
21178,rashmisingh85,1,0.00012,173789,20.18966,860782
21179,rassadi,1,0.00012,173790,20.18978,860782
21180,RastogiAbhijeet,1,0.00012,173791,20.18990,860782
21181,rasviitanen,1,0.00012,173792,20.19001,860782
21182,raufkk,1,0.00012,173793,20.19013,860782
21183,rauljordan,1,0.00012,173794,20.19025,860782
21184,raulsh,1,0.00012,173795,20.19036,860782
21185,Rauno56,1,0.00012,173796,20.19048,860782
21186,raushan2016,1,0.00012,173797,20.19059,860782
21187,ravibhim,1,0.00012,173798,20.19071,860782
21188,ravichauhan03,1,0.00012,173799,20.19083,860782
21189,ravichiripurapu,1,0.00012,173800,20.19094,860782
21190,ravihugo,1,0.00012,173801,20.19106,860782
21191,ravikanth39,1,0.00012,173802,20.19118,860782
21192,ravimartins,1,0.00012,173803,20.19129,860782
21193,ravindrabhargava,1,0.00012,173804,20.19141,860782
21194,raviseerapu,1,0.00012,173805,20.19152,860782
21195,ravitri,1,0.00012,173806,20.19164,860782
21196,rawipfel,1,0.00012,173807,20.19176,860782
21197,rawon,1,0.00012,173808,20.19187,860782
21198,rayjcwu,1,0.00012,173809,20.19199,860782
21199,RaymondKYLiu,1,0.00012,173810,20.19210,860782
21200,RaymondReddington,1,0.00012,173811,20.19222,860782
21201,raynix,1,0.00012,173812,20.19234,860782
21202,rayotte,1,0.00012,173813,20.19245,860782
21203,rayrad,1,0.00012,173814,20.19257,860782
21204,RaySmith1,1,0.00012,173815,20.19269,860782
21205,rayway30419,1,0.00012,173816,20.19280,860782
21206,RazaHasan84,1,0.00012,173817,20.19292,860782
21207,razorcd,1,0.00012,173818,20.19303,860782
21208,razuos,1,0.00012,173819,20.19315,860782
21209,razvan-flavius-panda,1,0.00012,173820,20.19327,860782
21210,razvan-ig,1,0.00012,173821,20.19338,860782
21211,rbarilani,1,0.00012,173822,20.19350,860782
21212,rbrayner,1,0.00012,173823,20.19361,860782
21213,rbrcurtis,1,0.00012,173824,20.19373,860782
21214,rbreekveldt,1,0.00012,173825,20.19385,860782
21215,rbrishabh,1,0.00012,173826,20.19396,860782
21216,rbs4ba,1,0.00012,173827,20.19408,860782
21217,rcalabro,1,0.00012,173828,20.19420,860782
21218,rcbrown,1,0.00012,173829,20.19431,860782
21219,Rchan0100,1,0.00012,173830,20.19443,860782
21220,rcmoutinho,1,0.00012,173831,20.19454,860782
21221,rcsilva83,1,0.00012,173832,20.19466,860782
21222,r-darwish,1,0.00012,173833,20.19478,860782
21223,rdettai,1,0.00012,173834,20.19489,860782
21224,rdiaz82,1,0.00012,173835,20.19501,860782
21225,rdoering,1,0.00012,173836,20.19512,860782
21226,rdohms,1,0.00012,173837,20.19524,860782
21227,rdos,1,0.00012,173838,20.19536,860782
21228,RDPzero,1,0.00012,173839,20.19547,860782
21229,rdrgporto,1,0.00012,173840,20.19559,860782
21230,rduda6017,1,0.00012,173841,20.19571,860782
21231,reachlakstar,1,0.00012,173842,20.19582,860782
21232,readall,1,0.00012,173843,20.19594,860782
21233,RealDekkia,1,0.00012,173844,20.19605,860782
21234,realrogerrt,1,0.00012,173845,20.19617,860782
21235,realvz,1,0.00012,173846,20.19629,860782
21236,recentcoin,1,0.00012,173847,20.19640,860782
21237,RedBaron80,1,0.00012,173848,20.19652,860782
21238,RedBoneZhang,1,0.00012,173849,20.19664,860782
21239,reddog335,1,0.00012,173850,20.19675,860782
21240,redeagle84,1,0.00012,173851,20.19687,860782
21241,redfoos,1,0.00012,173852,20.19698,860782
21242,rediphone,1,0.00012,173853,20.19710,860782
21243,RedlineTriad,1,0.00012,173854,20.19722,860782
21244,redmark-alt,1,0.00012,173855,20.19733,860782
21245,redoz94,1,0.00012,173856,20.19745,860782
21246,reecebenson,1,0.00012,173857,20.19756,860782
21247,regev-agabi,1,0.00012,173858,20.19768,860782
21248,ReggieCarey,1,0.00012,173859,20.19780,860782
21249,regorsmitz,1,0.00012,173860,20.19791,860782
21250,Reham-Fahmy,1,0.00012,173861,20.19803,860782
21251,ReiJr,1,0.00012,173862,20.19815,860782
21252,ReillyTevera,1,0.00012,173863,20.19826,860782
21253,reinhaun,1,0.00012,173864,20.19838,860782
21254,reklatsmasters,1,0.00012,173865,20.19849,860782
21255,Reksmeys,1,0.00012,173866,20.19861,860782
21256,relaxgo,1,0.00012,173867,20.19873,860782
21257,reliveyy,1,0.00012,173868,20.19884,860782
21258,relyt0925,1,0.00012,173869,20.19896,860782
21259,remiuz,1,0.00012,173870,20.19907,860782
21260,remizyaka,1,0.00012,173871,20.19919,860782
21261,renana,1,0.00012,173872,20.19931,860782
21262,RenaShahMSFT,1,0.00012,173873,20.19942,860782
21263,renatozhang,1,0.00012,173874,20.19954,860782
21264,RenaudGelai,1,0.00012,173875,20.19966,860782
21265,reneli5,1,0.00012,173876,20.19977,860782
21266,renelink,1,0.00012,173877,20.19989,860782
21267,renishb10,1,0.00012,173878,20.20000,860782
21268,renkei,1,0.00012,173879,20.20012,860782
21269,repliy,1,0.00012,173880,20.20024,860782
21270,rere16,1,0.00012,173881,20.20035,860782
21271,reschex,1,0.00012,173882,20.20047,860782
21272,ResDiaryLewis,1,0.00012,173883,20.20059,860782
21273,reshma-aws,1,0.00012,173884,20.20070,860782
21274,resnikb,1,0.00012,173885,20.20082,860782
21275,restanrm,1,0.00012,173886,20.20093,860782
21276,reste85,1,0.00012,173887,20.20105,860782
21277,retrry,1,0.00012,173888,20.20117,860782
21278,reutsharabani,1,0.00012,173889,20.20128,860782
21279,revant,1,0.00012,173890,20.20140,860782
21280,revengel,1,0.00012,173891,20.20151,860782
21281,rexagod,1,0.00012,173892,20.20163,860782
21282,rezabojnordi,1,0.00012,173893,20.20175,860782
21283,rfajarachmad,1,0.00012,173894,20.20186,860782
21284,rfarro82,1,0.00012,173895,20.20198,860782
21285,rfc2119,1,0.00012,173896,20.20210,860782
21286,rfleschenberg,1,0.00012,173897,20.20221,860782
21287,rgannu,1,0.00012,173898,20.20233,860782
21288,rgl,1,0.00012,173899,20.20244,860782
21289,rgoli922,1,0.00012,173900,20.20256,860782
21290,rgrishigajra,1,0.00012,173901,20.20268,860782
21291,rgstephens,1,0.00012,173902,20.20279,860782
21292,rhatlapa,1,0.00012,173903,20.20291,860782
21293,rhdojun,1,0.00012,173904,20.20302,860782
21294,rhettdyao,1,0.00012,173905,20.20314,860782
21295,rhinkel,1,0.00012,173906,20.20326,860782
21296,rhthaakkar,1,0.00012,173907,20.20337,860782
21297,rhyssmith,1,0.00012,173908,20.20349,860782
21298,rhzs,1,0.00012,173909,20.20361,860782
21299,riazarbi,1,0.00012,173910,20.20372,860782
21300,ribx,1,0.00012,173911,20.20384,860782
21301,ricardbejarano,1,0.00012,173912,20.20395,860782
21302,ricardjp-icabbi,1,0.00012,173913,20.20407,860782
21303,RicCu,1,0.00012,173914,20.20419,860782
21304,RichardAtArm,1,0.00012,173915,20.20430,860782
21305,Richard-Payne,1,0.00012,173916,20.20442,860782
21306,richardwhiuk,1,0.00012,173917,20.20453,860782
21307,richbryant,1,0.00012,173918,20.20465,860782
21308,richerrerag,1,0.00012,173919,20.20477,860782
21309,richfelker,1,0.00012,173920,20.20488,860782
21310,richgerrard,1,0.00012,173921,20.20500,860782
21311,richmain-sas,1,0.00012,173922,20.20512,860782
21312,richrepko,1,0.00012,173923,20.20523,860782
21313,richterdavid,1,0.00012,173924,20.20535,860782
21314,ricksentam,1,0.00012,173925,20.20546,860782
21315,ricoardiya,1,0.00012,173926,20.20558,860782
21316,Riimu,1,0.00012,173927,20.20570,860782
21317,rijosimon,1,0.00012,173928,20.20581,860782
21318,riker09,1,0.00012,173929,20.20593,860782
21319,riklopfer,1,0.00012,173930,20.20605,860782
21320,RikuXan,1,0.00012,173931,20.20616,860782
21321,RinckFox,1,0.00012,173932,20.20628,860782
21322,Rinsen,1,0.00012,173933,20.20639,860782
21323,ripread,1,0.00012,173934,20.20651,860782
21324,rishikeshbedre,1,0.00012,173935,20.20663,860782
21325,rishiraaz,1,0.00012,173936,20.20674,860782
21326,rishuhiver,1,0.00012,173937,20.20686,860782
21327,RiskyAdventure,1,0.00012,173938,20.20697,860782
21328,rit,1,0.00012,173939,20.20709,860782
21329,riteshgurung,1,0.00012,173940,20.20721,860782
21330,riteshja,1,0.00012,173941,20.20732,860782
21331,riteshtalks,1,0.00012,173942,20.20744,860782
21332,ritheshgm,1,0.00012,173943,20.20756,860782
21333,ritwik12,1,0.00012,173944,20.20767,860782
21334,RiyaTyagi,1,0.00012,173945,20.20779,860782
21335,riyaz-ali,1,0.00012,173946,20.20790,860782
21336,RizkiNfs,1,0.00012,173947,20.20802,860782
21337,rizkybiz,1,0.00012,173948,20.20814,860782
21338,rizwangcsit,1,0.00012,173949,20.20825,860782
21339,rj03hou,1,0.00012,173950,20.20837,860782
21340,RJanssens,1,0.00012,173951,20.20848,860782
21341,RJGhugo,1,0.00012,173952,20.20860,860782
21342,rjhenry,1,0.00012,173953,20.20872,860782
21343,rjl79,1,0.00012,173954,20.20883,860782
21344,rjonala,1,0.00012,173955,20.20895,860782
21345,rkalasky,1,0.00012,173956,20.20907,860782
21346,rkooo567,1,0.00012,173957,20.20918,860782
21347,rkoster,1,0.00012,173958,20.20930,860782
21348,rkpegoraro,1,0.00012,173959,20.20941,860782
21349,rlabrecque,1,0.00012,173960,20.20953,860782
21350,rlangfordBV,1,0.00012,173961,20.20965,860782
21351,rlex,1,0.00012,173962,20.20976,860782
21352,rluders,1,0.00012,173963,20.20988,860782
21353,rm3l,1,0.00012,173964,20.21000,860782
21354,rmak-cpi,1,0.00012,173965,20.21011,860782
21355,rmesquit,1,0.00012,173966,20.21023,860782
21356,rmleme,1,0.00012,173967,20.21034,860782
21357,rms1000watt,1,0.00012,173968,20.21046,860782
21358,rncortes1990,1,0.00012,173969,20.21058,860782
21359,rneu31,1,0.00012,173970,20.21069,860782
21360,rnkaufman,1,0.00012,173971,20.21081,860782
21361,rob0t7,1,0.00012,173972,20.21092,860782
21362,RobbieMcKinstry,1,0.00012,173973,20.21104,860782
21363,robbo10,1,0.00012,173974,20.21116,860782
21364,robbrit,1,0.00012,173975,20.21127,860782
21365,RobEarl,1,0.00012,173976,20.21139,860782
21366,robertchoi80,1,0.00012,173977,20.21151,860782
21367,robertgates55,1,0.00012,173978,20.21162,860782
21368,robertogyn19,1,0.00012,173979,20.21174,860782
21369,Robert-turbo,1,0.00012,173980,20.21185,860782
21370,robertvanhoesel,1,0.00012,173981,20.21197,860782
21371,robertvolkmann,1,0.00012,173982,20.21209,860782
21372,robertwe,1,0.00012,173983,20.21220,860782
21373,robertyoung81,1,0.00012,173984,20.21232,860782
21374,robertzhangwenjie,1,0.00012,173985,20.21243,860782
21375,Robertzyp,1,0.00012,173986,20.21255,860782
21376,robfr,1,0.00012,173987,20.21267,860782
21377,robfras,1,0.00012,173988,20.21278,860782
21378,robgoodwin,1,0.00012,173989,20.21290,860782
21379,robinator8,1,0.00012,173990,20.21302,860782
21380,robinmeiss,1,0.00012,173991,20.21313,860782
21381,RobinOvergaard,1,0.00012,173992,20.21325,860782
21382,robin-rpr,1,0.00012,173993,20.21336,860782
21383,roblen45,1,0.00012,173994,20.21348,860782
21384,robodude666,1,0.00012,173995,20.21360,860782
21385,robutil,1,0.00012,173996,20.21371,860782
21386,robwithhair,1,0.00012,173997,20.21383,860782
21387,Rock981119,1,0.00012,173998,20.21394,860782
21388,rockpanda,1,0.00012,173999,20.21406,860782
21389,rockwithamoon,1,0.00012,174000,20.21418,860782
21390,rockysingh,1,0.00012,174001,20.21429,860782
21391,rocLv,1,0.00012,174002,20.21441,860782
21392,rodalli,1,0.00012,174003,20.21453,860782
21393,rodel-talampas,1,0.00012,174004,20.21464,860782
21394,Roderick-Jonsson,1,0.00012,174005,20.21476,860782
21395,roderik,1,0.00012,174006,20.21487,860782
21396,rodrigo-molina,1,0.00012,174007,20.21499,860782
21397,rodrigoporcionato,1,0.00012,174008,20.21511,860782
21398,rodrigorpo,1,0.00012,174009,20.21522,860782
21399,rodrisbach,1,0.00012,174010,20.21534,860782
21400,rodsublime,1,0.00012,174011,20.21546,860782
21401,rofangaci,1,0.00012,174012,20.21557,860782
21402,rofreytag,1,0.00012,174013,20.21569,860782
21403,rogeliodh,1,0.00012,174014,20.21580,860782
21404,RogerLaw,1,0.00012,174015,20.21592,860782
21405,rogersd,1,0.00012,174016,20.21604,860782
21406,RoguePointer80,1,0.00012,174017,20.21615,860782
21407,rohandvora,1,0.00012,174018,20.21627,860782
21408,rohanmohapatra,1,0.00012,174019,20.21638,860782
21409,rohit94j,1,0.00012,174020,20.21650,860782
21410,rohitagg2020,1,0.00012,174021,20.21662,860782
21411,rohitkumr,1,0.00012,174022,20.21673,860782
21412,Roihn,1,0.00012,174023,20.21685,860782
21413,roland-haeusler,1,0.00012,174024,20.21697,860782
21414,roleymoley,1,0.00012,174025,20.21708,860782
21415,rolfberkenbosch,1,0.00012,174026,20.21720,860782
21416,rollerd,1,0.00012,174027,20.21731,860782
21417,romanjoffee,1,0.00012,174028,20.21743,860782
21418,Romanmc72,1,0.00012,174029,20.21755,860782
21419,RomanPanaget,1,0.00012,174030,20.21766,860782
21420,romenyrr,1,0.00012,174031,20.21778,860782
21421,romeotheriault,1,0.00012,174032,20.21789,860782
21422,romuloctba,1,0.00012,174033,20.21801,860782
21423,ronalcelaya,1,0.00012,174034,20.21813,860782
21424,ronaldvanderrest,1,0.00012,174035,20.21824,860782
21425,rongduan-zhu,1,0.00012,174036,20.21836,860782
21426,ronlost,1,0.00012,174037,20.21848,860782
21427,ronmeri28,1,0.00012,174038,20.21859,860782
21428,RonnieGandhi,1,0.00012,174039,20.21871,860782
21429,rootqu,1,0.00012,174040,20.21882,860782
21430,roquesao,1,0.00012,174041,20.21894,860782
21431,rosenta,1,0.00012,174042,20.21906,860782
21432,RottenLeaf24,1,0.00012,174043,20.21917,860782
21433,RouR,1,0.00012,174044,20.21929,860782
21434,roverliang,1,0.00012,174045,20.21941,860782
21435,rowan-baker,1,0.00012,174046,20.21952,860782
21436,roy2220,1,0.00012,174047,20.21964,860782
21437,royantman,1,0.00012,174048,20.21975,860782
21438,roycarser,1,0.00012,174049,20.21987,860782
21439,roylee17,1,0.00012,174050,20.21999,860782
21440,roysjosh,1,0.00012,174051,20.22010,860782
21441,roystchiang,1,0.00012,174052,20.22022,860782
21442,RoySunnySean007,1,0.00012,174053,20.22033,860782
21443,RoysyLee,1,0.00012,174054,20.22045,860782
21444,roy-t,1,0.00012,174055,20.22057,860782
21445,royyeah,1,0.00012,174056,20.22068,860782
21446,rozacek,1,0.00012,174057,20.22080,860782
21447,rp592h,1,0.00012,174058,20.22092,860782
21448,r-pai,1,0.00012,174059,20.22103,860782
21449,rpardini,1,0.00012,174060,20.22115,860782
21450,rpcyn,1,0.00012,174061,20.22126,860782
21451,rpeter,1,0.00012,174062,20.22138,860782
21452,rpnguyen,1,0.00012,174063,20.22150,860782
21453,rprasad17088,1,0.00012,174064,20.22161,860782
21454,rpsadarangani,1,0.00012,174065,20.22173,860782
21455,rptl,1,0.00012,174066,20.22184,860782
21456,rpunetha,1,0.00012,174067,20.22196,860782
21457,rrajarap,1,0.00012,174068,20.22208,860782
21458,rrcosta,1,0.00012,174069,20.22219,860782
21459,rrijkse,1,0.00012,174070,20.22231,860782
21460,rrmuchedzi,1,0.00012,174071,20.22243,860782
21461,rrneuron,1,0.00012,174072,20.22254,860782
21462,rroques,1,0.00012,174073,20.22266,860782
21463,R-Rudolf,1,0.00012,174074,20.22277,860782
21464,RS1989,1,0.00012,174075,20.22289,860782
21465,RSaladi,1,0.00012,174076,20.22301,860782
21466,rschoultz,1,0.00012,174077,20.22312,860782
21467,rseedorff,1,0.00012,174078,20.22324,860782
21468,rsraszka,1,0.00012,174079,20.22336,860782
21469,rstcruzo,1,0.00012,174080,20.22347,860782
21470,rstinear,1,0.00012,174081,20.22359,860782
21471,rstoyanchev,1,0.00012,174082,20.22370,860782
21472,rsvenkatesh,1,0.00012,174083,20.22382,860782
21473,rtatnet,1,0.00012,174084,20.22394,860782
21474,r-t-m,1,0.00012,174085,20.22405,860782
21475,ruanafan,1,0.00012,174086,20.22417,860782
21476,ruapho,1,0.00012,174087,20.22428,860782
21477,rubberduck203,1,0.00012,174088,20.22440,860782
21478,rubencabrera,1,0.00012,174089,20.22452,860782
21479,ruben-ojeda-mednax,1,0.00012,174090,20.22463,860782
21480,rubenst2013,1,0.00012,174091,20.22475,860782
21481,RuBiCK,1,0.00012,174092,20.22487,860782
21482,rubin55,1,0.00012,174093,20.22498,860782
21483,ruckc,1,0.00012,174094,20.22510,860782
21484,rudderfeet,1,0.00012,174095,20.22521,860782
21485,rudolfdobias,1,0.00012,174096,20.22533,860782
21486,rueian,1,0.00012,174097,20.22545,860782
21487,ruiengana,1,0.00012,174098,20.22556,860782
21488,ruijf,1,0.00012,174099,20.22568,860782
21489,Ruimingwang,1,0.00012,174100,20.22579,860782
21490,ruiyang2015,1,0.00012,174101,20.22591,860782
21491,ruiztulio,1,0.00012,174102,20.22603,860782
21492,rukletsov,1,0.00012,174103,20.22614,860782
21493,rumans,1,0.00012,174104,20.22626,860782
21494,rummens,1,0.00012,174105,20.22638,860782
21495,rushivarun,1,0.00012,174106,20.22649,860782
21496,rushrecon,1,0.00012,174107,20.22661,860782
21497,Russiancold,1,0.00012,174108,20.22672,860782
21498,russurquhart1,1,0.00012,174109,20.22684,860782
21499,Rustamtlt,1,0.00012,174110,20.22696,860782
21500,rustysys-dev,1,0.00012,174111,20.22707,860782
21501,rutgerbrf,1,0.00012,174112,20.22719,860782
21502,rvaidya,1,0.00012,174113,20.22730,860782
21503,rvcarlig,1,0.00012,174114,20.22742,860782
21504,rvdisodia,1,0.00012,174115,20.22754,860782
21505,rvmiller89,1,0.00012,174116,20.22765,860782
21506,rvt,1,0.00012,174117,20.22777,860782
21507,rwd5213,1,0.00012,174118,20.22789,860782
21508,rwestphal,1,0.00012,174119,20.22800,860782
21509,rxwang662001,1,0.00012,174120,20.22812,860782
21510,ryan-chase,1,0.00012,174121,20.22823,860782
21511,ryanclark,1,0.00012,174122,20.22835,860782
21512,ryan-cradick,1,0.00012,174123,20.22847,860782
21513,ryancwalsh,1,0.00012,174124,20.22858,860782
21514,ryandharper,1,0.00012,174125,20.22870,860782
21515,ryanelliottsmith,1,0.00012,174126,20.22882,860782
21516,ryangsteele,1,0.00012,174127,20.22893,860782
21517,ryanjwh,1,0.00012,174128,20.22905,860782
21518,ryanmjacobs,1,0.00012,174129,20.22916,860782
21519,ryannealeigh,1,0.00012,174130,20.22928,860782
21520,ryanneufeld,1,0.00012,174131,20.22940,860782
21521,ryanooi,1,0.00012,174132,20.22951,860782
21522,ryanoolala,1,0.00012,174133,20.22963,860782
21523,ryanschwartz,1,0.00012,174134,20.22974,860782
21524,ryantiger658,1,0.00012,174135,20.22986,860782
21525,RyanW8,1,0.00012,174136,20.22998,860782
21526,ryanwangJC,1,0.00012,174137,20.23009,860782
21527,ryanwyu,1,0.00012,174138,20.23021,860782
21528,rybnico,1,0.00012,174139,20.23033,860782
21529,rydrman,1,0.00012,174140,20.23044,860782
21530,rydzykje,1,0.00012,174141,20.23056,860782
21531,ryjogo,1,0.00012,174142,20.23067,860782
21532,rymonroe,1,0.00012,174143,20.23079,860782
21533,RyuBAI,1,0.00012,174144,20.23091,860782
21534,rzasgal,1,0.00012,174145,20.23102,860782
21535,s0ld13r,1,0.00012,174146,20.23114,860782
21536,s1rc,1,0.00012,174147,20.23125,860782
21537,s3lph,1,0.00012,174148,20.23137,860782
21538,s4nk,1,0.00012,174149,20.23149,860782
21539,s7v7nislands,1,0.00012,174150,20.23160,860782
21540,saaiprakash1,1,0.00012,174151,20.23172,860782
21541,saariniemi,1,0.00012,174152,20.23184,860782
21542,sabyabr,1,0.00012,174153,20.23195,860782
21543,sachabarber,1,0.00012,174154,20.23207,860782
21544,sachgit30,1,0.00012,174155,20.23218,860782
21545,sachin53110,1,0.00012,174156,20.23230,860782
21546,sachinmishra007,1,0.00012,174157,20.23242,860782
21547,sachinmyneni,1,0.00012,174158,20.23253,860782
21548,sachinsaju,1,0.00012,174159,20.23265,860782
21549,sachithmuhandiram,1,0.00012,174160,20.23277,860782
21550,sachua,1,0.00012,174161,20.23288,860782
21551,saeed617,1,0.00012,174162,20.23300,860782
21552,saehan-suh,1,0.00012,174163,20.23311,860782
21553,safaalai,1,0.00012,174164,20.23323,860782
21554,SafaTinaztepe,1,0.00012,174165,20.23335,860782
21555,saguirre1,1,0.00012,174166,20.23346,860782
21556,SagurovA93,1,0.00012,174167,20.23358,860782
21557,sagva123,1,0.00012,174168,20.23369,860782
21558,saharanrenu,1,0.00012,174169,20.23381,860782
21559,sahilshaikh89,1,0.00012,174170,20.23393,860782
21560,saibaldey,1,0.00012,174171,20.23404,860782
21561,saibanna,1,0.00012,174172,20.23416,860782
21562,Saifadin,1,0.00012,174173,20.23428,860782
21563,SaifJerbi,1,0.00012,174174,20.23439,860782
21564,SaigyoujiYuyuko233,1,0.00012,174175,20.23451,860782
21565,SaikiranDaripelli,1,0.00012,174176,20.23462,860782
21566,saipraveen-a,1,0.00012,174177,20.23474,860782
21567,saipraveengithub,1,0.00012,174178,20.23486,860782
21568,saisankargochhayat,1,0.00012,174179,20.23497,860782
21569,saithejareddy,1,0.00012,174180,20.23509,860782
21570,saivishalvangala,1,0.00012,174181,20.23520,860782
21571,saiyam1712,1,0.00012,174182,20.23532,860782
21572,sajeerzeji,1,0.00012,174183,20.23544,860782
21573,sajidul1111,1,0.00012,174184,20.23555,860782
21574,Sakha8990,1,0.00012,174185,20.23567,860782
21575,sakshi-bansal,1,0.00012,174186,20.23579,860782
21576,saktthevel,1,0.00012,174187,20.23590,860782
21577,salanfe,1,0.00012,174188,20.23602,860782
21578,saleh199,1,0.00012,174189,20.23613,860782
21579,salehi,1,0.00012,174190,20.23625,860782
21580,Salgat,1,0.00012,174191,20.23637,860782
21581,salimdawod1996,1,0.00012,174192,20.23648,860782
21582,salluu,1,0.00012,174193,20.23660,860782
21583,Sallyan,1,0.00012,174194,20.23671,860782
21584,salsal97,1,0.00012,174195,20.23683,860782
21585,SaltedEggIndomee,1,0.00012,174196,20.23695,860782
21586,saltera,1,0.00012,174197,20.23706,860782
21587,saltyskip,1,0.00012,174198,20.23718,860782
21588,salvadoravila,1,0.00012,174199,20.23730,860782
21589,SalvadorSarpi,1,0.00012,174200,20.23741,860782
21590,salvis2,1,0.00012,174201,20.23753,860782
21591,samadhiyaaman93,1,0.00012,174202,20.23764,860782
21592,sam-almighty,1,0.00012,174203,20.23776,860782
21593,SamambaMan,1,0.00012,174204,20.23788,860782
21594,SamarGooda,1,0.00012,174205,20.23799,860782
21595,samba,1,0.00012,174206,20.23811,860782
21596,samber,1,0.00012,174207,20.23823,860782
21597,SamDecrock,1,0.00012,174208,20.23834,860782
21598,SameeraMadushan,1,0.00012,174209,20.23846,860782
21599,sameergn,1,0.00012,174210,20.23857,860782
21600,samelie,1,0.00012,174211,20.23869,860782
21601,sam-gaylert,1,0.00012,174212,20.23881,860782
21602,samhuss,1,0.00012,174213,20.23892,860782
21603,samiachanna,1,0.00012,174214,20.23904,860782
21604,samik1996,1,0.00012,174215,20.23915,860782
21605,sam-jay,1,0.00012,174216,20.23927,860782
21606,sammlearning,1,0.00012,174217,20.23939,860782
21607,sampadsaha5,1,0.00012,174218,20.23950,860782
21608,sampaiodiego,1,0.00012,174219,20.23962,860782
21609,samson-arita,1,0.00012,174220,20.23974,860782
21610,samta,1,0.00012,174221,20.23985,860782
21611,samudurand,1,0.00012,174222,20.23997,860782
21612,samuelfischerscandio,1,0.00012,174223,20.24008,860782
21613,samverboven,1,0.00012,174224,20.24020,860782
21614,samyan123,1,0.00012,174225,20.24032,860782
21615,sanagarw,1,0.00012,174226,20.24043,860782
21616,Sandeep0045,1,0.00012,174227,20.24055,860782
21617,sandeepgd,1,0.00012,174228,20.24066,860782
21618,sandeepnethi,1,0.00012,174229,20.24078,860782
21619,sandeep-sidhu,1,0.00012,174230,20.24090,860782
21620,SandeepVaman,1,0.00012,174231,20.24101,860782
21621,Sandhya131,1,0.00012,174232,20.24113,860782
21622,SandhyaNagarajan,1,0.00012,174233,20.24125,860782
21623,sandhyashrek,1,0.00012,174234,20.24136,860782
21624,sangfei,1,0.00012,174235,20.24148,860782
21625,sanigo,1,0.00012,174236,20.24159,860782
21626,Sanit1,1,0.00012,174237,20.24171,860782
21627,sanjaychakravorty,1,0.00012,174238,20.24183,860782
21628,sanjaysingatalur,1,0.00012,174239,20.24194,860782
21629,sanjitc,1,0.00012,174240,20.24206,860782
21630,sanju99sen,1,0.00012,174241,20.24218,860782
21631,sanjuicgithub,1,0.00012,174242,20.24229,860782
21632,sankalp-d,1,0.00012,174243,20.24241,860782
21633,sankalp-rangare-sap,1,0.00012,174244,20.24252,860782
21634,sankareds,1,0.00012,174245,20.24264,860782
21635,SankarMittapally,1,0.00012,174246,20.24276,860782
21636,sanketaa,1,0.00012,174247,20.24287,860782
21637,sanleon,1,0.00012,174248,20.24299,860782
21638,sanmai,1,0.00012,174249,20.24310,860782
21639,sanminaben,1,0.00012,174250,20.24322,860782
21640,sannnan,1,0.00012,174251,20.24334,860782
21641,Sanojawscloud,1,0.00012,174252,20.24345,860782
21642,Sanrag,1,0.00012,174253,20.24357,860782
21643,sansarsankhyan2391,1,0.00012,174254,20.24369,860782
21644,sansice,1,0.00012,174255,20.24380,860782
21645,santi-asapp,1,0.00012,174256,20.24392,860782
21646,santoo1116,1,0.00012,174257,20.24403,860782
21647,santosh2297,1,0.00012,174258,20.24415,860782
21648,santoshpatro,1,0.00012,174259,20.24427,860782
21649,santoshvakiti,1,0.00012,174260,20.24438,860782
21650,sanvila,1,0.00012,174261,20.24450,860782
21651,sanyam1997,1,0.00012,174262,20.24461,860782
21652,SapientGuardian,1,0.00012,174263,20.24473,860782
21653,Saqibm128,1,0.00012,174264,20.24485,860782
21654,SaraBenShabbat,1,0.00012,174265,20.24496,860782
21655,sarahbx,1,0.00012,174266,20.24508,860782
21656,Sarang-Sangram,1,0.00012,174267,20.24520,860782
21657,SaravanakumarSivasankaran,1,0.00012,174268,20.24531,860782
21658,saravanant23,1,0.00012,174269,20.24543,860782
21659,sarbajitdutta,1,0.00012,174270,20.24554,860782
21660,sarcasticadmin,1,0.00012,174271,20.24566,860782
21661,sarlaccpit,1,0.00012,174272,20.24578,860782
21662,sarojsingh002,1,0.00012,174273,20.24589,860782
21663,sarthakvarshney8081,1,0.00012,174274,20.24601,860782
21664,sarthikgupta,1,0.00012,174275,20.24613,860782
21665,sarweshsuman,1,0.00012,174276,20.24624,860782
21666,Sas002,1,0.00012,174277,20.24636,860782
21667,sashaPM,1,0.00012,174278,20.24647,860782
21668,SAshish19,1,0.00012,174279,20.24659,860782
21669,sass1997,1,0.00012,174280,20.24671,860782
21670,saswatac,1,0.00012,174281,20.24682,860782
21671,SathishSuresh-opex,1,0.00012,174282,20.24694,860782
21672,SathyaSathishKum,1,0.00012,174283,20.24705,860782
21673,satish143,1,0.00012,174284,20.24717,860782
21674,satishsept7,1,0.00012,174285,20.24729,860782
21675,satishweb,1,0.00012,174286,20.24740,860782
21676,satyam130,1,0.00012,174287,20.24752,860782
21677,satyamkapoor,1,0.00012,174288,20.24764,860782
21678,satyendranit,1,0.00012,174289,20.24775,860782
21679,Satyricon,1,0.00012,174290,20.24787,860782
21680,saulfrank,1,0.00012,174291,20.24798,860782
21681,saulmmendoza,1,0.00012,174292,20.24810,860782
21682,saurabhcs,1,0.00012,174293,20.24822,860782
21683,saurabhnetskope,1,0.00012,174294,20.24833,860782
21684,saurabhvmishra,1,0.00012,174295,20.24845,860782
21685,saurastrirajat,1,0.00012,174296,20.24856,860782
21686,savar,1,0.00012,174297,20.24868,860782
21687,savitadwr,1,0.00012,174298,20.24880,860782
21688,savon-noir,1,0.00012,174299,20.24891,860782
21689,SawyerLan,1,0.00012,174300,20.24903,860782
21690,sayak-brm,1,0.00012,174301,20.24915,860782
21691,sayaoailun,1,0.00012,174302,20.24926,860782
21692,sayatul,1,0.00012,174303,20.24938,860782
21693,sayf-eddine-scality,1,0.00012,174304,20.24949,860782
21694,sayrer,1,0.00012,174305,20.24961,860782
21695,sbernauer,1,0.00012,174306,20.24973,860782
21696,sbkg0002,1,0.00012,174307,20.24984,860782
21697,sbollap1,1,0.00012,174308,20.24996,860782
21698,sbookworm,1,0.00012,174309,20.25007,860782
21699,sbordya-tradeshift,1,0.00012,174310,20.25019,860782
21700,sbskas,1,0.00012,174311,20.25031,860782
21701,sc0rp10,1,0.00012,174312,20.25042,860782
21702,scalp42,1,0.00012,174313,20.25054,860782
21703,scarby,1,0.00012,174314,20.25066,860782
21704,scastellani,1,0.00012,174315,20.25077,860782
21705,schabungbam,1,0.00012,174316,20.25089,860782
21706,schecterdamien,1,0.00012,174317,20.25100,860782
21707,schewara,1,0.00012,174318,20.25112,860782
21708,schguille,1,0.00012,174319,20.25124,860782
21709,schlauerlauer,1,0.00012,174320,20.25135,860782
21710,SchlingelNr1,1,0.00012,174321,20.25147,860782
21711,schnable,1,0.00012,174322,20.25159,860782
21712,schneems,1,0.00012,174323,20.25170,860782
21713,schneidersteve,1,0.00012,174324,20.25182,860782
21714,schnes4,1,0.00012,174325,20.25193,860782
21715,schod,1,0.00012,174326,20.25205,860782
21716,schoenenberg,1,0.00012,174327,20.25217,860782
21717,SchoIsles,1,0.00012,174328,20.25228,860782
21718,scholtalbers,1,0.00012,174329,20.25240,860782
21719,SchroterQuentin,1,0.00012,174330,20.25251,860782
21720,sciencey-sanjay,1,0.00012,174331,20.25263,860782
21721,scizeron,1,0.00012,174332,20.25275,860782
21722,scjudd,1,0.00012,174333,20.25286,860782
21723,Sckmo,1,0.00012,174334,20.25298,860782
21724,scloudguru,1,0.00012,174335,20.25310,860782
21725,scoser,1,0.00012,174336,20.25321,860782
21726,scotato,1,0.00012,174337,20.25333,860782
21727,scott2449,1,0.00012,174338,20.25344,860782
21728,scottdoane,1,0.00012,174339,20.25356,860782
21729,ScottFred,1,0.00012,174340,20.25368,860782
21730,scotthew1,1,0.00012,174341,20.25379,860782
21731,scott-jiang,1,0.00012,174342,20.25391,860782
21732,scott-kirk,1,0.00012,174343,20.25402,860782
21733,scottmalkie,1,0.00012,174344,20.25414,860782
21734,ScottSun,1,0.00012,174345,20.25426,860782
21735,scottybrisbane,1,0.00012,174346,20.25437,860782
21736,scp7,1,0.00012,174347,20.25449,860782
21737,scprek,1,0.00012,174348,20.25461,860782
21738,scrazy77,1,0.00012,174349,20.25472,860782
21739,screwyy,1,0.00012,174350,20.25484,860782
21740,scris,1,0.00012,174351,20.25495,860782
21741,scrummyin,1,0.00012,174352,20.25507,860782
21742,Scrumplex,1,0.00012,174353,20.25519,860782
21743,scs2771,1,0.00012,174354,20.25530,860782
21744,scubakiz,1,0.00012,174355,20.25542,860782
21745,sdavids13,1,0.00012,174356,20.25554,860782
21746,sdbaiguanghe,1,0.00012,174357,20.25565,860782
21747,sdgmf,1,0.00012,174358,20.25577,860782
21748,sdhoward,1,0.00012,174359,20.25588,860782
21749,sdonepudy,1,0.00012,174360,20.25600,860782
21750,seaiiok,1,0.00012,174361,20.25612,860782
21751,SeaLife,1,0.00012,174362,20.25623,860782
21752,sean-abbott,1,0.00012,174363,20.25635,860782
21753,seanamosw,1,0.00012,174364,20.25646,860782
21754,SeanCondon,1,0.00012,174365,20.25658,860782
21755,seangaffey,1,0.00012,174366,20.25670,860782
21756,seanly,1,0.00012,174367,20.25681,860782
21757,sean-msmg,1,0.00012,174368,20.25693,860782
21758,seanorama,1,0.00012,174369,20.25705,860782
21759,seanschade,1,0.00012,174370,20.25716,860782
21760,seansfkelley,1,0.00012,174371,20.25728,860782
21761,SEAPUNK,1,0.00012,174372,20.25739,860782
21762,SebastianKristof,1,0.00012,174373,20.25751,860782
21763,sebastianmacarescu,1,0.00012,174374,20.25763,860782
21764,SebastianSchildt,1,0.00012,174375,20.25774,860782
21765,SebastianStehle,1,0.00012,174376,20.25786,860782
21766,Sebastien10115985,1,0.00012,174377,20.25797,860782
21767,sebito91,1,0.00012,174378,20.25809,860782
21768,sebsanchez,1,0.00012,174379,20.25821,860782
21769,sebysr,1,0.00012,174380,20.25832,860782
21770,secnum,1,0.00012,174381,20.25844,860782
21771,SecretSun,1,0.00012,174382,20.25856,860782
21772,Security-Matrix,1,0.00012,174383,20.25867,860782
21773,seedarren,1,0.00012,174384,20.25879,860782
21774,seenumalavan,1,0.00012,174385,20.25890,860782
21775,segersniels,1,0.00012,174386,20.25902,860782
21776,segwin,1,0.00012,174387,20.25914,860782
21777,sehz,1,0.00012,174388,20.25925,860782
21778,selcukusta,1,0.00012,174389,20.25937,860782
21779,sellomkantjwa,1,0.00012,174390,20.25948,860782
21780,Sellto,1,0.00012,174391,20.25960,860782
21781,selvamraman,1,0.00012,174392,20.25972,860782
21782,selvapal,1,0.00012,174393,20.25983,860782
21783,semihmuhtaroglu,1,0.00012,174394,20.25995,860782
21784,semlanik,1,0.00012,174395,20.26007,860782
21785,senax,1,0.00012,174396,20.26018,860782
21786,SenCoder,1,0.00012,174397,20.26030,860782
21787,senorhesles,1,0.00012,174398,20.26041,860782
21788,senosigit,1,0.00012,174399,20.26053,860782
21789,Seoka,1,0.00012,174400,20.26065,860782
21790,Septem151,1,0.00012,174401,20.26076,860782
21791,sepulworld,1,0.00012,174402,20.26088,860782
21792,Sequel1,1,0.00012,174403,20.26100,860782
21793,serajam,1,0.00012,174404,20.26111,860782
21794,serdardalgic,1,0.00012,174405,20.26123,860782
21795,serefacet,1,0.00012,174406,20.26134,860782
21796,serg060606,1,0.00012,174407,20.26146,860782
21797,sergey-onanchenko,1,0.00012,174408,20.26158,860782
21798,sergimrz,1,0.00012,174409,20.26169,860782
21799,sergiomartins8,1,0.00012,174410,20.26181,860782
21800,sergiopozoh,1,0.00012,174411,20.26192,860782
21801,serheevas,1,0.00012,174412,20.26204,860782
21802,SerheyDolgushev,1,0.00012,174413,20.26216,860782
21803,serpent5,1,0.00012,174414,20.26227,860782
21804,serverbaboon,1,0.00012,174415,20.26239,860782
21805,sesky4,1,0.00012,174416,20.26251,860782
21806,setevoy2,1,0.00012,174417,20.26262,860782
21807,setharnold,1,0.00012,174418,20.26274,860782
21808,sethcohn,1,0.00012,174419,20.26285,860782
21809,seungrokoh,1,0.00012,174420,20.26297,860782
21810,sevaho,1,0.00012,174421,20.26309,860782
21811,SevereCloud,1,0.00012,174422,20.26320,860782
21812,sevteen,1,0.00012,174423,20.26332,860782
21813,seyedk,1,0.00012,174424,20.26343,860782
21814,sezuan,1,0.00012,174425,20.26355,860782
21815,sfgroups-k8s,1,0.00012,174426,20.26367,860782
21816,sfph,1,0.00012,174427,20.26378,860782
21817,sfright,1,0.00012,174428,20.26390,860782
21818,sghose0007,1,0.00012,174429,20.26402,860782
21819,sgops,1,0.00012,174430,20.26413,860782
21820,sgreene570,1,0.00012,174431,20.26425,860782
21821,sgs00,1,0.00012,174432,20.26436,860782
21822,sgtsquiggs,1,0.00012,174433,20.26448,860782
21823,Sha90,1,0.00012,174434,20.26460,860782
21824,shadow9911,1,0.00012,174435,20.26471,860782
21825,shahadarsh,1,0.00012,174436,20.26483,860782
21826,shahakash28,1,0.00012,174437,20.26495,860782
21827,shahar-lev,1,0.00012,174438,20.26506,860782
21828,shaharon,1,0.00012,174439,20.26518,860782
21829,shahedex,1,0.00012,174440,20.26529,860782
21830,shahid-mushtaq,1,0.00012,174441,20.26541,860782
21831,Shahrukh-10,1,0.00012,174442,20.26553,860782
21832,shahrukh330,1,0.00012,174443,20.26564,860782
21833,shake76,1,0.00012,174444,20.26576,860782
21834,shakenfr,1,0.00012,174445,20.26587,860782
21835,shakerman,1,0.00012,174446,20.26599,860782
21836,shakertanim,1,0.00012,174447,20.26611,860782
21837,shalev123d,1,0.00012,174448,20.26622,860782
21838,Shalrath,1,0.00012,174449,20.26634,860782
21839,sham1316,1,0.00012,174450,20.26646,860782
21840,s-h-a-m-a-n,1,0.00012,174451,20.26657,860782
21841,shamork,1,0.00012,174452,20.26669,860782
21842,shaneqld,1,0.00012,174453,20.26680,860782
21843,shanhu,1,0.00012,174454,20.26692,860782
21844,shankar-forgerock,1,0.00012,174455,20.26704,860782
21845,shankerbalan,1,0.00012,174456,20.26715,860782
21846,shao0222,1,0.00012,174457,20.26727,860782
21847,shapled,1,0.00012,174458,20.26738,860782
21848,SharanReddyK,1,0.00012,174459,20.26750,860782
21849,Sharath52,1,0.00012,174460,20.26762,860782
21850,sharma-sudhakar,1,0.00012,174461,20.26773,860782
21851,sharonjl,1,0.00012,174462,20.26785,860782
21852,sharpone74,1,0.00012,174463,20.26797,860782
21853,shasti86,1,0.00012,174464,20.26808,860782
21854,shaunofneuron,1,0.00012,174465,20.26820,860782
21855,ShawnUCD,1,0.00012,174466,20.26831,860782
21856,shaz1v,1,0.00012,174467,20.26843,860782
21857,sheaphillips,1,0.00012,174468,20.26855,860782
21858,Shedward,1,0.00012,174469,20.26866,860782
21859,sheepsong,1,0.00012,174470,20.26878,860782
21860,sheer-lore,1,0.00012,174471,20.26890,860782
21861,sheim-dev,1,0.00012,174472,20.26901,860782
21862,shekhar-d,1,0.00012,174473,20.26913,860782
21863,shelbaz,1,0.00012,174474,20.26924,860782
21864,sheldon-lu,1,0.00012,174475,20.26936,860782
21865,shelley1902,1,0.00012,174476,20.26948,860782
21866,shellwalker,1,0.00012,174477,20.26959,860782
21867,ShellyXueHan,1,0.00012,174478,20.26971,860782
21868,shenjiangc,1,0.00012,174479,20.26982,860782
21869,shenmou98,1,0.00012,174480,20.26994,860782
21870,sherbang,1,0.00012,174481,20.27006,860782
21871,Sher-Chowdhury,1,0.00012,174482,20.27017,860782
21872,sherif84,1,0.00012,174483,20.27029,860782
21873,Sherman-Chata,1,0.00012,174484,20.27041,860782
21874,sherwinwangs,1,0.00012,174485,20.27052,860782
21875,shevisjohnson,1,0.00012,174486,20.27064,860782
21876,shibbas,1,0.00012,174487,20.27075,860782
21877,shibumi-matt,1,0.00012,174488,20.27087,860782
21878,ShiJinYu2017,1,0.00012,174489,20.27099,860782
21879,shijukuchelan1985,1,0.00012,174490,20.27110,860782
21880,Shikhar1097,1,0.00012,174491,20.27122,860782
21881,Shikhar1210918,1,0.00012,174492,20.27133,860782
21882,ShilpaMerinMathew,1,0.00012,174493,20.27145,860782
21883,shilx3,1,0.00012,174494,20.27157,860782
21884,shinhwagk,1,0.00012,174495,20.27168,860782
21885,shirodkara,1,0.00012,174496,20.27180,860782
21886,ShirshaDatta,1,0.00012,174497,20.27192,860782
21887,shiva252,1,0.00012,174498,20.27203,860782
21888,shivaani0505,1,0.00012,174499,20.27215,860782
21889,shivabommakanti03,1,0.00012,174500,20.27226,860782
21890,shivakumargn,1,0.00012,174501,20.27238,860782
21891,shivammathur,1,0.00012,174502,20.27250,860782
21892,shivasuri,1,0.00012,174503,20.27261,860782
21893,shivdudhani,1,0.00012,174504,20.27273,860782
21894,shiyan2016,1,0.00012,174505,20.27284,860782
21895,shizacat,1,0.00012,174506,20.27296,860782
21896,shlomibendavid,1,0.00012,174507,20.27308,860782
21897,shnish,1,0.00012,174508,20.27319,860782
21898,shockogit,1,0.00012,174509,20.27331,860782
21899,shogo82148,1,0.00012,174510,20.27343,860782
21900,shotalinux,1,0.00012,174511,20.27354,860782
21901,shotu,1,0.00012,174512,20.27366,860782
21902,shqear93,1,0.00012,174513,20.27377,860782
21903,shreben,1,0.00012,174514,20.27389,860782
21904,shree007,1,0.00012,174515,20.27401,860782
21905,shreyansvm,1,0.00012,174516,20.27412,860782
21906,ShreyGargLTI,1,0.00012,174517,20.27424,860782
21907,shrgupta773,1,0.00012,174518,20.27436,860782
21908,shridharkute,1,0.00012,174519,20.27447,860782
21909,ShrikantSaxena,1,0.00012,174520,20.27459,860782
21910,shubham061292,1,0.00012,174521,20.27470,860782
21911,shubhamjangid532,1,0.00012,174522,20.27482,860782
21912,shubhamyelikar,1,0.00012,174523,20.27494,860782
21913,Shubhangi7490,1,0.00012,174524,20.27505,860782
21914,shubhomoy,1,0.00012,174525,20.27517,860782
21915,Shujaatu02,1,0.00012,174526,20.27528,860782
21916,shujaurr18,1,0.00012,174527,20.27540,860782
21917,shunkakinoki,1,0.00012,174528,20.27552,860782
21918,shurkus,1,0.00012,174529,20.27563,860782
21919,shuza,1,0.00012,174530,20.27575,860782
21920,sh-vasily,1,0.00012,174531,20.27587,860782
21921,shwegyi198361,1,0.00012,174532,20.27598,860782
21922,shwuhk,1,0.00012,174533,20.27610,860782
21923,shy000000,1,0.00012,174534,20.27621,860782
21924,shyamkhakhar9,1,0.00012,174535,20.27633,860782
21925,sibe7691,1,0.00012,174536,20.27645,860782
21926,sidarth164,1,0.00012,174537,20.27656,860782
21927,siddhantd28,1,0.00012,174538,20.27668,860782
21928,Siddharthk,1,0.00012,174539,20.27679,860782
21929,siddharthlal25,1,0.00012,174540,20.27691,860782
21930,SiddiqueAhmad,1,0.00012,174541,20.27703,860782
21931,sidhantbhayana,1,0.00012,174542,20.27714,860782
21932,sidheshdivekar29,1,0.00012,174543,20.27726,860782
21933,sidiesen,1,0.00012,174544,20.27738,860782
21934,sidikalamini,1,0.00012,174545,20.27749,860782
21935,siicosmos,1,0.00012,174546,20.27761,860782
21936,sijocherian,1,0.00012,174547,20.27772,860782
21937,sijohans,1,0.00012,174548,20.27784,860782
21938,Sikiryl,1,0.00012,174549,20.27796,860782
21939,silashansen,1,0.00012,174550,20.27807,860782
21940,silent-beaters,1,0.00012,174551,20.27819,860782
21941,silkeh,1,0.00012,174552,20.27831,860782
21942,sillent,1,0.00012,174553,20.27842,860782
21943,silme,1,0.00012,174554,20.27854,860782
21944,SilverBut,1,0.00012,174555,20.27865,860782
21945,simbainfotechh,1,0.00012,174556,20.27877,860782
21946,simbamarufu1,1,0.00012,174557,20.27889,860782
21947,simbro,1,0.00012,174558,20.27900,860782
21948,simkimsia,1,0.00012,174559,20.27912,860782
21949,simlun,1,0.00012,174560,20.27923,860782
21950,simon-anz,1,0.00012,174561,20.27935,860782
21951,simone201,1,0.00012,174562,20.27947,860782
21952,simon-jouet,1,0.00012,174563,20.27958,860782
21953,simonmatt,1,0.00012,174564,20.27970,860782
21954,simonmau,1,0.00012,174565,20.27982,860782
21955,simonoff,1,0.00012,174566,20.27993,860782
21956,simonracz,1,0.00012,174567,20.28005,860782
21957,simonvpe,1,0.00012,174568,20.28016,860782
21958,simon-weber,1,0.00012,174569,20.28028,860782
21959,SimonWoolf,1,0.00012,174570,20.28040,860782
21960,SimonyanG,1,0.00012,174571,20.28051,860782
21961,simran3695,1,0.00012,174572,20.28063,860782
21962,Simran-B,1,0.00012,174573,20.28074,860782
21963,simyco,1,0.00012,174574,20.28086,860782
21964,SinaRex,1,0.00012,174575,20.28098,860782
21965,sincejune,1,0.00012,174576,20.28109,860782
21966,sinchanroy,1,0.00012,174577,20.28121,860782
21967,singh728om,1,0.00012,174578,20.28133,860782
21968,singh-ajeet,1,0.00012,174579,20.28144,860782
21969,singhannie,1,0.00012,174580,20.28156,860782
21970,singhravi1,1,0.00012,174581,20.28167,860782
21971,SingularBunny,1,0.00012,174582,20.28179,860782
21972,SinisterMinister,1,0.00012,174583,20.28191,860782
21973,sinistersnare,1,0.00012,174584,20.28202,860782
21974,sirao,1,0.00012,174585,20.28214,860782
21975,siredmar,1,0.00012,174586,20.28225,860782
21976,SirensOfTitan,1,0.00012,174587,20.28237,860782
21977,sirianni,1,0.00012,174588,20.28249,860782
21978,Sirmagnolia,1,0.00012,174589,20.28260,860782
21979,SirOibaf,1,0.00012,174590,20.28272,860782
21980,sirtuxalot,1,0.00012,174591,20.28284,860782
21981,sisiliao,1,0.00012,174592,20.28295,860782
21982,sivag9,1,0.00012,174593,20.28307,860782
21983,sivagurudialpad,1,0.00012,174594,20.28318,860782
21984,sivakkr,1,0.00012,174595,20.28330,860782
21985,sivakumar-arumugam,1,0.00012,174596,20.28342,860782
21986,siyoo,1,0.00012,174597,20.28353,860782
21987,sizovilya,1,0.00012,174598,20.28365,860782
21988,sjarking,1,0.00012,174599,20.28377,860782
21989,sjwoodard,1,0.00012,174600,20.28388,860782
21990,skalle,1,0.00012,174601,20.28400,860782
21991,SkaMarius,1,0.00012,174602,20.28411,860782
21992,skambashi,1,0.00012,174603,20.28423,860782
21993,skamenetskiy,1,0.00012,174604,20.28435,860782
21994,skashyap7,1,0.00012,174605,20.28446,860782
21995,skdjango001,1,0.00012,174606,20.28458,860782
21996,SkeLLLa,1,0.00012,174607,20.28469,860782
21997,skemuel007,1,0.00012,174608,20.28481,860782
21998,Skepfyr,1,0.00012,174609,20.28493,860782
21999,skgandikota,1,0.00012,174610,20.28504,860782
22000,skhavari,1,0.00012,174611,20.28516,860782
22001,SkillsHat,1,0.00012,174612,20.28528,860782
22002,skorfmann,1,0.00012,174613,20.28539,860782
22003,SKowshik4614,1,0.00012,174614,20.28551,860782
22004,skraga,1,0.00012,174615,20.28562,860782
22005,skriesch,1,0.00012,174616,20.28574,860782
22006,skristallidis,1,0.00012,174617,20.28586,860782
22007,skuxy,1,0.00012,174618,20.28597,860782
22008,Sky-Blue-007,1,0.00012,174619,20.28609,860782
22009,skycmoon,1,0.00012,174620,20.28620,860782
22010,Skyfallz,1,0.00012,174621,20.28632,860782
22011,skyfirst93,1,0.00012,174622,20.28644,860782
22012,skyjia,1,0.00012,174623,20.28655,860782
22013,SkylarScaling,1,0.00012,174624,20.28667,860782
22014,skylar-stark,1,0.00012,174625,20.28679,860782
22015,skyrain,1,0.00012,174626,20.28690,860782
22016,sladkoff,1,0.00012,174627,20.28702,860782
22017,sledigabel,1,0.00012,174628,20.28713,860782
22018,sledoux,1,0.00012,174629,20.28725,860782
22019,sleshJdev,1,0.00012,174630,20.28737,860782
22020,slguarderas,1,0.00012,174631,20.28748,860782
22021,slightfoot,1,0.00012,174632,20.28760,860782
22022,slmingol,1,0.00012,174633,20.28772,860782
22023,SM616,1,0.00012,174634,20.28783,860782
22024,smacdav,1,0.00012,174635,20.28795,860782
22025,smallertomato,1,0.00012,174636,20.28806,860782
22026,smart-duck,1,0.00012,174637,20.28818,860782
22027,SmartsYoung,1,0.00012,174638,20.28830,860782
22028,smartxff,1,0.00012,174639,20.28841,860782
22029,SMDMANSOOR,1,0.00012,174640,20.28853,860782
22030,smehboub,1,0.00012,174641,20.28864,860782
22031,smehboub-dkt,1,0.00012,174642,20.28876,860782
22032,smerschjohann,1,0.00012,174643,20.28888,860782
22033,smibe,1,0.00012,174644,20.28899,860782
22034,smilelikeshit,1,0.00012,174645,20.28911,860782
22035,Smithx10,1,0.00012,174646,20.28923,860782
22036,Smlight,1,0.00012,174647,20.28934,860782
22037,smolaon,1,0.00012,174648,20.28946,860782
22038,Smolevich,1,0.00012,174649,20.28957,860782
22039,smolkaj,1,0.00012,174650,20.28969,860782
22040,smontosa,1,0.00012,174651,20.28981,860782
22041,SMR39,1,0.00012,174652,20.28992,860782
22042,smuel1414,1,0.00012,174653,20.29004,860782
22043,smuftee,1,0.00012,174654,20.29015,860782
22044,smuravev,1,0.00012,174655,20.29027,860782
22045,smw355,1,0.00012,174656,20.29039,860782
22046,Sn3b,1,0.00012,174657,20.29050,860782
22047,snaik,1,0.00012,174658,20.29062,860782
22048,snake-ch,1,0.00012,174659,20.29074,860782
22049,snarlynarwhal,1,0.00012,174660,20.29085,860782
22050,snc43,1,0.00012,174661,20.29097,860782
22051,snd3r,1,0.00012,174662,20.29108,860782
22052,sneben,1,0.00012,174663,20.29120,860782
22053,snehap25,1,0.00012,174664,20.29132,860782
22054,sniranjan,1,0.00012,174665,20.29143,860782
22055,snithish,1,0.00012,174666,20.29155,860782
22056,snodnipper,1,0.00012,174667,20.29167,860782
22057,snowiow,1,0.00012,174668,20.29178,860782
22058,snsie,1,0.00012,174669,20.29190,860782
22059,SnuK87,1,0.00012,174670,20.29201,860782
22060,snyamars,1,0.00012,174671,20.29213,860782
22061,snyman,1,0.00012,174672,20.29225,860782
22062,SobakaSlava,1,0.00012,174673,20.29236,860782
22063,socotra69,1,0.00012,174674,20.29248,860782
22064,Sodki,1,0.00012,174675,20.29259,860782
22065,softshipper,1,0.00012,174676,20.29271,860782
22066,sohaib-rafay,1,0.00012,174677,20.29283,860782
22067,soharaki,1,0.00012,174678,20.29294,860782
22068,soichisumi,1,0.00012,174679,20.29306,860782
22069,soilsk,1,0.00012,174680,20.29318,860782
22070,sokaran,1,0.00012,174681,20.29329,860782
22071,soleblaze,1,0.00012,174682,20.29341,860782
22072,solerman,1,0.00012,174683,20.29352,860782
22073,Solisol,1,0.00012,174684,20.29364,860782
22074,solocommand,1,0.00012,174685,20.29376,860782
22075,soloman817,1,0.00012,174686,20.29387,860782
22076,SolovyevAndrei,1,0.00012,174687,20.29399,860782
22077,soloyes,1,0.00012,174688,20.29410,860782
22078,solveretur,1,0.00012,174689,20.29422,860782
22079,SomaticIT,1,0.00012,174690,20.29434,860782
22080,SomniVertix,1,0.00012,174691,20.29445,860782
22081,somombo,1,0.00012,174692,20.29457,860782
22082,somyagarg94,1,0.00012,174693,20.29469,860782
22083,son4etyyy,1,0.00012,174694,20.29480,860782
22084,sonalkr132,1,0.00012,174695,20.29492,860782
22085,sonaysevik,1,0.00012,174696,20.29503,860782
22086,songeddy,1,0.00012,174697,20.29515,860782
22087,songhanpoo,1,0.00012,174698,20.29527,860782
22088,song-jiang,1,0.00012,174699,20.29538,860782
22089,songyang423915,1,0.00012,174700,20.29550,860782
22090,SoniaKaudjhis,1,0.00012,174701,20.29561,860782
22091,sonntag-dev,1,0.00012,174702,20.29573,860782
22092,SonnyAD,1,0.00012,174703,20.29585,860782
22093,sonogithub,1,0.00012,174704,20.29596,860782
22094,sonork,1,0.00012,174705,20.29608,860782
22095,sonvu0612,1,0.00012,174706,20.29620,860782
22096,sonwa,1,0.00012,174707,20.29631,860782
22097,sophieyfang,1,0.00012,174708,20.29643,860782
22098,sorenvind,1,0.00012,174709,20.29654,860782
22099,soriyath,1,0.00012,174710,20.29666,860782
22100,soslan,1,0.00012,174711,20.29678,860782
22101,sospartan,1,0.00012,174712,20.29689,860782
22102,soul12345,1,0.00012,174713,20.29701,860782
22103,soumeng09,1,0.00012,174714,20.29713,860782
22104,soumochak83,1,0.00012,174715,20.29724,860782
22105,soumyag25,1,0.00012,174716,20.29736,860782
22106,sourabhsparkala,1,0.00012,174717,20.29747,860782
22107,souravb11,1,0.00012,174718,20.29759,860782
22108,sourav-code-space,1,0.00012,174719,20.29771,860782
22109,sownak,1,0.00012,174720,20.29782,860782
22110,soygalla,1,0.00012,174721,20.29794,860782
22111,soyuka,1,0.00012,174722,20.29805,860782
22112,sp185503-ncr,1,0.00012,174723,20.29817,860782
22113,Space-Banana-42,1,0.00012,174724,20.29829,860782
22114,spacebarley,1,0.00012,174725,20.29840,860782
22115,spacentropy,1,0.00012,174726,20.29852,860782
22116,spanktar,1,0.00012,174727,20.29864,860782
22117,spanky-medal,1,0.00012,174728,20.29875,860782
22118,Spark2107,1,0.00012,174729,20.29887,860782
22119,spdfnet,1,0.00012,174730,20.29898,860782
22120,spellr,1,0.00012,174731,20.29910,860782
22121,SpencerMalone,1,0.00012,174732,20.29922,860782
22122,spenczar,1,0.00012,174733,20.29933,860782
22123,spigell,1,0.00012,174734,20.29945,860782
22124,SpikePy,1,0.00012,174735,20.29956,860782
22125,SpitNight,1,0.00012,174736,20.29968,860782
22126,splashx,1,0.00012,174737,20.29980,860782
22127,splattner,1,0.00012,174738,20.29991,860782
22128,splunkdevabhi,1,0.00012,174739,20.30003,860782
22129,sp-magicspells,1,0.00012,174740,20.30015,860782
22130,spoer78,1,0.00012,174741,20.30026,860782
22131,spoloj,1,0.00012,174742,20.30038,860782
22132,spots107,1,0.00012,174743,20.30049,860782
22133,Spredzy,1,0.00012,174744,20.30061,860782
22134,springfred,1,0.00012,174745,20.30073,860782
22135,spxcds,1,0.00012,174746,20.30084,860782
22136,spyle,1,0.00012,174747,20.30096,860782
22137,squaricdot,1,0.00012,174748,20.30108,860782
22138,squinn,1,0.00012,174749,20.30119,860782
22139,sra,1,0.00012,174750,20.30131,860782
22140,sramaley,1,0.00012,174751,20.30142,860782
22141,sramosubi,1,0.00012,174752,20.30154,860782
22142,sravan199,1,0.00012,174753,20.30166,860782
22143,sravanpatro,1,0.00012,174754,20.30177,860782
22144,sravanthiSabbani,1,0.00012,174755,20.30189,860782
22145,sray,1,0.00012,174756,20.30200,860782
22146,srcmake,1,0.00012,174757,20.30212,860782
22147,srdjan,1,0.00012,174758,20.30224,860782
22148,sreber84,1,0.00012,174759,20.30235,860782
22149,sreedharkurra,1,0.00012,174760,20.30247,860782
22150,sreejithpunnapuzha,1,0.00012,174761,20.30259,860782
22151,sreenuraghavan,1,0.00012,174762,20.30270,860782
22152,sreesarva,1,0.00012,174763,20.30282,860782
22153,srfaytkn,1,0.00012,174764,20.30293,860782
22154,srikanta50,1,0.00012,174765,20.30305,860782
22155,srikanth45,1,0.00012,174766,20.30317,860782
22156,srikaratstrings,1,0.00012,174767,20.30328,860782
22157,srikiraju,1,0.00012,174768,20.30340,860782
22158,Srikrishnabh,1,0.00012,174769,20.30351,860782
22159,srinat999,1,0.00012,174770,20.30363,860782
22160,Srinivas11789,1,0.00012,174771,20.30375,860782
22161,srinivasraojangiti,1,0.00012,174772,20.30386,860782
22162,sriramkannan,1,0.00012,174773,20.30398,860782
22163,srishab,1,0.00012,174774,20.30410,860782
22164,srivasthava,1,0.00012,174775,20.30421,860782
22165,srkiNZ84,1,0.00012,174776,20.30433,860782
22166,sroskelley,1,0.00012,174777,20.30444,860782
22167,srronak,1,0.00012,174778,20.30456,860782
22168,srsdevelopers,1,0.00012,174779,20.30468,860782
22169,srsneedis,1,0.00012,174780,20.30479,860782
22170,srt32,1,0.00012,174781,20.30491,860782
22171,srushingiv,1,0.00012,174782,20.30502,860782
22172,srvmsr,1,0.00012,174783,20.30514,860782
22173,SS30723,1,0.00012,174784,20.30526,860782
22174,ssahil628,1,0.00012,174785,20.30537,860782
22175,ssandanshi,1,0.00012,174786,20.30549,860782
22176,ssaxen0,1,0.00012,174787,20.30561,860782
22177,sschmitt,1,0.00012,174788,20.30572,860782
22178,sschu,1,0.00012,174789,20.30584,860782
22179,ssecond,1,0.00012,174790,20.30595,860782
22180,sseetharaman6,1,0.00012,174791,20.30607,860782
22181,sshah90,1,0.00012,174792,20.30619,860782
22182,sshaikh,1,0.00012,174793,20.30630,860782
22183,sshankjha,1,0.00012,174794,20.30642,860782
22184,s-spindler,1,0.00012,174795,20.30654,860782
22185,ssquan,1,0.00012,174796,20.30665,860782
22186,sstock,1,0.00012,174797,20.30677,860782
22187,sstone1,1,0.00012,174798,20.30688,860782
22188,sstoyanovucsd,1,0.00012,174799,20.30700,860782
22189,st0rmr1der1994,1,0.00012,174800,20.30712,860782
22190,stacylacy6,1,0.00012,174801,20.30723,860782
22191,staehle,1,0.00012,174802,20.30735,860782
22192,StandNorthStar,1,0.00012,174803,20.30746,860782
22193,stanhordiyenko,1,0.00012,174804,20.30758,860782
22194,stanislavlevin,1,0.00012,174805,20.30770,860782
22195,stanislav-zaprudskiy,1,0.00012,174806,20.30781,860782
22196,Stankye,1,0.00012,174807,20.30793,860782
22197,stanluk,1,0.00012,174808,20.30805,860782
22198,StanYago,1,0.00012,174809,20.30816,860782
22199,stappersg,1,0.00012,174810,20.30828,860782
22200,starbassma,1,0.00012,174811,20.30839,860782
22201,starbloom,1,0.00012,174812,20.30851,860782
22202,starcraft66,1,0.00012,174813,20.30863,860782
22203,Statemood,1,0.00012,174814,20.30874,860782
22204,staticdax,1,0.00012,174815,20.30886,860782
22205,statkashaman,1,0.00012,174816,20.30897,860782
22206,stayclassychicago,1,0.00012,174817,20.30909,860782
22207,stb2132,1,0.00012,174818,20.30921,860782
22208,stebet,1,0.00012,174819,20.30932,860782
22209,steevi,1,0.00012,174820,20.30944,860782
22210,stefan-caraiman,1,0.00012,174821,20.30956,860782
22211,StefanLiebenberg,1,0.00012,174822,20.30967,860782
22212,StefanMadsen,1,0.00012,174823,20.30979,860782
22213,StefanS111,1,0.00012,174824,20.30990,860782
22214,stefantalpalaru,1,0.00012,174825,20.31002,860782
22215,stefanv,1,0.00012,174826,20.31014,860782
22216,steffann,1,0.00012,174827,20.31025,860782
22217,steinbachr,1,0.00012,174828,20.31037,860782
22218,Steiniche,1,0.00012,174829,20.31049,860782
22219,stejnaci,1,0.00012,174830,20.31060,860782
22220,stelas,1,0.00012,174831,20.31072,860782
22221,stelford,1,0.00012,174832,20.31083,860782
22222,stephane303,1,0.00012,174833,20.31095,860782
22223,stephanepiel,1,0.00012,174834,20.31107,860782
22224,Stephane-Thales,1,0.00012,174835,20.31118,860782
22225,stephenbjm,1,0.00012,174836,20.31130,860782
22226,StephenCarboni,1,0.00012,174837,20.31141,860782
22227,StephenEvenson,1,0.00012,174838,20.31153,860782
22228,stephenplusplus,1,0.00012,174839,20.31165,860782
22229,stephenstrangeMD,1,0.00012,174840,20.31176,860782
22230,StephenWithPH,1,0.00012,174841,20.31188,860782
22231,stepusin,1,0.00012,174842,20.31200,860782
22232,steve1337,1,0.00012,174843,20.31211,860782
22233,SteveLas,1,0.00012,174844,20.31223,860782
22234,stevenkitter,1,0.00012,174845,20.31234,860782
22235,stevenmcastano,1,0.00012,174846,20.31246,860782
22236,SteveRaskin,1,0.00012,174847,20.31258,860782
22237,stevesea,1,0.00012,174848,20.31269,860782
22238,SteveTarter,1,0.00012,174849,20.31281,860782
22239,steveww,1,0.00012,174850,20.31292,860782
22240,stfnbstl,1,0.00012,174851,20.31304,860782
22241,Sticksword,1,0.00012,174852,20.31316,860782
22242,stigok,1,0.00012,174853,20.31327,860782
22243,StingyJack,1,0.00012,174854,20.31339,860782
22244,stk0vrfl0w,1,0.00012,174855,20.31351,860782
22245,stku1985,1,0.00012,174856,20.31362,860782
22246,stoehdoi,1,0.00012,174857,20.31374,860782
22247,stoksc,1,0.00012,174858,20.31385,860782
22248,StorkZ,1,0.00012,174859,20.31397,860782
22249,stormobile,1,0.00012,174860,20.31409,860782
22250,storpipfugl,1,0.00012,174861,20.31420,860782
22251,Storyyeller,1,0.00012,174862,20.31432,860782
22252,stravze,1,0.00012,174863,20.31444,860782
22253,Streeter220,1,0.00012,174864,20.31455,860782
22254,StrikerExtreem,1,0.00012,174865,20.31467,860782
22255,strmdvr,1,0.00012,174866,20.31478,860782
22256,strowk,1,0.00012,174867,20.31490,860782
22257,stubclan,1,0.00012,174868,20.31502,860782
22258,stuckj,1,0.00012,174869,20.31513,860782
22259,studylin,1,0.00012,174870,20.31525,860782
22260,stufently,1,0.00012,174871,20.31536,860782
22261,stuhood,1,0.00012,174872,20.31548,860782
22262,stupidlamo,1,0.00012,174873,20.31560,860782
22263,stupidly-logical,1,0.00012,174874,20.31571,860782
22264,stylius,1,0.00012,174875,20.31583,860782
22265,styshoo,1,0.00012,174876,20.31595,860782
22266,su-alfa,1,0.00012,174877,20.31606,860782
22267,suauk,1,0.00012,174878,20.31618,860782
22268,SubatomicHero,1,0.00012,174879,20.31629,860782
22269,subhrang,1,0.00012,174880,20.31641,860782
22270,subos2008,1,0.00012,174881,20.31653,860782
22271,subramani95,1,0.00012,174882,20.31664,860782
22272,subravi92,1,0.00012,174883,20.31676,860782
22273,successfuljian,1,0.00012,174884,20.31687,860782
22274,SuchSkill,1,0.00012,174885,20.31699,860782
22275,sudaxl,1,0.00012,174886,20.31711,860782
22276,sudeep-ib,1,0.00012,174887,20.31722,860782
22277,SudhakarKonduru,1,0.00012,174888,20.31734,860782
22278,Sudheerkumar,1,0.00012,174889,20.31746,860782
22279,sudhirshetty,1,0.00012,174890,20.31757,860782
22280,sudhirski,1,0.00012,174891,20.31769,860782
22281,sudhirtataraju,1,0.00012,174892,20.31780,860782
22282,sudinar,1,0.00012,174893,20.31792,860782
22283,Sudneo,1,0.00012,174894,20.31804,860782
22284,SudoBrendan,1,0.00012,174895,20.31815,860782
22285,sudswasavi,1,0.00012,174896,20.31827,860782
22286,suezzelur,1,0.00012,174897,20.31838,860782
22287,sugarbyheart2,1,0.00012,174898,20.31850,860782
22288,sugo-85,1,0.00012,174899,20.31862,860782
22289,Suhrad,1,0.00012,174900,20.31873,860782
22290,suistack,1,0.00012,174901,20.31885,860782
22291,sujata-sharma,1,0.00012,174902,20.31897,860782
22292,sujithvs74,1,0.00012,174903,20.31908,860782
22293,sukill,1,0.00012,174904,20.31920,860782
22294,sulaweyo,1,0.00012,174905,20.31931,860782
22295,sulixu,1,0.00012,174906,20.31943,860782
22296,Sullivan12138,1,0.00012,174907,20.31955,860782
22297,Sumaid,1,0.00012,174908,20.31966,860782
22298,sumakuma2006,1,0.00012,174909,20.31978,860782
22299,sumangongali,1,0.00012,174910,20.31990,860782
22300,sumanp89,1,0.00012,174911,20.32001,860782
22301,sumantfordev,1,0.00012,174912,20.32013,860782
22302,sumeet-kumar-rft,1,0.00012,174913,20.32024,860782
22303,sumeetoc,1,0.00012,174914,20.32036,860782
22304,sumitkute,1,0.00012,174915,20.32048,860782
22305,sumool,1,0.00012,174916,20.32059,860782
22306,Sunanda-S2,1,0.00012,174917,20.32071,860782
22307,sunil811,1,0.00012,174918,20.32082,860782
22308,sunilkrg,1,0.00012,174919,20.32094,860782
22309,sunil-parida,1,0.00012,174920,20.32106,860782
22310,sun-iot,1,0.00012,174921,20.32117,860782
22311,sunpeinju,1,0.00012,174922,20.32129,860782
22312,sunyl527,1,0.00012,174923,20.32141,860782
22313,sunysaurabh,1,0.00012,174924,20.32152,860782
22314,S-UP,1,0.00012,174925,20.32164,860782
22315,suparek,1,0.00012,174926,20.32175,860782
22316,superbiche,1,0.00012,174927,20.32187,860782
22317,supercoolgreatcoder,1,0.00012,174928,20.32199,860782
22318,superdevofficial,1,0.00012,174929,20.32210,860782
22319,superfenv,1,0.00012,174930,20.32222,860782
22320,SupermanCj,1,0.00012,174931,20.32233,860782
22321,supermiguel,1,0.00012,174932,20.32245,860782
22322,Superset1986,1,0.00012,174933,20.32257,860782
22323,supertetelman,1,0.00012,174934,20.32268,860782
22324,SuperTonic09,1,0.00012,174935,20.32280,860782
22325,suprraz,1,0.00012,174936,20.32292,860782
22326,surajkjai,1,0.00012,174937,20.32303,860782
22327,surajrajan-maf,1,0.00012,174938,20.32315,860782
22328,surazzarus,1,0.00012,174939,20.32326,860782
22329,surensinghkhatana,1,0.00012,174940,20.32338,860782
22330,surenther,1,0.00012,174941,20.32350,860782
22331,sureshamk,1,0.00012,174942,20.32361,860782
22332,sureshoao,1,0.00012,174943,20.32373,860782
22333,Surfer2010,1,0.00012,174944,20.32385,860782
22334,surfingsimbo,1,0.00012,174945,20.32396,860782
22335,surya2155,1,0.00012,174946,20.32408,860782
22336,sushant-at-nitor,1,0.00012,174947,20.32419,860782
22337,sustephen,1,0.00012,174948,20.32431,860782
22338,suvankar-git,1,0.00012,174949,20.32443,860782
22339,suxiaohei,1,0.00012,174950,20.32454,860782
22340,svalentino,1,0.00012,174951,20.32466,860782
22341,svalluru-aai,1,0.00012,174952,20.32477,860782
22342,sveiss,1,0.00012,174953,20.32489,860782
22343,svenkat89,1,0.00012,174954,20.32501,860782
22344,svet-b,1,0.00012,174955,20.32512,860782
22345,svilcu,1,0.00012,174956,20.32524,860782
22346,svinther,1,0.00012,174957,20.32536,860782
22347,svolence,1,0.00012,174958,20.32547,860782
22348,svpace,1,0.00012,174959,20.32559,860782
22349,svrc,1,0.00012,174960,20.32570,860782
22350,svrnm,1,0.00012,174961,20.32582,860782
22351,svzhl,1,0.00012,174962,20.32594,860782
22352,swapnilbjadhav,1,0.00012,174963,20.32605,860782
22353,swapnilpotnis,1,0.00012,174964,20.32617,860782
22354,swarmer,1,0.00012,174965,20.32628,860782
22355,swartz-k,1,0.00012,174966,20.32640,860782
22356,SwatantraYadav,1,0.00012,174967,20.32652,860782
22357,swathins079,1,0.00012,174968,20.32663,860782
22358,swathipriyanka999,1,0.00012,174969,20.32675,860782
22359,swedesoft,1,0.00012,174970,20.32687,860782
22360,sweitzel,1,0.00012,174971,20.32698,860782
22361,swgu931,1,0.00012,174972,20.32710,860782
22362,swuecho,1,0.00012,174973,20.32721,860782
22363,sxpujs,1,0.00012,174974,20.32733,860782
22364,syahrul12345,1,0.00012,174975,20.32745,860782
22365,sybrenbolandit,1,0.00012,174976,20.32756,860782
22366,sydnash,1,0.00012,174977,20.32768,860782
22367,sydnever,1,0.00012,174978,20.32779,860782
22368,syedhassaanahmed,1,0.00012,174979,20.32791,860782
22369,Syed-Saifulla,1,0.00012,174980,20.32803,860782
22370,syedzac,1,0.00012,174981,20.32814,860782
22371,symc-gail,1,0.00012,174982,20.32826,860782
22372,symdework,1,0.00012,174983,20.32838,860782
22373,Synehan,1,0.00012,174984,20.32849,860782
22374,synepolskyi,1,0.00012,174985,20.32861,860782
22375,syniack,1,0.00012,174986,20.32872,860782
22376,synixebrett,1,0.00012,174987,20.32884,860782
22377,syohex,1,0.00012,174988,20.32896,860782
22378,syq7970,1,0.00012,174989,20.32907,860782
22379,syrine10,1,0.00012,174990,20.32919,860782
22380,SysdigDan,1,0.00012,174991,20.32931,860782
22381,SystemZ,1,0.00012,174992,20.32942,860782
22382,sysword,1,0.00012,174993,20.32954,860782
22383,szalapski,1,0.00012,174994,20.32965,860782
22384,szediktam,1,0.00012,174995,20.32977,860782
22385,szmytson,1,0.00012,174996,20.32989,860782
22386,sznmaran,1,0.00012,174997,20.33000,860782
22387,sztupy,1,0.00012,174998,20.33012,860782
22388,szwed,1,0.00012,174999,20.33023,860782
22389,t051506,1,0.00012,175000,20.33035,860782
22390,t0k4rt,1,0.00012,175001,20.33047,860782
22391,t109595,1,0.00012,175002,20.33058,860782
22392,T1loc,1,0.00012,175003,20.33070,860782
22393,t3mi,1,0.00012,175004,20.33082,860782
22394,taaehk,1,0.00012,175005,20.33093,860782
22395,tabbi,1,0.00012,175006,20.33105,860782
22396,tabnul,1,0.00012,175007,20.33116,860782
22397,tacf,1,0.00012,175008,20.33128,860782
22398,tacurran,1,0.00012,175009,20.33140,860782
22399,Tadimsky,1,0.00012,175010,20.33151,860782
22400,tae9yu,1,0.00012,175011,20.33163,860782
22401,taesunny,1,0.00012,175012,20.33174,860782
22402,taha-au,1,0.00012,175013,20.33186,860782
22403,tahasabih,1,0.00012,175014,20.33198,860782
22404,tahir-gvs,1,0.00012,175015,20.33209,860782
22405,taideng,1,0.00012,175016,20.33221,860782
22406,taihen,1,0.00012,175017,20.33233,860782
22407,taiidani,1,0.00012,175018,20.33244,860782
22408,takanoshota,1,0.00012,175019,20.33256,860782
22409,takat0-h0rikosh1,1,0.00012,175020,20.33267,860782
22410,take31415,1,0.00012,175021,20.33279,860782
22411,takeoffnyc,1,0.00012,175022,20.33291,860782
22412,taknakamura,1,0.00012,175023,20.33302,860782
22413,takuhiro,1,0.00012,175024,20.33314,860782
22414,takyon77,1,0.00012,175025,20.33326,860782
22415,talalatpixlee,1,0.00012,175026,20.33337,860782
22416,talboren,1,0.00012,175027,20.33349,860782
22417,talbright,1,0.00012,175028,20.33360,860782
22418,talebzeghmi,1,0.00012,175029,20.33372,860782
22419,taleodor,1,0.00012,175030,20.33384,860782
22420,talgos1,1,0.00012,175031,20.33395,860782
22421,talha22081992,1,0.00012,175032,20.33407,860782
22422,talkraghu,1,0.00012,175033,20.33418,860782
22423,tallmanbrew,1,0.00012,175034,20.33430,860782
22424,talr1,1,0.00012,175035,20.33442,860782
22425,tamademicheli,1,0.00012,175036,20.33453,860782
22426,TAMDUC1,1,0.00012,175037,20.33465,860782
22427,tamipangadil,1,0.00012,175038,20.33477,860782
22428,tamirshaul,1,0.00012,175039,20.33488,860782
22429,tanapop,1,0.00012,175040,20.33500,860782
22430,Tanbouz,1,0.00012,175041,20.33511,860782
22431,tangent-devop,1,0.00012,175042,20.33523,860782
22432,tangjiecheng79,1,0.00012,175043,20.33535,860782
22433,tangname,1,0.00012,175044,20.33546,860782
22434,Tanhe,1,0.00012,175045,20.33558,860782
22435,tanHeXiang,1,0.00012,175046,20.33569,860782
22436,TannerBragg,1,0.00012,175047,20.33581,860782
22437,tan-stripe,1,0.00012,175048,20.33593,860782
22438,tantonescu,1,0.00012,175049,20.33604,860782
22439,taojian311,1,0.00012,175050,20.33616,860782
22440,taozhi8833998,1,0.00012,175051,20.33628,860782
22441,Tapa4ik,1,0.00012,175052,20.33639,860782
22442,tarcieri,1,0.00012,175053,20.33651,860782
22443,TARIKPHON85,1,0.00012,175054,20.33662,860782
22444,tariqulislam,1,0.00012,175055,20.33674,860782
22445,tarkesh2shar,1,0.00012,175056,20.33686,860782
22446,tarunactivity,1,0.00012,175057,20.33697,860782
22447,tatellos,1,0.00012,175058,20.33709,860782
22448,tathastu871,1,0.00012,175059,20.33721,860782
22449,Tatsu-Kishi,1,0.00012,175060,20.33732,860782
22450,tauseefj,1,0.00012,175061,20.33744,860782
22451,tawfik21,1,0.00012,175062,20.33755,860782
22452,taybur43,1,0.00012,175063,20.33767,860782
22453,Tayyab30,1,0.00012,175064,20.33779,860782
22454,tb438,1,0.00012,175065,20.33790,860782
22455,tbedi-jnpr,1,0.00012,175066,20.33802,860782
22456,tbhaagh,1,0.00012,175067,20.33813,860782
22457,tbiddu,1,0.00012,175068,20.33825,860782
22458,tbonfort,1,0.00012,175069,20.33837,860782
22459,tbox1911,1,0.00012,175070,20.33848,860782
22460,tbutkiewicz,1,0.00012,175071,20.33860,860782
22461,tbuyukliev,1,0.00012,175072,20.33872,860782
22462,tcarrio,1,0.00012,175073,20.33883,860782
22463,tcassaert,1,0.00012,175074,20.33895,860782
22464,tchangs,1,0.00012,175075,20.33906,860782
22465,tchiotludo,1,0.00012,175076,20.33918,860782
22466,tchrikch,1,0.00012,175077,20.33930,860782
22467,tclh123,1,0.00012,175078,20.33941,860782
22468,tcondeixa,1,0.00012,175079,20.33953,860782
22469,tcrowleyibm,1,0.00012,175080,20.33964,860782
22470,tcz001,1,0.00012,175081,20.33976,860782
22471,tdaleibm,1,0.00012,175082,20.33988,860782
22472,tdbs,1,0.00012,175083,20.33999,860782
22473,tdenmon,1,0.00012,175084,20.34011,860782
22474,TDesai10,1,0.00012,175085,20.34023,860782
22475,tdfischer,1,0.00012,175086,20.34034,860782
22476,teamfighter,1,0.00012,175087,20.34046,860782
22477,teamsun-cloud-system,1,0.00012,175088,20.34057,860782
22478,tebb,1,0.00012,175089,20.34069,860782
22479,tebrizetayi,1,0.00012,175090,20.34081,860782
22480,techctu,1,0.00012,175091,20.34092,860782
22481,TechIsCool,1,0.00012,175092,20.34104,860782
22482,techwolf359,1,0.00012,175093,20.34115,860782
22483,teddybdc,1,0.00012,175094,20.34127,860782
22484,teddylear,1,0.00012,175095,20.34139,860782
22485,tedgkassen,1,0.00012,175096,20.34150,860782
22486,ted-lee,1,0.00012,175097,20.34162,860782
22487,tedtramonte,1,0.00012,175098,20.34174,860782
22488,teebu,1,0.00012,175099,20.34185,860782
22489,teemu-anttila-arek,1,0.00012,175100,20.34197,860782
22490,tehuelche,1,0.00012,175101,20.34208,860782
22491,tejaschitale123,1,0.00012,175102,20.34220,860782
22492,tekenstam,1,0.00012,175103,20.34232,860782
22493,tekmark,1,0.00012,175104,20.34243,860782
22494,tekumara,1,0.00012,175105,20.34255,860782
22495,telphan,1,0.00012,175106,20.34267,860782
22496,temal-,1,0.00012,175107,20.34278,860782
22497,tempacct4q,1,0.00012,175108,20.34290,860782
22498,templafymek,1,0.00012,175109,20.34301,860782
22499,tengattack,1,0.00012,175110,20.34313,860782
22500,ten-lac,1,0.00012,175111,20.34325,860782
22501,tenwolde,1,0.00012,175112,20.34336,860782
22502,terracatta,1,0.00012,175113,20.34348,860782
22503,terryannis,1,0.00012,175114,20.34359,860782
22504,testbsstest,1,0.00012,175115,20.34371,860782
22505,tete17,1,0.00012,175116,20.34383,860782
22506,texasbobs,1,0.00012,175117,20.34394,860782
22507,teyc,1,0.00012,175118,20.34406,860782
22508,tfchan0,1,0.00012,175119,20.34418,860782
22509,tfemson,1,0.00012,175120,20.34429,860782
22510,TfM2,1,0.00012,175121,20.34441,860782
22511,tgamayush,1,0.00012,175122,20.34452,860782
22512,tgdn,1,0.00012,175123,20.34464,860782
22513,tgerczei,1,0.00012,175124,20.34476,860782
22514,tglanz,1,0.00012,175125,20.34487,860782
22515,Th3ABombs,1,0.00012,175126,20.34499,860782
22516,thanatchakromsang,1,0.00012,175127,20.34510,860782
22517,thande,1,0.00012,175128,20.34522,860782
22518,thangld322,1,0.00012,175129,20.34534,860782
22519,thaniyarasu,1,0.00012,175130,20.34545,860782
22520,thannaske,1,0.00012,175131,20.34557,860782
22521,ThaSami,1,0.00012,175132,20.34569,860782
22522,thatch,1,0.00012,175133,20.34580,860782
22523,thatInfrastructureGuy,1,0.00012,175134,20.34592,860782
22524,thebinary,1,0.00012,175135,20.34603,860782
22525,thechosenlne,1,0.00012,175136,20.34615,860782
22526,thechristschn,1,0.00012,175137,20.34627,860782
22527,thecjharries,1,0.00012,175138,20.34638,860782
22528,thecloudgeek,1,0.00012,175139,20.34650,860782
22529,TheCount,1,0.00012,175140,20.34662,860782
22530,thecrazzymouse,1,0.00012,175141,20.34673,860782
22531,thedanielsun,1,0.00012,175142,20.34685,860782
22532,The-Fonz,1,0.00012,175143,20.34696,860782
22533,thehackercat,1,0.00012,175144,20.34708,860782
22534,TheHostMaster20,1,0.00012,175145,20.34720,860782
22535,theindependentwolf,1,0.00012,175146,20.34731,860782
22536,TheJacobKim,1,0.00012,175147,20.34743,860782
22537,thejettanderson,1,0.00012,175148,20.34754,860782
22538,thejonanshow,1,0.00012,175149,20.34766,860782
22539,thekingofworld,1,0.00012,175150,20.34778,860782
22540,thelo-gaultier,1,0.00012,175151,20.34789,860782
22541,Thematrixme,1,0.00012,175152,20.34801,860782
22542,themonks,1,0.00012,175153,20.34813,860782
22543,TheMoxieFox,1,0.00012,175154,20.34824,860782
22544,TheNumberDevil,1,0.00012,175155,20.34836,860782
22545,TheodorAtBud,1,0.00012,175156,20.34847,860782
22546,Theoi-Meteoroi,1,0.00012,175157,20.34859,860782
22547,theoneLee,1,0.00012,175158,20.34871,860782
22548,theophilee,1,0.00012,175159,20.34882,860782
22549,theotherothermatt,1,0.00012,175160,20.34894,860782
22550,ThePaulHarding,1,0.00012,175161,20.34905,860782
22551,thepudds,1,0.00012,175162,20.34917,860782
22552,TheRealDwright,1,0.00012,175163,20.34929,860782
22553,therealnlee,1,0.00012,175164,20.34940,860782
22554,therealsamlin,1,0.00012,175165,20.34952,860782
22555,therzv,1,0.00012,175166,20.34964,860782
22556,theshatner,1,0.00012,175167,20.34975,860782
22557,thesyntaxinator,1,0.00012,175168,20.34987,860782
22558,thetechnick,1,0.00012,175169,20.34998,860782
22559,TheTFo,1,0.00012,175170,20.35010,860782
22560,thib92,1,0.00012,175171,20.35022,860782
22561,thievery80,1,0.00012,175172,20.35033,860782
22562,thiloplanz,1,0.00012,175173,20.35045,860782
22563,ThirtyThirds,1,0.00012,175174,20.35056,860782
22564,Thirugovindaraj,1,0.00012,175175,20.35068,860782
22565,thirumurthis,1,0.00012,175176,20.35080,860782
22566,thkukuk,1,0.00012,175177,20.35091,860782
22567,thokuest,1,0.00012,175178,20.35103,860782
22568,tholu,1,0.00012,175179,20.35115,860782
22569,thomasdba,1,0.00012,175180,20.35126,860782
22570,ThomasEscobar,1,0.00012,175181,20.35138,860782
22571,thomas-lamure,1,0.00012,175182,20.35149,860782
22572,ThomasLohmann,1,0.00012,175183,20.35161,860782
22573,thomasruegsegger,1,0.00012,175184,20.35173,860782
22574,ThomasSonck,1,0.00012,175185,20.35184,860782
22575,ThomasVitale,1,0.00012,175186,20.35196,860782
22576,thprice,1,0.00012,175187,20.35208,860782
22577,threesquared,1,0.00012,175188,20.35219,860782
22578,Thrimbda,1,0.00012,175189,20.35231,860782
22579,throrin19,1,0.00012,175190,20.35242,860782
22580,thucnd55,1,0.00012,175191,20.35254,860782
22581,thzois,1,0.00012,175192,20.35266,860782
22582,TiagoGoddard,1,0.00012,175193,20.35277,860782
22583,TiagoJMartins,1,0.00012,175194,20.35289,860782
22584,tiagotele,1,0.00012,175195,20.35300,860782
22585,tiandong19860806,1,0.00012,175196,20.35312,860782
22586,tianguantang,1,0.00012,175197,20.35324,860782
22587,tianhe-oi,1,0.00012,175198,20.35335,860782
22588,tibetsam,1,0.00012,175199,20.35347,860782
22589,tibkiss,1,0.00012,175200,20.35359,860782
22590,t-ide,1,0.00012,175201,20.35370,860782
22591,tienmanhhust,1,0.00012,175202,20.35382,860782
22592,TieSKey,1,0.00012,175203,20.35393,860782
22593,tiffanyzhou,1,0.00012,175204,20.35405,860782
22594,TigerHix,1,0.00012,175205,20.35417,860782
22595,Tigraine,1,0.00012,175206,20.35428,860782
22596,tilal6991,1,0.00012,175207,20.35440,860782
22597,tillig,1,0.00012,175208,20.35451,860782
22598,timactive,1,0.00012,175209,20.35463,860782
22599,TimAdams84,1,0.00012,175210,20.35475,860782
22600,timcruciano,1,0.00012,175211,20.35486,860782
22601,timduhenchanter,1,0.00012,175212,20.35498,860782
22602,tim-ebert,1,0.00012,175213,20.35510,860782
22603,TimeBye,1,0.00012,175214,20.35521,860782
22604,timfsw,1,0.00012,175215,20.35533,860782
22605,timgestson,1,0.00012,175216,20.35544,860782
22606,timhughes,1,0.00012,175217,20.35556,860782
22607,timmyers,1,0.00012,175218,20.35568,860782
22608,timofey-barmin,1,0.00012,175219,20.35579,860782
22609,TimoKoole,1,0.00012,175220,20.35591,860782
22610,TimothyAsirJeyasing,1,0.00012,175221,20.35603,860782
22611,timrabbetts,1,0.00012,175222,20.35614,860782
22612,timr-dev,1,0.00012,175223,20.35626,860782
22613,timsalu,1,0.00012,175224,20.35637,860782
22614,timurista,1,0.00012,175225,20.35649,860782
22615,tinatsou,1,0.00012,175226,20.35661,860782
22616,Tinche,1,0.00012,175227,20.35672,860782
22617,tinder-mattheworlove,1,0.00012,175228,20.35684,860782
22618,tinder-yueminyu,1,0.00012,175229,20.35695,860782
22619,tinder-yukisawa,1,0.00012,175230,20.35707,860782
22620,tinkalgogoi,1,0.00012,175231,20.35719,860782
22621,tinyma123,1,0.00012,175232,20.35730,860782
22622,Tioborto,1,0.00012,175233,20.35742,860782
22623,tiolan,1,0.00012,175234,20.35754,860782
22624,tirkarthi,1,0.00012,175235,20.35765,860782
22625,tisc0,1,0.00012,175236,20.35777,860782
22626,TisVictress,1,0.00012,175237,20.35788,860782
22627,tivizi,1,0.00012,175238,20.35800,860782
22628,tjackprime,1,0.00012,175239,20.35812,860782
22629,tjappo,1,0.00012,175240,20.35823,860782
22630,Tjianke,1,0.00012,175241,20.35835,860782
22631,tjma2001,1,0.00012,175242,20.35846,860782
22632,tjohnson31415,1,0.00012,175243,20.35858,860782
22633,tjwebb,1,0.00012,175244,20.35870,860782
22634,tkcmada,1,0.00012,175245,20.35881,860782
22635,tkilpela,1,0.00012,175246,20.35893,860782
22636,tkinz27,1,0.00012,175247,20.35905,860782
22637,tklae,1,0.00012,175248,20.35916,860782
22638,tkorrapati1,1,0.00012,175249,20.35928,860782
22639,tkovacs-2,1,0.00012,175250,20.35939,860782
22640,tkzv,1,0.00012,175251,20.35951,860782
22641,tleveille,1,0.00012,175252,20.35963,860782
22642,t-lin,1,0.00012,175253,20.35974,860782
22643,tlkanthan2020,1,0.00012,175254,20.35986,860782
22644,t-lo,1,0.00012,175255,20.35997,860782
22645,tly1980,1,0.00012,175256,20.36009,860782
22646,tlynchpin,1,0.00012,175257,20.36021,860782
22647,tm1810,1,0.00012,175258,20.36032,860782
22648,tmarcu,1,0.00012,175259,20.36044,860782
22649,tmarrs-alb,1,0.00012,175260,20.36056,860782
22650,tmatsuda-aicom,1,0.00012,175261,20.36067,860782
22651,tmccombs,1,0.00012,175262,20.36079,860782
22652,tmcmm,1,0.00012,175263,20.36090,860782
22653,tmitchell10,1,0.00012,175264,20.36102,860782
22654,tmojlupo,1,0.00012,175265,20.36114,860782
22655,tmongkolsmai,1,0.00012,175266,20.36125,860782
22656,tmyroadctfig,1,0.00012,175267,20.36137,860782
22657,TN801465,1,0.00012,175268,20.36149,860782
22658,tnguyen14,1,0.00012,175269,20.36160,860782
22659,tnleeuw,1,0.00012,175270,20.36172,860782
22660,tnorimat,1,0.00012,175271,20.36183,860782
22661,Toady00,1,0.00012,175272,20.36195,860782
22662,Tobias4872,1,0.00012,175273,20.36207,860782
22663,tobiasgiese,1,0.00012,175274,20.36218,860782
22664,TobiasGrave,1,0.00012,175275,20.36230,860782
22665,tobias-jenkner,1,0.00012,175276,20.36241,860782
22666,tobiasstadler,1,0.00012,175277,20.36253,860782
22667,TobiMichael96,1,0.00012,175278,20.36265,860782
22668,tobisanya,1,0.00012,175279,20.36276,860782
22669,tobisinghania,1,0.00012,175280,20.36288,860782
22670,TobyEalden,1,0.00012,175281,20.36300,860782
22671,tobypeschel,1,0.00012,175282,20.36311,860782
22672,todaygood,1,0.00012,175283,20.36323,860782
22673,toddward,1,0.00012,175284,20.36334,860782
22674,toddwest,1,0.00012,175285,20.36346,860782
22675,tofran,1,0.00012,175286,20.36358,860782
22676,token97,1,0.00012,175287,20.36369,860782
22677,Tokugero,1,0.00012,175288,20.36381,860782
22678,toloco,1,0.00012,175289,20.36392,860782
22679,tolson-vkn,1,0.00012,175290,20.36404,860782
22680,tom-acceleratecompliance,1,0.00012,175291,20.36416,860782
22681,tomashejatko,1,0.00012,175292,20.36427,860782
22682,tomaskrizek,1,0.00012,175293,20.36439,860782
22683,tomasnorre,1,0.00012,175294,20.36451,860782
22684,tomassrnka,1,0.00012,175295,20.36462,860782
22685,tomaszjonak,1,0.00012,175296,20.36474,860782
22686,tomaszszlek,1,0.00012,175297,20.36485,860782
22687,tom-beatdapp,1,0.00012,175298,20.36497,860782
22688,Tom-Br,1,0.00012,175299,20.36509,860782
22689,tombroi,1,0.00012,175300,20.36520,860782
22690,tom-dierckx,1,0.00012,175301,20.36532,860782
22691,tomdoherty,1,0.00012,175302,20.36544,860782
22692,tomelliot16,1,0.00012,175303,20.36555,860782
22693,tomhaynes,1,0.00012,175304,20.36567,860782
22694,TomHellier,1,0.00012,175305,20.36578,860782
22695,tomikonio,1,0.00012,175306,20.36590,860782
22696,tomilchik,1,0.00012,175307,20.36602,860782
22697,tomjones2a,1,0.00012,175308,20.36613,860782
22698,tommyp1ckles,1,0.00012,175309,20.36625,860782
22699,tompaschenda,1,0.00012,175310,20.36636,860782
22700,tompatib,1,0.00012,175311,20.36648,860782
22701,TomUnequals,1,0.00012,175312,20.36660,860782
22702,toneill818,1,0.00012,175313,20.36671,860782
22703,tongifer,1,0.00012,175314,20.36683,860782
22704,tongtongxiaopeng1979,1,0.00012,175315,20.36695,860782
22705,tonybenchsci,1,0.00012,175316,20.36706,860782
22706,tonyferrell,1,0.00012,175317,20.36718,860782
22707,Tony-Hu,1,0.00012,175318,20.36729,860782
22708,tonyjchong,1,0.00012,175319,20.36741,860782
22709,TonyK-T,1,0.00012,175320,20.36753,860782
22710,tonym97,1,0.00012,175321,20.36764,860782
22711,tonyredondo,1,0.00012,175322,20.36776,860782
22712,tonyseek,1,0.00012,175323,20.36787,860782
22713,tonyskapunk,1,0.00012,175324,20.36799,860782
22714,ToonvanStrijp,1,0.00012,175325,20.36811,860782
22715,tooolbox,1,0.00012,175326,20.36822,860782
22716,topeawolwo,1,0.00012,175327,20.36834,860782
22717,TopeltR,1,0.00012,175328,20.36846,860782
22718,topillar,1,0.00012,175329,20.36857,860782
22719,topine,1,0.00012,175330,20.36869,860782
22720,TopSwagCode,1,0.00012,175331,20.36880,860782
22721,torenware,1,0.00012,175332,20.36892,860782
22722,toreshonda,1,0.00012,175333,20.36904,860782
22723,toricls,1,0.00012,175334,20.36915,860782
22724,toroc,1,0.00012,175335,20.36927,860782
22725,toshovski,1,0.00012,175336,20.36939,860782
22726,tosih,1,0.00012,175337,20.36950,860782
22727,TothstarDEV,1,0.00012,175338,20.36962,860782
22728,TOTOleHero,1,0.00012,175339,20.36973,860782
22729,toufunao,1,0.00012,175340,20.36985,860782
22730,ToxicWar,1,0.00012,175341,20.36997,860782
22731,tpaschalis,1,0.00012,175342,20.37008,860782
22732,tpengandrew,1,0.00012,175343,20.37020,860782
22733,tpo,1,0.00012,175344,20.37031,860782
22734,tpppppub,1,0.00012,175345,20.37043,860782
22735,tprasadtp,1,0.00012,175346,20.37055,860782
22736,tpridge,1,0.00012,175347,20.37066,860782
22737,tpyo,1,0.00012,175348,20.37078,860782
22738,traceypooh,1,0.00012,175349,20.37090,860782
22739,tragiclifestories,1,0.00012,175350,20.37101,860782
22740,TranDinhKhang,1,0.00012,175351,20.37113,860782
22741,transient1,1,0.00012,175352,20.37124,860782
22742,travisf,1,0.00012,175353,20.37136,860782
22743,travisli1991,1,0.00012,175354,20.37148,860782
22744,travismgibson,1,0.00012,175355,20.37159,860782
22745,travnewmatic,1,0.00012,175356,20.37171,860782
22746,treaves,1,0.00012,175357,20.37182,860782
22747,treksler,1,0.00012,175358,20.37194,860782
22748,trevrosen,1,0.00012,175359,20.37206,860782
22749,trialley,1,0.00012,175360,20.37217,860782
22750,trickert76,1,0.00012,175361,20.37229,860782
22751,trilitheus,1,0.00012,175362,20.37241,860782
22752,Trimack,1,0.00012,175363,20.37252,860782
22753,trinhpham,1,0.00012,175364,20.37264,860782
22754,trink-ilan,1,0.00012,175365,20.37275,860782
22755,triplewy,1,0.00012,175366,20.37287,860782
22756,TRIPTI2110,1,0.00012,175367,20.37299,860782
22757,Tristan971,1,0.00012,175368,20.37310,860782
22758,trivigy,1,0.00012,175369,20.37322,860782
22759,trkohler,1,0.00012,175370,20.37333,860782
22760,troeger,1,0.00012,175371,20.37345,860782
22761,troyfontaine,1,0.00012,175372,20.37357,860782
22762,Troyhy,1,0.00012,175373,20.37368,860782
22763,truenoldor,1,0.00012,175374,20.37380,860782
22764,truman303,1,0.00012,175375,20.37392,860782
22765,trumhemcut,1,0.00012,175376,20.37403,860782
22766,trumpeteer,1,0.00012,175377,20.37415,860782
22767,truongnt85,1,0.00012,175378,20.37426,860782
22768,Trupal00p,1,0.00012,175379,20.37438,860782
22769,ts7101990,1,0.00012,175380,20.37450,860782
22770,tsadoklf,1,0.00012,175381,20.37461,860782
22771,tsalm-pivotal,1,0.00012,175382,20.37473,860782
22772,tsanterre-paypay,1,0.00012,175383,20.37485,860782
22773,tsekine354,1,0.00012,175384,20.37496,860782
22774,tsk9,1,0.00012,175385,20.37508,860782
22775,tsologub,1,0.00012,175386,20.37519,860782
22776,tspreeth,1,0.00012,175387,20.37531,860782
22777,tsterker,1,0.00012,175388,20.37543,860782
22778,tstjep,1,0.00012,175389,20.37554,860782
22779,tstrohmeier,1,0.00012,175390,20.37566,860782
22780,tstuber,1,0.00012,175391,20.37577,860782
22781,tsu1980,1,0.00012,175392,20.37589,860782
22782,Tsumida,1,0.00012,175393,20.37601,860782
22783,TszKitLo40,1,0.00012,175394,20.37612,860782
22784,TT6033,1,0.00012,175395,20.37624,860782
22785,ttinkr,1,0.00012,175396,20.37636,860782
22786,ttwd80,1,0.00012,175397,20.37647,860782
22787,ttww,1,0.00012,175398,20.37659,860782
22788,TudorHulban,1,0.00012,175399,20.37670,860782
22789,tulanian,1,0.00012,175400,20.37682,860782
22790,tuminoid,1,0.00012,175401,20.37694,860782
22791,Tumite,1,0.00012,175402,20.37705,860782
22792,tun0,1,0.00012,175403,20.37717,860782
22793,tung7970,1,0.00012,175404,20.37728,860782
22794,turnham,1,0.00012,175405,20.37740,860782
22795,turovnd,1,0.00012,175406,20.37752,860782
22796,turowicz,1,0.00012,175407,20.37763,860782
22797,tusharsonawanes,1,0.00012,175408,20.37775,860782
22798,tuskiomi,1,0.00012,175409,20.37787,860782
22799,tutengdihuang,1,0.00012,175410,20.37798,860782
22800,tutosfaciles48,1,0.00012,175411,20.37810,860782
22801,tuttieee,1,0.00012,175412,20.37821,860782
22802,TuvaevAndrey,1,0.00012,175413,20.37833,860782
22803,tverboon,1,0.00012,175414,20.37845,860782
22804,tvkit,1,0.00012,175415,20.37856,860782
22805,tvkrishnaAWS,1,0.00012,175416,20.37868,860782
22806,tvm1,1,0.00012,175417,20.37880,860782
22807,tvvsatish,1,0.00012,175418,20.37891,860782
22808,twendt,1,0.00012,175419,20.37903,860782
22809,two,1,0.00012,175420,20.37914,860782
22810,twodayslate,1,0.00012,175421,20.37926,860782
22811,tx19980520,1,0.00012,175422,20.37938,860782
22812,tyarimi,1,0.00012,175423,20.37949,860782
22813,tylandercasper,1,0.00012,175424,20.37961,860782
22814,tyler-8,1,0.00012,175425,20.37972,860782
22815,Tyler-Churchill,1,0.00012,175426,20.37984,860782
22816,tylerhartwig,1,0.00012,175427,20.37996,860782
22817,tymfr,1,0.00012,175428,20.38007,860782
22818,tymokvo,1,0.00012,175429,20.38019,860782
22819,Typhogenic,1,0.00012,175430,20.38031,860782
22820,typicalapi,1,0.00012,175431,20.38042,860782
22821,tyrasd,1,0.00012,175432,20.38054,860782
22822,tysegall,1,0.00012,175433,20.38065,860782
22823,tysen514,1,0.00012,175434,20.38077,860782
22824,tywtyw,1,0.00012,175435,20.38089,860782
22825,tzachshabtay,1,0.00012,175436,20.38100,860782
22826,tzago,1,0.00012,175437,20.38112,860782
22827,tzinm,1,0.00012,175438,20.38123,860782
22828,Tzrlk,1,0.00012,175439,20.38135,860782
22829,uberbrodt,1,0.00012,175440,20.38147,860782
22830,ubergeek77,1,0.00012,175441,20.38158,860782
22831,uberjay,1,0.00012,175442,20.38170,860782
22832,uberkelium,1,0.00012,175443,20.38182,860782
22833,ucef29,1,0.00012,175444,20.38193,860782
22834,UdayabhanuPani,1,0.00012,175445,20.38205,860782
22835,udayjalagam,1,0.00012,175446,20.38216,860782
22836,uddmorningsun,1,0.00012,175447,20.38228,860782
22837,uGiFarukh,1,0.00012,175448,20.38240,860782
22838,ugljesas,1,0.00012,175449,20.38251,860782
22839,uhari03,1,0.00012,175450,20.38263,860782
22840,uhinze,1,0.00012,175451,20.38274,860782
22841,ukch,1,0.00012,175452,20.38286,860782
22842,ukimpact,1,0.00012,175453,20.38298,860782
22843,ukphillips,1,0.00012,175454,20.38309,860782
22844,uliul-carpatin,1,0.00012,175455,20.38321,860782
22845,UlrichKnaack,1,0.00012,175456,20.38333,860782
22846,ulugbekov,1,0.00012,175457,20.38344,860782
22847,ulundevall,1,0.00012,175458,20.38356,860782
22848,umang5195,1,0.00012,175459,20.38367,860782
22849,Umar-Basharat103,1,0.00012,175460,20.38379,860782
22850,un000,1,0.00012,175461,20.38391,860782
22851,unconfigured,1,0.00012,175462,20.38402,860782
22852,underscorgan,1,0.00012,175463,20.38414,860782
22853,Unforgiven00000yasuo,1,0.00012,175464,20.38426,860782
22854,unitof,1,0.00012,175465,20.38437,860782
22855,universam1,1,0.00012,175466,20.38449,860782
22856,unleashed,1,0.00012,175467,20.38460,860782
22857,UNOPARATOR,1,0.00012,175468,20.38472,860782
22858,unstableunicorn,1,0.00012,175469,20.38484,860782
22859,unullmass,1,0.00012,175470,20.38495,860782
22860,upendran,1,0.00012,175471,20.38507,860782
22861,upeskartik,1,0.00012,175472,20.38518,860782
22862,uptycs-rmack,1,0.00012,175473,20.38530,860782
22863,uqee,1,0.00012,175474,20.38542,860782
22864,u-quark,1,0.00012,175475,20.38553,860782
22865,urandu,1,0.00012,175476,20.38565,860782
22866,urbandroid,1,0.00012,175477,20.38577,860782
22867,urusha,1,0.00012,175478,20.38588,860782
22868,usax,1,0.00012,175479,20.38600,860782
22869,uscorchr,1,0.00012,175480,20.38611,860782
22870,usefree,1,0.00012,175481,20.38623,860782
22871,usernameisnull0,1,0.00012,175482,20.38635,860782
22872,usernameisnull2,1,0.00012,175483,20.38646,860782
22873,usero4eg,1,0.00012,175484,20.38658,860782
22874,usmcgwg,1,0.00012,175485,20.38669,860782
22875,ustiugov,1,0.00012,175486,20.38681,860782
22876,utkarshyadavin,1,0.00012,175487,20.38693,860782
22877,utkinpol,1,0.00012,175488,20.38704,860782
22878,utkuturunc,1,0.00012,175489,20.38716,860782
22879,utsavakru,1,0.00012,175490,20.38728,860782
22880,uvsmtid,1,0.00012,175491,20.38739,860782
22881,uvyuhin,1,0.00012,175492,20.38751,860782
22882,uweenukr,1,0.00012,175493,20.38762,860782
22883,uysalnet,1,0.00012,175494,20.38774,860782
22884,v0112358,1,0.00012,175495,20.38786,860782
22885,v0ldemort,1,0.00012,175496,20.38797,860782
22886,v3n,1,0.00012,175497,20.38809,860782
22887,v4mpir0ck,1,0.00012,175498,20.38821,860782
22888,v703612,1,0.00012,175499,20.38832,860782
22889,va1erian,1,0.00012,175500,20.38844,860782
22890,vaddisrinivas,1,0.00012,175501,20.38855,860782
22891,vadim-shadrin,1,0.00012,175502,20.38867,860782
22892,vadivem786,1,0.00012,175503,20.38879,860782
22893,vadlit,1,0.00012,175504,20.38890,860782
22894,vadomlore,1,0.00012,175505,20.38902,860782
22895,Vafilor,1,0.00012,175506,20.38913,860782
22896,vaghesh,1,0.00012,175507,20.38925,860782
22897,VAHID1449,1,0.00012,175508,20.38937,860782
22898,vaibhavjpr,1,0.00012,175509,20.38948,860782
22899,vainu-lauri,1,0.00012,175510,20.38960,860782
22900,valayDave,1,0.00012,175511,20.38972,860782
22901,valentinlehmann,1,0.00012,175512,20.38983,860782
22902,valentyntu,1,0.00012,175513,20.38995,860782
22903,valkolaci,1,0.00012,175514,20.39006,860782
22904,ValleyZw,1,0.00012,175515,20.39018,860782
22905,valll94,1,0.00012,175516,20.39030,860782
22906,Vallsten,1,0.00012,175517,20.39041,860782
22907,valorl,1,0.00012,175518,20.39053,860782
22908,vamage,1,0.00012,175519,20.39064,860782
22909,VampireDX,1,0.00012,175520,20.39076,860782
22910,VamshiKrishnaNemalikonda,1,0.00012,175521,20.39088,860782
22911,vamshisiddarth,1,0.00012,175522,20.39099,860782
22912,vamsijakkula,1,0.00012,175523,20.39111,860782
22913,vanbalken,1,0.00012,175524,20.39123,860782
22914,vandiedakaf,1,0.00012,175525,20.39134,860782
22915,vaneyckt,1,0.00012,175526,20.39146,860782
22916,vaniha,1,0.00012,175527,20.39157,860782
22917,VanitySoft,1,0.00012,175528,20.39169,860782
22918,vanpeltj,1,0.00012,175529,20.39181,860782
22919,vany0114,1,0.00012,175530,20.39192,860782
22920,vanzin,1,0.00012,175531,20.39204,860782
22921,VaraKatare,1,0.00012,175532,20.39216,860782
22922,vardani,1,0.00012,175533,20.39227,860782
22923,VarroReve,1,0.00012,175534,20.39239,860782
22924,varunbpatil,1,0.00012,175535,20.39250,860782
22925,varun-da,1,0.00012,175536,20.39262,860782
22926,varunrayen,1,0.00012,175537,20.39274,860782
22927,vasilvestre,1,0.00012,175538,20.39285,860782
22928,VassilisVassiliadis,1,0.00012,175539,20.39297,860782
22929,vasu-git,1,0.00012,175540,20.39308,860782
22930,VasylSamoilov,1,0.00012,175541,20.39320,860782
22931,vavenk-ms,1,0.00012,175542,20.39332,860782
22932,vaxinate,1,0.00012,175543,20.39343,860782
22933,vazir,1,0.00012,175544,20.39355,860782
22934,vbatuev,1,0.00012,175545,20.39367,860782
22935,V-Bhadauriya,1,0.00012,175546,20.39378,860782
22936,vbousson,1,0.00012,175547,20.39390,860782
22937,vbvkel,1,0.00012,175548,20.39401,860782
22938,vcsomor,1,0.00012,175549,20.39413,860782
22939,Vedrillan,1,0.00012,175550,20.39425,860782
22940,veenagurram,1,0.00012,175551,20.39436,860782
22941,veer123prathap,1,0.00012,175552,20.39448,860782
22942,veera83372,1,0.00012,175553,20.39459,860782
22943,veerapatyok,1,0.00012,175554,20.39471,860782
22944,veerun14,1,0.00012,175555,20.39483,860782
22945,veeveksen,1,0.00012,175556,20.39494,860782
22946,vekergu,1,0.00012,175557,20.39506,860782
22947,Velfo,1,0.00012,175558,20.39518,860782
22948,velmuruganvelayutham,1,0.00012,175559,20.39529,860782
22949,vemod,1,0.00012,175560,20.39541,860782
22950,vengam,1,0.00012,175561,20.39552,860782
22951,venkata-ai,1,0.00012,175562,20.39564,860782
22952,venkata-satish,1,0.00012,175563,20.39576,860782
22953,venkatesh551,1,0.00012,175564,20.39587,860782
22954,venkatesh588,1,0.00012,175565,20.39599,860782
22955,venkatesh-phenompeople,1,0.00012,175566,20.39610,860782
22956,Venkatsai,1,0.00012,175567,20.39622,860782
22957,ventris,1,0.00012,175568,20.39634,860782
22958,venukasu,1,0.00012,175569,20.39645,860782
22959,verganas,1,0.00012,175570,20.39657,860782
22960,Verlet64,1,0.00012,175571,20.39669,860782
22961,Vermillionaire,1,0.00012,175572,20.39680,860782
22962,verstrae,1,0.00012,175573,20.39692,860782
22963,VeselaHouba,1,0.00012,175574,20.39703,860782
22964,Vesnica,1,0.00012,175575,20.39715,860782
22965,veton,1,0.00012,175576,20.39727,860782
22966,vezir,1,0.00012,175577,20.39738,860782
22967,vfarafontov,1,0.00012,175578,20.39750,860782
22968,vggarg96,1,0.00012,175579,20.39762,860782
22969,vgribok,1,0.00012,175580,20.39773,860782
22970,vgudavar,1,0.00012,175581,20.39785,860782
22971,vhatsura,1,0.00012,175582,20.39796,860782
22972,vibhat89,1,0.00012,175583,20.39808,860782
22973,viceice,1,0.00012,175584,20.39820,860782
22974,vickyvikas7988,1,0.00012,175585,20.39831,860782
22975,vicpara,1,0.00012,175586,20.39843,860782
22976,victorcasado,1,0.00012,175587,20.39854,860782
22977,victorcopque,1,0.00012,175588,20.39866,860782
22978,VictorLee0321,1,0.00012,175589,20.39878,860782
22979,victorlevasseur,1,0.00012,175590,20.39889,860782
22980,victorNewRelic,1,0.00012,175591,20.39901,860782
22981,victorpcamargo,1,0.00012,175592,20.39913,860782
22982,victorrikhotso,1,0.00012,175593,20.39924,860782
22983,victorrodriguez1984,1,0.00012,175594,20.39936,860782
22984,victorthevong,1,0.00012,175595,20.39947,860782
22985,victory-jooyon,1,0.00012,175596,20.39959,860782
22986,vide,1,0.00012,175597,20.39971,860782
22987,videni,1,0.00012,175598,20.39982,860782
22988,vidister,1,0.00012,175599,20.39994,860782
22989,viggin543,1,0.00012,175600,20.40005,860782
22990,VigneshSP94,1,0.00012,175601,20.40017,860782
22991,vignesh-subburaj,1,0.00012,175602,20.40029,860782
22992,vigneshsweekaran,1,0.00012,175603,20.40040,860782
22993,vi-gupta17,1,0.00012,175604,20.40052,860782
22994,vijay-jindal,1,0.00012,175605,20.40064,860782
22995,vijaynetha,1,0.00012,175606,20.40075,860782
22996,vijaysoul,1,0.00012,175607,20.40087,860782
22997,vijay-veeranki-moj,1,0.00012,175608,20.40098,860782
22998,Vikash082,1,0.00012,175609,20.40110,860782
22999,vikaskaradia,1,0.00012,175610,20.40122,860782
23000,vikatskhay,1,0.00012,175611,20.40133,860782
23001,vikram-bitnami,1,0.00012,175612,20.40145,860782
23002,vikram-raj,1,0.00012,175613,20.40157,860782
23003,vikramraman,1,0.00012,175614,20.40168,860782
23004,viktor-nikolaev,1,0.00012,175615,20.40180,860782
23005,vimalcloud,1,0.00012,175616,20.40191,860782
23006,vimekala,1,0.00012,175617,20.40203,860782
23007,vinayGudi,1,0.00012,175618,20.40215,860782
23008,vinayus,1,0.00012,175619,20.40226,860782
23009,vincent-zurczak,1,0.00012,175620,20.40238,860782
23010,Vincoll,1,0.00012,175621,20.40249,860782
23011,Vineet-Sharma29,1,0.00012,175622,20.40261,860782
23012,vinglogn,1,0.00012,175623,20.40273,860782
23013,Vinigas,1,0.00012,175624,20.40284,860782
23014,vinkdong,1,0.00012,175625,20.40296,860782
23015,vinnizworld,1,0.00012,175626,20.40308,860782
23016,vinnyfs89,1,0.00012,175627,20.40319,860782
23017,vinod827,1,0.00012,175628,20.40331,860782
23018,vinodkamisetti,1,0.00012,175629,20.40342,860782
23019,vinodkmrm,1,0.00012,175630,20.40354,860782
23020,vinsce,1,0.00012,175631,20.40366,860782
23021,vintury,1,0.00012,175632,20.40377,860782
23022,vioan,1,0.00012,175633,20.40389,860782
23023,vio-lin,1,0.00012,175634,20.40400,860782
23024,viovanov,1,0.00012,175635,20.40412,860782
23025,vipingupta5352,1,0.00012,175636,20.40424,860782
23026,VirannaGadgoli,1,0.00012,175637,20.40435,860782
23027,virtrixke,1,0.00012,175638,20.40447,860782
23028,viruslobster,1,0.00012,175639,20.40459,860782
23029,visenger,1,0.00012,175640,20.40470,860782
23030,viseth,1,0.00012,175641,20.40482,860782
23031,vishal1991gupta,1,0.00012,175642,20.40493,860782
23032,Vishal700-cmd,1,0.00012,175643,20.40505,860782
23033,vishalbiradar,1,0.00012,175644,20.40517,860782
23034,vishalcs05,1,0.00012,175645,20.40528,860782
23035,vishalud,1,0.00012,175646,20.40540,860782
23036,vishmalviya,1,0.00012,175647,20.40551,860782
23037,vishnoianil,1,0.00012,175648,20.40563,860782
23038,vishnu-anil,1,0.00012,175649,20.40575,860782
23039,vishnukprakash,1,0.00012,175650,20.40586,860782
23040,Vishnuvardhan777,1,0.00012,175651,20.40598,860782
23041,vishwakhrushi,1,0.00012,175652,20.40610,860782
23042,vishwaskumar58,1,0.00012,175653,20.40621,860782
23043,Viswa88,1,0.00012,175654,20.40633,860782
23044,vitabaks,1,0.00012,175655,20.40644,860782
23045,vital-dhaveloose,1,0.00012,175656,20.40656,860782
23046,vitaliitylyk,1,0.00012,175657,20.40668,860782
23047,vitaliy-leschenko,1,0.00012,175658,20.40679,860782
23048,Vitaliyusf,1,0.00012,175659,20.40691,860782
23049,vitaliy-zinchenko,1,0.00012,175660,20.40703,860782
23050,vitali-zevako,1,0.00012,175661,20.40714,860782
23051,vitalyu,1,0.00012,175662,20.40726,860782
23052,vitiokss,1,0.00012,175663,20.40737,860782
23053,vitoantonio,1,0.00012,175664,20.40749,860782
23054,vitomanu96,1,0.00012,175665,20.40761,860782
23055,Vitorspk,1,0.00012,175666,20.40772,860782
23056,viv86,1,0.00012,175667,20.40784,860782
23057,vivekaglawe,1,0.00012,175668,20.40795,860782
23058,vivekananda49,1,0.00012,175669,20.40807,860782
23059,vivekgrover1,1,0.00012,175670,20.40819,860782
23060,vivekgupta8983,1,0.00012,175671,20.40830,860782
23061,vivekgurikar,1,0.00012,175672,20.40842,860782
23062,vivekpd15,1,0.00012,175673,20.40854,860782
23063,vivekverma066,1,0.00012,175674,20.40865,860782
23064,vixns,1,0.00012,175675,20.40877,860782
23065,viyer28,1,0.00012,175676,20.40888,860782
23066,vizhur,1,0.00012,175677,20.40900,860782
23067,vkamlesh,1,0.00012,175678,20.40912,860782
23068,v-kay,1,0.00012,175679,20.40923,860782
23069,vkazandzic92,1,0.00012,175680,20.40935,860782
23070,vk-cmd,1,0.00012,175681,20.40946,860782
23071,vkim-rogers,1,0.00012,175682,20.40958,860782
23072,vklohiya,1,0.00012,175683,20.40970,860782
23073,vkmc,1,0.00012,175684,20.40981,860782
23074,vkotheka,1,0.00012,175685,20.40993,860782
23075,vkropotko,1,0.00012,175686,20.41005,860782
23076,vkruoso,1,0.00012,175687,20.41016,860782
23077,vkudrik,1,0.00012,175688,20.41028,860782
23078,vlad2010,1,0.00012,175689,20.41039,860782
23079,vladdy,1,0.00012,175690,20.41051,860782
23080,vladg9,1,0.00012,175691,20.41063,860782
23081,vladh91,1,0.00012,175692,20.41074,860782
23082,VladimirAkopyan,1,0.00012,175693,20.41086,860782
23083,vlado-github,1,0.00012,175694,20.41098,860782
23084,vlandemaine-orange,1,0.00012,175695,20.41109,860782
23085,vlinden-cs,1,0.00012,175696,20.41121,860782
23086,vmagamedov,1,0.00012,175697,20.41132,860782
23087,vmanyushin,1,0.00012,175698,20.41144,860782
23088,vmarinkov,1,0.00012,175699,20.41156,860782
23089,vmayrink1,1,0.00012,175700,20.41167,860782
23090,v-mihaylov,1,0.00012,175701,20.41179,860782
23091,vmwiz,1,0.00012,175702,20.41190,860782
23092,vnextcoder,1,0.00012,175703,20.41202,860782
23093,vnvo2409,1,0.00012,175704,20.41214,860782
23094,vnzongzna,1,0.00012,175705,20.41225,860782
23095,vodwood,1,0.00012,175706,20.41237,860782
23096,voidhofer,1,0.00012,175707,20.41249,860782
23097,voki,1,0.00012,175708,20.41260,860782
23098,volk1234,1,0.00012,175709,20.41272,860782
23099,Volkimd,1,0.00012,175710,20.41283,860782
23100,volnei,1,0.00012,175711,20.41295,860782
23101,volodyad,1,0.00012,175712,20.41307,860782
23102,vologue,1,0.00012,175713,20.41318,860782
23103,volschin,1,0.00012,175714,20.41330,860782
23104,volym3ad,1,0.00012,175715,20.41341,860782
23105,vonguard,1,0.00012,175716,20.41353,860782
23106,voodoodror,1,0.00012,175717,20.41365,860782
23107,voodoonofx,1,0.00012,175718,20.41376,860782
23108,vooon,1,0.00012,175719,20.41388,860782
23109,vorpalhex,1,0.00012,175720,20.41400,860782
23110,vorsel,1,0.00012,175721,20.41411,860782
23111,voxmaster,1,0.00012,175722,20.41423,860782
23112,vpuria,1,0.00012,175723,20.41434,860782
23113,VRay27,1,0.00012,175724,20.41446,860782
23114,vrichmond499,1,0.00012,175725,20.41458,860782
23115,vs268153,1,0.00012,175726,20.41469,860782
23116,vseosilit,1,0.00012,175727,20.41481,860782
23117,vsile,1,0.00012,175728,20.41493,860782
23118,vsilverman,1,0.00012,175729,20.41504,860782
23119,vsomasvr,1,0.00012,175730,20.41516,860782
23120,v-srinivasan-sfdc,1,0.00012,175731,20.41527,860782
23121,Vstural,1,0.00012,175732,20.41539,860782
23122,vteran93,1,0.00012,175733,20.41551,860782
23123,vtrippel,1,0.00012,175734,20.41562,860782
23124,vukomir,1,0.00012,175735,20.41574,860782
23125,vutbao,1,0.00012,175736,20.41585,860782
23126,vuxuanlai,1,0.00012,175737,20.41597,860782
23127,vvanholl,1,0.00012,175738,20.41609,860782
23128,vvchik,1,0.00012,175739,20.41620,860782
23129,vverst,1,0.00012,175740,20.41632,860782
23130,vvksahoo,1,0.00012,175741,20.41644,860782
23131,vvsiva007,1,0.00012,175742,20.41655,860782
23132,vvydier,1,0.00012,175743,20.41667,860782
23133,vxavictor513,1,0.00012,175744,20.41678,860782
23134,vxe,1,0.00012,175745,20.41690,860782
23135,vyarosh,1,0.00012,175746,20.41702,860782
23136,vykulakov,1,0.00012,175747,20.41713,860782
23137,vymarkov,1,0.00012,175748,20.41725,860782
23138,v-yzakapko,1,0.00012,175749,20.41736,860782
23139,vzburke,1,0.00012,175750,20.41748,860782
23140,vzemtsov,1,0.00012,175751,20.41760,860782
23141,v-zhuravlev,1,0.00012,175752,20.41771,860782
23142,w00519772,1,0.00012,175753,20.41783,860782
23143,w0x12ef,1,0.00012,175754,20.41795,860782
23144,w1593950,1,0.00012,175755,20.41806,860782
23145,w4,1,0.00012,175756,20.41818,860782
23146,w4-hyunseok,1,0.00012,175757,20.41829,860782
23147,w4rgrum,1,0.00012,175758,20.41841,860782
23148,wa1one,1,0.00012,175759,20.41853,860782
23149,wahyd4,1,0.00012,175760,20.41864,860782
23150,waigani,1,0.00012,175761,20.41876,860782
23151,waldemarmeier,1,0.00012,175762,20.41887,860782
23152,walec51,1,0.00012,175763,20.41899,860782
23153,walkerdu,1,0.00012,175764,20.41911,860782
23154,walker-tom,1,0.00012,175765,20.41922,860782
23155,walkley,1,0.00012,175766,20.41934,860782
23156,walterhiggins,1,0.00012,175767,20.41946,860782
23157,walterkozlowski,1,0.00012,175768,20.41957,860782
23158,walthhy,1,0.00012,175769,20.41969,860782
23159,waluo,1,0.00012,175770,20.41980,860782
23160,Wander1024,1,0.00012,175771,20.41992,860782
23161,wangaoran,1,0.00012,175772,20.42004,860782
23162,wangbaocongnb,1,0.00012,175773,20.42015,860782
23163,wangbus,1,0.00012,175774,20.42027,860782
23164,Wang-Cankun,1,0.00012,175775,20.42039,860782
23165,wangchuande,1,0.00012,175776,20.42050,860782
23166,WangEP,1,0.00012,175777,20.42062,860782
23167,wanghaifeng,1,0.00012,175778,20.42073,860782
23168,wanghonglei5181,1,0.00012,175779,20.42085,860782
23169,wangjia184,1,0.00012,175780,20.42097,860782
23170,wangjiezhang,1,0.00012,175781,20.42108,860782
23171,wangjinh,1,0.00012,175782,20.42120,860782
23172,Wang-Kai,1,0.00012,175783,20.42131,860782
23173,WANGKE-InCodeWeTrust,1,0.00012,175784,20.42143,860782
23174,wangkundo10,1,0.00012,175785,20.42155,860782
23175,wanglzh,1,0.00012,175786,20.42166,860782
23176,wangrong2012,1,0.00012,175787,20.42178,860782
23177,wangting1995,1,0.00012,175788,20.42190,860782
23178,wangyf2010,1,0.00012,175789,20.42201,860782
23179,wangyp0701,1,0.00012,175790,20.42213,860782
23180,wangyu8460958,1,0.00012,175791,20.42224,860782
23181,wangyun1517,1,0.00012,175792,20.42236,860782
23182,wangyx1992,1,0.00012,175793,20.42248,860782
23183,wangzh1993,1,0.00012,175794,20.42259,860782
23184,wanhl1990,1,0.00012,175795,20.42271,860782
23185,wanjiecs,1,0.00012,175796,20.42282,860782
23186,wann-ap,1,0.00012,175797,20.42294,860782
23187,wanwenli,1,0.00012,175798,20.42306,860782
23188,waqas-cs,1,0.00012,175799,20.42317,860782
23189,wArren-Huang,1,0.00012,175800,20.42329,860782
23190,waseemkhosa,1,0.00012,175801,20.42341,860782
23191,washin0,1,0.00012,175802,20.42352,860782
23192,wasiqanwar,1,0.00012,175803,20.42364,860782
23193,waterdrops,1,0.00012,175804,20.42375,860782
23194,WaterKnight1998,1,0.00012,175805,20.42387,860782
23195,watery,1,0.00012,175806,20.42399,860782
23196,watsuwo,1,0.00012,175807,20.42410,860782
23197,wavemoran,1,0.00012,175808,20.42422,860782
23198,wawashra,1,0.00012,175809,20.42434,860782
23199,wayne-beep,1,0.00012,175810,20.42445,860782
23200,waynetjes,1,0.00012,175811,20.42457,860782
23201,wczyz,1,0.00012,175812,20.42468,860782
23202,wd,1,0.00012,175813,20.42480,860782
23203,weaktyper,1,0.00012,175814,20.42492,860782
23204,Web5G,1,0.00012,175815,20.42503,860782
23205,webbdog28,1,0.00012,175816,20.42515,860782
23206,webberwang,1,0.00012,175817,20.42526,860782
23207,webchi,1,0.00012,175818,20.42538,860782
23208,webmat,1,0.00012,175819,20.42550,860782
23209,webnull,1,0.00012,175820,20.42561,860782
23210,websecureNL,1,0.00012,175821,20.42573,860782
23211,wedgie32,1,0.00012,175822,20.42585,860782
23212,wednesdaygogo,1,0.00012,175823,20.42596,860782
23213,weenxin,1,0.00012,175824,20.42608,860782
23214,weichuliu,1,0.00012,175825,20.42619,860782
23215,weimdall,1,0.00012,175826,20.42631,860782
23216,weiqiang333,1,0.00012,175827,20.42643,860782
23217,weiqiangt,1,0.00012,175828,20.42654,860782
23218,WeiShiuChang,1,0.00012,175829,20.42666,860782
23219,Weizhuo-Zhang,1,0.00012,175830,20.42677,860782
23220,welovegopher,1,0.00012,175831,20.42689,860782
23221,wemgl,1,0.00012,175832,20.42701,860782
23222,wenbor33,1,0.00012,175833,20.42712,860782
23223,wenhui-prudencemed,1,0.00012,175834,20.42724,860782
23224,wenn32,1,0.00012,175835,20.42736,860782
23225,werne2j,1,0.00012,175836,20.42747,860782
23226,weshouman,1,0.00012,175837,20.42759,860782
23227,wesley9620,1,0.00012,175838,20.42770,860782
23228,wesleyjconnorsesame,1,0.00012,175839,20.42782,860782
23229,wesleyw72,1,0.00012,175840,20.42794,860782
23230,wgabsi88,1,0.00012,175841,20.42805,860782
23231,wgorczyca,1,0.00012,175842,20.42817,860782
23232,whalesalad,1,0.00012,175843,20.42828,860782
23233,whatnick,1,0.00012,175844,20.42840,860782
23234,whatwhat280,1,0.00012,175845,20.42852,860782
23235,whg517,1,0.00012,175846,20.42863,860782
23236,whihathac,1,0.00012,175847,20.42875,860782
23237,whilp,1,0.00012,175848,20.42887,860782
23238,white-hat,1,0.00012,175849,20.42898,860782
23239,whizard,1,0.00012,175850,20.42910,860782
23240,whoo,1,0.00012,175851,20.42921,860782
23241,whume,1,0.00012,175852,20.42933,860782
23242,wicksim,1,0.00012,175853,20.42945,860782
23243,wi-cuckoo,1,0.00012,175854,20.42956,860782
23244,wid,1,0.00012,175855,20.42968,860782
23245,widdix123,1,0.00012,175856,20.42980,860782
23246,wieslaw-decent,1,0.00012,175857,20.42991,860782
23247,willemm,1,0.00012,175858,20.43003,860782
23248,willemswang,1,0.00012,175859,20.43014,860782
23249,williambrode,1,0.00012,175860,20.43026,860782
23250,williamleferrand,1,0.00012,175861,20.43038,860782
23251,williamoliveira,1,0.00012,175862,20.43049,860782
23252,williamzhao1979,1,0.00012,175863,20.43061,860782
23253,williansvi,1,0.00012,175864,20.43072,860782
23254,willie,1,0.00012,175865,20.43084,860782
23255,WillLennon,1,0.00012,175866,20.43096,860782
23256,willsalz,1,0.00012,175867,20.43107,860782
23257,will-sargent-eero,1,0.00012,175868,20.43119,860782
23258,willysamz,1,0.00012,175869,20.43131,860782
23259,wilsonge,1,0.00012,175870,20.43142,860782
23260,wilsonhipolito,1,0.00012,175871,20.43154,860782
23261,wilsonianb,1,0.00012,175872,20.43165,860782
23262,wimi,1,0.00012,175873,20.43177,860782
23263,wimnat,1,0.00012,175874,20.43189,860782
23264,wimsikal,1,0.00012,175875,20.43200,860782
23265,win32nipuh,1,0.00012,175876,20.43212,860782
23266,winaterion,1,0.00012,175877,20.43223,860782
23267,wincus,1,0.00012,175878,20.43235,860782
23268,wind57,1,0.00012,175879,20.43247,860782
23269,windmark,1,0.00012,175880,20.43258,860782
23270,windNight,1,0.00012,175881,20.43270,860782
23271,windrammer,1,0.00012,175882,20.43282,860782
23272,Windrill,1,0.00012,175883,20.43293,860782
23273,windskyer,1,0.00012,175884,20.43305,860782
23274,wing328,1,0.00012,175885,20.43316,860782
23275,winhtaikaung,1,0.00012,175886,20.43328,860782
23276,winhung,1,0.00012,175887,20.43340,860782
23277,winster,1,0.00012,175888,20.43351,860782
23278,wiorka,1,0.00012,175889,20.43363,860782
23279,wirwolf,1,0.00012,175890,20.43375,860782
23280,wisekaa03,1,0.00012,175891,20.43386,860782
23281,wisni,1,0.00012,175892,20.43398,860782
23282,wizbit,1,0.00012,175893,20.43409,860782
23283,Wizofgoz,1,0.00012,175894,20.43421,860782
23284,wkclz,1,0.00012,175895,20.43433,860782
23285,wkjun,1,0.00012,175896,20.43444,860782
23286,Wkkkkk,1,0.00012,175897,20.43456,860782
23287,wlfghdr,1,0.00012,175898,20.43467,860782
23288,wll8,1,0.00012,175899,20.43479,860782
23289,wlritchi,1,0.00012,175900,20.43491,860782
23290,wmriachi,1,0.00012,175901,20.43502,860782
23291,wmullen0,1,0.00012,175902,20.43514,860782
23292,Wobbley,1,0.00012,175903,20.43526,860782
23293,wochanda,1,0.00012,175904,20.43537,860782
23294,wochinge,1,0.00012,175905,20.43549,860782
23295,woelflone,1,0.00012,175906,20.43560,860782
23296,wohlfrom,1,0.00012,175907,20.43572,860782
23297,WojoInc,1,0.00012,175908,20.43584,860782
23298,wojtek-viirtue,1,0.00012,175909,20.43595,860782
23299,wolf27w,1,0.00012,175910,20.43607,860782
23300,wolfm89,1,0.00012,175911,20.43618,860782
23301,wolszakp,1,0.00012,175912,20.43630,860782
23302,wondersd,1,0.00012,175913,20.43642,860782
23303,wonsjb,1,0.00012,175914,20.43653,860782
23304,woodsmur,1,0.00012,175915,20.43665,860782
23305,WoopsDoops,1,0.00012,175916,20.43677,860782
23306,woowanamu,1,0.00012,175917,20.43688,860782
23307,woraser,1,0.00012,175918,20.43700,860782
23308,worawatwijarn,1,0.00012,175919,20.43711,860782
23309,workhorse2020,1,0.00012,175920,20.43723,860782
23310,woshiqiuxiaoyan,1,0.00012,175921,20.43735,860782
23311,wrenashe,1,0.00012,175922,20.43746,860782
23312,wroney688,1,0.00012,175923,20.43758,860782
23313,wsaca,1,0.00012,175924,20.43770,860782
23314,wsg911024,1,0.00012,175925,20.43781,860782
23315,WSLUser,1,0.00012,175926,20.43793,860782
23316,wstian,1,0.00012,175927,20.43804,860782
23317,wsx812585705,1,0.00012,175928,20.43816,860782
23318,wtchangdm,1,0.00012,175929,20.43828,860782
23319,wtcloud2020,1,0.00012,175930,20.43839,860782
23320,wtllc,1,0.00012,175931,20.43851,860782
23321,wtnb75,1,0.00012,175932,20.43862,860782
23322,wtthetop,1,0.00012,175933,20.43874,860782
23323,wudebao,1,0.00012,175934,20.43886,860782
23324,wuhuan001,1,0.00012,175935,20.43897,860782
23325,wujinhu,1,0.00012,175936,20.43909,860782
23326,wujy-cs,1,0.00012,175937,20.43921,860782
23327,wuminsure,1,0.00012,175938,20.43932,860782
23328,WuShaoQiang,1,0.00012,175939,20.43944,860782
23329,wusuoweiman,1,0.00012,175940,20.43955,860782
23330,wuvs,1,0.00012,175941,20.43967,860782
23331,wuyanxin,1,0.00012,175942,20.43979,860782
23332,wuyd2,1,0.00012,175943,20.43990,860782
23333,wuyezhiyu,1,0.00012,175944,20.44002,860782
23334,wuyudian1,1,0.00012,175945,20.44013,860782
23335,wuzhihui1123,1,0.00012,175946,20.44025,860782
23336,wvivek,1,0.00012,175947,20.44037,860782
23337,wwq1988,1,0.00012,175948,20.44048,860782
23338,wxiaoguang,1,0.00012,175949,20.44060,860782
23339,wyattjsmith1,1,0.00012,175950,20.44072,860782
23340,wybrobin,1,0.00012,175951,20.44083,860782
23341,wyh,1,0.00012,175952,20.44095,860782
23342,WYmindsky,1,0.00012,175953,20.44106,860782
23343,wzkun,1,0.00012,175954,20.44118,860782
23344,wzm74110,1,0.00012,175955,20.44130,860782
23345,x448,1,0.00012,175956,20.44141,860782
23346,xa4a,1,0.00012,175957,20.44153,860782
23347,Xaenalt,1,0.00012,175958,20.44164,860782
23348,xaki23,1,0.00012,175959,20.44176,860782
23349,xamalahmed,1,0.00012,175960,20.44188,860782
23350,Xanagandr,1,0.00012,175961,20.44199,860782
23351,xanmanning,1,0.00012,175962,20.44211,860782
23352,Xaroth,1,0.00012,175963,20.44223,860782
23353,xaviersierra,1,0.00012,175964,20.44234,860782
23354,x-avinash-singh,1,0.00012,175965,20.44246,860782
23355,xbblq62,1,0.00012,175966,20.44257,860782
23356,xCASx,1,0.00012,175967,20.44269,860782
23357,xcellenceit,1,0.00012,175968,20.44281,860782
23358,xclan,1,0.00012,175969,20.44292,860782
23359,xeleoss,1,0.00012,175970,20.44304,860782
23360,xenoterracide,1,0.00012,175971,20.44316,860782
23361,xerdink,1,0.00012,175972,20.44327,860782
23362,xforze,1,0.00012,175973,20.44339,860782
23363,xgfone,1,0.00012,175974,20.44350,860782
23364,xgourmandin,1,0.00012,175975,20.44362,860782
23365,xhanj02,1,0.00012,175976,20.44374,860782
23366,xhken,1,0.00012,175977,20.44385,860782
23367,xiagw,1,0.00012,175978,20.44397,860782
23368,xiak,1,0.00012,175979,20.44408,860782
23369,xiamengyu,1,0.00012,175980,20.44420,860782
23370,XianB,1,0.00012,175981,20.44432,860782
23371,xiangninglyu,1,0.00012,175982,20.44443,860782
23372,xiangzhai,1,0.00012,175983,20.44455,860782
23373,xiaolul,1,0.00012,175984,20.44467,860782
23374,xiaomabetter,1,0.00012,175985,20.44478,860782
23375,xiaowuwu163,1,0.00012,175986,20.44490,860782
23376,xiaoxiaoxiao-s,1,0.00012,175987,20.44501,860782
23377,xiatiandefeng-long,1,0.00012,175988,20.44513,860782
23378,xidongc-wish,1,0.00012,175989,20.44525,860782
23379,xiedaijin1018,1,0.00012,175990,20.44536,860782
23380,xieyt9,1,0.00012,175991,20.44548,860782
23381,xifanyan,1,0.00012,175992,20.44559,860782
23382,xijiz,1,0.00012,175993,20.44571,860782
23383,Xindahuang,1,0.00012,175994,20.44583,860782
23384,xingjy10,1,0.00012,175995,20.44594,860782
23385,xinhongwei67,1,0.00012,175996,20.44606,860782
23386,xinxinzhao1212,1,0.00012,175997,20.44618,860782
23387,Xiryl,1,0.00012,175998,20.44629,860782
23388,xiuxiu,1,0.00012,175999,20.44641,860782
23389,xiviu123,1,0.00012,176000,20.44652,860782
23390,xiyangyouzi,1,0.00012,176001,20.44664,860782
23391,xjantoth,1,0.00012,176002,20.44676,860782
23392,xjliang2007,1,0.00012,176003,20.44687,860782
23393,xkdidl,1,0.00012,176004,20.44699,860782
23394,xlanor,1,0.00012,176005,20.44711,860782
23395,xlixlixli,1,0.00012,176006,20.44722,860782
23396,xlogin,1,0.00012,176007,20.44734,860782
23397,xlrd,1,0.00012,176008,20.44745,860782
23398,xnutsive,1,0.00012,176009,20.44757,860782
23399,xonze,1,0.00012,176010,20.44769,860782
23400,xorjain,1,0.00012,176011,20.44780,860782
23401,Xorso,1,0.00012,176012,20.44792,860782
23402,xpepermint,1,0.00012,176013,20.44803,860782
23403,xpicio,1,0.00012,176014,20.44815,860782
23404,xprxprx,1,0.00012,176015,20.44827,860782
23405,xqzhang2015,1,0.00012,176016,20.44838,860782
23406,xs2tarunkukreja,1,0.00012,176017,20.44850,860782
23407,xsorifc28,1,0.00012,176018,20.44862,860782
23408,xsresearch,1,0.00012,176019,20.44873,860782
23409,xtez,1,0.00012,176020,20.44885,860782
23410,xtophe02,1,0.00012,176021,20.44896,860782
23411,xuan200922702,1,0.00012,176022,20.44908,860782
23412,xuanaxuan,1,0.00012,176023,20.44920,860782
23413,XuanYang-cn,1,0.00012,176024,20.44931,860782
23414,xuanyuanaosheng,1,0.00012,176025,20.44943,860782
23415,xubofei1983,1,0.00012,176026,20.44954,860782
23416,xuchongchong,1,0.00012,176027,20.44966,860782
23417,Xuehai-Chen,1,0.00012,176028,20.44978,860782
23418,xuexiaoao,1,0.00012,176029,20.44989,860782
23419,xuexuemiao,1,0.00012,176030,20.45001,860782
23420,xuhrc,1,0.00012,176031,20.45013,860782
23421,xuhz,1,0.00012,176032,20.45024,860782
23422,xujianhai666,1,0.00012,176033,20.45036,860782
23423,xukunfeng0496,1,0.00012,176034,20.45047,860782
23424,xurei,1,0.00012,176035,20.45059,860782
23425,xuxiaowei0512,1,0.00012,176036,20.45071,860782
23426,xuyixin1996,1,0.00012,176037,20.45082,860782
23427,xuyue86,1,0.00012,176038,20.45094,860782
23428,xuzhenhai,1,0.00012,176039,20.45105,860782
23429,xxCoDeBoX,1,0.00012,176040,20.45117,860782
23430,xxjwxc,1,0.00012,176041,20.45129,860782
23431,xytnba,1,0.00012,176042,20.45140,860782
23432,xyyp224,1,0.00012,176043,20.45152,860782
23433,xz64,1,0.00012,176044,20.45164,860782
23434,xzfc,1,0.00012,176045,20.45175,860782
23435,Yacine-A,1,0.00012,176046,20.45187,860782
23436,yacklebeam,1,0.00012,176047,20.45198,860782
23437,yadavvineet,1,0.00012,176048,20.45210,860782
23438,yagachi,1,0.00012,176049,20.45222,860782
23439,yagiaoskywalker,1,0.00012,176050,20.45233,860782
23440,Yagora,1,0.00012,176051,20.45245,860782
23441,YahuiAn,1,0.00012,176052,20.45257,860782
23442,yaitskov,1,0.00012,176053,20.45268,860782
23443,yakbulut,1,0.00012,176054,20.45280,860782
23444,yananielsen,1,0.00012,176055,20.45291,860782
23445,yangcheng-icbc,1,0.00012,176056,20.45303,860782
23446,yangchenliang,1,0.00012,176057,20.45315,860782
23447,yangd102,1,0.00012,176058,20.45326,860782
23448,yangfan-shine,1,0.00012,176059,20.45338,860782
23449,yanghong1995220,1,0.00012,176060,20.45349,860782
23450,yanghuiyh,1,0.00012,176061,20.45361,860782
23451,yangjindong,1,0.00012,176062,20.45373,860782
23452,yangjuncode,1,0.00012,176063,20.45384,860782
23453,yangMHyang,1,0.00012,176064,20.45396,860782
23454,yangnaihua,1,0.00012,176065,20.45408,860782
23455,yangqince,1,0.00012,176066,20.45419,860782
23456,yangshuhao,1,0.00012,176067,20.45431,860782
23457,yangxinyi8,1,0.00012,176068,20.45442,860782
23458,yanickxia,1,0.00012,176069,20.45454,860782
23459,YanivHaramati,1,0.00012,176070,20.45466,860782
23460,yanivpaz,1,0.00012,176071,20.45477,860782
23461,yanivroz,1,0.00012,176072,20.45489,860782
23462,yannick,1,0.00012,176073,20.45500,860782
23463,yann-yy,1,0.00012,176074,20.45512,860782
23464,yanqd0,1,0.00012,176075,20.45524,860782
23465,Yaowei-Du,1,0.00012,176076,20.45535,860782
23466,yarax,1,0.00012,176077,20.45547,860782
23467,yardenfi,1,0.00012,176078,20.45559,860782
23468,YarekTyshchenko,1,0.00012,176079,20.45570,860782
23469,yarelm,1,0.00012,176080,20.45582,860782
23470,yaron,1,0.00012,176081,20.45593,860782
23471,yaronf,1,0.00012,176082,20.45605,860782
23472,yaroslavkasatikov,1,0.00012,176083,20.45617,860782
23473,yashspr,1,0.00012,176084,20.45628,860782
23474,yasreeb,1,0.00012,176085,20.45640,860782
23475,yassun,1,0.00012,176086,20.45652,860782
23476,yasushi-saito,1,0.00012,176087,20.45663,860782
23477,ybhatnagar,1,0.00012,176088,20.45675,860782
23478,yc-alex-xu,1,0.00012,176089,20.45686,860782
23479,yceoshda,1,0.00012,176090,20.45698,860782
23480,ydzhou,1,0.00012,176091,20.45710,860782
23481,YeDongaidiiqu,1,0.00012,176092,20.45721,860782
23482,yegle,1,0.00012,176093,20.45733,860782
23483,yehia67,1,0.00012,176094,20.45744,860782
23484,yeluolei,1,0.00012,176095,20.45756,860782
23485,YeonSeoMom,1,0.00012,176096,20.45768,860782
23486,yerriswamykonanki,1,0.00012,176097,20.45779,860782
23487,yesminek,1,0.00012,176098,20.45791,860782
23488,yevvievvy,1,0.00012,176099,20.45803,860782
23489,yexiang841,1,0.00012,176100,20.45814,860782
23490,yeyudetiankon1,1,0.00012,176101,20.45826,860782
23491,ygqygq2,1,0.00012,176102,20.45837,860782
23492,Ygshvr,1,0.00012,176103,20.45849,860782
23493,yhack,1,0.00012,176104,20.45861,860782
23494,yhalpha,1,0.00012,176105,20.45872,860782
23495,yharish991,1,0.00012,176106,20.45884,860782
23496,yheonhochoi,1,0.00012,176107,20.45895,860782
23497,yhrenlee,1,0.00012,176108,20.45907,860782
23498,yhyecho,1,0.00012,176109,20.45919,860782
23499,yhz1985,1,0.00012,176110,20.45930,860782
23500,yifeikong,1,0.00012,176111,20.45942,860782
23501,YifMor,1,0.00012,176112,20.45954,860782
23502,yihuibest3,1,0.00012,176113,20.45965,860782
23503,yiliaofan,1,0.00012,176114,20.45977,860782
23504,yindaheng98,1,0.00012,176115,20.45988,860782
23505,yingjun-hw,1,0.00012,176116,20.46000,860782
23506,yingnanzhang666,1,0.00012,176117,20.46012,860782
23507,yinjun622,1,0.00012,176118,20.46023,860782
23508,yinjunfa,1,0.00012,176119,20.46035,860782
23509,yinshengphy,1,0.00012,176120,20.46047,860782
23510,yinxiulong,1,0.00012,176121,20.46058,860782
23511,yipulash,1,0.00012,176122,20.46070,860782
23512,yittg,1,0.00012,176123,20.46081,860782
23513,yiweng-amz,1,0.00012,176124,20.46093,860782
23514,yizha,1,0.00012,176125,20.46105,860782
23515,Yizong98,1,0.00012,176126,20.46116,860782
23516,ylangisc,1,0.00012,176127,20.46128,860782
23517,yli186,1,0.00012,176128,20.46139,860782
23518,ymyzk,1,0.00012,176129,20.46151,860782
23519,ynnt,1,0.00012,176130,20.46163,860782
23520,ynojima,1,0.00012,176131,20.46174,860782
23521,yntelectual,1,0.00012,176132,20.46186,860782
23522,yoann-ls,1,0.00012,176133,20.46198,860782
23523,yodaqua,1,0.00012,176134,20.46209,860782
23524,yoeldovidcohen,1,0.00012,176135,20.46221,860782
23525,yogarajrafay,1,0.00012,176136,20.46232,860782
23526,yogeshbidari,1,0.00012,176137,20.46244,860782
23527,yogeshdass,1,0.00012,176138,20.46256,860782
23528,yogisau,1,0.00012,176139,20.46267,860782
23529,yogyad,1,0.00012,176140,20.46279,860782
23530,yohan-couppey,1,0.00012,176141,20.46290,860782
23531,yoichiro0217,1,0.00012,176142,20.46302,860782
23532,yoitsbenco,1,0.00012,176143,20.46314,860782
23533,yokeshvs,1,0.00012,176144,20.46325,860782
23534,yomesky2000,1,0.00012,176145,20.46337,860782
23535,YongHaoWu,1,0.00012,176146,20.46349,860782
23536,yong-qq,1,0.00012,176147,20.46360,860782
23537,yongruilin,1,0.00012,176148,20.46372,860782
23538,YoninL,1,0.00012,176149,20.46383,860782
23539,yonz2,1,0.00012,176150,20.46395,860782
23540,YoogottamK,1,0.00012,176151,20.46407,860782
23541,yoonseok312,1,0.00012,176152,20.46418,860782
23542,yoshieki1992,1,0.00012,176153,20.46430,860782
23543,yosiat,1,0.00012,176154,20.46441,860782
23544,yosshy,1,0.00012,176155,20.46453,860782
23545,yossigilad,1,0.00012,176156,20.46465,860782
23546,young-0,1,0.00012,176157,20.46476,860782
23547,youngjoon-lee,1,0.00012,176158,20.46488,860782
23548,yourmoonlight,1,0.00012,176159,20.46500,860782
23549,youurayy,1,0.00012,176160,20.46511,860782
23550,youxq,1,0.00012,176161,20.46523,860782
23551,ypadlyak,1,0.00012,176162,20.46534,860782
23552,yphulke,1,0.00012,176163,20.46546,860782
23553,ypnuaa037,1,0.00012,176164,20.46558,860782
23554,yrobla,1,0.00012,176165,20.46569,860782
23555,ys199210,1,0.00012,176166,20.46581,860782
23556,yschimke,1,0.00012,176167,20.46593,860782
23557,yshalabi,1,0.00012,176168,20.46604,860782
23558,ysimonson,1,0.00012,176169,20.46616,860782
23559,ysow,1,0.00012,176170,20.46627,860782
23560,y-tabata,1,0.00012,176171,20.46639,860782
23561,ytcisme,1,0.00012,176172,20.46651,860782
23562,yuan1238y,1,0.00012,176173,20.46662,860782
23563,yu-areznikov,1,0.00012,176174,20.46674,860782
23564,yuchunyun,1,0.00012,176175,20.46685,860782
23565,yuecong,1,0.00012,176176,20.46697,860782
23566,yuehliu,1,0.00012,176177,20.46709,860782
23567,yuejiang-code,1,0.00012,176178,20.46720,860782
23568,yueseW,1,0.00012,176179,20.46732,860782
23569,yueyongyue,1,0.00012,176180,20.46744,860782
23570,yulianedyalkova,1,0.00012,176181,20.46755,860782
23571,yulibaozi,1,0.00012,176182,20.46767,860782
23572,YuLimin,1,0.00012,176183,20.46778,860782
23573,yunbo-xufeng,1,0.00012,176184,20.46790,860782
23574,yunsonbai,1,0.00012,176185,20.46802,860782
23575,yuokada,1,0.00012,176186,20.46813,860782
23576,yuphing-ong,1,0.00012,176187,20.46825,860782
23577,yuranos,1,0.00012,176188,20.46836,860782
23578,yuraxdrumz,1,0.00012,176189,20.46848,860782
23579,yuregir,1,0.00012,176190,20.46860,860782
23580,yurilaaziz,1,0.00012,176191,20.46871,860782
23581,YuriyKrasilnikov,1,0.00012,176192,20.46883,860782
23582,yury-alpatov,1,0.00012,176193,20.46895,860782
23583,yusufharip,1,0.00012,176194,20.46906,860782
23584,yuyayamayuy,1,0.00012,176195,20.46918,860782
23585,yuyue9284,1,0.00012,176196,20.46929,860782
23586,yuzhaopeng,1,0.00012,176197,20.46941,860782
23587,YvesChan,1,0.00012,176198,20.46953,860782
23588,yvesdeceuleners,1,0.00012,176199,20.46964,860782
23589,yxliang01,1,0.00012,176200,20.46976,860782
23590,yxyx520,1,0.00012,176201,20.46988,860782
23591,yyefet,1,0.00012,176202,20.46999,860782
23592,yyrdl,1,0.00012,176203,20.47011,860782
23593,yzhang-flexera,1,0.00012,176204,20.47022,860782
23594,z1oy,1,0.00012,176205,20.47034,860782
23595,z7658329,1,0.00012,176206,20.47046,860782
23596,zaabskr,1,0.00012,176207,20.47057,860782
23597,ZacHaque,1,0.00012,176208,20.47069,860782
23598,zacharycmontoya,1,0.00012,176209,20.47080,860782
23599,ZacharyLiu-CS,1,0.00012,176210,20.47092,860782
23600,ZachGoldberg,1,0.00012,176211,20.47104,860782
23601,zackb,1,0.00012,176212,20.47115,860782
23602,zacker330,1,0.00012,176213,20.47127,860782
23603,zackijack,1,0.00012,176214,20.47139,860782
23604,zakir-dashdevs,1,0.00012,176215,20.47150,860782
23605,zalyoung,1,0.00012,176216,20.47162,860782
23606,zanglang,1,0.00012,176217,20.47173,860782
23607,Zanis7,1,0.00012,176218,20.47185,860782
23608,zann1e,1,0.00012,176219,20.47197,860782
23609,zanoubia,1,0.00012,176220,20.47208,860782
23610,zanshuo,1,0.00012,176221,20.47220,860782
23611,zapman449,1,0.00012,176222,20.47231,860782
23612,zarbis,1,0.00012,176223,20.47243,860782
23613,zarhane,1,0.00012,176224,20.47255,860782
23614,zasgar,1,0.00012,176225,20.47266,860782
23615,zatricky,1,0.00012,176226,20.47278,860782
23616,Zayan1221,1,0.00012,176227,20.47290,860782
23617,ZaynJarvis,1,0.00012,176228,20.47301,860782
23618,zblach,1,0.00012,176229,20.47313,860782
23619,zbw1983,1,0.00012,176230,20.47324,860782
23620,zcalusic,1,0.00012,176231,20.47336,860782
23621,zc-hemenfei,1,0.00012,176232,20.47348,860782
23622,zcnewt,1,0.00012,176233,20.47359,860782
23623,zd-double,1,0.00012,176234,20.47371,860782
23624,zdenulo,1,0.00012,176235,20.47382,860782
23625,ZeeshanRaza25,1,0.00012,176236,20.47394,860782
23626,zejar,1,0.00012,176237,20.47406,860782
23627,zemaj,1,0.00012,176238,20.47417,860782
23628,zemmet,1,0.00012,176239,20.47429,860782
23629,zenglingmin168,1,0.00012,176240,20.47441,860782
23630,zengxiaobai,1,0.00012,176241,20.47452,860782
23631,zengzhengrong,1,0.00012,176242,20.47464,860782
23632,Zenlil,1,0.00012,176243,20.47475,860782
23633,zephinzer,1,0.00012,176244,20.47487,860782
23634,zepouet,1,0.00012,176245,20.47499,860782
23635,Zergvl,1,0.00012,176246,20.47510,860782
23636,zeroepoch,1,0.00012,176247,20.47522,860782
23637,zero-go,1,0.00012,176248,20.47534,860782
23638,zeroisme,1,0.00012,176249,20.47545,860782
23639,zerone12,1,0.00012,176250,20.47557,860782
23640,zeroX-tj,1,0.00012,176251,20.47568,860782
23641,Zest-nikunj,1,0.00012,176252,20.47580,860782
23642,zetiaGithub,1,0.00012,176253,20.47592,860782
23643,zettop,1,0.00012,176254,20.47603,860782
23644,zevaks,1,0.00012,176255,20.47615,860782
23645,zfrank,1,0.00012,176256,20.47626,860782
23646,zgcbj,1,0.00012,176257,20.47638,860782
23647,zgorizzo69,1,0.00012,176258,20.47650,860782
23648,zgswl,1,0.00012,176259,20.47661,860782
23649,Zhang21,1,0.00012,176260,20.47673,860782
23650,zhangalex,1,0.00012,176261,20.47685,860782
23651,zhangchengshan,1,0.00012,176262,20.47696,860782
23652,zhangfan-5391621,1,0.00012,176263,20.47708,860782
23653,zhangfei9734,1,0.00012,176264,20.47719,860782
23654,zhangguangguang,1,0.00012,176265,20.47731,860782
23655,zhangjianghua,1,0.00012,176266,20.47743,860782
23656,zhangjin-007,1,0.00012,176267,20.47754,860782
23657,zhangqingwen,1,0.00012,176268,20.47766,860782
23658,zhangrui153169,1,0.00012,176269,20.47777,860782
23659,zhangwenlong8911,1,0.00012,176270,20.47789,860782
23660,zhangyuxuan1992,1,0.00012,176271,20.47801,860782
23661,zhangzhaorui,1,0.00012,176272,20.47812,860782
23662,zhangzhongbin001,1,0.00012,176273,20.47824,860782
23663,zhanlinfeng,1,0.00012,176274,20.47836,860782
23664,zhannb,1,0.00012,176275,20.47847,860782
23665,zhaoge77,1,0.00012,176276,20.47859,860782
23666,zhaoxinjie0,1,0.00012,176277,20.47870,860782
23667,zhashuyu,1,0.00012,176278,20.47882,860782
23668,zhboseu,1,0.00012,176279,20.47894,860782
23669,zheker,1,0.00012,176280,20.47905,860782
23670,zheng1,1,0.00012,176281,20.47917,860782
23671,Zhengmao-Wang,1,0.00012,176282,20.47929,860782
23672,zhengqisong,1,0.00012,176283,20.47940,860782
23673,ZhengRongTan,1,0.00012,176284,20.47952,860782
23674,Zhengxiaoxiang,1,0.00012,176285,20.47963,860782
23675,zhenkm0507,1,0.00012,176286,20.47975,860782
23676,zhfg,1,0.00012,176287,20.47987,860782
23677,zhilyaev,1,0.00012,176288,20.47998,860782
23678,zhjdenislyft,1,0.00012,176289,20.48010,860782
23679,zhoufeilongjava,1,0.00012,176290,20.48021,860782
23680,zhoujianhui,1,0.00012,176291,20.48033,860782
23681,zhouxdd,1,0.00012,176292,20.48045,860782
23682,zhouyoufa,1,0.00012,176293,20.48056,860782
23683,zhubinjqjy,1,0.00012,176294,20.48068,860782
23684,zhugejingcheng,1,0.00012,176295,20.48080,860782
23685,zhuheec,1,0.00012,176296,20.48091,860782
23686,zhujik,1,0.00012,176297,20.48103,860782
23687,ZhukovAlexander,1,0.00012,176298,20.48114,860782
23688,zhupeixiang1234,1,0.00012,176299,20.48126,860782
23689,zhuzhenfirst,1,0.00012,176300,20.48138,860782
23690,zhxu73,1,0.00012,176301,20.48149,860782
23691,zicongmei,1,0.00012,176302,20.48161,860782
23692,zidex,1,0.00012,176303,20.48172,860782
23693,zidhumenon,1,0.00012,176304,20.48184,860782
23694,ziemerz,1,0.00012,176305,20.48196,860782
23695,zigmint,1,0.00012,176306,20.48207,860782
23696,zihotki,1,0.00012,176307,20.48219,860782
23697,zillerium,1,0.00012,176308,20.48231,860782
23698,zilmarr,1,0.00012,176309,20.48242,860782
23699,zinneranast,1,0.00012,176310,20.48254,860782
23700,Ziwi01,1,0.00012,176311,20.48265,860782
23701,Zizhen,1,0.00012,176312,20.48277,860782
23702,zjinys,1,0.00012,176313,20.48289,860782
23703,zkf1987,1,0.00012,176314,20.48300,860782
23704,zkhcohen,1,0.00012,176315,20.48312,860782
23705,zkovac-devops,1,0.00012,176316,20.48324,860782
23706,zlcnju,1,0.00012,176317,20.48335,860782
23707,zlesnr,1,0.00012,176318,20.48347,860782
23708,zlosim,1,0.00012,176319,20.48358,860782
23709,zltl,1,0.00012,176320,20.48370,860782
23710,znatashka,1,0.00012,176321,20.48382,860782
23711,zobelhelas,1,0.00012,176322,20.48393,860782
23712,zocario,1,0.00012,176323,20.48405,860782
23713,zodiac182,1,0.00012,176324,20.48416,860782
23714,zoftdev,1,0.00012,176325,20.48428,860782
23715,zohairajmal,1,0.00012,176326,20.48440,860782
23716,zojovano,1,0.00012,176327,20.48451,860782
23717,zolij,1,0.00012,176328,20.48463,860782
23718,ZolotarenkoM,1,0.00012,176329,20.48475,860782
23719,zoltan-fedor,1,0.00012,176330,20.48486,860782
23720,zombym,1,0.00012,176331,20.48498,860782
23721,zoran3,1,0.00012,176332,20.48509,860782
23722,zoranpopovic,1,0.00012,176333,20.48521,860782
23723,zosorock,1,0.00012,176334,20.48533,860782
23724,zouchengtao,1,0.00012,176335,20.48544,860782
23725,zqingqing1,1,0.00012,176336,20.48556,860782
23726,zrml,1,0.00012,176337,20.48567,860782
23727,zrqgood,1,0.00012,176338,20.48579,860782
23728,zsedem,1,0.00012,176339,20.48591,860782
23729,zshi456,1,0.00012,176340,20.48602,860782
23730,zsuzhengdu,1,0.00012,176341,20.48614,860782
23731,zsylvia,1,0.00012,176342,20.48626,860782
23732,zud0ku,1,0.00012,176343,20.48637,860782
23733,zummenix,1,0.00012,176344,20.48649,860782
23734,zurvan2,1,0.00012,176345,20.48660,860782
23735,ZusorCode,1,0.00012,176346,20.48672,860782
23736,Zwiefront,1,0.00012,176347,20.48684,860782
23737,zwurv,1,0.00012,176348,20.48695,860782
23738,zxcasongs,1,0.00012,176349,20.48707,860782
23739,zyboy2000,1,0.00012,176350,20.48718,860782
23740,zyjiaobj,1,0.00012,176351,20.48730,860782
23741,zylthinking,1,0.00012,176352,20.48742,860782
23742,zystem,1,0.00012,176353,20.48753,860782
23743,zzaareer,1,0.00012,176354,20.48765,860782
23744,zzarbi,1,0.00012,176355,20.48777,860782
23745,zzh8829,1,0.00012,176356,20.48788,860782
23746,zziawan,1,0.00012,176357,20.48800,860782
23747,zzmg,1,0.00012,176358,20.48811,860782
