rank_number,actor,contributions,percent,cumulative_sum,cumulative_percent,all_contributions
1,mvalarh,1540,0.51280,1540,0.51280,300314
2,phlax,1331,0.44320,2871,0.95600,300314
3,innobead,641,0.21344,3512,1.16944,300314
4,realshuting,591,0.19679,4103,1.36624,300314
5,J0zi,533,0.17748,4636,1.54372,300314
6,lalitb,520,0.17315,5156,1.71687,300314
7,yangjunmyfm192085,511,0.17016,5667,1.88702,300314
8,scottf,487,0.16216,6154,2.04919,300314
9,mfelsche,399,0.13286,6553,2.18205,300314
10,kuritka,394,0.13120,6947,2.31325,300314
11,buildbreaker,359,0.11954,7306,2.43279,300314
12,Thor-wl,349,0.11621,7655,2.54900,300314
13,eduser25,321,0.10689,7976,2.65589,300314
14,whynowy,317,0.10556,8293,2.76144,300314
15,ormergi,315,0.10489,8608,2.86633,300314
16,glazychev-art,308,0.10256,8916,2.96889,300314
17,chriswldenyer,305,0.10156,9221,3.07045,300314
18,Kirdock,299,0.09956,9520,3.17002,300314
19,cynthia-sg,266,0.08857,9786,3.25859,300314
20,AsterNighT,265,0.08824,10051,3.34683,300314
21,Fox32,263,0.08758,10314,3.43441,300314
22,antmendoza,257,0.08558,10571,3.51998,300314
23,champtar,255,0.08491,10826,3.60489,300314
24,laneli,247,0.08225,11073,3.68714,300314
25,frouioui,235,0.07825,11308,3.76539,300314
26,mauriciopoppe,233,0.07759,11541,3.84298,300314
27,mattcary,227,0.07559,11768,3.91857,300314
28,jsuereth,224,0.07459,11992,3.99315,300314
29,andylokandy,220,0.07326,12212,4.06641,300314
30,gaius-qi,217,0.07226,12429,4.13867,300314
31,brybacki,211,0.07026,12640,4.20893,300314
32,PhanLe1010,210,0.06993,12850,4.27885,300314
33,llhuii,207,0.06893,13057,4.34778,300314
34,zasweq,205,0.06826,13262,4.41604,300314
35,SgtCoDFish,195,0.06493,13457,4.48098,300314
36,anishakj,194,0.06460,13651,4.54558,300314
37,ErinThacker,188,0.06260,13839,4.60818,300314
38,DavidSchinazi,177,0.05894,14016,4.66712,300314
39,acardace,176,0.05861,14192,4.72572,300314
40,RinkiyaKeDad,174,0.05794,14366,4.78366,300314
41,M00nF1sh,170,0.05661,14536,4.84027,300314
42,RyanTheOptimist,169,0.05627,14705,4.89654,300314
43,MarkLodato,168,0.05594,14873,4.95248,300314
44,scottilee,165,0.05494,15038,5.00743,300314
45,lhy1024,163,0.05428,15201,5.06170,300314
46,mtzaurus,161,0.05361,15362,5.11531,300314
47,iholder-redhat,159,0.05294,15521,5.16826,300314
48,AndyXiangLi,156,0.05195,15677,5.22020,300314
49,CaoDonghui123,155,0.05161,15832,5.27182,300314
50,lonewolf3739,151,0.05028,15983,5.32210,300314
51,niladrih,143,0.04762,16126,5.36971,300314
52,allenlsy,142,0.04728,16268,5.41700,300314
53,xpivarc,140,0.04662,16408,5.46361,300314
54,xavier-rbz,139,0.04628,16547,5.50990,300314
55,hongliangl,138,0.04595,16685,5.55585,300314
56,BinacsLee,137,0.04562,16822,5.60147,300314
57,shrids,133,0.04429,16955,5.64576,300314
58,abvaidya,128,0.04262,17083,5.68838,300314
59,drfloob,127,0.04229,17210,5.73067,300314
60,myan9,127,0.04229,17337,5.77296,300314
61,paulosjca,126,0.04196,17463,5.81491,300314
62,sachin-j-joshi,124,0.04129,17587,5.85620,300314
63,im-konge,123,0.04096,17710,5.89716,300314
64,LeviHarrison,123,0.04096,17833,5.93812,300314
65,GraysonWu,121,0.04029,17954,5.97841,300314
66,whitetiger1399,120,0.03996,18074,6.01837,300314
67,crockeo,117,0.03896,18191,6.05733,300314
68,Priyankasaggu11929,114,0.03796,18305,6.09529,300314
69,Jibbow,111,0.03696,18416,6.13225,300314
70,MadhavJivrajani,111,0.03696,18527,6.16921,300314
71,shannonxtreme,111,0.03696,18638,6.20617,300314
72,JBBianchi,110,0.03663,18748,6.24280,300314
73,wanlin31,106,0.03530,18854,6.27810,300314
74,Kavindu-Dodan,105,0.03496,18959,6.31306,300314
75,wangyysde,105,0.03496,19064,6.34802,300314
76,CathPag,104,0.03463,19168,6.38265,300314
77,laxmikantbpandhare,104,0.03463,19272,6.41728,300314
78,5kbpers,102,0.03396,19374,6.45125,300314
79,Tristan1900,102,0.03396,19476,6.48521,300314
80,CLAassistant,96,0.03197,19572,6.51718,300314
81,dwillist,96,0.03197,19668,6.54915,300314
82,ludusrusso,96,0.03197,19764,6.58111,300314
83,lauchokyip,91,0.03030,19855,6.61141,300314
84,pingleig,91,0.03030,19946,6.64172,300314
85,fewdan,90,0.02997,20036,6.67168,300314
86,Andrewmatilde,89,0.02964,20125,6.70132,300314
87,julianKatz,89,0.02964,20214,6.73095,300314
88,relyt0925,89,0.02964,20303,6.76059,300314
89,cclhsu,88,0.02930,20391,6.78989,300314
90,andriyDev,85,0.02830,20476,6.81820,300314
91,pxaws,85,0.02830,20561,6.84650,300314
92,qinggniq,85,0.02830,20646,6.87480,300314
93,stevesg,84,0.02797,20730,6.90278,300314
94,AliceZhang2016,83,0.02764,20813,6.93041,300314
95,RobertDrazkowskiGL,83,0.02764,20896,6.95805,300314
96,mkilchhofer,82,0.02730,20978,6.98536,300314
97,njuptlzf,82,0.02730,21060,7.01266,300314
98,thekingofcity,82,0.02730,21142,7.03996,300314
99,adrianke77,81,0.02697,21223,7.06694,300314
100,carloseltuerto,81,0.02697,21304,7.09391,300314
101,wilsonwang371,81,0.02697,21385,7.12088,300314
102,Neuroglia,80,0.02664,21465,7.14752,300314
103,getporterbot,79,0.02631,21544,7.17382,300314
104,inteon,79,0.02631,21623,7.20013,300314
105,rolfedh,79,0.02631,21702,7.22644,300314
106,tokers,79,0.02631,21781,7.25274,300314
107,vasiliy-ul,78,0.02597,21859,7.27871,300314
108,d-uzlov,77,0.02564,21936,7.30435,300314
109,hallaroo,76,0.02531,22012,7.32966,300314
110,pmmalinov01,76,0.02531,22088,7.35497,300314
111,zacharycmontoya,76,0.02531,22164,7.38028,300314
112,doeg,75,0.02497,22239,7.40525,300314
113,harshita19244,75,0.02497,22314,7.43022,300314
114,cndoit18,74,0.02464,22388,7.45486,300314
115,kuangp,74,0.02464,22462,7.47950,300314
116,wangyx1992,74,0.02464,22536,7.50415,300314
117,bobuxFromAmazonEy,72,0.02397,22608,7.52812,300314
118,aguinet,71,0.02364,22679,7.55176,300314
119,vdhanan,71,0.02364,22750,7.57540,300314
120,victlu,71,0.02364,22821,7.59905,300314
121,Little-Wallace,70,0.02331,22891,7.62236,300314
122,aabmass,69,0.02298,22960,7.64533,300314
123,dhruv-vora,69,0.02298,23029,7.66831,300314
124,someshkoli,69,0.02298,23098,7.69128,300314
125,tim-sendible,68,0.02264,23166,7.71393,300314
126,treydock,68,0.02264,23234,7.73657,300314
127,mpherman2,67,0.02231,23301,7.75888,300314
128,gy95,66,0.02198,23367,7.78086,300314
129,lkatalin,66,0.02198,23433,7.80283,300314
130,bri365,65,0.02164,23498,7.82448,300314
131,macaptain,65,0.02164,23563,7.84612,300314
132,weyert,65,0.02164,23628,7.86777,300314
133,JimmyYang20,64,0.02131,23692,7.88908,300314
134,khaosdoctor,64,0.02131,23756,7.91039,300314
135,luolanzone,63,0.02098,23819,7.93137,300314
136,parkanzky,62,0.02065,23881,7.95201,300314
137,jdmaguire,61,0.02031,23942,7.97232,300314
138,OferLevi85,61,0.02031,24003,7.99263,300314
139,jchunkins,60,0.01998,24063,8.01261,300314
140,rhdxmr,60,0.01998,24123,8.03259,300314
141,zhongzc,60,0.01998,24183,8.05257,300314
142,anovis,58,0.01931,24241,8.07188,300314
143,Mixaster995,58,0.01931,24299,8.09120,300314
144,vyankyGH,58,0.01931,24357,8.11051,300314
145,dshomoye,57,0.01898,24414,8.12949,300314
146,JasonMorgan,57,0.01898,24471,8.14847,300314
147,jim3ma,57,0.01898,24528,8.16745,300314
148,lack,57,0.01898,24585,8.18643,300314
149,parth-gr,57,0.01898,24642,8.20541,300314
150,TrafalgarZZZ,57,0.01898,24699,8.22439,300314
151,huone1,56,0.01865,24755,8.24304,300314
152,kshamajain99,56,0.01865,24811,8.26169,300314
153,mcshooter,56,0.01865,24867,8.28033,300314
154,robertlaurin,56,0.01865,24923,8.29898,300314
155,wbpcode,56,0.01865,24979,8.31763,300314
156,arcolife,55,0.01831,25034,8.33594,300314
157,lahabana,55,0.01831,25089,8.35426,300314
158,maugustosilva,55,0.01831,25144,8.37257,300314
159,Mrod1598,54,0.01798,25198,8.39055,300314
160,rdxmb,54,0.01798,25252,8.40853,300314
161,wangchenglong01,54,0.01798,25306,8.42651,300314
162,donnadionne,51,0.01698,25357,8.44350,300314
163,fvaleri,50,0.01665,25407,8.46015,300314
164,GreenApple10,50,0.01665,25457,8.47679,300314
165,nisarg1499,50,0.01665,25507,8.49344,300314
166,nshankar13,50,0.01665,25557,8.51009,300314
167,Radolumbo,50,0.01665,25607,8.52674,300314
168,sishbi,50,0.01665,25657,8.54339,300314
169,yangyuliufeng,50,0.01665,25707,8.56004,300314
170,maxim-kuderko,49,0.01632,25756,8.57636,300314
171,MisterMX,49,0.01632,25805,8.59267,300314
172,RenjieTang,49,0.01632,25854,8.60899,300314
173,utpilla,49,0.01632,25903,8.62531,300314
174,Xitric,49,0.01632,25952,8.64162,300314
175,zhiguo-lu,49,0.01632,26001,8.65794,300314
176,framework-automation,48,0.01598,26049,8.67392,300314
177,KofClubs,48,0.01598,26097,8.68990,300314
178,Sherlouk,48,0.01598,26145,8.70589,300314
179,bufferflies,47,0.01565,26192,8.72154,300314
180,dubious90,47,0.01565,26239,8.73719,300314
181,echernous,47,0.01565,26286,8.75284,300314
182,jkowall,47,0.01565,26333,8.76849,300314
183,kennytrytek,47,0.01565,26380,8.78414,300314
184,sashrith,47,0.01565,26427,8.79979,300314
185,wpedrak,47,0.01565,26474,8.81544,300314
186,anuragpaliwal80,46,0.01532,26520,8.83076,300314
187,jingwei99,46,0.01532,26566,8.84607,300314
188,RyanDevlin,46,0.01532,26612,8.86139,300314
189,salaboy,46,0.01532,26658,8.87671,300314
190,ahayworth,45,0.01498,26703,8.89169,300314
191,bhiravabhatla,45,0.01498,26748,8.90668,300314
192,fjogeleit,45,0.01498,26793,8.92166,300314
193,gavindoudou,45,0.01498,26838,8.93665,300314
194,ybbbby,45,0.01498,26883,8.95163,300314
195,masap,44,0.01465,26927,8.96628,300314
196,mizunos,44,0.01465,26971,8.98093,300314
197,TeweiLuo,44,0.01465,27015,8.99558,300314
198,dmilov,43,0.01432,27058,9.00990,300314
199,jtway,43,0.01432,27101,9.02422,300314
200,GlennBullingham,42,0.01399,27143,9.03821,300314
201,jshen28,42,0.01399,27185,9.05219,300314
202,piotr-sumo,42,0.01399,27227,9.06618,300314
203,tiny-x,42,0.01399,27269,9.08016,300314
204,ydFu,42,0.01399,27311,9.09415,300314
205,244372610,41,0.01365,27352,9.10780,300314
206,guo-shaoge,41,0.01365,27393,9.12145,300314
207,jaellio,41,0.01365,27434,9.13511,300314
208,lastchiliarch,41,0.01365,27475,9.14876,300314
209,marsishandsome,41,0.01365,27516,9.16241,300314
210,meenal06,41,0.01365,27557,9.17606,300314
211,mind-mind,41,0.01365,27598,9.18971,300314
212,suniltheta,41,0.01365,27639,9.20337,300314
213,Yashks1994,41,0.01365,27680,9.21702,300314
214,aws-cdk-automation,40,0.01332,27720,9.23034,300314
215,bartavelle,40,0.01332,27760,9.24366,300314
216,DailyAlice,40,0.01332,27800,9.25698,300314
217,eifrach,40,0.01332,27840,9.27030,300314
218,punya,40,0.01332,27880,9.28362,300314
219,rpiceage,40,0.01332,27920,9.29694,300314
220,YifeiZhuang,40,0.01332,27960,9.31026,300314
221,alexvanboxel,39,0.01299,27999,9.32324,300314
222,ardaguclu,39,0.01299,28038,9.33623,300314
223,davideimola,39,0.01299,28077,9.34921,300314
224,iamniting,39,0.01299,28116,9.36220,300314
225,kylejohnson514,39,0.01299,28155,9.37519,300314
226,purelind,39,0.01299,28194,9.38817,300314
227,SarthakJain26,39,0.01299,28233,9.40116,300314
228,shivanshs9,39,0.01299,28272,9.41415,300314
229,xphyr,39,0.01299,28311,9.42713,300314
230,Ab-hishek,38,0.01265,28349,9.43979,300314
231,chlins,38,0.01265,28387,9.45244,300314
232,cindy52,38,0.01265,28425,9.46509,300314
233,govargo,38,0.01265,28463,9.47775,300314
234,ryota-sakamoto,38,0.01265,28501,9.49040,300314
235,vanshBhatia-A4k9,38,0.01265,28539,9.50305,300314
236,xliuxu,38,0.01265,28577,9.51571,300314
237,andreyod,37,0.01232,28614,9.52803,300314
238,aryan9600,37,0.01232,28651,9.54035,300314
239,haslersn,37,0.01232,28688,9.55267,300314
240,heanlan,37,0.01232,28725,9.56499,300314
241,IdealUsrname,37,0.01232,28762,9.57731,300314
242,LiamClarkeNZ,37,0.01232,28799,9.58963,300314
243,liuzix,37,0.01232,28836,9.60195,300314
244,marunachalam,37,0.01232,28873,9.61427,300314
245,rpanduranga,37,0.01232,28910,9.62659,300314
246,nshalman,36,0.01199,28946,9.63858,300314
247,qiancai,36,0.01199,28982,9.65057,300314
248,specter25,36,0.01199,29018,9.66255,300314
249,sujil02,36,0.01199,29054,9.67454,300314
250,zhonghui12,36,0.01199,29090,9.68653,300314
251,zyjhtangtang,36,0.01199,29126,9.69852,300314
252,marcinzaremba,35,0.01165,29161,9.71017,300314
253,pavankrish123,35,0.01165,29196,9.72182,300314
254,rahulgrover99,35,0.01165,29231,9.73348,300314
255,ShubhamRwt,35,0.01165,29266,9.74513,300314
256,songxiao-wang87,35,0.01165,29301,9.75679,300314
257,vangork,35,0.01165,29336,9.76844,300314
258,chrisholmes,34,0.01132,29370,9.77976,300314
259,dobsonj,34,0.01132,29404,9.79109,300314
260,frankleaf,34,0.01132,29438,9.80241,300314
261,horizonzy,34,0.01132,29472,9.81373,300314
262,IrisTuntun,34,0.01132,29506,9.82505,300314
263,jjbustamante,34,0.01132,29540,9.83637,300314
264,kavyashree-r,34,0.01132,29574,9.84769,300314
265,lipingxue,34,0.01132,29608,9.85901,300314
266,MrCroxx,34,0.01132,29642,9.87034,300314
267,regicsolutions,34,0.01132,29676,9.88166,300314
268,RongGu,34,0.01132,29710,9.89298,300314
269,XIAO-HOU,34,0.01132,29744,9.90430,300314
270,zuc,34,0.01132,29778,9.91562,300314
271,howieyuen,33,0.01099,29811,9.92661,300314
272,jackThomass,33,0.01099,29844,9.93760,300314
273,jn9e9,33,0.01099,29877,9.94859,300314
274,Namanl2001,33,0.01099,29910,9.95958,300314
275,simongottschlag,33,0.01099,29943,9.97056,300314
276,aasraoui,32,0.01066,29975,9.98122,300314
277,danpopSD,32,0.01066,30007,9.99188,300314
278,jsalinas29,32,0.01066,30039,10.00253,300314
279,jupblb,32,0.01066,30071,10.01319,300314
280,kun-lu20,32,0.01066,30103,10.02384,300314
281,lilongfeng0902,32,0.01066,30135,10.03450,300314
282,navist2020,32,0.01066,30167,10.04515,300314
283,spiros-reblaze,32,0.01066,30199,10.05581,300314
284,Thoro,32,0.01066,30231,10.06646,300314
285,ulucinar,32,0.01066,30263,10.07712,300314
286,whites11,32,0.01066,30295,10.08777,300314
287,yanjunxiang-google,32,0.01066,30327,10.09843,300314
288,Akiros001,31,0.01032,30358,10.10875,300314
289,DangerOnTheRanger,31,0.01032,30389,10.11908,300314
290,guydog28,31,0.01032,30420,10.12940,300314
291,JanKoehnlein,31,0.01032,30451,10.13972,300314
292,jeesmon,31,0.01032,30482,10.15004,300314
293,joebowbeer,31,0.01032,30513,10.16037,300314
294,JoshLove-msft,31,0.01032,30544,10.17069,300314
295,jstewmon,31,0.01032,30575,10.18101,300314
296,nitgoy,31,0.01032,30606,10.19133,300314
297,Austin-Tan,30,0.00999,30636,10.20132,300314
298,bmayfi3ld,30,0.00999,30666,10.21131,300314
299,chandrasekhar1996,30,0.00999,30696,10.22130,300314
300,imeoer,30,0.00999,30726,10.23129,300314
301,joshuajorel,30,0.00999,30756,10.24128,300314
302,prymitive,30,0.00999,30786,10.25127,300314
303,Rakshith-R,30,0.00999,30816,10.26126,300314
304,srisatya1197,30,0.00999,30846,10.27125,300314
305,w0wn3r0,30,0.00999,30876,10.28124,300314
306,adabuleanu,29,0.00966,30905,10.29090,300314
307,alakesh,29,0.00966,30934,10.30055,300314
308,ChinYing-Li,29,0.00966,30963,10.31021,300314
309,nikhil1511,29,0.00966,30992,10.31987,300314
310,rficcaglia,29,0.00966,31021,10.32952,300314
311,sharkymcdongles,29,0.00966,31050,10.33918,300314
312,sincejune,29,0.00966,31079,10.34883,300314
313,strongjz,29,0.00966,31108,10.35849,300314
314,zhangzujian,29,0.00966,31137,10.36815,300314
315,AdamKorcz,28,0.00932,31165,10.37747,300314
316,AllenzhLi,28,0.00932,31193,10.38680,300314
317,bjsignalfx,28,0.00932,31221,10.39612,300314
318,bryce-b,28,0.00932,31249,10.40544,300314
319,cdk8s-automation,28,0.00932,31277,10.41477,300314
320,ChristianCiach,28,0.00932,31305,10.42409,300314
321,Debanitrkl,28,0.00932,31333,10.43341,300314
322,delong-coder,28,0.00932,31361,10.44274,300314
323,HaloFour,28,0.00932,31389,10.45206,300314
324,jtmalinowski,28,0.00932,31417,10.46138,300314
325,kopiczko,28,0.00932,31445,10.47071,300314
326,LeducH,28,0.00932,31473,10.48003,300314
327,littletiger123,28,0.00932,31501,10.48935,300314
328,timmysilv,28,0.00932,31529,10.49868,300314
329,WeavingGao,28,0.00932,31557,10.50800,300314
330,BatanGaming,27,0.00899,31584,10.51699,300314
331,ccchieh,27,0.00899,31611,10.52598,300314
332,dragcp,27,0.00899,31638,10.53497,300314
333,gracenng,27,0.00899,31665,10.54396,300314
334,hanamantagoudvk,27,0.00899,31692,10.55295,300314
335,mswiderski,27,0.00899,31719,10.56195,300314
336,ryanvazquez,27,0.00899,31746,10.57094,300314
337,sanwishe,27,0.00899,31773,10.57993,300314
338,t3hmrman,27,0.00899,31800,10.58892,300314
339,WalkerWang731,27,0.00899,31827,10.59791,300314
340,alertedsnake,26,0.00866,31853,10.60657,300314
341,asekretenko,26,0.00866,31879,10.61522,300314
342,bernokl,26,0.00866,31905,10.62388,300314
343,bhautikpip,26,0.00866,31931,10.63254,300314
344,Dkaykay,26,0.00866,31957,10.64120,300314
345,Elbehery,26,0.00866,31983,10.64985,300314
346,f41gh7,26,0.00866,32009,10.65851,300314
347,gyunnkim,26,0.00866,32035,10.66717,300314
348,mandelsoft,26,0.00866,32061,10.67583,300314
349,mhennoch,26,0.00866,32087,10.68448,300314
350,paulcarlton-ww,26,0.00866,32113,10.69314,300314
351,williamsfu99,26,0.00866,32139,10.70180,300314
352,zulh-civo,26,0.00866,32165,10.71046,300314
353,caipengbo,25,0.00832,32190,10.71878,300314
354,chaochn47,25,0.00832,32215,10.72711,300314
355,chenk008,25,0.00832,32240,10.73543,300314
356,chgl,25,0.00832,32265,10.74375,300314
357,dclendenan,25,0.00832,32290,10.75208,300314
358,galmasi,25,0.00832,32315,10.76040,300314
359,gnosek,25,0.00832,32340,10.76873,300314
360,hitanshu-mehta,25,0.00832,32365,10.77705,300314
361,humivo,25,0.00832,32390,10.78538,300314
362,iangregsondev,25,0.00832,32415,10.79370,300314
363,Jell,25,0.00832,32440,10.80203,300314
364,jveski,25,0.00832,32465,10.81035,300314
365,lfdominguez,25,0.00832,32490,10.81868,300314
366,lloydchang,25,0.00832,32515,10.82700,300314
367,maoyangLiu,25,0.00832,32540,10.83533,300314
368,mcwumbly,25,0.00832,32565,10.84365,300314
369,MikeEdgar,25,0.00832,32590,10.85197,300314
370,Misteur-Z,25,0.00832,32615,10.86030,300314
371,shuoliu1,25,0.00832,32640,10.86862,300314
372,thinpark,25,0.00832,32665,10.87695,300314
373,tydhot,25,0.00832,32690,10.88527,300314
374,yfauser,25,0.00832,32715,10.89360,300314
375,zhan9san,25,0.00832,32740,10.90192,300314
376,abhishekghiya,24,0.00799,32764,10.90991,300314
377,andreaskaris,24,0.00799,32788,10.91791,300314
378,bryce-anderson,24,0.00799,32812,10.92590,300314
379,caueasantos,24,0.00799,32836,10.93389,300314
380,codex70,24,0.00799,32860,10.94188,300314
381,davidkornel,24,0.00799,32884,10.94987,300314
382,demonCoder95,24,0.00799,32908,10.95786,300314
383,jacobmarble,24,0.00799,32932,10.96586,300314
384,jomasti,24,0.00799,32956,10.97385,300314
385,kkruk-sumo,24,0.00799,32980,10.98184,300314
386,kommendorkapten,24,0.00799,33004,10.98983,300314
387,mallick370,24,0.00799,33028,10.99782,300314
388,mdisibio,24,0.00799,33052,11.00581,300314
389,nswarnkar,24,0.00799,33076,11.01381,300314
390,phin1x,24,0.00799,33100,11.02180,300314
391,rck,24,0.00799,33124,11.02979,300314
392,synarete,24,0.00799,33148,11.03778,300314
393,vigothehacker,24,0.00799,33172,11.04577,300314
394,Waleed-Iqbal,24,0.00799,33196,11.05376,300314
395,wgslr,24,0.00799,33220,11.06176,300314
396,zhangshj-inspur,24,0.00799,33244,11.06975,300314
397,3pointer,23,0.00766,33267,11.07741,300314
398,AbdYsn,23,0.00766,33290,11.08506,300314
399,abhisheksinghbaghel,23,0.00766,33313,11.09272,300314
400,alecrajeev,23,0.00766,33336,11.10038,300314
401,anthr76,23,0.00766,33359,11.10804,300314
402,jacobsa,23,0.00766,33382,11.11570,300314
403,kassarl,23,0.00766,33405,11.12336,300314
404,nadworny,23,0.00766,33428,11.13102,300314
405,narcsfz,23,0.00766,33451,11.13867,300314
406,sanposhiho,23,0.00766,33474,11.14633,300314
407,sarandia,23,0.00766,33497,11.15399,300314
408,timbyr,23,0.00766,33520,11.16165,300314
409,wespanther,23,0.00766,33543,11.16931,300314
410,wshwsh12,23,0.00766,33566,11.17697,300314
411,Xunzhuo,23,0.00766,33589,11.18463,300314
412,zmberg,23,0.00766,33612,11.19229,300314
413,akavel,22,0.00733,33634,11.19961,300314
414,bac-w,22,0.00733,33656,11.20694,300314
415,changweige,22,0.00733,33678,11.21426,300314
416,C-Mejlak,22,0.00733,33700,11.22159,300314
417,conorevans,22,0.00733,33722,11.22891,300314
418,galemccommons,22,0.00733,33744,11.23624,300314
419,jijeesh,22,0.00733,33766,11.24357,300314
420,kaykhancheckpoint,22,0.00733,33788,11.25089,300314
421,merryzhou,22,0.00733,33810,11.25822,300314
422,mozillazg,22,0.00733,33832,11.26554,300314
423,qls152,22,0.00733,33854,11.27287,300314
424,Rodolfodc,22,0.00733,33876,11.28019,300314
425,rverma-nsl,22,0.00733,33898,11.28752,300314
426,slott56,22,0.00733,33920,11.29484,300314
427,smira,22,0.00733,33942,11.30217,300314
428,srprash,22,0.00733,33964,11.30950,300314
429,stoneshi-yunify,22,0.00733,33986,11.31682,300314
430,TannerGabriel,22,0.00733,34008,11.32415,300314
431,TomShawn,22,0.00733,34030,11.33147,300314
432,VivekThrivikraman-est,22,0.00733,34052,11.33880,300314
433,wenqiq,22,0.00733,34074,11.34612,300314
434,Abhishek357,21,0.00699,34095,11.35312,300314
435,arielvalentin,21,0.00699,34116,11.36011,300314
436,bai3shuo4,21,0.00699,34137,11.36710,300314
437,busser,21,0.00699,34158,11.37410,300314
438,Carmezim,21,0.00699,34179,11.38109,300314
439,ceclinux,21,0.00699,34200,11.38808,300314
440,djc,21,0.00699,34221,11.39507,300314
441,dkulchinsky,21,0.00699,34242,11.40207,300314
442,DreamEagle0,21,0.00699,34263,11.40906,300314
443,egandro,21,0.00699,34284,11.41605,300314
444,h4ghhh,21,0.00699,34305,11.42304,300314
445,haugenj,21,0.00699,34326,11.43004,300314
446,ike-ma,21,0.00699,34347,11.43703,300314
447,liufen90,21,0.00699,34368,11.44402,300314
448,ranchothu,21,0.00699,34389,11.45101,300314
449,sathieu,21,0.00699,34410,11.45801,300314
450,ShellyKa13,21,0.00699,34431,11.46500,300314
451,tumido,21,0.00699,34452,11.47199,300314
452,twghu,21,0.00699,34473,11.47899,300314
453,zhu733756,21,0.00699,34494,11.48598,300314
454,3Xpl0it3r,20,0.00666,34514,11.49264,300314
455,BobVanB,20,0.00666,34534,11.49930,300314
456,divolgin,20,0.00666,34554,11.50596,300314
457,eric846,20,0.00666,34574,11.51262,300314
458,ethernoy,20,0.00666,34594,11.51928,300314
459,harihud,20,0.00666,34614,11.52594,300314
460,Jerry-Ge,20,0.00666,34634,11.53260,300314
461,kskumgk63,20,0.00666,34654,11.53926,300314
462,LuizBuffa25,20,0.00666,34674,11.54592,300314
463,lut777,20,0.00666,34694,11.55257,300314
464,macrogreg,20,0.00666,34714,11.55923,300314
465,maheshkurund,20,0.00666,34734,11.56589,300314
466,marceloamaral,20,0.00666,34754,11.57255,300314
467,npecka,20,0.00666,34774,11.57921,300314
468,owent,20,0.00666,34794,11.58587,300314
469,patrick-stephens,20,0.00666,34814,11.59253,300314
470,Rast1234,20,0.00666,34834,11.59919,300314
471,realAaronWu,20,0.00666,34854,11.60585,300314
472,ruruiye,20,0.00666,34874,11.61251,300314
473,troydn,20,0.00666,34894,11.61917,300314
474,v-byte-cpu,20,0.00666,34914,11.62583,300314
475,vmihailenco,20,0.00666,34934,11.63249,300314
476,zhanghe9702,20,0.00666,34954,11.63915,300314
477,aaron-kasten,19,0.00633,34973,11.64548,300314
478,abhinav454,19,0.00633,34992,11.65180,300314
479,adriangonciarz,19,0.00633,35011,11.65813,300314
480,alexmnyc,19,0.00633,35030,11.66446,300314
481,alexpantyukhin,19,0.00633,35049,11.67078,300314
482,allenporter,19,0.00633,35068,11.67711,300314
483,avrittrohwer,19,0.00633,35087,11.68344,300314
484,book987,19,0.00633,35106,11.68976,300314
485,CraneShiEMC,19,0.00633,35125,11.69609,300314
486,d-van,19,0.00633,35144,11.70242,300314
487,electrical,19,0.00633,35163,11.70874,300314
488,fanriming,19,0.00633,35182,11.71507,300314
489,himanshu007-creator,19,0.00633,35201,11.72140,300314
490,janaganh,19,0.00633,35220,11.72772,300314
491,jandersen-plaid,19,0.00633,35239,11.73405,300314
492,jasiam,19,0.00633,35258,11.74038,300314
493,jgwest,19,0.00633,35277,11.74671,300314
494,Legion2,19,0.00633,35296,11.75303,300314
495,lunhuijie,19,0.00633,35315,11.75936,300314
496,Malax,19,0.00633,35334,11.76569,300314
497,PiratkaXx,19,0.00633,35353,11.77201,300314
498,pratikgote,19,0.00633,35372,11.77834,300314
499,roederja2,19,0.00633,35391,11.78467,300314
500,sergeyshevch,19,0.00633,35410,11.79099,300314
501,siyuan0322,19,0.00633,35429,11.79732,300314
502,smckay-signifyd,19,0.00633,35448,11.80365,300314
503,sshah90,19,0.00633,35467,11.80997,300314
504,tavishvaidya,19,0.00633,35486,11.81630,300314
505,TianTianBigWang,19,0.00633,35505,11.82263,300314
506,valinskas,19,0.00633,35524,11.82895,300314
507,wangmeng99,19,0.00633,35543,11.83528,300314
508,yangshuothtf,19,0.00633,35562,11.84161,300314
509,artemkrim,18,0.00599,35580,11.84760,300314
510,Atharva321,18,0.00599,35598,11.85359,300314
511,BinaryHB0916,18,0.00599,35616,11.85959,300314
512,cedy,18,0.00599,35634,11.86558,300314
513,crazycs520,18,0.00599,35652,11.87157,300314
514,danrusei,18,0.00599,35670,11.87757,300314
515,dragonbone81,18,0.00599,35688,11.88356,300314
516,dty1er,18,0.00599,35706,11.88956,300314
517,dyzsr,18,0.00599,35724,11.89555,300314
518,eddyleelin,18,0.00599,35742,11.90154,300314
519,enderv,18,0.00599,35760,11.90754,300314
520,gprossliner,18,0.00599,35778,11.91353,300314
521,gridworkz,18,0.00599,35796,11.91952,300314
522,H3rman8,18,0.00599,35814,11.92552,300314
523,hanjm,18,0.00599,35832,11.93151,300314
524,hkdsun,18,0.00599,35850,11.93751,300314
525,iliveforfun,18,0.00599,35868,11.94350,300314
526,jfcg,18,0.00599,35886,11.94949,300314
527,jothi-prasad,18,0.00599,35904,11.95549,300314
528,kipwoker,18,0.00599,35922,11.96148,300314
529,krya-kryak,18,0.00599,35940,11.96747,300314
530,leiysky,18,0.00599,35958,11.97347,300314
531,mickkael,18,0.00599,35976,11.97946,300314
532,msg555,18,0.00599,35994,11.98546,300314
533,nelsonghezzi,18,0.00599,36012,11.99145,300314
534,padraigobrien,18,0.00599,36030,11.99744,300314
535,schanjr,18,0.00599,36048,12.00344,300314
536,sdmodi,18,0.00599,36066,12.00943,300314
537,sgirem463,18,0.00599,36084,12.01542,300314
538,StefanSa,18,0.00599,36102,12.02142,300314
539,su225,18,0.00599,36120,12.02741,300314
540,tczhao,18,0.00599,36138,12.03341,300314
541,voutcn,18,0.00599,36156,12.03940,300314
542,witekest,18,0.00599,36174,12.04539,300314
543,yangjun289519474,18,0.00599,36192,12.05139,300314
544,Z0Marlin,18,0.00599,36210,12.05738,300314
545,acsecengtesting,17,0.00566,36227,12.06304,300314
546,adrdc,17,0.00566,36244,12.06870,300314
547,aheng-ch,17,0.00566,36261,12.07436,300314
548,alexey-pankratyev,17,0.00566,36278,12.08002,300314
549,alien-ike,17,0.00566,36295,12.08568,300314
550,amarjothi,17,0.00566,36312,12.09134,300314
551,arne-rusek,17,0.00566,36329,12.09701,300314
552,au-akash,17,0.00566,36346,12.10267,300314
553,cdavernas,17,0.00566,36363,12.10833,300314
554,cfzjywxk,17,0.00566,36380,12.11399,300314
555,cosven,17,0.00566,36397,12.11965,300314
556,cutiechi,17,0.00566,36414,12.12531,300314
557,cynthiakedu,17,0.00566,36431,12.13097,300314
558,Damans227,17,0.00566,36448,12.13663,300314
559,Deepak1100,17,0.00566,36465,12.14229,300314
560,didiladi,17,0.00566,36482,12.14795,300314
561,edsoncelio,17,0.00566,36499,12.15361,300314
562,ethervoid,17,0.00566,36516,12.15927,300314
563,gabegorelick,17,0.00566,36533,12.16493,300314
564,ggardet,17,0.00566,36550,12.17059,300314
565,Hangzhi,17,0.00566,36567,12.17626,300314
566,humancalico,17,0.00566,36584,12.18192,300314
567,Jammicus,17,0.00566,36601,12.18758,300314
568,juntao,17,0.00566,36618,12.19324,300314
569,Kappie37,17,0.00566,36635,12.19890,300314
570,lobziik,17,0.00566,36652,12.20456,300314
571,malza321,17,0.00566,36669,12.21022,300314
572,MandssS,17,0.00566,36686,12.21588,300314
573,melnikalex,17,0.00566,36703,12.22154,300314
574,mruoss,17,0.00566,36720,12.22720,300314
575,mstumpfx,17,0.00566,36737,12.23286,300314
576,nikclayton-dfinity,17,0.00566,36754,12.23852,300314
577,ntgsx92,17,0.00566,36771,12.24418,300314
578,patrasap0908,17,0.00566,36788,12.24985,300314
579,pedjak,17,0.00566,36805,12.25551,300314
580,pranavmarla,17,0.00566,36822,12.26117,300314
581,psmit,17,0.00566,36839,12.26683,300314
582,snuggie12,17,0.00566,36856,12.27249,300314
583,snyksec,17,0.00566,36873,12.27815,300314
584,stuh84,17,0.00566,36890,12.28381,300314
585,tico24,17,0.00566,36907,12.28947,300314
586,timmyyuan,17,0.00566,36924,12.29513,300314
587,treble-snake,17,0.00566,36941,12.30079,300314
588,TymonXie,17,0.00566,36958,12.30645,300314
589,vishjain,17,0.00566,36975,12.31211,300314
590,w3st3ry,17,0.00566,36992,12.31777,300314
591,watcher00090,17,0.00566,37009,12.32343,300314
592,wpeng102,17,0.00566,37026,12.32910,300314
593,zqzten,17,0.00566,37043,12.33476,300314
594,zxh326,17,0.00566,37060,12.34042,300314
595,0yi0,16,0.00533,37076,12.34574,300314
596,aakifshaikh,16,0.00533,37092,12.35107,300314
597,andrehaland,16,0.00533,37108,12.35640,300314
598,blame19,16,0.00533,37124,12.36173,300314
599,christle,16,0.00533,37140,12.36706,300314
600,CodingSpiderFox,16,0.00533,37156,12.37238,300314
601,cuirunxing-hub,16,0.00533,37172,12.37771,300314
602,cyran-ryan,16,0.00533,37188,12.38304,300314
603,dajudge,16,0.00533,37204,12.38837,300314
604,danieldin95,16,0.00533,37220,12.39369,300314
605,erikburgess,16,0.00533,37236,12.39902,300314
606,evkuzin,16,0.00533,37252,12.40435,300314
607,gecube,16,0.00533,37268,12.40968,300314
608,Gerrit-K,16,0.00533,37284,12.41501,300314
609,gr8Adakron,16,0.00533,37300,12.42033,300314
610,gswai123,16,0.00533,37316,12.42566,300314
611,gunturaf,16,0.00533,37332,12.43099,300314
612,HannahShiSFB,16,0.00533,37348,12.43632,300314
613,hty690,16,0.00533,37364,12.44164,300314
614,iblancasa,16,0.00533,37380,12.44697,300314
615,idoqo,16,0.00533,37396,12.45230,300314
616,josecordaz,16,0.00533,37412,12.45763,300314
617,jozenstar,16,0.00533,37428,12.46296,300314
618,jralmaraz,16,0.00533,37444,12.46828,300314
619,jronnblom,16,0.00533,37460,12.47361,300314
620,litmusbot,16,0.00533,37476,12.47894,300314
621,LuckySB,16,0.00533,37492,12.48427,300314
622,luoMonkeyKing,16,0.00533,37508,12.48959,300314
623,MartinKanters,16,0.00533,37524,12.49492,300314
624,mengmichael1,16,0.00533,37540,12.50025,300314
625,sej7278,16,0.00533,37556,12.50558,300314
626,StingyJack,16,0.00533,37572,12.51091,300314
627,sunpa93,16,0.00533,37588,12.51623,300314
628,tianyaqu,16,0.00533,37604,12.52156,300314
629,xdu31,16,0.00533,37620,12.52689,300314
630,xuhdev,16,0.00533,37636,12.53222,300314
631,yebyen,16,0.00533,37652,12.53754,300314
632,zhelongp,16,0.00533,37668,12.54287,300314
633,zsistla,16,0.00533,37684,12.54820,300314
634,2fst4u,15,0.00499,37699,12.55319,300314
635,56quarters,15,0.00499,37714,12.55819,300314
636,amyangfei,15,0.00499,37729,12.56318,300314
637,artis3n,15,0.00499,37744,12.56818,300314
638,atheriel,15,0.00499,37759,12.57317,300314
639,benjaminguttmann-avtq,15,0.00499,37774,12.57817,300314
640,bhkamath,15,0.00499,37789,12.58316,300314
641,bodleytunes,15,0.00499,37804,12.58816,300314
642,caseywebdev,15,0.00499,37819,12.59315,300314
643,charles-woshicai,15,0.00499,37834,12.59815,300314
644,christianang,15,0.00499,37849,12.60314,300314
645,cocampbe,15,0.00499,37864,12.60814,300314
646,CSP197,15,0.00499,37879,12.61313,300314
647,dmikusa-pivotal,15,0.00499,37894,12.61813,300314
648,eroteme,15,0.00499,37909,12.62312,300314
649,flavorjones,15,0.00499,37924,12.62812,300314
650,hashweather,15,0.00499,37939,12.63311,300314
651,HelloKunal,15,0.00499,37954,12.63811,300314
652,hex0punk,15,0.00499,37969,12.64310,300314
653,JackZxj,15,0.00499,37984,12.64809,300314
654,jasonatball,15,0.00499,37999,12.65309,300314
655,Jenniferstrej,15,0.00499,38014,12.65808,300314
656,jschintag,15,0.00499,38029,12.66308,300314
657,judyQD,15,0.00499,38044,12.66807,300314
658,Kernald,15,0.00499,38059,12.67307,300314
659,kikimo,15,0.00499,38074,12.67806,300314
660,mhofstetter,15,0.00499,38089,12.68306,300314
661,mmontalvo,15,0.00499,38104,12.68805,300314
662,mpetason,15,0.00499,38119,12.69305,300314
663,mzzgaopeng,15,0.00499,38134,12.69804,300314
664,n888,15,0.00499,38149,12.70304,300314
665,nolimitkun,15,0.00499,38164,12.70803,300314
666,pmatyjasek-sumo,15,0.00499,38179,12.71303,300314
667,rahul799,15,0.00499,38194,12.71802,300314
668,RicardoNalesAmato,15,0.00499,38209,12.72302,300314
669,ScottGarman,15,0.00499,38224,12.72801,300314
670,sunface,15,0.00499,38239,12.73301,300314
671,Victorzsg,15,0.00499,38254,12.73800,300314
672,vinzo99,15,0.00499,38269,12.74300,300314
673,Xxllj834738992,15,0.00499,38284,12.74799,300314
674,ZainubW,15,0.00499,38299,12.75299,300314
675,Abhishek-Srivastava,14,0.00466,38313,12.75765,300314
676,Abirdcfly,14,0.00466,38327,12.76231,300314
677,adamantike,14,0.00466,38341,12.76697,300314
678,alfredgamulo,14,0.00466,38355,12.77163,300314
679,Aman-Codes,14,0.00466,38369,12.77629,300314
680,andyyumiao,14,0.00466,38383,12.78096,300314
681,being-vishal,14,0.00466,38397,12.78562,300314
682,bodgit,14,0.00466,38411,12.79028,300314
683,caoyingjunz,14,0.00466,38425,12.79494,300314
684,davidsbond,14,0.00466,38439,12.79960,300314
685,e96wic,14,0.00466,38453,12.80426,300314
686,elruwen,14,0.00466,38467,12.80893,300314
687,fyang86,14,0.00466,38481,12.81359,300314
688,gaoliangdut,14,0.00466,38495,12.81825,300314
689,GaryPWhite,14,0.00466,38509,12.82291,300314
690,gaurav517,14,0.00466,38523,12.82757,300314
691,heatheralee,14,0.00466,38537,12.83224,300314
692,hsmatulisgoogle,14,0.00466,38551,12.83690,300314
693,iassurewipro,14,0.00466,38565,12.84156,300314
694,Inode1,14,0.00466,38579,12.84622,300314
695,jailton,14,0.00466,38593,12.85088,300314
696,jigyasak05,14,0.00466,38607,12.85554,300314
697,jiridanek,14,0.00466,38621,12.86021,300314
698,jonathanvila,14,0.00466,38635,12.86487,300314
699,joostas,14,0.00466,38649,12.86953,300314
700,jorgevillaverde,14,0.00466,38663,12.87419,300314
701,joshua-bone,14,0.00466,38677,12.87885,300314
702,jsirianni,14,0.00466,38691,12.88352,300314
703,Jun10ng,14,0.00466,38705,12.88818,300314
704,kevinteg,14,0.00466,38719,12.89284,300314
705,littlegreyzhang,14,0.00466,38733,12.89750,300314
706,lmq1999,14,0.00466,38747,12.90216,300314
707,logeable,14,0.00466,38761,12.90682,300314
708,LukeMathWalker,14,0.00466,38775,12.91149,300314
709,maskarb,14,0.00466,38789,12.91615,300314
710,MaxRenaud,14,0.00466,38803,12.92081,300314
711,michalzxc,14,0.00466,38817,12.92547,300314
712,mladedav,14,0.00466,38831,12.93013,300314
713,murex971,14,0.00466,38845,12.93479,300314
714,NickSulistio,14,0.00466,38859,12.93946,300314
715,OPSTime,14,0.00466,38873,12.94412,300314
716,owt5008137,14,0.00466,38887,12.94878,300314
717,plevart,14,0.00466,38901,12.95344,300314
718,poconnor1,14,0.00466,38915,12.95810,300314
719,Poorunga,14,0.00466,38929,12.96277,300314
720,praveengt,14,0.00466,38943,12.96743,300314
721,qqustc,14,0.00466,38957,12.97209,300314
722,RockyFu267,14,0.00466,38971,12.97675,300314
723,rumstead,14,0.00466,38985,12.98141,300314
724,sniperking1234,14,0.00466,38999,12.98607,300314
725,TejasQ,14,0.00466,39013,12.99074,300314
726,tobisinghania,14,0.00466,39027,12.99540,300314
727,tommyjcarpenter,14,0.00466,39041,13.00006,300314
728,Wander1024,14,0.00466,39055,13.00472,300314
729,yiwenh,14,0.00466,39069,13.00938,300314
730,yojay11717,14,0.00466,39083,13.01405,300314
731,205g0,13,0.00433,39096,13.01837,300314
732,abhranilc,13,0.00433,39109,13.02270,300314
733,AdityaC45,13,0.00433,39122,13.02703,300314
734,akalenyu,13,0.00433,39135,13.03136,300314
735,alabulei1,13,0.00433,39148,13.03569,300314
736,asadali,13,0.00433,39161,13.04002,300314
737,bbarnes52,13,0.00433,39174,13.04435,300314
738,boringuy,13,0.00433,39187,13.04868,300314
739,ByoungJoonIm,13,0.00433,39200,13.05300,300314
740,cebernardi,13,0.00433,39213,13.05733,300314
741,clarshad,13,0.00433,39226,13.06166,300314
742,Dragoncell,13,0.00433,39239,13.06599,300314
743,ElisaMeng,13,0.00433,39252,13.07032,300314
744,everton-nasc,13,0.00433,39265,13.07465,300314
745,franciosi,13,0.00433,39278,13.07898,300314
746,Fred78290,13,0.00433,39291,13.08331,300314
747,genevieve,13,0.00433,39304,13.08763,300314
748,ghuntley,13,0.00433,39317,13.09196,300314
749,gokulnair,13,0.00433,39330,13.09629,300314
750,GrooveCS,13,0.00433,39343,13.10062,300314
751,gtzefrain,13,0.00433,39356,13.10495,300314
752,HamzaZo,13,0.00433,39369,13.10928,300314
753,hisa-tanaka,13,0.00433,39382,13.11361,300314
754,HppZ,13,0.00433,39395,13.11794,300314
755,iven,13,0.00433,39408,13.12227,300314
756,jemisonf,13,0.00433,39421,13.12659,300314
757,JesusAlvarezTorres,13,0.00433,39434,13.13092,300314
758,jevgenimarenkov,13,0.00433,39447,13.13525,300314
759,jonathan-innis,13,0.00433,39460,13.13958,300314
760,Jukie,13,0.00433,39473,13.14391,300314
761,jyz0309,13,0.00433,39486,13.14824,300314
762,kostas-theo,13,0.00433,39499,13.15257,300314
763,kunal-kushwaha,13,0.00433,39512,13.15690,300314
764,leoluz,13,0.00433,39525,13.16122,300314
765,levsha,13,0.00433,39538,13.16555,300314
766,loganmc10,13,0.00433,39551,13.16988,300314
767,m1pl,13,0.00433,39564,13.17421,300314
768,minbaev,13,0.00433,39577,13.17854,300314
769,nearora-msft,13,0.00433,39590,13.18287,300314
770,niulechuan,13,0.00433,39603,13.18720,300314
771,NovaHe,13,0.00433,39616,13.19153,300314
772,Oleg26Dev,13,0.00433,39629,13.19586,300314
773,QIvan,13,0.00433,39642,13.20018,300314
774,Radha13,13,0.00433,39655,13.20451,300314
775,rgolangh,13,0.00433,39668,13.20884,300314
776,rupang790,13,0.00433,39681,13.21317,300314
777,ShubhamTatvamasi,13,0.00433,39694,13.21750,300314
778,softmarch,13,0.00433,39707,13.22183,300314
779,St0rmingBr4in,13,0.00433,39720,13.22616,300314
780,steveprabha,13,0.00433,39733,13.23049,300314
781,stnor,13,0.00433,39746,13.23481,300314
782,s-u-b-h-a-k-a-r,13,0.00433,39759,13.23914,300314
783,t2t2,13,0.00433,39772,13.24347,300314
784,tchupp,13,0.00433,39785,13.24780,300314
785,thxCode,13,0.00433,39798,13.25213,300314
786,tibbe,13,0.00433,39811,13.25646,300314
787,TszKitLo40,13,0.00433,39824,13.26079,300314
788,urso,13,0.00433,39837,13.26512,300314
789,vaibhavjainwiz,13,0.00433,39850,13.26944,300314
790,vreynolds,13,0.00433,39863,13.27377,300314
791,wangrzneu,13,0.00433,39876,13.27810,300314
792,yaoyao12138,13,0.00433,39889,13.28243,300314
793,zhaogaolong,13,0.00433,39902,13.28676,300314
794,zidhumenon,13,0.00433,39915,13.29109,300314
795,zr-msft,13,0.00433,39928,13.29542,300314
796,alex-vmw,12,0.00400,39940,13.29941,300314
797,amanchourasiya,12,0.00400,39952,13.30341,300314
798,amirschw,12,0.00400,39964,13.30740,300314
799,ananda1066,12,0.00400,39976,13.31140,300314
800,anderson4u2,12,0.00400,39988,13.31540,300314
801,avelichka,12,0.00400,40000,13.31939,300314
802,baoervsdier,12,0.00400,40012,13.32339,300314
803,bgdnlp,12,0.00400,40024,13.32738,300314
804,brunzefb,12,0.00400,40036,13.33138,300314
805,bryan-aguilar,12,0.00400,40048,13.33538,300314
806,C123R,12,0.00400,40060,13.33937,300314
807,callumeveratt,12,0.00400,40072,13.34337,300314
808,clambin,12,0.00400,40084,13.34736,300314
809,cyclops8456,12,0.00400,40096,13.35136,300314
810,dengliming,12,0.00400,40108,13.35535,300314
811,didof,12,0.00400,40120,13.35935,300314
812,digambar15,12,0.00400,40132,13.36335,300314
813,fbalicchia,12,0.00400,40144,13.36734,300314
814,fjammes,12,0.00400,40156,13.37134,300314
815,frankgu968,12,0.00400,40168,13.37533,300314
816,gerardgorrion,12,0.00400,40180,13.37933,300314
817,goreleaserbot,12,0.00400,40192,13.38333,300314
818,hendra-2020,12,0.00400,40204,13.38732,300314
819,holmesb,12,0.00400,40216,13.39132,300314
820,HubertStefanski,12,0.00400,40228,13.39531,300314
821,jamesmulcahy,12,0.00400,40240,13.39931,300314
822,jckling,12,0.00400,40252,13.40330,300314
823,jdziat,12,0.00400,40264,13.40730,300314
824,jiangkaihua,12,0.00400,40276,13.41130,300314
825,jobbler,12,0.00400,40288,13.41529,300314
826,JoeRegnier,12,0.00400,40300,13.41929,300314
827,johnduhart,12,0.00400,40312,13.42328,300314
828,joostschriek,12,0.00400,40324,13.42728,300314
829,Juneezee,12,0.00400,40336,13.43128,300314
830,justinrush,12,0.00400,40348,13.43527,300314
831,Jw-Jm,12,0.00400,40360,13.43927,300314
832,kgtw,12,0.00400,40372,13.44326,300314
833,kmag,12,0.00400,40384,13.44726,300314
834,KrissiWi,12,0.00400,40396,13.45125,300314
835,landesherr,12,0.00400,40408,13.45525,300314
836,love-miao,12,0.00400,40420,13.45925,300314
837,LWJ,12,0.00400,40432,13.46324,300314
838,max3903,12,0.00400,40444,13.46724,300314
839,mballoni,12,0.00400,40456,13.47123,300314
840,MengmengZHANG,12,0.00400,40468,13.47523,300314
841,morremeyer,12,0.00400,40480,13.47923,300314
842,mritunjaysharma394,12,0.00400,40492,13.48322,300314
843,Niekvdplas,12,0.00400,40504,13.48722,300314
844,NomadXD,12,0.00400,40516,13.49121,300314
845,pankaj892,12,0.00400,40528,13.49521,300314
846,payall4u,12,0.00400,40540,13.49920,300314
847,Pranava29,12,0.00400,40552,13.50320,300314
848,renuka-fernando,12,0.00400,40564,13.50720,300314
849,sgtsquiggs,12,0.00400,40576,13.51119,300314
850,shibataka000,12,0.00400,40588,13.51519,300314
851,skri547,12,0.00400,40600,13.51918,300314
852,skyline75489,12,0.00400,40612,13.52318,300314
853,smcavallo,12,0.00400,40624,13.52717,300314
854,soschwei,12,0.00400,40636,13.53117,300314
855,sxd,12,0.00400,40648,13.53517,300314
856,tjstansell,12,0.00400,40660,13.53916,300314
857,umialpha,12,0.00400,40672,13.54316,300314
858,vagdevik,12,0.00400,40684,13.54715,300314
859,vj4iosdev,12,0.00400,40696,13.55115,300314
860,vmuzikar,12,0.00400,40708,13.55515,300314
861,welborntellis,12,0.00400,40720,13.55914,300314
862,Wenliang-CHEN,12,0.00400,40732,13.56314,300314
863,xiqiu618,12,0.00400,40744,13.56713,300314
864,XudongLiuHarold,12,0.00400,40756,13.57113,300314
865,zcc35357949,12,0.00400,40768,13.57512,300314
866,zecke,12,0.00400,40780,13.57912,300314
867,1Psy,11,0.00366,40791,13.58278,300314
868,acharisshopify,11,0.00366,40802,13.58645,300314
869,amitkatyal,11,0.00366,40813,13.59011,300314
870,arnogeurts-sqills,11,0.00366,40824,13.59377,300314
871,Ayatallah,11,0.00366,40835,13.59743,300314
872,benjamincburns,11,0.00366,40846,13.60110,300314
873,bradmccoydev,11,0.00366,40857,13.60476,300314
874,bravecobra,11,0.00366,40868,13.60842,300314
875,chengshiwen,11,0.00366,40879,13.61209,300314
876,chris-giblin,11,0.00366,40890,13.61575,300314
877,christopheblin,11,0.00366,40901,13.61941,300314
878,chuanhaojin,11,0.00366,40912,13.62307,300314
879,CMCDragonkai,11,0.00366,40923,13.62674,300314
880,cocotyty,11,0.00366,40934,13.63040,300314
881,courtneypacheco,11,0.00366,40945,13.63406,300314
882,csnance,11,0.00366,40956,13.63773,300314
883,dabaooline,11,0.00366,40967,13.64139,300314
884,danielhass,11,0.00366,40978,13.64505,300314
885,dawid-nowak,11,0.00366,40989,13.64871,300314
886,Diaoul,11,0.00366,41000,13.65238,300314
887,dsbos,11,0.00366,41011,13.65604,300314
888,dudicoco,11,0.00366,41022,13.65970,300314
889,EdVinyard,11,0.00366,41033,13.66337,300314
890,f1r3starter,11,0.00366,41044,13.66703,300314
891,felipegcampos,11,0.00366,41055,13.67069,300314
892,ganeshniyer,11,0.00366,41066,13.67435,300314
893,golgotow,11,0.00366,41077,13.67802,300314
894,gozssky,11,0.00366,41088,13.68168,300314
895,GuangchaoDeng,11,0.00366,41099,13.68534,300314
896,HaveFun83,11,0.00366,41110,13.68901,300314
897,heqg,11,0.00366,41121,13.69267,300314
898,heriet,11,0.00366,41132,13.69633,300314
899,huiwq1990,11,0.00366,41143,13.69999,300314
900,ildikov,11,0.00366,41154,13.70366,300314
901,ionutz89,11,0.00366,41165,13.70732,300314
902,ishitasequeira,11,0.00366,41176,13.71098,300314
903,ivomagi,11,0.00366,41187,13.71465,300314
904,jack1902,11,0.00366,41198,13.71831,300314
905,Jainbrt,11,0.00366,41209,13.72197,300314
906,jfrabaute,11,0.00366,41220,13.72563,300314
907,jjshanks,11,0.00366,41231,13.72930,300314
908,jnodorp-jaconi,11,0.00366,41242,13.73296,300314
909,johejo,11,0.00366,41253,13.73662,300314
910,justinmchase,11,0.00366,41264,13.74029,300314
911,libaoan,11,0.00366,41275,13.74395,300314
912,liuqi-sun,11,0.00366,41286,13.74761,300314
913,lowc1012,11,0.00366,41297,13.75127,300314
914,ludydoo,11,0.00366,41308,13.75494,300314
915,lukonjun,11,0.00366,41319,13.75860,300314
916,martin-ducar-gd,11,0.00366,41330,13.76226,300314
917,mazocode,11,0.00366,41341,13.76592,300314
918,mhoyer,11,0.00366,41352,13.76959,300314
919,moadqassem,11,0.00366,41363,13.77325,300314
920,mshitrit,11,0.00366,41374,13.77691,300314
921,nasirkamal,11,0.00366,41385,13.78058,300314
922,Nerzal,11,0.00366,41396,13.78424,300314
923,nicomitchell,11,0.00366,41407,13.78790,300314
924,nilekhc,11,0.00366,41418,13.79156,300314
925,nimbinatus,11,0.00366,41429,13.79523,300314
926,Nordes,11,0.00366,41440,13.79889,300314
927,parkedwards,11,0.00366,41451,13.80255,300314
928,pballok-logmein,11,0.00366,41462,13.80622,300314
929,priyavj08,11,0.00366,41473,13.80988,300314
930,pupseba,11,0.00366,41484,13.81354,300314
931,rayterrill,11,0.00366,41495,13.81720,300314
932,robbkidd,11,0.00366,41506,13.82087,300314
933,Rui-Tang,11,0.00366,41517,13.82453,300314
934,saharMlowell,11,0.00366,41528,13.82819,300314
935,sarahbx,11,0.00366,41539,13.83186,300314
936,siddhartha97,11,0.00366,41550,13.83552,300314
937,smnmtzgr,11,0.00366,41561,13.83918,300314
938,soeirosantos,11,0.00366,41572,13.84284,300314
939,Sreevani871,11,0.00366,41583,13.84651,300314
940,stevenshuang,11,0.00366,41594,13.85017,300314
941,sunnoy,11,0.00366,41605,13.85383,300314
942,surendarkaniops,11,0.00366,41616,13.85750,300314
943,thehajime,11,0.00366,41627,13.86116,300314
944,tomastigera,11,0.00366,41638,13.86482,300314
945,ubcharron,11,0.00366,41649,13.86848,300314
946,viovanov,11,0.00366,41660,13.87215,300314
947,whfuyn,11,0.00366,41671,13.87581,300314
948,williambrode,11,0.00366,41682,13.87947,300314
949,xinchenyixian,11,0.00366,41693,13.88314,300314
950,yangxiaoliang,11,0.00366,41704,13.88680,300314
951,ybhagwatkar,11,0.00366,41715,13.89046,300314
952,yunhjiang,11,0.00366,41726,13.89412,300314
953,zengyongjie,11,0.00366,41737,13.89779,300314
954,zhaochengwei,11,0.00366,41748,13.90145,300314
955,zongke,11,0.00366,41759,13.90511,300314
956,zwtop,11,0.00366,41770,13.90878,300314
957,13567436138,10,0.00333,41780,13.91211,300314
958,4s3ti,10,0.00333,41790,13.91544,300314
959,ajosep514,10,0.00333,41800,13.91877,300314
960,AkshayDubey29,10,0.00333,41810,13.92209,300314
961,alanprot,10,0.00333,41820,13.92542,300314
962,alex-berger,10,0.00333,41830,13.92875,300314
963,amorey,10,0.00333,41840,13.93208,300314
964,ankitnayan,10,0.00333,41850,13.93541,300314
965,anthony-pastor,10,0.00333,41860,13.93874,300314
966,Arnavion,10,0.00333,41870,13.94207,300314
967,AshRing,10,0.00333,41880,13.94540,300314
968,AswinTimalsina,10,0.00333,41890,13.94873,300314
969,beyondyinjl2,10,0.00333,41900,13.95206,300314
970,binchenX,10,0.00333,41910,13.95539,300314
971,Biswajitghosh98,10,0.00333,41920,13.95872,300314
972,blublinsky,10,0.00333,41930,13.96205,300314
973,carbonetes,10,0.00333,41940,13.96538,300314
974,cdvv7788,10,0.00333,41950,13.96871,300314
975,chasekiefer,10,0.00333,41960,13.97204,300314
976,chtcvl,10,0.00333,41970,13.97537,300314
977,cyril-corbon,10,0.00333,41980,13.97870,300314
978,cyrilcros,10,0.00333,41990,13.98203,300314
979,dfeldman,10,0.00333,42000,13.98536,300314
980,dorinclisu,10,0.00333,42010,13.98869,300314
981,eddycharly,10,0.00333,42020,13.99202,300314
982,fishcakez,10,0.00333,42030,13.99535,300314
983,Fish-pro,10,0.00333,42040,13.99868,300314
984,GaboFrontDev,10,0.00333,42050,14.00201,300314
985,hai046,10,0.00333,42060,14.00534,300314
986,huineng,10,0.00333,42070,14.00867,300314
987,iboonox,10,0.00333,42080,14.01200,300314
988,iocumine,10,0.00333,42090,14.01533,300314
989,Irma12,10,0.00333,42100,14.01866,300314
990,jabbermouth,10,0.00333,42110,14.02199,300314
991,jasonliu747,10,0.00333,42120,14.02532,300314
992,jaypume,10,0.00333,42130,14.02865,300314
993,JennyMet,10,0.00333,42140,14.03198,300314
994,jewertow,10,0.00333,42150,14.03531,300314
995,jlunavtgrad,10,0.00333,42160,14.03864,300314
996,Joseph-Goergen,10,0.00333,42170,14.04197,300314
997,justin-mp,10,0.00333,42180,14.04530,300314
998,jzyeezy,10,0.00333,42190,14.04863,300314
999,ktoso,10,0.00333,42200,14.05196,300314
1000,kyle-burnette,10,0.00333,42210,14.05529,300314
1001,lagalbra,10,0.00333,42220,14.05862,300314
1002,leiw324,10,0.00333,42230,14.06195,300314
1003,lin1005q,10,0.00333,42240,14.06528,300314
1004,mailhari,10,0.00333,42250,14.06861,300314
1005,marcstreeter,10,0.00333,42260,14.07194,300314
1006,MartinMa28,10,0.00333,42270,14.07527,300314
1007,milasuperstar,10,0.00333,42280,14.07860,300314
1008,morlay,10,0.00333,42290,14.08193,300314
1009,MyannaHarris,10,0.00333,42300,14.08526,300314
1010,niya3,10,0.00333,42310,14.08859,300314
1011,njegosrailic,10,0.00333,42320,14.09192,300314
1012,OGtrilliams,10,0.00333,42330,14.09525,300314
1013,ougfh,10,0.00333,42340,14.09858,300314
1014,padmaja-nadkarni,10,0.00333,42350,14.10191,300314
1015,pangsq,10,0.00333,42360,14.10524,300314
1016,perenesenko,10,0.00333,42370,14.10857,300314
1017,PPCM,10,0.00333,42380,14.11190,300314
1018,prasus,10,0.00333,42390,14.11523,300314
1019,primael,10,0.00333,42400,14.11856,300314
1020,pyiyun,10,0.00333,42410,14.12189,300314
1021,Rania-Bojar,10,0.00333,42420,14.12522,300314
1022,rcousineau-xandr,10,0.00333,42430,14.12855,300314
1023,rialg,10,0.00333,42440,14.13188,300314
1024,rittneje,10,0.00333,42450,14.13521,300314
1025,Ruminateer,10,0.00333,42460,14.13854,300314
1026,rward27,10,0.00333,42470,14.14186,300314
1027,salarali,10,0.00333,42480,14.14519,300314
1028,sandaymin123,10,0.00333,42490,14.14852,300314
1029,scott-grimes,10,0.00333,42500,14.15185,300314
1030,sirianni,10,0.00333,42510,14.15518,300314
1031,skdasari-inndata,10,0.00333,42520,14.15851,300314
1032,slernersplunk,10,0.00333,42530,14.16184,300314
1033,s-nadendla,10,0.00333,42540,14.16517,300314
1034,snir911,10,0.00333,42550,14.16850,300314
1035,stefan-zh,10,0.00333,42560,14.17183,300314
1036,steled,10,0.00333,42570,14.17516,300314
1037,sumit-badaya,10,0.00333,42580,14.17849,300314
1038,tgelter,10,0.00333,42590,14.18182,300314
1039,thaodt,10,0.00333,42600,14.18515,300314
1040,tinkerborg,10,0.00333,42610,14.18848,300314
1041,TomHennen,10,0.00333,42620,14.19181,300314
1042,torbjornvatn,10,0.00333,42630,14.19514,300314
1043,victormorfin97,10,0.00333,42640,14.19847,300314
1044,vishweshbankwar,10,0.00333,42650,14.20180,300314
1045,WintonChan,10,0.00333,42660,14.20513,300314
1046,wrighbr,10,0.00333,42670,14.20846,300314
1047,wxuedong,10,0.00333,42680,14.21179,300314
1048,xiang17,10,0.00333,42690,14.21512,300314
1049,xkilian,10,0.00333,42700,14.21845,300314
1050,yahaa,10,0.00333,42710,14.22178,300314
1051,yu-croco,10,0.00333,42720,14.22511,300314
1052,Z18Aplha,10,0.00333,42730,14.22844,300314
1053,ZekeLu,10,0.00333,42740,14.23177,300314
1054,Zhanxueyou,10,0.00333,42750,14.23510,300314
1055,1riggs,9,0.00300,42759,14.23810,300314
1056,addozhang,9,0.00300,42768,14.24109,300314
1057,AlonGluz,9,0.00300,42777,14.24409,300314
1058,aniecki,9,0.00300,42786,14.24709,300314
1059,anirudhaps,9,0.00300,42795,14.25008,300314
1060,apoorvemohan,9,0.00300,42804,14.25308,300314
1061,arielvinas,9,0.00300,42813,14.25608,300314
1062,arkbriar,9,0.00300,42822,14.25908,300314
1063,arunsriniv,9,0.00300,42831,14.26207,300314
1064,avorima,9,0.00300,42840,14.26507,300314
1065,bbroniewski,9,0.00300,42849,14.26807,300314
1066,bjosv,9,0.00300,42858,14.27106,300314
1067,BLasan,9,0.00300,42867,14.27406,300314
1068,Booster2ooo,9,0.00300,42876,14.27706,300314
1069,boypssy09,9,0.00300,42885,14.28005,300314
1070,bryanuribe,9,0.00300,42894,14.28305,300314
1071,champly,9,0.00300,42903,14.28605,300314
1072,daipom,9,0.00300,42912,14.28904,300314
1073,damingerdai,9,0.00300,42921,14.29204,300314
1074,damnever,9,0.00300,42930,14.29504,300314
1075,danielzhanghl,9,0.00300,42939,14.29803,300314
1076,davidbhoward,9,0.00300,42948,14.30103,300314
1077,dev-samples,9,0.00300,42957,14.30403,300314
1078,dimitricole,9,0.00300,42966,14.30703,300314
1079,divyagandhisethi,9,0.00300,42975,14.31002,300314
1080,DVEfremov,9,0.00300,42984,14.31302,300314
1081,Echo0117,9,0.00300,42993,14.31602,300314
1082,elakito,9,0.00300,43002,14.31901,300314
1083,ElArtista,9,0.00300,43011,14.32201,300314
1084,enjoy-binbin,9,0.00300,43020,14.32501,300314
1085,epaulson10,9,0.00300,43029,14.32800,300314
1086,eunice98k,9,0.00300,43038,14.33100,300314
1087,evertrain,9,0.00300,43047,14.33400,300314
1088,fletcm,9,0.00300,43056,14.33699,300314
1089,forestuser,9,0.00300,43065,14.33999,300314
1090,furkhat,9,0.00300,43074,14.34299,300314
1091,Gandem,9,0.00300,43083,14.34598,300314
1092,gfreezy,9,0.00300,43092,14.34898,300314
1093,ghabarid,9,0.00300,43101,14.35198,300314
1094,GillesZhao,9,0.00300,43110,14.35498,300314
1095,gossion,9,0.00300,43119,14.35797,300314
1096,guyguy333,9,0.00300,43128,14.36097,300314
1097,harikrongali,9,0.00300,43137,14.36397,300314
1098,HeinrichHartmann,9,0.00300,43146,14.36696,300314
1099,hetong07,9,0.00300,43155,14.36996,300314
1100,hui-maker,9,0.00300,43164,14.37296,300314
1101,hzliangbin,9,0.00300,43173,14.37595,300314
1102,ide-rea,9,0.00300,43182,14.37895,300314
1103,ilyee,9,0.00300,43191,14.38195,300314
1104,jason-kane,9,0.00300,43200,14.38494,300314
1105,jawabuu,9,0.00300,43209,14.38794,300314
1106,jcstanaway,9,0.00300,43218,14.39094,300314
1107,JIIOryo,9,0.00300,43227,14.39393,300314
1108,jj-2020,9,0.00300,43236,14.39693,300314
1109,jodeev,9,0.00300,43245,14.39993,300314
1110,JohnWu20,9,0.00300,43254,14.40292,300314
1111,jonatan-ivanov,9,0.00300,43263,14.40592,300314
1112,josegob,9,0.00300,43272,14.40892,300314
1113,jsalatiel,9,0.00300,43281,14.41192,300314
1114,justincely,9,0.00300,43290,14.41491,300314
1115,kgibcc,9,0.00300,43299,14.41791,300314
1116,kotlasaicharanreddy,9,0.00300,43308,14.42091,300314
1117,kwangh,9,0.00300,43317,14.42390,300314
1118,learner0810,9,0.00300,43326,14.42690,300314
1119,leonids2005,9,0.00300,43335,14.42990,300314
1120,loreleimccollum-work,9,0.00300,43344,14.43289,300314
1121,luizluca,9,0.00300,43353,14.43589,300314
1122,makinje16,9,0.00300,43362,14.43889,300314
1123,mandala23,9,0.00300,43371,14.44188,300314
1124,marioortizmanero,9,0.00300,43380,14.44488,300314
1125,matusf,9,0.00300,43389,14.44788,300314
1126,mGurusamy,9,0.00300,43398,14.45087,300314
1127,mikechengwei,9,0.00300,43407,14.45387,300314
1128,MisterTimn,9,0.00300,43416,14.45687,300314
1129,mkruskal-google,9,0.00300,43425,14.45987,300314
1130,mksha,9,0.00300,43434,14.46286,300314
1131,msbecker,9,0.00300,43443,14.46586,300314
1132,muhammadn,9,0.00300,43452,14.46886,300314
1133,muka,9,0.00300,43461,14.47185,300314
1134,niekert,9,0.00300,43470,14.47485,300314
1135,nitinrajput1997,9,0.00300,43479,14.47785,300314
1136,omriz,9,0.00300,43488,14.48084,300314
1137,passcod,9,0.00300,43497,14.48384,300314
1138,perezjasonr,9,0.00300,43506,14.48684,300314
1139,phil777,9,0.00300,43515,14.48983,300314
1140,PhilParisot,9,0.00300,43524,14.49283,300314
1141,PiotrZakrzewski,9,0.00300,43533,14.49583,300314
1142,Prabhaker24,9,0.00300,43542,14.49882,300314
1143,praseedasathaye,9,0.00300,43551,14.50182,300314
1144,PsiACE,9,0.00300,43560,14.50482,300314
1145,raakella,9,0.00300,43569,14.50782,300314
1146,radudd,9,0.00300,43578,14.51081,300314
1147,rahulii,9,0.00300,43587,14.51381,300314
1148,rayfordj,9,0.00300,43596,14.51681,300314
1149,Razdeep,9,0.00300,43605,14.51980,300314
1150,rensyct,9,0.00300,43614,14.52280,300314
1151,rjcastillejo-chile,9,0.00300,43623,14.52580,300314
1152,robertdavidsmith,9,0.00300,43632,14.52879,300314
1153,rojosinalma,9,0.00300,43641,14.53179,300314
1154,roystchiang,9,0.00300,43650,14.53479,300314
1155,Ruppsn,9,0.00300,43659,14.53778,300314
1156,SailingYYC,9,0.00300,43668,14.54078,300314
1157,saktib,9,0.00300,43677,14.54378,300314
1158,salmanahmed404,9,0.00300,43686,14.54677,300314
1159,SameerMahajan-GSLab,9,0.00300,43695,14.54977,300314
1160,SeanHood,9,0.00300,43704,14.55277,300314
1161,sfunkhouser,9,0.00300,43713,14.55576,300314
1162,Shihao-Zhong,9,0.00300,43722,14.55876,300314
1163,shubhamagarwal19,9,0.00300,43731,14.56176,300314
1164,ShwethaKumbla,9,0.00300,43740,14.56476,300314
1165,sjacobs-indeed,9,0.00300,43749,14.56775,300314
1166,softwarebloat,9,0.00300,43758,14.57075,300314
1167,sprior,9,0.00300,43767,14.57375,300314
1168,sri-vathsa,9,0.00300,43776,14.57674,300314
1169,steeling,9,0.00300,43785,14.57974,300314
1170,StefanCenusa,9,0.00300,43794,14.58274,300314
1171,sunstonesecure-robert,9,0.00300,43803,14.58573,300314
1172,Szymongib,9,0.00300,43812,14.58873,300314
1173,tbertenshaw,9,0.00300,43821,14.59173,300314
1174,TCeason,9,0.00300,43830,14.59472,300314
1175,tcolloca,9,0.00300,43839,14.59772,300314
1176,tonychoe,9,0.00300,43848,14.60072,300314
1177,tope94,9,0.00300,43857,14.60371,300314
1178,trastle,9,0.00300,43866,14.60671,300314
1179,trutty,9,0.00300,43875,14.60971,300314
1180,tsunamishaun,9,0.00300,43884,14.61271,300314
1181,Unb9rn,9,0.00300,43893,14.61570,300314
1182,valdemarpavesi,9,0.00300,43902,14.61870,300314
1183,VigneshSP94,9,0.00300,43911,14.62170,300314
1184,WT-Liu,9,0.00300,43920,14.62469,300314
1185,wutkemtt,9,0.00300,43929,14.62769,300314
1186,xclud,9,0.00300,43938,14.63069,300314
1187,xhejtman,9,0.00300,43947,14.63368,300314
1188,xishengcai,9,0.00300,43956,14.63668,300314
1189,ycy1766,9,0.00300,43965,14.63968,300314
1190,y-taka-23,9,0.00300,43974,14.64267,300314
1191,yutian-github,9,0.00300,43983,14.64567,300314
1192,z4ce,9,0.00300,43992,14.64867,300314
1193,2nick,8,0.00266,44000,14.65133,300314
1194,AbdulBasitAlvi,8,0.00266,44008,14.65400,300314
1195,acezen,8,0.00266,44016,14.65666,300314
1196,adefisher,8,0.00266,44024,14.65932,300314
1197,adesurya,8,0.00266,44032,14.66199,300314
1198,adriancuadrado,8,0.00266,44040,14.66465,300314
1199,ahrtr,8,0.00266,44048,14.66731,300314
1200,akhilgoel09,8,0.00266,44056,14.66998,300314
1201,akhil-rane,8,0.00266,44064,14.67264,300314
1202,alessandroargentierimilkman,8,0.00266,44072,14.67531,300314
1203,AlessioCasco,8,0.00266,44080,14.67797,300314
1204,alidadar7676,8,0.00266,44088,14.68063,300314
1205,alpha-baby,8,0.00266,44096,14.68330,300314
1206,ambarve,8,0.00266,44104,14.68596,300314
1207,AmitBenAmi,8,0.00266,44112,14.68863,300314
1208,amoore877,8,0.00266,44120,14.69129,300314
1209,andrewpollack,8,0.00266,44128,14.69395,300314
1210,aniekgul,8,0.00266,44136,14.69662,300314
1211,anujva,8,0.00266,44144,14.69928,300314
1212,ArminMW,8,0.00266,44152,14.70195,300314
1213,arriqaaq,8,0.00266,44160,14.70461,300314
1214,artemlops,8,0.00266,44168,14.70727,300314
1215,arthuravila26,8,0.00266,44176,14.70994,300314
1216,Asafb26,8,0.00266,44184,14.71260,300314
1217,AssafKatz3,8,0.00266,44192,14.71526,300314
1218,astorath,8,0.00266,44200,14.71793,300314
1219,atefhaloui,8,0.00266,44208,14.72059,300314
1220,Atharex,8,0.00266,44216,14.72326,300314
1221,Azbesciak,8,0.00266,44224,14.72592,300314
1222,azuwis,8,0.00266,44232,14.72858,300314
1223,belltoy,8,0.00266,44240,14.73125,300314
1224,bensch98,8,0.00266,44248,14.73391,300314
1225,bibi520,8,0.00266,44256,14.73658,300314
1226,bimmerkiev,8,0.00266,44264,14.73924,300314
1227,bonc2021,8,0.00266,44272,14.74190,300314
1228,boniek83,8,0.00266,44280,14.74457,300314
1229,cage1016,8,0.00266,44288,14.74723,300314
1230,carnei-ro,8,0.00266,44296,14.74990,300314
1231,cloudlady911,8,0.00266,44304,14.75256,300314
1232,ComptonAlvaro,8,0.00266,44312,14.75522,300314
1233,contractormarketplace,8,0.00266,44320,14.75789,300314
1234,crearys,8,0.00266,44328,14.76055,300314
1235,davidgwcurve,8,0.00266,44336,14.76321,300314
1236,davidjlynn,8,0.00266,44344,14.76588,300314
1237,Daxcor69,8,0.00266,44352,14.76854,300314
1238,dctrwatson,8,0.00266,44360,14.77121,300314
1239,delps1001,8,0.00266,44368,14.77387,300314
1240,dependabof,8,0.00266,44376,14.77653,300314
1241,devOpsHelm,8,0.00266,44384,14.77920,300314
1242,dgoldssfo,8,0.00266,44392,14.78186,300314
1243,dmilind,8,0.00266,44400,14.78453,300314
1244,duanjiong,8,0.00266,44408,14.78719,300314
1245,ebarped,8,0.00266,44416,14.78985,300314
1246,elinesterov,8,0.00266,44424,14.79252,300314
1247,emiran-orange,8,0.00266,44432,14.79518,300314
1248,Escapingbug,8,0.00266,44440,14.79784,300314
1249,falconbin,8,0.00266,44448,14.80051,300314
1250,farodin91,8,0.00266,44456,14.80317,300314
1251,francky06l,8,0.00266,44464,14.80584,300314
1252,genzgd,8,0.00266,44472,14.80850,300314
1253,gerrywastaken,8,0.00266,44480,14.81116,300314
1254,ghoneycutt,8,0.00266,44488,14.81383,300314
1255,GinYM,8,0.00266,44496,14.81649,300314
1256,gizahNL,8,0.00266,44504,14.81916,300314
1257,glucaci,8,0.00266,44512,14.82182,300314
1258,guyyakir,8,0.00266,44520,14.82448,300314
1259,hankedang,8,0.00266,44528,14.82715,300314
1260,harnitsignalfx,8,0.00266,44536,14.82981,300314
1261,hiteshghia,8,0.00266,44544,14.83248,300314
1262,hnsk,8,0.00266,44552,14.83514,300314
1263,iAnomaly,8,0.00266,44560,14.83780,300314
1264,igorkchyts,8,0.00266,44568,14.84047,300314
1265,iluoeli,8,0.00266,44576,14.84313,300314
1266,imoisharma,8,0.00266,44584,14.84579,300314
1267,instantlinux,8,0.00266,44592,14.84846,300314
1268,Israphel,8,0.00266,44600,14.85112,300314
1269,iwctwbai,8,0.00266,44608,14.85379,300314
1270,jbvmio,8,0.00266,44616,14.85645,300314
1271,jc-lab,8,0.00266,44624,14.85911,300314
1272,jdgri,8,0.00266,44632,14.86178,300314
1273,jdowni000,8,0.00266,44640,14.86444,300314
1274,Jeansen,8,0.00266,44648,14.86711,300314
1275,jindijamie,8,0.00266,44656,14.86977,300314
1276,jqmichael,8,0.00266,44664,14.87243,300314
1277,junjihashimoto,8,0.00266,44672,14.87510,300314
1278,kaladaOpuiyo,8,0.00266,44680,14.87776,300314
1279,khatrig,8,0.00266,44688,14.88043,300314
1280,kkh913,8,0.00266,44696,14.88309,300314
1281,konradasb,8,0.00266,44704,14.88575,300314
1282,kpramesh2212,8,0.00266,44712,14.88842,300314
1283,kstiehl,8,0.00266,44720,14.89108,300314
1284,lasred,8,0.00266,44728,14.89374,300314
1285,lemonit-eric-mao,8,0.00266,44736,14.89641,300314
1286,life1347,8,0.00266,44744,14.89907,300314
1287,LLLLimbo,8,0.00266,44752,14.90174,300314
1288,Lng88,8,0.00266,44760,14.90440,300314
1289,lowang-bh,8,0.00266,44768,14.90706,300314
1290,ltyson,8,0.00266,44776,14.90973,300314
1291,LuFred,8,0.00266,44784,14.91239,300314
1292,lukaskalvenas,8,0.00266,44792,14.91506,300314
1293,luoyunhe,8,0.00266,44800,14.91772,300314
1294,lx1036,8,0.00266,44808,14.92038,300314
1295,madchap,8,0.00266,44816,14.92305,300314
1296,MakDon,8,0.00266,44824,14.92571,300314
1297,maksim-paskal,8,0.00266,44832,14.92837,300314
1298,maxisam,8,0.00266,44840,14.93104,300314
1299,mihirg,8,0.00266,44848,14.93370,300314
1300,minerba,8,0.00266,44856,14.93637,300314
1301,mitchellhuang,8,0.00266,44864,14.93903,300314
1302,msamad,8,0.00266,44872,14.94169,300314
1303,nandeeshb09,8,0.00266,44880,14.94436,300314
1304,nhayes1031,8,0.00266,44888,14.94702,300314
1305,nikfot,8,0.00266,44896,14.94969,300314
1306,nilansaha,8,0.00266,44904,14.95235,300314
1307,obrienrobert,8,0.00266,44912,14.95501,300314
1308,orrymr,8,0.00266,44920,14.95768,300314
1309,pavelmaliy,8,0.00266,44928,14.96034,300314
1310,perrynzhou,8,0.00266,44936,14.96301,300314
1311,pinikomarov,8,0.00266,44944,14.96567,300314
1312,pjajootibco,8,0.00266,44952,14.96833,300314
1313,plajjan,8,0.00266,44960,14.97100,300314
1314,rmiller14,8,0.00266,44968,14.97366,300314
1315,rptaylor,8,0.00266,44976,14.97632,300314
1316,russellwhitaker,8,0.00266,44984,14.97899,300314
1317,s50600822,8,0.00266,44992,14.98165,300314
1318,sairamvoggu1007,8,0.00266,45000,14.98432,300314
1319,sanandan,8,0.00266,45008,14.98698,300314
1320,sanjvij,8,0.00266,45016,14.98964,300314
1321,sartx,8,0.00266,45024,14.99231,300314
1322,satyapriyamishra222,8,0.00266,45032,14.99497,300314
1323,schizoid90,8,0.00266,45040,14.99764,300314
1324,SchrodingerZhu,8,0.00266,45048,15.00030,300314
1325,SebastianGau,8,0.00266,45056,15.00296,300314
1326,sechunOH,8,0.00266,45064,15.00563,300314
1327,silence-coding,8,0.00266,45072,15.00829,300314
1328,singh-kamal,8,0.00266,45080,15.01096,300314
1329,sio4,8,0.00266,45088,15.01362,300314
1330,s-mahesh-kumar,8,0.00266,45096,15.01628,300314
1331,SpencerMalone,8,0.00266,45104,15.01895,300314
1332,sperrenotcantin,8,0.00266,45112,15.02161,300314
1333,stecky,8,0.00266,45120,15.02427,300314
1334,SteveBisnett,8,0.00266,45128,15.02694,300314
1335,stpierre,8,0.00266,45136,15.02960,300314
1336,suraj-zemoso,8,0.00266,45144,15.03227,300314
1337,sylock,8,0.00266,45152,15.03493,300314
1338,TeoGoddet,8,0.00266,45160,15.03759,300314
1339,ThaSami,8,0.00266,45168,15.04026,300314
1340,thatsmydoing,8,0.00266,45176,15.04292,300314
1341,thefang12,8,0.00266,45184,15.04559,300314
1342,tiloso,8,0.00266,45192,15.04825,300314
1343,timmy59100,8,0.00266,45200,15.05091,300314
1344,tomashibm,8,0.00266,45208,15.05358,300314
1345,ttk,8,0.00266,45216,15.05624,300314
1346,tyzbit,8,0.00266,45224,15.05891,300314
1347,ukitazume,8,0.00266,45232,15.06157,300314
1348,uucloud,8,0.00266,45240,15.06423,300314
1349,vatine,8,0.00266,45248,15.06690,300314
1350,ventifus,8,0.00266,45256,15.06956,300314
1351,vickiyan,8,0.00266,45264,15.07222,300314
1352,wchajl,8,0.00266,45272,15.07489,300314
1353,wewang58,8,0.00266,45280,15.07755,300314
1354,windowsrefund,8,0.00266,45288,15.08022,300314
1355,wonderg,8,0.00266,45296,15.08288,300314
1356,wtcampos,8,0.00266,45304,15.08554,300314
1357,Xachman,8,0.00266,45312,15.08821,300314
1358,xiaozhao123254,8,0.00266,45320,15.09087,300314
1359,XinLin,8,0.00266,45328,15.09354,300314
1360,xmuyoo,8,0.00266,45336,15.09620,300314
1361,15077693d,7,0.00233,45343,15.09853,300314
1362,9547,7,0.00233,45350,15.10086,300314
1363,aashikam,7,0.00233,45357,15.10319,300314
1364,ackfin,7,0.00233,45364,15.10552,300314
1365,adambartholomew,7,0.00233,45371,15.10785,300314
1366,adamglt,7,0.00233,45378,15.11018,300314
1367,adberger,7,0.00233,45385,15.11252,300314
1368,adjika,7,0.00233,45392,15.11485,300314
1369,ahmadzaikk,7,0.00233,45399,15.11718,300314
1370,airkewld,7,0.00233,45406,15.11951,300314
1371,ajieliu,7,0.00233,45413,15.12184,300314
1372,akazimierskigl,7,0.00233,45420,15.12417,300314
1373,Ala0005,7,0.00233,45427,15.12650,300314
1374,AlbertMarashi,7,0.00233,45434,15.12883,300314
1375,AlleyWei,7,0.00233,45441,15.13116,300314
1376,amenzhinsky,7,0.00233,45448,15.13349,300314
1377,angelnu,7,0.00233,45455,15.13582,300314
1378,anshulkumar19,7,0.00233,45462,15.13816,300314
1379,antaloala,7,0.00233,45469,15.14049,300314
1380,anton-ryzhov,7,0.00233,45476,15.14282,300314
1381,apmarshall,7,0.00233,45483,15.14515,300314
1382,ArgTang,7,0.00233,45490,15.14748,300314
1383,arturo-skydio,7,0.00233,45497,15.14981,300314
1384,ashenoy-hedvig,7,0.00233,45504,15.15214,300314
1385,AyushCloud,7,0.00233,45511,15.15447,300314
1386,benqwu,7,0.00233,45518,15.15680,300314
1387,BinaryHexer,7,0.00233,45525,15.15913,300314
1388,bklaubos,7,0.00233,45532,15.16146,300314
1389,BlizzTom,7,0.00233,45539,15.16380,300314
1390,borissmidt,7,0.00233,45546,15.16613,300314
1391,brendamckenne,7,0.00233,45553,15.16846,300314
1392,brethubbard,7,0.00233,45560,15.17079,300314
1393,buggithubs,7,0.00233,45567,15.17312,300314
1394,captnbp,7,0.00233,45574,15.17545,300314
1395,cbuckley01,7,0.00233,45581,15.17778,300314
1396,chipmaurer,7,0.00233,45588,15.18011,300314
1397,Ckathiravan,7,0.00233,45595,15.18244,300314
1398,clayrisser,7,0.00233,45602,15.18477,300314
1399,cleo2525,7,0.00233,45609,15.18710,300314
1400,codergs,7,0.00233,45616,15.18944,300314
1401,ctigersre,7,0.00233,45623,15.19177,300314
1402,dagrayvid,7,0.00233,45630,15.19410,300314
1403,davidcollom,7,0.00233,45637,15.19643,300314
1404,defreng,7,0.00233,45644,15.19876,300314
1405,dev999k8,7,0.00233,45651,15.20109,300314
1406,diru1100,7,0.00233,45658,15.20342,300314
1407,dmitry-irtegov,7,0.00233,45665,15.20575,300314
1408,donngchao,7,0.00233,45672,15.20808,300314
1409,drewpca,7,0.00233,45679,15.21041,300314
1410,dseomn,7,0.00233,45686,15.21274,300314
1411,durd07,7,0.00233,45693,15.21507,300314
1412,dvirguttman,7,0.00233,45700,15.21741,300314
1413,ekiziv,7,0.00233,45707,15.21974,300314
1414,eltociear,7,0.00233,45714,15.22207,300314
1415,eplightning,7,0.00233,45721,15.22440,300314
1416,EricHripko,7,0.00233,45728,15.22673,300314
1417,esweiss,7,0.00233,45735,15.22906,300314
1418,eyJhb,7,0.00233,45742,15.23139,300314
1419,felix0080,7,0.00233,45749,15.23372,300314
1420,flokain,7,0.00233,45756,15.23605,300314
1421,forestsword,7,0.00233,45763,15.23838,300314
1422,Frefreak,7,0.00233,45770,15.24071,300314
1423,gaganapplatix,7,0.00233,45777,15.24305,300314
1424,glorv,7,0.00233,45784,15.24538,300314
1425,goobysnack,7,0.00233,45791,15.24771,300314
1426,GregoireW,7,0.00233,45798,15.25004,300314
1427,gupf0719,7,0.00233,45805,15.25237,300314
1428,hakuno,7,0.00233,45812,15.25470,300314
1429,hari819,7,0.00233,45819,15.25703,300314
1430,HarshitaJha,7,0.00233,45826,15.25936,300314
1431,heruv1m,7,0.00233,45833,15.26169,300314
1432,hixichen,7,0.00233,45840,15.26402,300314
1433,ichasco-heytrade,7,0.00233,45847,15.26635,300314
1434,Identitry,7,0.00233,45854,15.26869,300314
1435,IgorGanapolsky,7,0.00233,45861,15.27102,300314
1436,ihciah,7,0.00233,45868,15.27335,300314
1437,iivanf,7,0.00233,45875,15.27568,300314
1438,irizzant,7,0.00233,45882,15.27801,300314
1439,it2008018,7,0.00233,45889,15.28034,300314
1440,J0,7,0.00233,45896,15.28267,300314
1441,jabbera,7,0.00233,45903,15.28500,300314
1442,jakubednarek,7,0.00233,45910,15.28733,300314
1443,jerguslejko,7,0.00233,45917,15.28966,300314
1444,jfgauron,7,0.00233,45924,15.29199,300314
1445,jingxiang95,7,0.00233,45931,15.29433,300314
1446,jmoldow,7,0.00233,45938,15.29666,300314
1447,jnsrikanth,7,0.00233,45945,15.29899,300314
1448,johnjeffers,7,0.00233,45952,15.30132,300314
1449,jonny-wg2,7,0.00233,45959,15.30365,300314
1450,k-9527,7,0.00233,45966,15.30598,300314
1451,kale-amruta,7,0.00233,45973,15.30831,300314
1452,KapJI,7,0.00233,45980,15.31064,300314
1453,keidevs,7,0.00233,45987,15.31297,300314
1454,kjetijor,7,0.00233,45994,15.31530,300314
1455,KKelvinLo,7,0.00233,46001,15.31763,300314
1456,kyrieSun-wow,7,0.00233,46008,15.31997,300314
1457,lauralorenz,7,0.00233,46015,15.32230,300314
1458,leventogut,7,0.00233,46022,15.32463,300314
1459,lilyzhoupeijie,7,0.00233,46029,15.32696,300314
1460,LionelJouin,7,0.00233,46036,15.32929,300314
1461,lukos,7,0.00233,46043,15.33162,300314
1462,lukqw,7,0.00233,46050,15.33395,300314
1463,lum1n0us,7,0.00233,46057,15.33628,300314
1464,lynxnathan,7,0.00233,46064,15.33861,300314
1465,lzmhhh123,7,0.00233,46071,15.34094,300314
1466,mackjmr,7,0.00233,46078,15.34327,300314
1467,magnate3,7,0.00233,46085,15.34560,300314
1468,manupm87,7,0.00233,46092,15.34794,300314
1469,mapno,7,0.00233,46099,15.35027,300314
1470,marckamerbeek,7,0.00233,46106,15.35260,300314
1471,MarkHarris21,7,0.00233,46113,15.35493,300314
1472,MarkSRobinson,7,0.00233,46120,15.35726,300314
1473,MattJeanes,7,0.00233,46127,15.35959,300314
1474,mCapricorn,7,0.00233,46134,15.36192,300314
1475,mercuriete,7,0.00233,46141,15.36425,300314
1476,mikeinton,7,0.00233,46148,15.36658,300314
1477,mikekamornikov,7,0.00233,46155,15.36891,300314
1478,mkomu,7,0.00233,46162,15.37124,300314
1479,mmiller1,7,0.00233,46169,15.37358,300314
1480,moonheart,7,0.00233,46176,15.37591,300314
1481,morozov,7,0.00233,46183,15.37824,300314
1482,mveea,7,0.00233,46190,15.38057,300314
1483,namra98,7,0.00233,46197,15.38290,300314
1484,nanorobocop,7,0.00233,46204,15.38523,300314
1485,nemobis,7,0.00233,46211,15.38756,300314
1486,nerditup,7,0.00233,46218,15.38989,300314
1487,Nerja,7,0.00233,46225,15.39222,300314
1488,Nicklason,7,0.00233,46232,15.39455,300314
1489,niemeyer,7,0.00233,46239,15.39688,300314
1490,nrvmodi,7,0.00233,46246,15.39922,300314
1491,nurhun,7,0.00233,46253,15.40155,300314
1492,nyanpassu,7,0.00233,46260,15.40388,300314
1493,ojab,7,0.00233,46267,15.40621,300314
1494,Omar007,7,0.00233,46274,15.40854,300314
1495,onecer,7,0.00233,46281,15.41087,300314
1496,opviel,7,0.00233,46288,15.41320,300314
1497,packi,7,0.00233,46295,15.41553,300314
1498,PedroArvela,7,0.00233,46302,15.41786,300314
1499,PepijnSenders,7,0.00233,46309,15.42019,300314
1500,petedmarsh,7,0.00233,46316,15.42252,300314
1501,peterwishart,7,0.00233,46323,15.42486,300314
1502,pmorch,7,0.00233,46330,15.42719,300314
1503,PokerBySwq,7,0.00233,46337,15.42952,300314
1504,poksiala,7,0.00233,46344,15.43185,300314
1505,pramodrj07,7,0.00233,46351,15.43418,300314
1506,praveenpattisapu,7,0.00233,46358,15.43651,300314
1507,Raboo,7,0.00233,46365,15.43884,300314
1508,rafis,7,0.00233,46372,15.44117,300314
1509,Rajalakshmi-Girish,7,0.00233,46379,15.44350,300314
1510,randrusiak,7,0.00233,46386,15.44583,300314
1511,ravilushqa,7,0.00233,46393,15.44816,300314
1512,rifftual,7,0.00233,46400,15.45050,300314
1513,Rishikeshpal,7,0.00233,46407,15.45283,300314
1514,robax,7,0.00233,46414,15.45516,300314
1515,roberthstrand,7,0.00233,46421,15.45749,300314
1516,rtttech,7,0.00233,46428,15.45982,300314
1517,sanjaygopinath89,7,0.00233,46435,15.46215,300314
1518,Sawmi,7,0.00233,46442,15.46448,300314
1519,ScheererJ,7,0.00233,46449,15.46681,300314
1520,seanhoughton,7,0.00233,46456,15.46914,300314
1521,secondsun,7,0.00233,46463,15.47147,300314
1522,shahriak,7,0.00233,46470,15.47380,300314
1523,shhdgit,7,0.00233,46477,15.47613,300314
1524,shihtiy-tw,7,0.00233,46484,15.47847,300314
1525,sidewinder12s,7,0.00233,46491,15.48080,300314
1526,SilverSoldier,7,0.00233,46498,15.48313,300314
1527,SimonBaeumer,7,0.00233,46505,15.48546,300314
1528,Snehil03,7,0.00233,46512,15.48779,300314
1529,sodabrew,7,0.00233,46519,15.49012,300314
1530,soumik0108,7,0.00233,46526,15.49245,300314
1531,sreeharimohan,7,0.00233,46533,15.49478,300314
1532,srinicrick65,7,0.00233,46540,15.49711,300314
1533,ssbostan,7,0.00233,46547,15.49944,300314
1534,sschober,7,0.00233,46554,15.50177,300314
1535,staniondaniel,7,0.00233,46561,15.50411,300314
1536,stemid,7,0.00233,46568,15.50644,300314
1537,stephen-harris,7,0.00233,46575,15.50877,300314
1538,techmunk,7,0.00233,46582,15.51110,300314
1539,themonaminor,7,0.00233,46589,15.51343,300314
1540,tibers,7,0.00233,46596,15.51576,300314
1541,tiolan,7,0.00233,46603,15.51809,300314
1542,tirumerla,7,0.00233,46610,15.52042,300314
1543,titou10titou10,7,0.00233,46617,15.52275,300314
1544,tlefevre,7,0.00233,46624,15.52508,300314
1545,tomdymond,7,0.00233,46631,15.52741,300314
1546,treyhendon,7,0.00233,46638,15.52975,300314
1547,vbarbaresi,7,0.00233,46645,15.53208,300314
1548,vlad-diachenko,7,0.00233,46652,15.53441,300314
1549,vutkin,7,0.00233,46659,15.53674,300314
1550,wcurry,7,0.00233,46666,15.53907,300314
1551,wdwangcumt,7,0.00233,46673,15.54140,300314
1552,weetime,7,0.00233,46680,15.54373,300314
1553,weilaaa,7,0.00233,46687,15.54606,300314
1554,Weilbyte,7,0.00233,46694,15.54839,300314
1555,weimingwill,7,0.00233,46701,15.55072,300314
1556,xiaobaitusi,7,0.00233,46708,15.55305,300314
1557,xiaozhi747,7,0.00233,46715,15.55539,300314
1558,xordspar0,7,0.00233,46722,15.55772,300314
1559,Y2Kot,7,0.00233,46729,15.56005,300314
1560,ywave620,7,0.00233,46736,15.56238,300314
1561,zcola,7,0.00233,46743,15.56471,300314
1562,Zhaoyu1123,7,0.00233,46750,15.56704,300314
1563,abhi93104,6,0.00200,46756,15.56904,300314
1564,ABNER-1,6,0.00200,46762,15.57104,300314
1565,absynth76,6,0.00200,46768,15.57303,300314
1566,achesin,6,0.00200,46774,15.57503,300314
1567,ahached,6,0.00200,46780,15.57703,300314
1568,aidagha,6,0.00200,46786,15.57903,300314
1569,akosyakov,6,0.00200,46792,15.58103,300314
1570,alessandroargentieri,6,0.00200,46798,15.58302,300314
1571,allir,6,0.00200,46804,15.58502,300314
1572,allymparker,6,0.00200,46810,15.58702,300314
1573,amitm02,6,0.00200,46816,15.58902,300314
1574,Andrew-Wichmann,6,0.00200,46822,15.59101,300314
1575,angellk,6,0.00200,46828,15.59301,300314
1576,annakhm,6,0.00200,46834,15.59501,300314
1577,anupkrish24,6,0.00200,46840,15.59701,300314
1578,anuragensemble,6,0.00200,46846,15.59901,300314
1579,archcloudlabs,6,0.00200,46852,15.60100,300314
1580,arnarpall,6,0.00200,46858,15.60300,300314
1581,asavov,6,0.00200,46864,15.60500,300314
1582,AtlanCI,6,0.00200,46870,15.60700,300314
1583,aug70,6,0.00200,46876,15.60900,300314
1584,AustinSmart,6,0.00200,46882,15.61099,300314
1585,baoho1106,6,0.00200,46888,15.61299,300314
1586,BaronStack,6,0.00200,46894,15.61499,300314
1587,bbarin,6,0.00200,46900,15.61699,300314
1588,belak,6,0.00200,46906,15.61899,300314
1589,benagricola,6,0.00200,46912,15.62098,300314
1590,benjaminp,6,0.00200,46918,15.62298,300314
1591,BentCoder,6,0.00200,46924,15.62498,300314
1592,betermieux,6,0.00200,46930,15.62698,300314
1593,bigclouds,6,0.00200,46936,15.62898,300314
1594,BirolYildiz,6,0.00200,46942,15.63097,300314
1595,bleech1,6,0.00200,46948,15.63297,300314
1596,bmmadhuprasad,6,0.00200,46954,15.63497,300314
1597,BodilessSleeper,6,0.00200,46960,15.63697,300314
1598,Boxjan,6,0.00200,46966,15.63896,300314
1599,brentleyjones,6,0.00200,46972,15.64096,300314
1600,brngylni,6,0.00200,46978,15.64296,300314
1601,brsolomon,6,0.00200,46984,15.64496,300314
1602,btalbot,6,0.00200,46990,15.64696,300314
1603,budiprihhastomo,6,0.00200,46996,15.64895,300314
1604,buptliuwei,6,0.00200,47002,15.65095,300314
1605,bzhaoopenstack,6,0.00200,47008,15.65295,300314
1606,bzmotoros,6,0.00200,47014,15.65495,300314
1607,caleygoff-invitae,6,0.00200,47020,15.65695,300314
1608,camathieu,6,0.00200,47026,15.65894,300314
1609,canuysal,6,0.00200,47032,15.66094,300314
1610,capoferro,6,0.00200,47038,15.66294,300314
1611,cbcos,6,0.00200,47044,15.66494,300314
1612,chenbiaoit,6,0.00200,47050,15.66694,300314
1613,christiangonre,6,0.00200,47056,15.66893,300314
1614,cmsmith7,6,0.00200,47062,15.67093,300314
1615,copierrj,6,0.00200,47068,15.67293,300314
1616,cretz,6,0.00200,47074,15.67493,300314
1617,Cronos-fr,6,0.00200,47080,15.67692,300314
1618,CyberHippo,6,0.00200,47086,15.67892,300314
1619,damora,6,0.00200,47092,15.68092,300314
1620,dan-slinky-ckpd,6,0.00200,47098,15.68292,300314
1621,DarthBenro008,6,0.00200,47104,15.68492,300314
1622,Daverkex,6,0.00200,47110,15.68691,300314
1623,dawidd6,6,0.00200,47116,15.68891,300314
1624,debu99,6,0.00200,47122,15.69091,300314
1625,deepakkinni,6,0.00200,47128,15.69291,300314
1626,Derekkaoo,6,0.00200,47134,15.69491,300314
1627,devopstales,6,0.00200,47140,15.69690,300314
1628,Dhairya3124,6,0.00200,47146,15.69890,300314
1629,dkleissa,6,0.00200,47152,15.70090,300314
1630,dk-lockdown,6,0.00200,47158,15.70290,300314
1631,docast,6,0.00200,47164,15.70490,300314
1632,dtaivpp,6,0.00200,47170,15.70689,300314
1633,Dunateo,6,0.00200,47176,15.70889,300314
1634,dwindsor-scwx,6,0.00200,47182,15.71089,300314
1635,edeediong,6,0.00200,47188,15.71289,300314
1636,EduardoLaranjo,6,0.00200,47194,15.71489,300314
1637,ekund,6,0.00200,47200,15.71688,300314
1638,EnfangCui,6,0.00200,47206,15.71888,300314
1639,fabjan,6,0.00200,47212,15.72088,300314
1640,fangyi-zhou,6,0.00200,47218,15.72288,300314
1641,febelery,6,0.00200,47224,15.72487,300314
1642,FengqiQiao,6,0.00200,47230,15.72687,300314
1643,fitchos,6,0.00200,47236,15.72887,300314
1644,FriedrichWilken,6,0.00200,47242,15.73087,300314
1645,gabecazares-cc,6,0.00200,47248,15.73287,300314
1646,gabihodoroaga,6,0.00200,47254,15.73486,300314
1647,gevraud,6,0.00200,47260,15.73686,300314
1648,gjmzj,6,0.00200,47266,15.73886,300314
1649,Glyphack,6,0.00200,47272,15.74086,300314
1650,GongWilliam,6,0.00200,47278,15.74286,300314
1651,goock,6,0.00200,47284,15.74485,300314
1652,goslim56,6,0.00200,47290,15.74685,300314
1653,gstanchev,6,0.00200,47296,15.74885,300314
1654,haarchri,6,0.00200,47302,15.75085,300314
1655,haibinxie,6,0.00200,47308,15.75285,300314
1656,hakrac,6,0.00200,47314,15.75484,300314
1657,haowells,6,0.00200,47320,15.75684,300314
1658,harshakondreddy,6,0.00200,47326,15.75884,300314
1659,heartTorres,6,0.00200,47332,15.76084,300314
1660,hochuenw-dd,6,0.00200,47338,15.76283,300314
1661,hooklee2000,6,0.00200,47344,15.76483,300314
1662,humiao8sz,6,0.00200,47350,15.76683,300314
1663,iamargopelter,6,0.00200,47356,15.76883,300314
1664,indra0007,6,0.00200,47362,15.77083,300314
1665,IngussNeilands,6,0.00200,47368,15.77282,300314
1666,jacek-jablonski,6,0.00200,47374,15.77482,300314
1667,jackycdc,6,0.00200,47380,15.77682,300314
1668,jadeapplegate,6,0.00200,47386,15.77882,300314
1669,jameswilsongrant,6,0.00200,47392,15.78082,300314
1670,jasonschroeder-sfdc,6,0.00200,47398,15.78281,300314
1671,jc42jc,6,0.00200,47404,15.78481,300314
1672,jef,6,0.00200,47410,15.78681,300314
1673,jelmer,6,0.00200,47416,15.78881,300314
1674,Jimmy-Newtron,6,0.00200,47422,15.79081,300314
1675,jiriproX,6,0.00200,47428,15.79280,300314
1676,jlsan92,6,0.00200,47434,15.79480,300314
1677,JoacimWall,6,0.00200,47440,15.79680,300314
1678,JoeyHwong-gk,6,0.00200,47446,15.79880,300314
1679,Johnny-Three,6,0.00200,47452,15.80080,300314
1680,jonasdlindner,6,0.00200,47458,15.80279,300314
1681,jonathansp,6,0.00200,47464,15.80479,300314
1682,jproig,6,0.00200,47470,15.80679,300314
1683,jsjeannotte,6,0.00200,47476,15.80879,300314
1684,juampynr,6,0.00200,47482,15.81078,300314
1685,juanjoku,6,0.00200,47488,15.81278,300314
1686,justin-silveri,6,0.00200,47494,15.81478,300314
1687,Karmavil,6,0.00200,47500,15.81678,300314
1688,kbreit,6,0.00200,47506,15.81878,300314
1689,kcolemangt,6,0.00200,47512,15.82077,300314
1690,kconwayinvision,6,0.00200,47518,15.82277,300314
1691,keith-miller,6,0.00200,47524,15.82477,300314
1692,kerenlahav,6,0.00200,47530,15.82677,300314
1693,kfirfer,6,0.00200,47536,15.82877,300314
1694,kimilpyoung,6,0.00200,47542,15.83076,300314
1695,klboke,6,0.00200,47548,15.83276,300314
1696,kmajcher-rh,6,0.00200,47554,15.83476,300314
1697,kozdincer,6,0.00200,47560,15.83676,300314
1698,krystianmlynek,6,0.00200,47566,15.83876,300314
1699,L1ghtman2k,6,0.00200,47572,15.84075,300314
1700,langes2BE3,6,0.00200,47578,15.84275,300314
1701,lapwat,6,0.00200,47584,15.84475,300314
1702,leonzz,6,0.00200,47590,15.84675,300314
1703,lprimak,6,0.00200,47596,15.84874,300314
1704,lrascao,6,0.00200,47602,15.85074,300314
1705,lucastheisen,6,0.00200,47608,15.85274,300314
1706,maberny,6,0.00200,47614,15.85474,300314
1707,mabikash,6,0.00200,47620,15.85674,300314
1708,maciejaszek,6,0.00200,47626,15.85873,300314
1709,mahnoorm,6,0.00200,47632,15.86073,300314
1710,manedurphy,6,0.00200,47638,15.86273,300314
1711,marcoferrer,6,0.00200,47644,15.86473,300314
1712,MarcPow,6,0.00200,47650,15.86673,300314
1713,martijnjanssen,6,0.00200,47656,15.86872,300314
1714,matoszz,6,0.00200,47662,15.87072,300314
1715,MatteoJoliveau,6,0.00200,47668,15.87272,300314
1716,matthewflannery,6,0.00200,47674,15.87472,300314
1717,mattthhdp,6,0.00200,47680,15.87672,300314
1718,maxbrodin,6,0.00200,47686,15.87871,300314
1719,mazamats,6,0.00200,47692,15.88071,300314
1720,mbergin,6,0.00200,47698,15.88271,300314
1721,mibarg,6,0.00200,47704,15.88471,300314
1722,michaelkacher,6,0.00200,47710,15.88671,300314
1723,mindyor,6,0.00200,47716,15.88870,300314
1724,mityayak,6,0.00200,47722,15.89070,300314
1725,mkridzelis,6,0.00200,47728,15.89270,300314
1726,moninCX,6,0.00200,47734,15.89470,300314
1727,mrliptontea,6,0.00200,47740,15.89669,300314
1728,MRoci,6,0.00200,47746,15.89869,300314
1729,mshalmanov,6,0.00200,47752,15.90069,300314
1730,muxx,6,0.00200,47758,15.90269,300314
1731,najohnsn,6,0.00200,47764,15.90469,300314
1732,necatican,6,0.00200,47770,15.90668,300314
1733,netodeolino,6,0.00200,47776,15.90868,300314
1734,netpoetica,6,0.00200,47782,15.91068,300314
1735,nextrevision,6,0.00200,47788,15.91268,300314
1736,nigels-com,6,0.00200,47794,15.91468,300314
1737,NilsGriebner,6,0.00200,47800,15.91667,300314
1738,No9,6,0.00200,47806,15.91867,300314
1739,nomeelnoj,6,0.00200,47812,15.92067,300314
1740,nonefaken,6,0.00200,47818,15.92267,300314
1741,nozik,6,0.00200,47824,15.92467,300314
1742,nuriel77,6,0.00200,47830,15.92666,300314
1743,nwaistd,6,0.00200,47836,15.92866,300314
1744,odalet,6,0.00200,47842,15.93066,300314
1745,oekarlsson,6,0.00200,47848,15.93266,300314
1746,oertl,6,0.00200,47854,15.93466,300314
1747,ogarcia,6,0.00200,47860,15.93665,300314
1748,OmairK,6,0.00200,47866,15.93865,300314
1749,omrikiei,6,0.00200,47872,15.94065,300314
1750,oppegard,6,0.00200,47878,15.94265,300314
1751,ordovicia,6,0.00200,47884,15.94464,300314
1752,ozoz03,6,0.00200,47890,15.94664,300314
1753,pavilalopes,6,0.00200,47896,15.94864,300314
1754,pchandrasekhar210893,6,0.00200,47902,15.95064,300314
1755,pcjeffmac,6,0.00200,47908,15.95264,300314
1756,pdrastil,6,0.00200,47914,15.95463,300314
1757,phoenixwu0229,6,0.00200,47920,15.95663,300314
1758,phybros,6,0.00200,47926,15.95863,300314
1759,piano-man,6,0.00200,47932,15.96063,300314
1760,pkbhowmick,6,0.00200,47938,15.96263,300314
1761,pparapatics,6,0.00200,47944,15.96462,300314
1762,pradnic,6,0.00200,47950,15.96662,300314
1763,prahaladdarkin,6,0.00200,47956,15.96862,300314
1764,Preisschild,6,0.00200,47962,15.97062,300314
1765,Promaethius,6,0.00200,47968,15.97262,300314
1766,psaini79,6,0.00200,47974,15.97461,300314
1767,ragoncsa,6,0.00200,47980,15.97661,300314
1768,raphaelauv,6,0.00200,47986,15.97861,300314
1769,rebeccajae,6,0.00200,47992,15.98061,300314
1770,reginapizza,6,0.00200,47998,15.98260,300314
1771,reith,6,0.00200,48004,15.98460,300314
1772,RichieSams,6,0.00200,48010,15.98660,300314
1773,rickif,6,0.00200,48016,15.98860,300314
1774,Rizary,6,0.00200,48022,15.99060,300314
1775,rizerzero,6,0.00200,48028,15.99259,300314
1776,rmzturkmen,6,0.00200,48034,15.99459,300314
1777,rory-lamendola,6,0.00200,48040,15.99659,300314
1778,rra,6,0.00200,48046,15.99859,300314
1779,RSoodAMAT,6,0.00200,48052,16.00059,300314
1780,rsparulek,6,0.00200,48058,16.00258,300314
1781,rudimk,6,0.00200,48064,16.00458,300314
1782,rutgerbrf,6,0.00200,48070,16.00658,300314
1783,rysunder,6,0.00200,48076,16.00858,300314
1784,samiramkr,6,0.00200,48082,16.01058,300314
1785,samyak-jn,6,0.00200,48088,16.01257,300314
1786,sanderson042,6,0.00200,48094,16.01457,300314
1787,saparaj,6,0.00200,48100,16.01657,300314
1788,satr,6,0.00200,48106,16.01857,300314
1789,sdeoras,6,0.00200,48112,16.02057,300314
1790,sdickhoven,6,0.00200,48118,16.02256,300314
1791,sebumd,6,0.00200,48124,16.02456,300314
1792,seveas,6,0.00200,48130,16.02656,300314
1793,seventieskid,6,0.00200,48136,16.02856,300314
1794,sfc-gh-cxu,6,0.00200,48142,16.03055,300314
1795,shubham391,6,0.00200,48148,16.03255,300314
1796,sirkubax,6,0.00200,48154,16.03455,300314
1797,sleeping-barber,6,0.00200,48160,16.03655,300314
1798,SleepingShell,6,0.00200,48166,16.03855,300314
1799,sli720,6,0.00200,48172,16.04054,300314
1800,smartaquarius10,6,0.00200,48178,16.04254,300314
1801,SomalianIvan,6,0.00200,48184,16.04454,300314
1802,spatel-cog,6,0.00200,48190,16.04654,300314
1803,srteam2020,6,0.00200,48196,16.04854,300314
1804,Stefanqn,6,0.00200,48202,16.05053,300314
1805,steve2021,6,0.00200,48208,16.05253,300314
1806,sullis,6,0.00200,48214,16.05453,300314
1807,t3mi,6,0.00200,48220,16.05653,300314
1808,Tal-or,6,0.00200,48226,16.05853,300314
1809,tangmin823,6,0.00200,48232,16.06052,300314
1810,taragurung,6,0.00200,48238,16.06252,300314
1811,TattdCodeMonkey,6,0.00200,48244,16.06452,300314
1812,teo-tsou,6,0.00200,48250,16.06652,300314
1813,tho861998,6,0.00200,48256,16.06851,300314
1814,tmousaw-ptc,6,0.00200,48262,16.07051,300314
1815,tompsota,6,0.00200,48268,16.07251,300314
1816,tshaiman,6,0.00200,48274,16.07451,300314
1817,uxth,6,0.00200,48280,16.07651,300314
1818,valerauko,6,0.00200,48286,16.07850,300314
1819,venkatjk,6,0.00200,48292,16.08050,300314
1820,vickeyrihal1,6,0.00200,48298,16.08250,300314
1821,vincetai,6,0.00200,48304,16.08450,300314
1822,vivek-26,6,0.00200,48310,16.08650,300314
1823,viveksahu26,6,0.00200,48316,16.08849,300314
1824,vonProteus,6,0.00200,48322,16.09049,300314
1825,wahabmk,6,0.00200,48328,16.09249,300314
1826,wangzd1,6,0.00200,48334,16.09449,300314
1827,waulee,6,0.00200,48340,16.09649,300314
1828,wen11497110,6,0.00200,48346,16.09848,300314
1829,xavipanda,6,0.00200,48352,16.10048,300314
1830,xkrt,6,0.00200,48358,16.10248,300314
1831,xoxys,6,0.00200,48364,16.10448,300314
1832,yolossn,6,0.00200,48370,16.10648,300314
1833,yunkunrao,6,0.00200,48376,16.10847,300314
1834,ywyt738,6,0.00200,48382,16.11047,300314
1835,zeeshanalisyed,6,0.00200,48388,16.11247,300314
1836,zhangwenlong8911,6,0.00200,48394,16.11447,300314
1837,zsuzhengdu,6,0.00200,48400,16.11646,300314
1838,zyitingftnt,6,0.00200,48406,16.11846,300314
1839,0Ams,5,0.00166,48411,16.12013,300314
1840,4n4nd,5,0.00166,48416,16.12179,300314
1841,a8j8i8t8,5,0.00166,48421,16.12346,300314
1842,aalcaraz97,5,0.00166,48426,16.12512,300314
1843,aamattos,5,0.00166,48431,16.12679,300314
1844,AaruniAggarwal,5,0.00166,48436,16.12845,300314
1845,aatifbandey,5,0.00166,48441,16.13012,300314
1846,aauren,5,0.00166,48446,16.13178,300314
1847,AbelTaylor,5,0.00166,48451,16.13345,300314
1848,abiliojr,5,0.00166,48456,16.13511,300314
1849,adam-olema,5,0.00166,48461,16.13678,300314
1850,adbjo,5,0.00166,48466,16.13844,300314
1851,addname,5,0.00166,48471,16.14011,300314
1852,agilob,5,0.00166,48476,16.14177,300314
1853,ahjohannessen,5,0.00166,48481,16.14344,300314
1854,ahmet,5,0.00166,48486,16.14510,300314
1855,aland-zhang,5,0.00166,48491,16.14677,300314
1856,aledegano,5,0.00166,48496,16.14843,300314
1857,alxy,5,0.00166,48501,16.15010,300314
1858,Ancient-Dragon,5,0.00166,48506,16.15176,300314
1859,AndreKR,5,0.00166,48511,16.15343,300314
1860,Aniket118,5,0.00166,48516,16.15509,300314
1861,anonymint,5,0.00166,48521,16.15676,300314
1862,AnyISalIn,5,0.00166,48526,16.15842,300314
1863,Archer1A,5,0.00166,48531,16.16009,300314
1864,ardove,5,0.00166,48536,16.16175,300314
1865,ArenaSu,5,0.00166,48541,16.16342,300314
1866,arno-snop,5,0.00166,48546,16.16508,300314
1867,artem-nefedov,5,0.00166,48551,16.16675,300314
1868,asanderson,5,0.00166,48556,16.16841,300314
1869,AshenW0lf,5,0.00166,48561,16.17008,300314
1870,ashok-an,5,0.00166,48566,16.17174,300314
1871,ashokc,5,0.00166,48571,16.17341,300314
1872,astute-engineering,5,0.00166,48576,16.17507,300314
1873,atze234,5,0.00166,48581,16.17674,300314
1874,avifried1,5,0.00166,48586,16.17840,300314
1875,axelgobletbdr,5,0.00166,48591,16.18006,300314
1876,badabapidas,5,0.00166,48596,16.18173,300314
1877,baikai,5,0.00166,48601,16.18339,300314
1878,balous,5,0.00166,48606,16.18506,300314
1879,banshee86vr,5,0.00166,48611,16.18672,300314
1880,bcsaller,5,0.00166,48616,16.18839,300314
1881,bdutta,5,0.00166,48621,16.19005,300314
1882,BigSammich,5,0.00166,48626,16.19172,300314
1883,billinghamj,5,0.00166,48631,16.19338,300314
1884,BitProcessor,5,0.00166,48636,16.19505,300314
1885,bl-ue,5,0.00166,48641,16.19671,300314
1886,bluepuma77,5,0.00166,48646,16.19838,300314
1887,bob-rohan,5,0.00166,48651,16.20004,300314
1888,Born2Bake,5,0.00166,48656,16.20171,300314
1889,brendonthiede,5,0.00166,48661,16.20337,300314
1890,brianannis,5,0.00166,48666,16.20504,300314
1891,brunnels,5,0.00166,48671,16.20670,300314
1892,c0bra,5,0.00166,48676,16.20837,300314
1893,caleb15,5,0.00166,48681,16.21003,300314
1894,camjohson,5,0.00166,48686,16.21170,300314
1895,CathalAherne,5,0.00166,48691,16.21336,300314
1896,cezzaine,5,0.00166,48696,16.21503,300314
1897,chadiandianwenrou,5,0.00166,48701,16.21669,300314
1898,ChadJessup,5,0.00166,48706,16.21836,300314
1899,chainhead,5,0.00166,48711,16.22002,300314
1900,chaospuppy,5,0.00166,48716,16.22169,300314
1901,ChaturvediSulabh,5,0.00166,48721,16.22335,300314
1902,chenwng,5,0.00166,48726,16.22502,300314
1903,chikinchoi,5,0.00166,48731,16.22668,300314
1904,ch-plattner,5,0.00166,48736,16.22835,300314
1905,Chuyukang,5,0.00166,48741,16.23001,300314
1906,ClaudiuLSH,5,0.00166,48746,16.23168,300314
1907,clcchai,5,0.00166,48751,16.23334,300314
1908,clearday4,5,0.00166,48756,16.23501,300314
1909,cloudfather,5,0.00166,48761,16.23667,300314
1910,cmayer-indeed,5,0.00166,48766,16.23834,300314
1911,coala-svn,5,0.00166,48771,16.24000,300314
1912,codedevote,5,0.00166,48776,16.24167,300314
1913,conradwt,5,0.00166,48781,16.24333,300314
1914,corend,5,0.00166,48786,16.24500,300314
1915,corest,5,0.00166,48791,16.24666,300314
1916,dactionx,5,0.00166,48796,16.24833,300314
1917,dahrens,5,0.00166,48801,16.24999,300314
1918,Daniel-Vaz,5,0.00166,48806,16.25166,300314
1919,DanielW10001,5,0.00166,48811,16.25332,300314
1920,danielwegener,5,0.00166,48816,16.25499,300314
1921,danilorsilva,5,0.00166,48821,16.25665,300314
1922,darox,5,0.00166,48826,16.25832,300314
1923,dbsid,5,0.00166,48831,16.25998,300314
1924,DeathBorn,5,0.00166,48836,16.26165,300314
1925,defenestration,5,0.00166,48841,16.26331,300314
1926,deining,5,0.00166,48846,16.26498,300314
1927,DennisGlindhart,5,0.00166,48851,16.26664,300314
1928,djboris9,5,0.00166,48856,16.26831,300314
1929,dme26,5,0.00166,48861,16.26997,300314
1930,dmitry-mightydevops,5,0.00166,48866,16.27164,300314
1931,domainname,5,0.00166,48871,16.27330,300314
1932,dpp23,5,0.00166,48876,16.27497,300314
1933,duanguoxue,5,0.00166,48881,16.27663,300314
1934,ejderdal,5,0.00166,48886,16.27830,300314
1935,enyo,5,0.00166,48891,16.27996,300314
1936,erekgit,5,0.00166,48896,16.28163,300314
1937,eyakimov-bbg,5,0.00166,48901,16.28329,300314
1938,Falconx1000,5,0.00166,48906,16.28496,300314
1939,falun,5,0.00166,48911,16.28662,300314
1940,felixsiju,5,0.00166,48916,16.28828,300314
1941,fengypants,5,0.00166,48921,16.28995,300314
1942,fitchtech,5,0.00166,48926,16.29161,300314
1943,FNaughton,5,0.00166,48931,16.29328,300314
1944,foromer4,5,0.00166,48936,16.29494,300314
1945,forselli-stratio,5,0.00166,48941,16.29661,300314
1946,Frederik-Baetens,5,0.00166,48946,16.29827,300314
1947,frenzymadness,5,0.00166,48951,16.29994,300314
1948,friendlydevops,5,0.00166,48956,16.30160,300314
1949,froblesmartin,5,0.00166,48961,16.30327,300314
1950,fsigalov,5,0.00166,48966,16.30493,300314
1951,fysd,5,0.00166,48971,16.30660,300314
1952,gagipro,5,0.00166,48976,16.30826,300314
1953,gakkiyomi,5,0.00166,48981,16.30993,300314
1954,gaojx,5,0.00166,48986,16.31159,300314
1955,gaoxinge,5,0.00166,48991,16.31326,300314
1956,gavinvandermerwe,5,0.00166,48996,16.31492,300314
1957,georgeslb,5,0.00166,49001,16.31659,300314
1958,gilad-bendor,5,0.00166,49006,16.31825,300314
1959,giovanni-ferrari,5,0.00166,49011,16.31992,300314
1960,gmintoco,5,0.00166,49016,16.32158,300314
1961,Goend,5,0.00166,49021,16.32325,300314
1962,goudai,5,0.00166,49026,16.32491,300314
1963,grandich,5,0.00166,49031,16.32658,300314
1964,grasparv,5,0.00166,49036,16.32824,300314
1965,gregoryfranklin,5,0.00166,49041,16.32991,300314
1966,gromanmartin,5,0.00166,49046,16.33157,300314
1967,Gromcio,5,0.00166,49051,16.33324,300314
1968,guillaumep,5,0.00166,49056,16.33490,300314
1969,guitarrapc,5,0.00166,49061,16.33657,300314
1970,gunjasal,5,0.00166,49066,16.33823,300314
1971,HankTheCrank,5,0.00166,49071,16.33990,300314
1972,hardwaysun,5,0.00166,49076,16.34156,300314
1973,harinreddy,5,0.00166,49081,16.34323,300314
1974,harshasrimal,5,0.00166,49086,16.34489,300314
1975,haruelico,5,0.00166,49091,16.34656,300314
1976,hawkaa,5,0.00166,49096,16.34822,300314
1977,heatonmatthew,5,0.00166,49101,16.34989,300314
1978,hemna,5,0.00166,49106,16.35155,300314
1979,hickersonj,5,0.00166,49111,16.35322,300314
1980,Himself12794,5,0.00166,49116,16.35488,300314
1981,hl3w22bupt,5,0.00166,49121,16.35655,300314
1982,houchunzhong,5,0.00166,49126,16.35821,300314
1983,hovinen,5,0.00166,49131,16.35988,300314
1984,hrpatel,5,0.00166,49136,16.36154,300314
1985,Huweicai,5,0.00166,49141,16.36321,300314
1986,hyserver,5,0.00166,49146,16.36487,300314
1987,IainColledge,5,0.00166,49151,16.36654,300314
1988,iamanv,5,0.00166,49156,16.36820,300314
1989,ibesso-rh,5,0.00166,49161,16.36987,300314
1990,iJebus,5,0.00166,49166,16.37153,300314
1991,ikeeip,5,0.00166,49171,16.37320,300314
1992,imle,5,0.00166,49176,16.37486,300314
1993,immae,5,0.00166,49181,16.37653,300314
1994,indera-shsp,5,0.00166,49186,16.37819,300314
1995,jackson541,5,0.00166,49191,16.37986,300314
1996,jaimehrubiks,5,0.00166,49196,16.38152,300314
1997,jalseth,5,0.00166,49201,16.38319,300314
1998,JamesIsHuang,5,0.00166,49206,16.38485,300314
1999,james-song,5,0.00166,49211,16.38652,300314
2000,jamesylgan,5,0.00166,49216,16.38818,300314
2001,JanMkl,5,0.00166,49221,16.38985,300314
2002,JasonNing96,5,0.00166,49226,16.39151,300314
2003,jdomag,5,0.00166,49231,16.39318,300314
2004,jean,5,0.00166,49236,16.39484,300314
2005,jeff51419,5,0.00166,49241,16.39650,300314
2006,jefjos,5,0.00166,49246,16.39817,300314
2007,jerry153fish,5,0.00166,49251,16.39983,300314
2008,jespino,5,0.00166,49256,16.40150,300314
2009,jgrund,5,0.00166,49261,16.40316,300314
2010,jimmyat,5,0.00166,49266,16.40483,300314
2011,jithesh124,5,0.00166,49271,16.40649,300314
2012,jjschwarz,5,0.00166,49276,16.40816,300314
2013,JM89,5,0.00166,49281,16.40982,300314
2014,jobcespedes,5,0.00166,49286,16.41149,300314
2015,johanneslarsson,5,0.00166,49291,16.41315,300314
2016,Jojoooo1,5,0.00166,49296,16.41482,300314
2017,jonashackt,5,0.00166,49301,16.41648,300314
2018,joncel-lan,5,0.00166,49306,16.41815,300314
2019,jorgemarey,5,0.00166,49311,16.41981,300314
2020,joshuabezaleel,5,0.00166,49316,16.42148,300314
2021,jrRibeiro,5,0.00166,49321,16.42314,300314
2022,jsshinn,5,0.00166,49326,16.42481,300314
2023,juergenthomann,5,0.00166,49331,16.42647,300314
2024,julian-mp,5,0.00166,49336,16.42814,300314
2025,junox365,5,0.00166,49341,16.42980,300314
2026,justbert,5,0.00166,49346,16.43147,300314
2027,j-zimnowoda,5,0.00166,49351,16.43313,300314
2028,KainaatSingh,5,0.00166,49356,16.43480,300314
2029,kchilka-msft,5,0.00166,49361,16.43646,300314
2030,kindermoumoute,5,0.00166,49366,16.43813,300314
2031,kingudk,5,0.00166,49371,16.43979,300314
2032,kirinnee-atomi,5,0.00166,49376,16.44146,300314
2033,kkujawa-sumo,5,0.00166,49381,16.44312,300314
2034,KnechtionsCoding,5,0.00166,49386,16.44479,300314
2035,kolomenkin,5,0.00166,49391,16.44645,300314
2036,kou-h,5,0.00166,49396,16.44812,300314
2037,krishnakekan19,5,0.00166,49401,16.44978,300314
2038,kycfeel,5,0.00166,49406,16.45145,300314
2039,lamw,5,0.00166,49411,16.45311,300314
2040,lasdolphin,5,0.00166,49416,16.45478,300314
2041,lbscorpio,5,0.00166,49421,16.45644,300314
2042,lcwangchao,5,0.00166,49426,16.45811,300314
2043,lcwus2,5,0.00166,49431,16.45977,300314
2044,LeeStevens318,5,0.00166,49436,16.46144,300314
2045,lennartmohr,5,0.00166,49441,16.46310,300314
2046,liangli1213,5,0.00166,49446,16.46477,300314
2047,lidavidm,5,0.00166,49451,16.46643,300314
2048,liorfranko,5,0.00166,49456,16.46810,300314
2049,lisongmin,5,0.00166,49461,16.46976,300314
2050,little-dude,5,0.00166,49466,16.47143,300314
2051,liuquanhao,5,0.00166,49471,16.47309,300314
2052,liwanxue,5,0.00166,49476,16.47476,300314
2053,lixiaochun,5,0.00166,49481,16.47642,300314
2054,lkakarla,5,0.00166,49486,16.47809,300314
2055,loopingz,5,0.00166,49491,16.47975,300314
2056,Lordieolore,5,0.00166,49496,16.48142,300314
2057,ludz-lim,5,0.00166,49501,16.48308,300314
2058,luryus,5,0.00166,49506,16.48475,300314
2059,LuyaoZhong,5,0.00166,49511,16.48641,300314
2060,lzhfromustc,5,0.00166,49516,16.48808,300314
2061,madhukkc,5,0.00166,49521,16.48974,300314
2062,madhuresh04,5,0.00166,49526,16.49141,300314
2063,maha-z,5,0.00166,49531,16.49307,300314
2064,maniankara,5,0.00166,49536,16.49474,300314
2065,manojpandey,5,0.00166,49541,16.49640,300314
2066,marklester,5,0.00166,49546,16.49807,300314
2067,MartinThoma,5,0.00166,49551,16.49973,300314
2068,matthunt1984,5,0.00166,49556,16.50140,300314
2069,mauricionr,5,0.00166,49561,16.50306,300314
2070,MB1211,5,0.00166,49566,16.50473,300314
2071,mbeaulie,5,0.00166,49571,16.50639,300314
2072,mbwmbw1337,5,0.00166,49576,16.50805,300314
2073,MD-V,5,0.00166,49581,16.50972,300314
2074,mehmetsalgar,5,0.00166,49586,16.51138,300314
2075,mensylisir,5,0.00166,49591,16.51305,300314
2076,merlante,5,0.00166,49596,16.51471,300314
2077,mfaorlkzus,5,0.00166,49601,16.51638,300314
2078,michbsd,5,0.00166,49606,16.51804,300314
2079,mike-sirs,5,0.00166,49611,16.51971,300314
2080,MirzaSikander,5,0.00166,49616,16.52137,300314
2081,mishraprafful,5,0.00166,49621,16.52304,300314
2082,mistikel,5,0.00166,49626,16.52470,300314
2083,mkuger,5,0.00166,49631,16.52637,300314
2084,mkustermann,5,0.00166,49636,16.52803,300314
2085,moraitisk,5,0.00166,49641,16.52970,300314
2086,mpoettgen,5,0.00166,49646,16.53136,300314
2087,Mrzhangxd,5,0.00166,49651,16.53303,300314
2088,msarvar,5,0.00166,49656,16.53469,300314
2089,msinghal34,5,0.00166,49661,16.53636,300314
2090,msts1906,5,0.00166,49666,16.53802,300314
2091,murki,5,0.00166,49671,16.53969,300314
2092,mxmorin,5,0.00166,49676,16.54135,300314
2093,NavindrenBaskaran,5,0.00166,49681,16.54302,300314
2094,nchetan,5,0.00166,49686,16.54468,300314
2095,ncksp,5,0.00166,49691,16.54635,300314
2096,ncook-hxgn,5,0.00166,49696,16.54801,300314
2097,ndimitry,5,0.00166,49701,16.54968,300314
2098,NeckBeardPrince,5,0.00166,49706,16.55134,300314
2099,nettoclaudio,5,0.00166,49711,16.55301,300314
2100,nguyenvulong,5,0.00166,49716,16.55467,300314
2101,NICK-DUAN,5,0.00166,49721,16.55634,300314
2102,NickEPalmer,5,0.00166,49726,16.55800,300314
2103,nicolas-geniteau,5,0.00166,49731,16.55967,300314
2104,Nilubkal,5,0.00166,49736,16.56133,300314
2105,niranjanative,5,0.00166,49741,16.56300,300314
2106,nopa607,5,0.00166,49746,16.56466,300314
2107,notgerry,5,0.00166,49751,16.56633,300314
2108,NRKirby,5,0.00166,49756,16.56799,300314
2109,NutsArray,5,0.00166,49761,16.56966,300314
2110,oguera,5,0.00166,49766,16.57132,300314
2111,omerbensaadon,5,0.00166,49771,16.57299,300314
2112,OpenetCK,5,0.00166,49776,16.57465,300314
2113,oprudkyi,5,0.00166,49781,16.57632,300314
2114,oranichu,5,0.00166,49786,16.57798,300314
2115,Ornias1993,5,0.00166,49791,16.57965,300314
2116,osddeitf,5,0.00166,49796,16.58131,300314
2117,panho66,5,0.00166,49801,16.58298,300314
2118,paulliss,5,0.00166,49806,16.58464,300314
2119,pendyalal,5,0.00166,49811,16.58631,300314
2120,peteroneilljr,5,0.00166,49816,16.58797,300314
2121,plan-do-break-fix,5,0.00166,49821,16.58964,300314
2122,plentifullee,5,0.00166,49826,16.59130,300314
2123,pmatheson-greenphire,5,0.00166,49831,16.59297,300314
2124,prab2014,5,0.00166,49836,16.59463,300314
2125,prageetika,5,0.00166,49841,16.59630,300314
2126,prime-minister-of-fun,5,0.00166,49846,16.59796,300314
2127,PriyankaH21,5,0.00166,49851,16.59963,300314
2128,qloog,5,0.00166,49856,16.60129,300314
2129,r0bobo,5,0.00166,49861,16.60296,300314
2130,radzikp,5,0.00166,49866,16.60462,300314
2131,rafaelsilvaaa10,5,0.00166,49871,16.60629,300314
2132,raidancampbell,5,0.00166,49876,16.60795,300314
2133,raonelakurti,5,0.00166,49881,16.60962,300314
2134,rashmichandrashekar,5,0.00166,49886,16.61128,300314
2135,raunyoliveira-hotmart,5,0.00166,49891,16.61295,300314
2136,rbren,5,0.00166,49896,16.61461,300314
2137,RedRoserade,5,0.00166,49901,16.61627,300314
2138,ReillyBrogan,5,0.00166,49906,16.61794,300314
2139,RenaShahMSFT,5,0.00166,49911,16.61960,300314
2140,rgoerwit,5,0.00166,49916,16.62127,300314
2141,rileyhun,5,0.00166,49921,16.62293,300314
2142,rnachire,5,0.00166,49926,16.62460,300314
2143,rossi-fi,5,0.00166,49931,16.62626,300314
2144,rozcietrzewiacz,5,0.00166,49936,16.62793,300314
2145,rpasche,5,0.00166,49941,16.62959,300314
2146,RudeDude,5,0.00166,49946,16.63126,300314
2147,rudeigerc,5,0.00166,49951,16.63292,300314
2148,ruibinghao,5,0.00166,49956,16.63459,300314
2149,rustrial,5,0.00166,49961,16.63625,300314
2150,RyanAoh,5,0.00166,49966,16.63792,300314
2151,RyuunoAelia,5,0.00166,49971,16.63958,300314
2152,sa-,5,0.00166,49976,16.64125,300314
2153,saberkan,5,0.00166,49981,16.64291,300314
2154,Sabyasachi2k,5,0.00166,49986,16.64458,300314
2155,Sadzeih,5,0.00166,49991,16.64624,300314
2156,SamarthUpadhya,5,0.00166,49996,16.64791,300314
2157,sangeetg,5,0.00166,50001,16.64957,300314
2158,santosh-kodali,5,0.00166,50006,16.65124,300314
2159,sappo,5,0.00166,50011,16.65290,300314
2160,sa-spag,5,0.00166,50016,16.65457,300314
2161,saurabhnanda,5,0.00166,50021,16.65623,300314
2162,s-bauer,5,0.00166,50026,16.65790,300314
2163,schuhu,5,0.00166,50031,16.65956,300314
2164,Sebastian-Landl,5,0.00166,50036,16.66123,300314
2165,seiya-annie,5,0.00166,50041,16.66289,300314
2166,shanghai-Jerry,5,0.00166,50046,16.66456,300314
2167,shashwat-appdirect,5,0.00166,50051,16.66622,300314
2168,shibin-george,5,0.00166,50056,16.66789,300314
2169,shilicqupt,5,0.00166,50061,16.66955,300314
2170,shnplr,5,0.00166,50066,16.67122,300314
2171,Shohou,5,0.00166,50071,16.67288,300314
2172,shubhamc183,5,0.00166,50076,16.67455,300314
2173,shyung,5,0.00166,50081,16.67621,300314
2174,siegfriedweber,5,0.00166,50086,16.67788,300314
2175,simar7,5,0.00166,50091,16.67954,300314
2176,sincorchetes,5,0.00166,50096,16.68121,300314
2177,sitaramshelke,5,0.00166,50101,16.68287,300314
2178,SkrPaoWang,5,0.00166,50106,16.68454,300314
2179,Smuu,5,0.00166,50111,16.68620,300314
2180,solacelost,5,0.00166,50116,16.68787,300314
2181,sosoriov,5,0.00166,50121,16.68953,300314
2182,spaparaju,5,0.00166,50126,16.69120,300314
2183,Srikrishnabh,5,0.00166,50131,16.69286,300314
2184,sshnaidm,5,0.00166,50136,16.69453,300314
2185,stevelerner,5,0.00166,50141,16.69619,300314
2186,stone-z,5,0.00166,50146,16.69786,300314
2187,Stuxend,5,0.00166,50151,16.69952,300314
2188,SVronskiy,5,0.00166,50156,16.70119,300314
2189,Swee1997,5,0.00166,50161,16.70285,300314
2190,sweko,5,0.00166,50166,16.70452,300314
2191,symbiont-ji,5,0.00166,50171,16.70618,300314
2192,Teriand,5,0.00166,50176,16.70785,300314
2193,tgwallenborg,5,0.00166,50181,16.70951,300314
2194,TheKangaroo,5,0.00166,50186,16.71118,300314
2195,thelabdude,5,0.00166,50191,16.71284,300314
2196,thepeterstone,5,0.00166,50196,16.71451,300314
2197,thrixton,5,0.00166,50201,16.71617,300314
2198,Tiberivs,5,0.00166,50206,16.71784,300314
2199,TinyWhite1997,5,0.00166,50211,16.71950,300314
2200,tjamet,5,0.00166,50216,16.72117,300314
2201,tkosanke,5,0.00166,50221,16.72283,300314
2202,tmoschou,5,0.00166,50226,16.72450,300314
2203,tocado,5,0.00166,50231,16.72616,300314
2204,TomMD,5,0.00166,50236,16.72782,300314
2205,tommy-heyde-olsen,5,0.00166,50241,16.72949,300314
2206,toshi1127,5,0.00166,50246,16.73115,300314
2207,toshipp,5,0.00166,50251,16.73282,300314
2208,tspearconquest,5,0.00166,50256,16.73448,300314
2209,tszngai,5,0.00166,50261,16.73615,300314
2210,tvanderka,5,0.00166,50266,16.73781,300314
2211,ukreddy-erwin,5,0.00166,50271,16.73948,300314
2212,unfor19,5,0.00166,50276,16.74114,300314
2213,unikzforce,5,0.00166,50281,16.74281,300314
2214,UnknownGnome,5,0.00166,50286,16.74447,300314
2215,vacheli,5,0.00166,50291,16.74614,300314
2216,VajiraPrabuddhaka,5,0.00166,50296,16.74780,300314
2217,vazra,5,0.00166,50301,16.74947,300314
2218,veikoon,5,0.00166,50306,16.75113,300314
2219,velcrine,5,0.00166,50311,16.75280,300314
2220,vignesh-goutham,5,0.00166,50316,16.75446,300314
2221,vignesh-v-nutanix,5,0.00166,50321,16.75613,300314
2222,vildek,5,0.00166,50326,16.75779,300314
2223,vishaltripathi24,5,0.00166,50331,16.75946,300314
2224,vivekjhauipath,5,0.00166,50336,16.76112,300314
2225,vivekpatani,5,0.00166,50341,16.76279,300314
2226,vvvprabhakar,5,0.00166,50346,16.76445,300314
2227,vyankd,5,0.00166,50351,16.76612,300314
2228,VybavaRamadoss,5,0.00166,50356,16.76778,300314
2229,wajika,5,0.00166,50361,16.76945,300314
2230,wangchaoforever,5,0.00166,50366,16.77111,300314
2231,Wang-Kai,5,0.00166,50371,16.77278,300314
2232,WAY-IT,5,0.00166,50376,16.77444,300314
2233,wdec,5,0.00166,50381,16.77611,300314
2234,whyman,5,0.00166,50386,16.77777,300314
2235,wjuan-AFK,5,0.00166,50391,16.77944,300314
2236,wuhuizuo,5,0.00166,50396,16.78110,300314
2237,wursterje,5,0.00166,50401,16.78277,300314
2238,xenoglaux88,5,0.00166,50406,16.78443,300314
2239,XiaoMuYi,5,0.00166,50411,16.78610,300314
2240,xiaonancc77,5,0.00166,50416,16.78776,300314
2241,yaminet1024,5,0.00166,50421,16.78943,300314
2242,yangmarcyang,5,0.00166,50426,16.79109,300314
2243,yanji09,5,0.00166,50431,16.79276,300314
2244,yariksheptykin,5,0.00166,50436,16.79442,300314
2245,ydp,5,0.00166,50441,16.79609,300314
2246,yhrn,5,0.00166,50446,16.79775,300314
2247,yiyuanyu17,5,0.00166,50451,16.79942,300314
2248,yoave23,5,0.00166,50456,16.80108,300314
2249,zdyxry,5,0.00166,50461,16.80275,300314
2250,zenvdeluca,5,0.00166,50466,16.80441,300314
2251,zhhray,5,0.00166,50471,16.80608,300314
2252,zoetrope,5,0.00166,50476,16.80774,300314
2253,zpan-open,5,0.00166,50481,16.80941,300314
2254,zryfish,5,0.00166,50486,16.81107,300314
2255,1141330133,4,0.00133,50490,16.81240,300314
2256,2sin18,4,0.00133,50494,16.81373,300314
2257,aatarasoff,4,0.00133,50498,16.81507,300314
2258,abdelmonem17,4,0.00133,50502,16.81640,300314
2259,abennani31,4,0.00133,50506,16.81773,300314
2260,Abheestanistala,4,0.00133,50510,16.81906,300314
2261,Abhijit-Mane,4,0.00133,50514,16.82039,300314
2262,abierbaum,4,0.00133,50518,16.82173,300314
2263,acastong,4,0.00133,50522,16.82306,300314
2264,actor168,4,0.00133,50526,16.82439,300314
2265,admilazz,4,0.00133,50530,16.82572,300314
2266,aemperador,4,0.00133,50534,16.82705,300314
2267,aholler,4,0.00133,50538,16.82839,300314
2268,AjohnsonLS,4,0.00133,50542,16.82972,300314
2269,akhalyavka,4,0.00133,50546,16.83105,300314
2270,AleksandrIakhnev,4,0.00133,50550,16.83238,300314
2271,alexandrovas,4,0.00133,50554,16.83371,300314
2272,alexandru-crossover,4,0.00133,50558,16.83505,300314
2273,AlexDHoffer,4,0.00133,50562,16.83638,300314
2274,AlexGS74,4,0.00133,50566,16.83771,300314
2275,alghe-global,4,0.00133,50570,16.83904,300314
2276,almas33,4,0.00133,50574,16.84037,300314
2277,altexdim,4,0.00133,50578,16.84171,300314
2278,altwohill,4,0.00133,50582,16.84304,300314
2279,amartyarooney,4,0.00133,50586,16.84437,300314
2280,Amos-85,4,0.00133,50590,16.84570,300314
2281,amshankaran,4,0.00133,50594,16.84703,300314
2282,anasalloush,4,0.00133,50598,16.84837,300314
2283,AndreyKrupskii,4,0.00133,50602,16.84970,300314
2284,anishagg17,4,0.00133,50606,16.85103,300314
2285,Annegies,4,0.00133,50610,16.85236,300314
2286,anshulr,4,0.00133,50614,16.85369,300314
2287,apeksharma,4,0.00133,50618,16.85503,300314
2288,aplanas,4,0.00133,50622,16.85636,300314
2289,archlinux-github,4,0.00133,50626,16.85769,300314
2290,archoversight,4,0.00133,50630,16.85902,300314
2291,arckey,4,0.00133,50634,16.86035,300314
2292,argamanza,4,0.00133,50638,16.86168,300314
2293,arkrishnan,4,0.00133,50642,16.86302,300314
2294,armourshield,4,0.00133,50646,16.86435,300314
2295,arpitkh96,4,0.00133,50650,16.86568,300314
2296,arunavamagi,4,0.00133,50654,16.86701,300314
2297,arunk4m,4,0.00133,50658,16.86834,300314
2298,asafc,4,0.00133,50662,16.86968,300314
2299,asafsofer-sl,4,0.00133,50666,16.87101,300314
2300,Asdprom,4,0.00133,50670,16.87234,300314
2301,atline,4,0.00133,50674,16.87367,300314
2302,AubreyMuhlach,4,0.00133,50678,16.87500,300314
2303,avdurgesh,4,0.00133,50682,16.87634,300314
2304,avinashk442,4,0.00133,50686,16.87767,300314
2305,AvniWala-Sophos,4,0.00133,50690,16.87900,300314
2306,axelczk,4,0.00133,50694,16.88033,300314
2307,aztechian,4,0.00133,50698,16.88166,300314
2308,AzucenaL,4,0.00133,50702,16.88300,300314
2309,azulkarnyaev,4,0.00133,50706,16.88433,300314
2310,azzy123,4,0.00133,50710,16.88566,300314
2311,BadriL,4,0.00133,50714,16.88699,300314
2312,bainilybi,4,0.00133,50718,16.88832,300314
2313,balonik,4,0.00133,50722,16.88966,300314
2314,baryluk,4,0.00133,50726,16.89099,300314
2315,bazzilio,4,0.00133,50730,16.89232,300314
2316,bgutschke,4,0.00133,50734,16.89365,300314
2317,bhatiakartik10,4,0.00133,50738,16.89498,300314
2318,billykwooten,4,0.00133,50742,16.89632,300314
2319,Bit-Chaos,4,0.00133,50746,16.89765,300314
2320,bjw-s,4,0.00133,50750,16.89898,300314
2321,blastik,4,0.00133,50754,16.90031,300314
2322,bledieu,4,0.00133,50758,16.90164,300314
2323,BlueCog,4,0.00133,50762,16.90297,300314
2324,brathina-spectro,4,0.00133,50766,16.90431,300314
2325,bret-hubbard,4,0.00133,50770,16.90564,300314
2326,briansterle,4,0.00133,50774,16.90697,300314
2327,britoaldan,4,0.00133,50778,16.90830,300314
2328,brross,4,0.00133,50782,16.90963,300314
2329,btdan,4,0.00133,50786,16.91097,300314
2330,CadmusJiang,4,0.00133,50790,16.91230,300314
2331,canberkkoc,4,0.00133,50794,16.91363,300314
2332,capkrunch,4,0.00133,50798,16.91496,300314
2333,carlosstrand,4,0.00133,50802,16.91629,300314
2334,catblade,4,0.00133,50806,16.91763,300314
2335,catenacyber,4,0.00133,50810,16.91896,300314
2336,ca-wvestjens,4,0.00133,50814,16.92029,300314
2337,cborealis,4,0.00133,50818,16.92162,300314
2338,ccpp-apriorit,4,0.00133,50822,16.92295,300314
2339,cesarokuti,4,0.00133,50826,16.92429,300314
2340,cf250024,4,0.00133,50830,16.92562,300314
2341,cforce,4,0.00133,50834,16.92695,300314
2342,cfw11,4,0.00133,50838,16.92828,300314
2343,c-goes,4,0.00133,50842,16.92961,300314
2344,cgorbit,4,0.00133,50846,16.93095,300314
2345,chaitanyabandi,4,0.00133,50850,16.93228,300314
2346,chaitushiva,4,0.00133,50854,16.93361,300314
2347,chandanAggarwal,4,0.00133,50858,16.93494,300314
2348,Cheers-am,4,0.00133,50862,16.93627,300314
2349,chinglinwen,4,0.00133,50866,16.93761,300314
2350,ChrisCGH,4,0.00133,50870,16.93894,300314
2351,Chris-Johnston,4,0.00133,50874,16.94027,300314
2352,chris-ng-scmp,4,0.00133,50878,16.94160,300314
2353,christophd,4,0.00133,50882,16.94293,300314
2354,chrye,4,0.00133,50886,16.94427,300314
2355,CHTONGY,4,0.00133,50890,16.94560,300314
2356,c-kruse,4,0.00133,50894,16.94693,300314
2357,cloudcafetech,4,0.00133,50898,16.94826,300314
2358,clrxbl,4,0.00133,50902,16.94959,300314
2359,cmd-werner,4,0.00133,50906,16.95092,300314
2360,codefromthecrypt,4,0.00133,50910,16.95226,300314
2361,cotjoey,4,0.00133,50914,16.95359,300314
2362,cptkng23,4,0.00133,50918,16.95492,300314
2363,Craftoncu,4,0.00133,50922,16.95625,300314
2364,craigbryson,4,0.00133,50926,16.95758,300314
2365,criscola,4,0.00133,50930,16.95892,300314
2366,Cshanmukh80,4,0.00133,50934,16.96025,300314
2367,damadei-google,4,0.00133,50938,16.96158,300314
2368,damoye,4,0.00133,50942,16.96291,300314
2369,danifr,4,0.00133,50946,16.96424,300314
2370,dastergon,4,0.00133,50950,16.96558,300314
2371,Davidde94,4,0.00133,50954,16.96691,300314
2372,DavidHaltinner,4,0.00133,50958,16.96824,300314
2373,dcherman,4,0.00133,50962,16.96957,300314
2374,DerekStrickland,4,0.00133,50966,16.97090,300314
2375,dervoeti,4,0.00133,50970,16.97224,300314
2376,devZer0,4,0.00133,50974,16.97357,300314
2377,dex4er,4,0.00133,50978,16.97490,300314
2378,dgarciarubio,4,0.00133,50982,16.97623,300314
2379,d-honeybadger,4,0.00133,50986,16.97756,300314
2380,dimitarKiryakov,4,0.00133,50990,16.97890,300314
2381,dkontorovskyy,4,0.00133,50994,16.98023,300314
2382,dkravetz,4,0.00133,50998,16.98156,300314
2383,dmolenda-sumo,4,0.00133,51002,16.98289,300314
2384,dmsqls,4,0.00133,51006,16.98422,300314
2385,DoHuber,4,0.00133,51010,16.98556,300314
2386,douglasmakey,4,0.00133,51014,16.98689,300314
2387,drogus,4,0.00133,51018,16.98822,300314
2388,Drugoy,4,0.00133,51022,16.98955,300314
2389,dschunack,4,0.00133,51026,16.99088,300314
2390,dsmackie,4,0.00133,51030,16.99221,300314
2391,dsnet,4,0.00133,51034,16.99355,300314
2392,dsnr-pavankumar,4,0.00133,51038,16.99488,300314
2393,duchungvu,4,0.00133,51042,16.99621,300314
2394,D-wenhao,4,0.00133,51046,16.99754,300314
2395,dylex,4,0.00133,51050,16.99887,300314
2396,Eagleman7,4,0.00133,51054,17.00021,300314
2397,EddieHoffman,4,0.00133,51058,17.00154,300314
2398,ediezh,4,0.00133,51062,17.00287,300314
2399,Edord99,4,0.00133,51066,17.00420,300314
2400,eedorenko,4,0.00133,51070,17.00553,300314
2401,efrikin,4,0.00133,51074,17.00687,300314
2402,ehsavoie,4,0.00133,51078,17.00820,300314
2403,emmayang,4,0.00133,51082,17.00953,300314
2404,endink,4,0.00133,51086,17.01086,300314
2405,eocantu,4,0.00133,51090,17.01219,300314
2406,erdii,4,0.00133,51094,17.01353,300314
2407,ericmillin,4,0.00133,51098,17.01486,300314
2408,esn89,4,0.00133,51102,17.01619,300314
2409,Estherbdf,4,0.00133,51106,17.01752,300314
2410,e-sung,4,0.00133,51110,17.01885,300314
2411,ethe,4,0.00133,51114,17.02019,300314
2412,eugrin,4,0.00133,51118,17.02152,300314
2413,evilpilaf,4,0.00133,51122,17.02285,300314
2414,ewirch,4,0.00133,51126,17.02418,300314
2415,eXpire163,4,0.00133,51130,17.02551,300314
2416,EzxD,4,0.00133,51134,17.02685,300314
2417,fabianfett,4,0.00133,51138,17.02818,300314
2418,farr-slmn,4,0.00133,51142,17.02951,300314
2419,faruryo,4,0.00133,51146,17.03084,300314
2420,fasterthanlime,4,0.00133,51150,17.03217,300314
2421,faun,4,0.00133,51154,17.03350,300314
2422,FauxFaux,4,0.00133,51158,17.03484,300314
2423,fbrier,4,0.00133,51162,17.03617,300314
2424,felix-hxz,4,0.00133,51166,17.03750,300314
2425,ffred1962,4,0.00133,51170,17.03883,300314
2426,fionaliao,4,0.00133,51174,17.04016,300314
2427,FireSon,4,0.00133,51178,17.04150,300314
2428,fischerman,4,0.00133,51182,17.04283,300314
2429,flyskyfloow,4,0.00133,51186,17.04416,300314
2430,fopina,4,0.00133,51190,17.04549,300314
2431,FriedCircuits,4,0.00133,51194,17.04682,300314
2432,fuleow,4,0.00133,51198,17.04816,300314
2433,gaetanars,4,0.00133,51202,17.04949,300314
2434,garenchan,4,0.00133,51206,17.05082,300314
2435,gcalmettes,4,0.00133,51210,17.05215,300314
2436,gedw99,4,0.00133,51214,17.05348,300314
2437,genegr,4,0.00133,51218,17.05482,300314
2438,gerricchaplin,4,0.00133,51222,17.05615,300314
2439,getong,4,0.00133,51226,17.05748,300314
2440,getspooky,4,0.00133,51230,17.05881,300314
2441,ghoubrial,4,0.00133,51234,17.06014,300314
2442,gibbscullen,4,0.00133,51238,17.06148,300314
2443,GJKrupa,4,0.00133,51242,17.06281,300314
2444,glightfoot,4,0.00133,51246,17.06414,300314
2445,GlowingRuby,4,0.00133,51250,17.06547,300314
2446,godgogo,4,0.00133,51254,17.06680,300314
2447,gorsr01,4,0.00133,51258,17.06814,300314
2448,goutamtadi1,4,0.00133,51262,17.06947,300314
2449,gracewehner,4,0.00133,51266,17.07080,300314
2450,greaterthanmost,4,0.00133,51270,17.07213,300314
2451,griffint61,4,0.00133,51274,17.07346,300314
2452,gtstewar,4,0.00133,51278,17.07480,300314
2453,guongle-ssense,4,0.00133,51282,17.07613,300314
2454,guxlightyear,4,0.00133,51286,17.07746,300314
2455,ha5ky,4,0.00133,51290,17.07879,300314
2456,haithamgabr,4,0.00133,51294,17.08012,300314
2457,haithem-souala,4,0.00133,51298,17.08145,300314
2458,halobolah,4,0.00133,51302,17.08279,300314
2459,hangqiu,4,0.00133,51306,17.08412,300314
2460,hanxiaolong891128,4,0.00133,51310,17.08545,300314
2461,haraldatbmw,4,0.00133,51314,17.08678,300314
2462,HarikrishnanBalagopal,4,0.00133,51318,17.08811,300314
2463,hariyada,4,0.00133,51322,17.08945,300314
2464,harryyann,4,0.00133,51326,17.09078,300314
2465,hb5488,4,0.00133,51330,17.09211,300314
2466,hblixt,4,0.00133,51334,17.09344,300314
2467,hellt,4,0.00133,51338,17.09477,300314
2468,henkbirkholz,4,0.00133,51342,17.09611,300314
2469,hhy5861,4,0.00133,51346,17.09744,300314
2470,hieu29791,4,0.00133,51350,17.09877,300314
2471,hieumoscow,4,0.00133,51354,17.10010,300314
2472,hiqsociety,4,0.00133,51358,17.10143,300314
2473,hklauke,4,0.00133,51362,17.10277,300314
2474,hmhagberg,4,0.00133,51366,17.10410,300314
2475,hobin2017,4,0.00133,51370,17.10543,300314
2476,hoopoe61,4,0.00133,51374,17.10676,300314
2477,HosamAlmoghraby,4,0.00133,51378,17.10809,300314
2478,HubbeKing,4,0.00133,51382,17.10943,300314
2479,hugoboos,4,0.00133,51386,17.11076,300314
2480,iainfogg,4,0.00133,51390,17.11209,300314
2481,iamatsundere,4,0.00133,51394,17.11342,300314
2482,iam-veeramalla,4,0.00133,51398,17.11475,300314
2483,ibottamike,4,0.00133,51402,17.11609,300314
2484,iisworks,4,0.00133,51406,17.11742,300314
2485,ila-001,4,0.00133,51410,17.11875,300314
2486,impl1874,4,0.00133,51414,17.12008,300314
2487,inajob,4,0.00133,51418,17.12141,300314
2488,ironyman,4,0.00133,51422,17.12274,300314
2489,itayrin,4,0.00133,51426,17.12408,300314
2490,iul1an,4,0.00133,51430,17.12541,300314
2491,jachou,4,0.00133,51434,17.12674,300314
2492,jackpan123,4,0.00133,51438,17.12807,300314
2493,jaisonsteephen,4,0.00133,51442,17.12940,300314
2494,jameshilliard,4,0.00133,51446,17.13074,300314
2495,jamesrwhite,4,0.00133,51450,17.13207,300314
2496,jandubois,4,0.00133,51454,17.13340,300314
2497,janLo,4,0.00133,51458,17.13473,300314
2498,JanScheurich,4,0.00133,51462,17.13606,300314
2499,jaricftw,4,0.00133,51466,17.13740,300314
2500,jaydeepva,4,0.00133,51470,17.13873,300314
2501,jcyriac-synamedia,4,0.00133,51474,17.14006,300314
2502,Jeaniowang,4,0.00133,51478,17.14139,300314
2503,jeremyong,4,0.00133,51482,17.14272,300314
2504,jessica-mottner-cko,4,0.00133,51486,17.14406,300314
2505,jetmuffin,4,0.00133,51490,17.14539,300314
2506,jf647,4,0.00133,51494,17.14672,300314
2507,jianhaiqing,4,0.00133,51498,17.14805,300314
2508,jiaweicheng77,4,0.00133,51502,17.14938,300314
2509,jiejieling,4,0.00133,51506,17.15072,300314
2510,jingzhao-self,4,0.00133,51510,17.15205,300314
2511,jinjyoo,4,0.00133,51514,17.15338,300314
2512,jludvig,4,0.00133,51518,17.15471,300314
2513,jmboby,4,0.00133,51522,17.15604,300314
2514,jmholla,4,0.00133,51526,17.15738,300314
2515,joelbyronbarker,4,0.00133,51530,17.15871,300314
2516,jogaleins,4,0.00133,51534,17.16004,300314
2517,johann8384,4,0.00133,51538,17.16137,300314
2518,joker-joker-joker,4,0.00133,51542,17.16270,300314
2519,jonassteinberg1,4,0.00133,51546,17.16403,300314
2520,Jooho,4,0.00133,51550,17.16537,300314
2521,jordangarside,4,0.00133,51554,17.16670,300314
2522,jorgelbg,4,0.00133,51558,17.16803,300314
2523,josh-gree,4,0.00133,51562,17.16936,300314
2524,joulaud,4,0.00133,51566,17.17069,300314
2525,jp250595,4,0.00133,51570,17.17203,300314
2526,jpfourny,4,0.00133,51574,17.17336,300314
2527,jqueiroz,4,0.00133,51578,17.17469,300314
2528,jsen-,4,0.00133,51582,17.17602,300314
2529,JulesBelveze,4,0.00133,51586,17.17735,300314
2530,julian3xl,4,0.00133,51590,17.17869,300314
2531,juliohm1978,4,0.00133,51594,17.18002,300314
2532,julius88,4,0.00133,51598,17.18135,300314
2533,junyer,4,0.00133,51602,17.18268,300314
2534,jurriaanpro,4,0.00133,51606,17.18401,300314
2535,justin27c,4,0.00133,51610,17.18535,300314
2536,Justin-DynamicD,4,0.00133,51614,17.18668,300314
2537,Justin-Young,4,0.00133,51618,17.18801,300314
2538,juzhiyuan,4,0.00133,51622,17.18934,300314
2539,kaaboaye,4,0.00133,51626,17.19067,300314
2540,kadzielawa,4,0.00133,51630,17.19201,300314
2541,kamarules74,4,0.00133,51634,17.19334,300314
2542,kamilkopcinski,4,0.00133,51638,17.19467,300314
2543,kappakappa,4,0.00133,51642,17.19600,300314
2544,karlism,4,0.00133,51646,17.19733,300314
2545,KashyapMadhu,4,0.00133,51650,17.19867,300314
2546,kaskavalci,4,0.00133,51654,17.20000,300314
2547,kenaniah,4,0.00133,51658,17.20133,300314
2548,Keramblock,4,0.00133,51662,17.20266,300314
2549,kevinhwang,4,0.00133,51666,17.20399,300314
2550,kiahmed,4,0.00133,51670,17.20533,300314
2551,kiragoo,4,0.00133,51674,17.20666,300314
2552,kjschnei001,4,0.00133,51678,17.20799,300314
2553,kkallday,4,0.00133,51682,17.20932,300314
2554,kkirilov91,4,0.00133,51686,17.21065,300314
2555,kodeninja,4,0.00133,51690,17.21198,300314
2556,kotyara85,4,0.00133,51694,17.21332,300314
2557,KozyarValeriy,4,0.00133,51698,17.21465,300314
2558,KrishnaSindhur,4,0.00133,51702,17.21598,300314
2559,kuddusrhce,4,0.00133,51706,17.21731,300314
2560,kulkarnicr,4,0.00133,51710,17.21864,300314
2561,kunalekawde,4,0.00133,51714,17.21998,300314
2562,KushagraIndurkhya,4,0.00133,51718,17.22131,300314
2563,kynetiv,4,0.00133,51722,17.22264,300314
2564,Kyrawnd,4,0.00133,51726,17.22397,300314
2565,lake-of-dreams,4,0.00133,51730,17.22530,300314
2566,laloyalo,4,0.00133,51734,17.22664,300314
2567,larsrnielsen,4,0.00133,51738,17.22797,300314
2568,laststem,4,0.00133,51742,17.22930,300314
2569,laszlocph,4,0.00133,51746,17.23063,300314
2570,laverite,4,0.00133,51750,17.23196,300314
2571,laymain,4,0.00133,51754,17.23330,300314
2572,lenoch7,4,0.00133,51758,17.23463,300314
2573,lewis-edginton,4,0.00133,51762,17.23596,300314
2574,liaden,4,0.00133,51766,17.23729,300314
2575,liguozhong,4,0.00133,51770,17.23862,300314
2576,limarev,4,0.00133,51774,17.23996,300314
2577,LimitlessEarth,4,0.00133,51778,17.24129,300314
2578,linuxgood1230,4,0.00133,51782,17.24262,300314
2579,lirantal,4,0.00133,51786,17.24395,300314
2580,LittleFox94,4,0.00133,51790,17.24528,300314
2581,Liu-Aohan,4,0.00133,51794,17.24662,300314
2582,livyfu,4,0.00133,51798,17.24795,300314
2583,logingood,4,0.00133,51802,17.24928,300314
2584,logoff,4,0.00133,51806,17.25061,300314
2585,lopesit0,4,0.00133,51810,17.25194,300314
2586,lorf,4,0.00133,51814,17.25327,300314
2587,lperdereau,4,0.00133,51818,17.25461,300314
2588,lslebodn,4,0.00133,51822,17.25594,300314
2589,lucianodesa,4,0.00133,51826,17.25727,300314
2590,luigidifraia,4,0.00133,51830,17.25860,300314
2591,LuizGirhub,4,0.00133,51834,17.25993,300314
2592,lunchboxav,4,0.00133,51838,17.26127,300314
2593,lvht,4,0.00133,51842,17.26260,300314
2594,lyoumar,4,0.00133,51846,17.26393,300314
2595,m0un10,4,0.00133,51850,17.26526,300314
2596,m4r1k,4,0.00133,51854,17.26659,300314
2597,maikelvl,4,0.00133,51858,17.26793,300314
2598,ManirajDeivendran,4,0.00133,51862,17.26926,300314
2599,ManneW,4,0.00133,51866,17.27059,300314
2600,marcozov,4,0.00133,51870,17.27192,300314
2601,marcusway,4,0.00133,51874,17.27325,300314
2602,marekhanus,4,0.00133,51878,17.27459,300314
2603,mariojacobo,4,0.00133,51882,17.27592,300314
2604,markbenschop,4,0.00133,51886,17.27725,300314
2605,markterm,4,0.00133,51890,17.27858,300314
2606,marpio,4,0.00133,51894,17.27991,300314
2607,martinezlucas98,4,0.00133,51898,17.28125,300314
2608,martinhaus,4,0.00133,51902,17.28258,300314
2609,mathisve,4,0.00133,51906,17.28391,300314
2610,mattatcha,4,0.00133,51910,17.28524,300314
2611,MatthieuSarter,4,0.00133,51914,17.28657,300314
2612,mattwparas,4,0.00133,51918,17.28791,300314
2613,maxreb,4,0.00133,51922,17.28924,300314
2614,mbaykara,4,0.00133,51926,17.29057,300314
2615,mbouchenoire,4,0.00133,51930,17.29190,300314
2616,mdb,4,0.00133,51934,17.29323,300314
2617,mecseid,4,0.00133,51938,17.29457,300314
2618,meiblorn,4,0.00133,51942,17.29590,300314
2619,mercion,4,0.00133,51946,17.29723,300314
2620,michaelandrepearce,4,0.00133,51950,17.29856,300314
2621,michael-db,4,0.00133,51954,17.29989,300314
2622,mickael-carl,4,0.00133,51958,17.30122,300314
2623,mikemrm,4,0.00133,51962,17.30256,300314
2624,Mini256,4,0.00133,51966,17.30389,300314
2625,mioyui88,4,0.00133,51970,17.30522,300314
2626,mirajranpura,4,0.00133,51974,17.30655,300314
2627,MisLink,4,0.00133,51978,17.30788,300314
2628,mkagenius,4,0.00133,51982,17.30922,300314
2629,mleklund,4,0.00133,51986,17.31055,300314
2630,mmadoo,4,0.00133,51990,17.31188,300314
2631,mnasiadka,4,0.00133,51994,17.31321,300314
2632,mnlwldr,4,0.00133,51998,17.31454,300314
2633,MohiK98,4,0.00133,52002,17.31588,300314
2634,mohit94614,4,0.00133,52006,17.31721,300314
2635,moreal,4,0.00133,52010,17.31854,300314
2636,MoritzKn,4,0.00133,52014,17.31987,300314
2637,moto-timo,4,0.00133,52018,17.32120,300314
2638,mouchii,4,0.00133,52022,17.32254,300314
2639,Moumouls,4,0.00133,52026,17.32387,300314
2640,mparamas-zz,4,0.00133,52030,17.32520,300314
2641,mridu23,4,0.00133,52034,17.32653,300314
2642,mrksngl,4,0.00133,52038,17.32786,300314
2643,mtlewis,4,0.00133,52042,17.32920,300314
2644,mtulio,4,0.00133,52046,17.33053,300314
2645,muhammedbuvaydani,4,0.00133,52050,17.33186,300314
2646,munipravy,4,0.00133,52054,17.33319,300314
2647,musicinmybrain,4,0.00133,52058,17.33452,300314
2648,mwasilew2,4,0.00133,52062,17.33586,300314
2649,nagaprabhu,4,0.00133,52066,17.33719,300314
2650,nastacio,4,0.00133,52070,17.33852,300314
2651,NatureLingRan,4,0.00133,52074,17.33985,300314
2652,nbenaglia,4,0.00133,52078,17.34118,300314
2653,neilfordyce,4,0.00133,52082,17.34251,300314
2654,Nessumsar,4,0.00133,52086,17.34385,300314
2655,nesv,4,0.00133,52090,17.34518,300314
2656,newb1e,4,0.00133,52094,17.34651,300314
2657,newHE3DBer,4,0.00133,52098,17.34784,300314
2658,newton28,4,0.00133,52102,17.34917,300314
2659,nithu0115,4,0.00133,52106,17.35051,300314
2660,nonamef,4,0.00133,52110,17.35184,300314
2661,norrisjeremy,4,0.00133,52114,17.35317,300314
2662,ns-rwong,4,0.00133,52118,17.35450,300314
2663,nvthuong1996,4,0.00133,52122,17.35583,300314
2664,ohmyglb,4,0.00133,52126,17.35717,300314
2665,olamiko,4,0.00133,52130,17.35850,300314
2666,oliver-kriska,4,0.00133,52134,17.35983,300314
2667,orange-llajeanne,4,0.00133,52138,17.36116,300314
2668,pabrahamusa,4,0.00133,52142,17.36249,300314
2669,palokam,4,0.00133,52146,17.36383,300314
2670,panaji,4,0.00133,52150,17.36516,300314
2671,pandeykartikey,4,0.00133,52154,17.36649,300314
2672,partcyborg,4,0.00133,52158,17.36782,300314
2673,pasimoes,4,0.00133,52162,17.36915,300314
2674,patsevanton,4,0.00133,52166,17.37049,300314
2675,PaulFurtado,4,0.00133,52170,17.37182,300314
2676,pavanfhw,4,0.00133,52174,17.37315,300314
2677,pawankanumalli,4,0.00133,52178,17.37448,300314
2678,pbetkier,4,0.00133,52182,17.37581,300314
2679,pdominguite,4,0.00133,52186,17.37715,300314
2680,petermicuch,4,0.00133,52190,17.37848,300314
2681,pgoyal01,4,0.00133,52194,17.37981,300314
2682,philippart,4,0.00133,52198,17.38114,300314
2683,pianiststickman,4,0.00133,52202,17.38247,300314
2684,pierreilki,4,0.00133,52206,17.38380,300314
2685,pixiake,4,0.00133,52210,17.38514,300314
2686,PKizzle,4,0.00133,52214,17.38647,300314
2687,pklimowx,4,0.00133,52218,17.38780,300314
2688,PocketMobsters,4,0.00133,52222,17.38913,300314
2689,Pondidum,4,0.00133,52226,17.39046,300314
2690,pPanda-beta,4,0.00133,52230,17.39180,300314
2691,ppapasani1,4,0.00133,52234,17.39313,300314
2692,pycaster,4,0.00133,52238,17.39446,300314
2693,pzoxiuv,4,0.00133,52242,17.39579,300314
2694,qas,4,0.00133,52246,17.39712,300314
2695,qrilka,4,0.00133,52250,17.39846,300314
2696,queil,4,0.00133,52254,17.39979,300314
2697,RainingNight,4,0.00133,52258,17.40112,300314
2698,rajendragosavi,4,0.00133,52262,17.40245,300314
2699,ram2012k,4,0.00133,52266,17.40378,300314
2700,RandomGHUser,4,0.00133,52270,17.40512,300314
2701,r-andrew-dev,4,0.00133,52274,17.40645,300314
2702,rauanmayemir,4,0.00133,52278,17.40778,300314
2703,ravargs,4,0.00133,52282,17.40911,300314
2704,rayanebel,4,0.00133,52286,17.41044,300314
2705,rbkaspr,4,0.00133,52290,17.41178,300314
2706,red8888,4,0.00133,52294,17.41311,300314
2707,RehanSaeed,4,0.00133,52298,17.41444,300314
2708,renan-campos,4,0.00133,52302,17.41577,300314
2709,revaniki,4,0.00133,52306,17.41710,300314
2710,RileyMShea,4,0.00133,52310,17.41844,300314
2711,Ripolin,4,0.00133,52314,17.41977,300314
2712,rizalgowandy,4,0.00133,52318,17.42110,300314
2713,rmanibus,4,0.00133,52322,17.42243,300314
2714,rmr-silicom,4,0.00133,52326,17.42376,300314
2715,rneu31,4,0.00133,52330,17.42510,300314
2716,RobGrobbers,4,0.00133,52334,17.42643,300314
2717,roelfdutoit,4,0.00133,52338,17.42776,300314
2718,RolandMa1986,4,0.00133,52342,17.42909,300314
2719,rounaksarda,4,0.00133,52346,17.43042,300314
2720,rrraditya,4,0.00133,52350,17.43175,300314
2721,rryter,4,0.00133,52354,17.43309,300314
2722,rsinden,4,0.00133,52358,17.43442,300314
2723,rtfee,4,0.00133,52362,17.43575,300314
2724,ruohki,4,0.00133,52366,17.43708,300314
2725,sagargulabani,4,0.00133,52370,17.43841,300314
2726,SahilNarans,4,0.00133,52374,17.43975,300314
2727,sahramelissa,4,0.00133,52378,17.44108,300314
2728,saitrips,4,0.00133,52382,17.44241,300314
2729,Sangshaai,4,0.00133,52386,17.44374,300314
2730,santoshsb,4,0.00133,52390,17.44507,300314
2731,sanzenwin,4,0.00133,52394,17.44641,300314
2732,scottkurz,4,0.00133,52398,17.44774,300314
2733,scumpah,4,0.00133,52402,17.44907,300314
2734,searsaw,4,0.00133,52406,17.45040,300314
2735,sebastian-bello,4,0.00133,52410,17.45173,300314
2736,SebTardif,4,0.00133,52414,17.45307,300314
2737,Sellto,4,0.00133,52418,17.45440,300314
2738,serxansherif,4,0.00133,52422,17.45573,300314
2739,shaftofchina,4,0.00133,52426,17.45706,300314
2740,ShamoX,4,0.00133,52430,17.45839,300314
2741,shankarsundaram,4,0.00133,52434,17.45973,300314
2742,sheshankgujjari,4,0.00133,52438,17.46106,300314
2743,shizhMSFT,4,0.00133,52442,17.46239,300314
2744,shkim-will,4,0.00133,52446,17.46372,300314
2745,shoce,4,0.00133,52450,17.46505,300314
2746,shoekstra,4,0.00133,52454,17.46639,300314
2747,shuker85,4,0.00133,52458,17.46772,300314
2748,siddharth,4,0.00133,52462,17.46905,300314
2749,SimonGurney,4,0.00133,52466,17.47038,300314
2750,simonhargos,4,0.00133,52470,17.47171,300314
2751,sivatarunp,4,0.00133,52474,17.47304,300314
2752,Skaronator,4,0.00133,52478,17.47438,300314
2753,skaymakca,4,0.00133,52482,17.47571,300314
2754,skipworkgh,4,0.00133,52486,17.47704,300314
2755,skumarpi,4,0.00133,52490,17.47837,300314
2756,SleepyBrett,4,0.00133,52494,17.47970,300314
2757,smartnava,4,0.00133,52498,17.48104,300314
2758,smnblt,4,0.00133,52502,17.48237,300314
2759,snorwin,4,0.00133,52506,17.48370,300314
2760,soodpr,4,0.00133,52510,17.48503,300314
2761,sorindumitru,4,0.00133,52514,17.48636,300314
2762,springasa,4,0.00133,52518,17.48770,300314
2763,srcarrier,4,0.00133,52522,17.48903,300314
2764,sreedaum,4,0.00133,52526,17.49036,300314
2765,starbassma,4,0.00133,52530,17.49169,300314
2766,ste93cry,4,0.00133,52534,17.49302,300314
2767,steveonjava,4,0.00133,52538,17.49436,300314
2768,stijnbrouwers,4,0.00133,52542,17.49569,300314
2769,stoetti,4,0.00133,52546,17.49702,300314
2770,strangiato,4,0.00133,52550,17.49835,300314
2771,striver619,4,0.00133,52554,17.49968,300314
2772,subrata83,4,0.00133,52558,17.50102,300314
2773,sudomakeinstall2,4,0.00133,52562,17.50235,300314
2774,suhas316380,4,0.00133,52566,17.50368,300314
2775,SunChero,4,0.00133,52570,17.50501,300314
2776,sunchill06,4,0.00133,52574,17.50634,300314
2777,superbiche,4,0.00133,52578,17.50768,300314
2778,sushil-prasad,4,0.00133,52582,17.50901,300314
2779,Sushisource,4,0.00133,52586,17.51034,300314
2780,svasseur,4,0.00133,52590,17.51167,300314
2781,sysnet4admin,4,0.00133,52594,17.51300,300314
2782,szab100,4,0.00133,52598,17.51433,300314
2783,szydek,4,0.00133,52602,17.51567,300314
2784,t0nik0,4,0.00133,52606,17.51700,300314
2785,talj-us-ibm-com,4,0.00133,52610,17.51833,300314
2786,tanqhnguyen,4,0.00133,52614,17.51966,300314
2787,tanvir-appveen,4,0.00133,52618,17.52099,300314
2788,tarkhil,4,0.00133,52622,17.52233,300314
2789,tarquin-the-brave,4,0.00133,52626,17.52366,300314
2790,tburschka,4,0.00133,52630,17.52499,300314
2791,tdyas,4,0.00133,52634,17.52632,300314
2792,tears-of-noobs,4,0.00133,52638,17.52765,300314
2793,th3M1ke,4,0.00133,52642,17.52899,300314
2794,thanhma,4,0.00133,52646,17.53032,300314
2795,thernstig,4,0.00133,52650,17.53165,300314
2796,ThinkMo,4,0.00133,52654,17.53298,300314
2797,thomaswoeckinger,4,0.00133,52658,17.53431,300314
2798,tibeer,4,0.00133,52662,17.53565,300314
2799,tinchi,4,0.00133,52666,17.53698,300314
2800,tiwarishrijan,4,0.00133,52670,17.53831,300314
2801,tl-alessio-casco,4,0.00133,52674,17.53964,300314
2802,tmorin,4,0.00133,52678,17.54097,300314
2803,tobiscr,4,0.00133,52682,17.54231,300314
2804,toddkazakov,4,0.00133,52686,17.54364,300314
2805,tokikanno,4,0.00133,52690,17.54497,300314
2806,tomekit,4,0.00133,52694,17.54630,300314
2807,tomer-epstein,4,0.00133,52698,17.54763,300314
2808,tomhjp,4,0.00133,52702,17.54897,300314
2809,tomoyamachi,4,0.00133,52706,17.55030,300314
2810,towens,4,0.00133,52710,17.55163,300314
2811,trinhpham,4,0.00133,52714,17.55296,300314
2812,tripolkaandrey,4,0.00133,52718,17.55429,300314
2813,troub1emaker0911,4,0.00133,52722,17.55563,300314
2814,TrueBrain,4,0.00133,52726,17.55696,300314
2815,TrueCarry,4,0.00133,52730,17.55829,300314
2816,twellspring,4,0.00133,52734,17.55962,300314
2817,un-stantane,4,0.00133,52738,17.56095,300314
2818,usingsky,4,0.00133,52742,17.56228,300314
2819,utamas,4,0.00133,52746,17.56362,300314
2820,uvwild,4,0.00133,52750,17.56495,300314
2821,v42net,4,0.00133,52754,17.56628,300314
2822,ValentinH,4,0.00133,52758,17.56761,300314
2823,VannTen,4,0.00133,52762,17.56894,300314
2824,vazirim,4,0.00133,52766,17.57028,300314
2825,vdvarlamov,4,0.00133,52770,17.57161,300314
2826,Veknelyon,4,0.00133,52774,17.57294,300314
2827,VengefulAncient,4,0.00133,52778,17.57427,300314
2828,vgratian,4,0.00133,52782,17.57560,300314
2829,victorkirov,4,0.00133,52786,17.57694,300314
2830,virus2016,4,0.00133,52790,17.57827,300314
2831,visweshwar,4,0.00133,52794,17.57960,300314
2832,vot4anto,4,0.00133,52798,17.58093,300314
2833,vrivellino,4,0.00133,52802,17.58226,300314
2834,wahammed,4,0.00133,52806,17.58360,300314
2835,wainersm,4,0.00133,52810,17.58493,300314
2836,wallezhang,4,0.00133,52814,17.58626,300314
2837,wanghe-fit2cloud,4,0.00133,52818,17.58759,300314
2838,wanghong230,4,0.00133,52822,17.58892,300314
2839,wangyanghack,4,0.00133,52826,17.59026,300314
2840,washcycle,4,0.00133,52830,17.59159,300314
2841,wedneyyuri,4,0.00133,52834,17.59292,300314
2842,wei5523,4,0.00133,52838,17.59425,300314
2843,Wenshiqi222,4,0.00133,52842,17.59558,300314
2844,whillas,4,0.00133,52846,17.59692,300314
2845,whirm,4,0.00133,52850,17.59825,300314
2846,will-ds,4,0.00133,52854,17.59958,300314
2847,williamdes,4,0.00133,52858,17.60091,300314
2848,william-salt-cko,4,0.00133,52862,17.60224,300314
2849,WillooWisp,4,0.00133,52866,17.60357,300314
2850,winder-source,4,0.00133,52870,17.60491,300314
2851,wjf3121,4,0.00133,52874,17.60624,300314
2852,wmedlar,4,0.00133,52878,17.60757,300314
2853,wsdt,4,0.00133,52882,17.60890,300314
2854,wtchangdm,4,0.00133,52886,17.61023,300314
2855,wu0407,4,0.00133,52890,17.61157,300314
2856,wxy929629,4,0.00133,52894,17.61290,300314
2857,xakraz,4,0.00133,52898,17.61423,300314
2858,xaocon,4,0.00133,52902,17.61556,300314
2859,xavidop,4,0.00133,52906,17.61689,300314
2860,Xenon-777,4,0.00133,52910,17.61823,300314
2861,xinydev,4,0.00133,52914,17.61956,300314
2862,xmlking,4,0.00133,52918,17.62089,300314
2863,Xswer,4,0.00133,52922,17.62222,300314
2864,XuanThuLe,4,0.00133,52926,17.62355,300314
2865,yash-saini275,4,0.00133,52930,17.62489,300314
2866,yashwanthkalva,4,0.00133,52934,17.62622,300314
2867,yatinmaan,4,0.00133,52938,17.62755,300314
2868,yershalom,4,0.00133,52942,17.62888,300314
2869,y-vectorfield,4,0.00133,52946,17.63021,300314
2870,YYashwanth,4,0.00133,52950,17.63155,300314
2871,yydzhou,4,0.00133,52954,17.63288,300314
2872,yz271544,4,0.00133,52958,17.63421,300314
2873,yzhao244,4,0.00133,52962,17.63554,300314
2874,yzs981130,4,0.00133,52966,17.63687,300314
2875,Zannith,4,0.00133,52970,17.63821,300314
2876,zbbkeepgoing,4,0.00133,52974,17.63954,300314
2877,Zebradil,4,0.00133,52978,17.64087,300314
2878,zhangxiaogang01,4,0.00133,52982,17.64220,300314
2879,zhaoyun006,4,0.00133,52986,17.64353,300314
2880,zhenjunMa,4,0.00133,52990,17.64487,300314
2881,zhiweiv,4,0.00133,52994,17.64620,300314
2882,zhongdai,4,0.00133,52998,17.64753,300314
2883,zhoudayongdennis,4,0.00133,53002,17.64886,300314
2884,zjcnew,4,0.00133,53006,17.65019,300314
2885,030,3,0.00100,53009,17.65119,300314
2886,20988902,3,0.00100,53012,17.65219,300314
2887,2tim,3,0.00100,53015,17.65319,300314
2888,300481,3,0.00100,53018,17.65419,300314
2889,42Atomys,3,0.00100,53021,17.65519,300314
2890,5idu,3,0.00100,53024,17.65619,300314
2891,666DoxGangLucifer,3,0.00100,53027,17.65719,300314
2892,6ecuk,3,0.00100,53030,17.65818,300314
2893,70data,3,0.00100,53033,17.65918,300314
2894,7rouz,3,0.00100,53036,17.66018,300314
2895,811105717,3,0.00100,53039,17.66118,300314
2896,957204459,3,0.00100,53042,17.66218,300314
2897,a502270682,3,0.00100,53045,17.66318,300314
2898,A830612,3,0.00100,53048,17.66418,300314
2899,aaronjheng,3,0.00100,53051,17.66518,300314
2900,aaronkaz,3,0.00100,53054,17.66618,300314
2901,abaehreMC,3,0.00100,53057,17.66718,300314
2902,abel-von,3,0.00100,53060,17.66817,300314
2903,abhihome-github,3,0.00100,53063,17.66917,300314
2904,Abhishek01039,3,0.00100,53066,17.67017,300314
2905,ABlueCy,3,0.00100,53069,17.67117,300314
2906,acelyc111,3,0.00100,53072,17.67217,300314
2907,acjohnson,3,0.00100,53075,17.67317,300314
2908,acutchin-bitpusher,3,0.00100,53078,17.67417,300314
2909,adambro,3,0.00100,53081,17.67517,300314
2910,adamday2,3,0.00100,53084,17.67617,300314
2911,adievkadyrbek,3,0.00100,53087,17.67716,300314
2912,adigeak,3,0.00100,53090,17.67816,300314
2913,adonaicosta,3,0.00100,53093,17.67916,300314
2914,adpempx,3,0.00100,53096,17.68016,300314
2915,adriank-convoy,3,0.00100,53099,17.68116,300314
2916,ahesford,3,0.00100,53102,17.68216,300314
2917,ahmadbabaei,3,0.00100,53105,17.68316,300314
2918,ahmed-adly-khalil,3,0.00100,53108,17.68416,300314
2919,aislinncronin,3,0.00100,53111,17.68516,300314
2920,ajanth97,3,0.00100,53114,17.68616,300314
2921,akin-ozer,3,0.00100,53117,17.68715,300314
2922,akshaysharama,3,0.00100,53120,17.68815,300314
2923,akubala,3,0.00100,53123,17.68915,300314
2924,AKWolff037,3,0.00100,53126,17.69015,300314
2925,al3pht,3,0.00100,53129,17.69115,300314
2926,Alan-buaa,3,0.00100,53132,17.69215,300314
2927,alberto,3,0.00100,53135,17.69315,300314
2928,albuch,3,0.00100,53138,17.69415,300314
2929,AlexanderButs,3,0.00100,53141,17.69515,300314
2930,alexarefev,3,0.00100,53144,17.69614,300314
2931,alexcurtin,3,0.00100,53147,17.69714,300314
2932,AlexKovalevych,3,0.00100,53150,17.69814,300314
2933,alex-vladut,3,0.00100,53153,17.69914,300314
2934,alexzhc,3,0.00100,53156,17.70014,300314
2935,alfianabdi,3,0.00100,53159,17.70114,300314
2936,Alfusainey,3,0.00100,53162,17.70214,300314
2937,alicommit-malp,3,0.00100,53165,17.70314,300314
2938,AlinVina,3,0.00100,53168,17.70414,300314
2939,aliusmiles,3,0.00100,53171,17.70514,300314
2940,aljohn0422,3,0.00100,53174,17.70613,300314
2941,alperkokmen,3,0.00100,53177,17.70713,300314
2942,alterEgo123,3,0.00100,53180,17.70813,300314
2943,AlverezYari,3,0.00100,53183,17.70913,300314
2944,amanand,3,0.00100,53186,17.71013,300314
2945,amanjain08,3,0.00100,53189,17.71113,300314
2946,amayr666,3,0.00100,53192,17.71213,300314
2947,AmazoneyBobuxey,3,0.00100,53195,17.71313,300314
2948,amccague,3,0.00100,53198,17.71413,300314
2949,amendoza-navent,3,0.00100,53201,17.71512,300314
2950,amine250,3,0.00100,53204,17.71612,300314
2951,ampaire,3,0.00100,53207,17.71712,300314
2952,anandg112,3,0.00100,53210,17.71812,300314
2953,AnastasiaBlack,3,0.00100,53213,17.71912,300314
2954,Anders-PlanetScale,3,0.00100,53216,17.72012,300314
2955,andreabolandrina,3,0.00100,53219,17.72112,300314
2956,andreas-p,3,0.00100,53222,17.72212,300314
2957,anhkhoa45,3,0.00100,53225,17.72312,300314
2958,ansjsun,3,0.00100,53228,17.72412,300314
2959,antoniodellelce,3,0.00100,53231,17.72511,300314
2960,AntonSmolkov,3,0.00100,53234,17.72611,300314
2961,AntPAllen,3,0.00100,53237,17.72711,300314
2962,anupdhml,3,0.00100,53240,17.72811,300314
2963,aonurdemir,3,0.00100,53243,17.72911,300314
2964,aperigault,3,0.00100,53246,17.73011,300314
2965,Aqilmirza,3,0.00100,53249,17.73111,300314
2966,aqua777,3,0.00100,53252,17.73211,300314
2967,aquaherd,3,0.00100,53255,17.73311,300314
2968,ardok,3,0.00100,53258,17.73410,300314
2969,ariescheurwater,3,0.00100,53261,17.73510,300314
2970,ArmitageW,3,0.00100,53264,17.73610,300314
2971,arthurlm,3,0.00100,53267,17.73710,300314
2972,aSapien,3,0.00100,53270,17.73810,300314
2973,askreet,3,0.00100,53273,17.73910,300314
2974,aswanevelder,3,0.00100,53276,17.74010,300314
2975,aswin6197,3,0.00100,53279,17.74110,300314
2976,atantawi,3,0.00100,53282,17.74210,300314
2977,Aut0R3V,3,0.00100,53285,17.74310,300314
2978,autodidaddict,3,0.00100,53288,17.74409,300314
2979,AverageMarcus,3,0.00100,53291,17.74509,300314
2980,awanlin,3,0.00100,53294,17.74609,300314
2981,AWKIF,3,0.00100,53297,17.74709,300314
2982,aws-sidhartha,3,0.00100,53300,17.74809,300314
2983,axelgMS,3,0.00100,53303,17.74909,300314
2984,ayasuda-ge,3,0.00100,53306,17.75009,300314
2985,ayushghosh,3,0.00100,53309,17.75109,300314
2986,azamin,3,0.00100,53312,17.75209,300314
2987,b225ccc,3,0.00100,53315,17.75309,300314
2988,babuveld,3,0.00100,53318,17.75408,300314
2989,bacmat,3,0.00100,53321,17.75508,300314
2990,baelen-git,3,0.00100,53324,17.75608,300314
2991,bainss,3,0.00100,53327,17.75708,300314
2992,bamason14,3,0.00100,53330,17.75808,300314
2993,bandwiches,3,0.00100,53333,17.75908,300314
2994,barkanido,3,0.00100,53336,17.76008,300314
2995,barkardk,3,0.00100,53339,17.76108,300314
2996,barlass,3,0.00100,53342,17.76208,300314
2997,basavaraj29,3,0.00100,53345,17.76307,300314
2998,bayerlse,3,0.00100,53348,17.76407,300314
2999,bbgobie,3,0.00100,53351,17.76507,300314
3000,bbuchalter,3,0.00100,53354,17.76607,300314
3001,bdobsonca,3,0.00100,53357,17.76707,300314
3002,bearpaws,3,0.00100,53360,17.76807,300314
3003,becky-hd,3,0.00100,53363,17.76907,300314
3004,belomx,3,0.00100,53366,17.77007,300314
3005,BeniaminK,3,0.00100,53369,17.77107,300314
3006,benjaminjb,3,0.00100,53372,17.77207,300314
3007,benjamintanweihao,3,0.00100,53375,17.77306,300314
3008,benjamin-wright,3,0.00100,53378,17.77406,300314
3009,benke33,3,0.00100,53381,17.77506,300314
3010,bergundy,3,0.00100,53384,17.77606,300314
3011,bernardbr,3,0.00100,53387,17.77706,300314
3012,bessonovevgen,3,0.00100,53390,17.77806,300314
3013,BeWaterMyFriend7,3,0.00100,53393,17.77906,300314
3014,bgray-onica,3,0.00100,53396,17.78006,300314
3015,bgsilvait,3,0.00100,53399,17.78106,300314
3016,bhavanshuS,3,0.00100,53402,17.78205,300314
3017,bhavelyn,3,0.00100,53405,17.78305,300314
3018,biefy,3,0.00100,53408,17.78405,300314
3019,bifr0ns,3,0.00100,53411,17.78505,300314
3020,bionicles,3,0.00100,53414,17.78605,300314
3021,bkono,3,0.00100,53417,17.78705,300314
3022,Bl00d-B0b,3,0.00100,53420,17.78805,300314
3023,bladedancer,3,0.00100,53423,17.78905,300314
3024,blaqkube,3,0.00100,53426,17.79005,300314
3025,Blobonat,3,0.00100,53429,17.79105,300314
3026,Blorpy,3,0.00100,53432,17.79204,300314
3027,blueblau1979,3,0.00100,53435,17.79304,300314
3028,bluppfisk,3,0.00100,53438,17.79404,300314
3029,bmbbms,3,0.00100,53441,17.79504,300314
3030,bmonikraj,3,0.00100,53444,17.79604,300314
3031,bnekolny,3,0.00100,53447,17.79704,300314
3032,bolinlee,3,0.00100,53450,17.79804,300314
3033,bolt-leandro,3,0.00100,53453,17.79904,300314
3034,boneal,3,0.00100,53456,17.80004,300314
3035,bonky42,3,0.00100,53459,17.80103,300314
3036,booleanbetrayal,3,0.00100,53462,17.80203,300314
3037,boostchicken,3,0.00100,53465,17.80303,300314
3038,bperales,3,0.00100,53468,17.80403,300314
3039,br0ziliy,3,0.00100,53471,17.80503,300314
3040,BradBarnich,3,0.00100,53474,17.80603,300314
3041,bretm,3,0.00100,53477,17.80703,300314
3042,brettcave,3,0.00100,53480,17.80803,300314
3043,bruceforlearn,3,0.00100,53483,17.80903,300314
3044,bruno-,3,0.00100,53486,17.81003,300314
3045,bruth,3,0.00100,53489,17.81102,300314
3046,bryanmcgrane,3,0.00100,53492,17.81202,300314
3047,Bryce1010,3,0.00100,53495,17.81302,300314
3048,bshifter,3,0.00100,53498,17.81402,300314
3049,bsord,3,0.00100,53501,17.81502,300314
3050,bsukh,3,0.00100,53504,17.81602,300314
3051,btwear,3,0.00100,53507,17.81702,300314
3052,bvberg,3,0.00100,53510,17.81802,300314
3053,bvwells,3,0.00100,53513,17.81902,300314
3054,byangtri,3,0.00100,53516,17.82002,300314
3055,BytedanceRPC,3,0.00100,53519,17.82101,300314
3056,caitmulholland,3,0.00100,53522,17.82201,300314
3057,Cappuccinuo,3,0.00100,53525,17.82301,300314
3058,cardoe,3,0.00100,53528,17.82401,300314
3059,carnivorelogic,3,0.00100,53531,17.82501,300314
3060,CashWilliams,3,0.00100,53534,17.82601,300314
3061,cassid4,3,0.00100,53537,17.82701,300314
3062,cbuto,3,0.00100,53540,17.82801,300314
3063,cdchris12,3,0.00100,53543,17.82901,300314
3064,cdtomkins,3,0.00100,53546,17.83000,300314
3065,celestialorb,3,0.00100,53549,17.83100,300314
3066,Cellebyte,3,0.00100,53552,17.83200,300314
3067,ChandrewR,3,0.00100,53555,17.83300,300314
3068,charandas,3,0.00100,53558,17.83400,300314
3069,CharesLee,3,0.00100,53561,17.83500,300314
3070,Charley-Mann,3,0.00100,53564,17.83600,300314
3071,Chauhan619,3,0.00100,53567,17.83700,300314
3072,CheneyCookie,3,0.00100,53570,17.83800,300314
3073,chengchengmu,3,0.00100,53573,17.83900,300314
3074,chenwenjun1995,3,0.00100,53576,17.83999,300314
3075,chevvi,3,0.00100,53579,17.84099,300314
3076,chloejiwon,3,0.00100,53582,17.84199,300314
3077,chodges15,3,0.00100,53585,17.84299,300314
3078,ChrisChinchilla,3,0.00100,53588,17.84399,300314
3079,christarazi,3,0.00100,53591,17.84499,300314
3080,chuan9,3,0.00100,53594,17.84599,300314
3081,chunliu,3,0.00100,53597,17.84699,300314
3082,Cicatrice,3,0.00100,53600,17.84799,300314
3083,cjiang-ias,3,0.00100,53603,17.84898,300314
3084,ckittel,3,0.00100,53606,17.84998,300314
3085,clatour,3,0.00100,53609,17.85098,300314
3086,claywd-x,3,0.00100,53612,17.85198,300314
3087,clemensvonschwerin,3,0.00100,53615,17.85298,300314
3088,clhain,3,0.00100,53618,17.85398,300314
3089,clux,3,0.00100,53621,17.85498,300314
3090,cobolbaby,3,0.00100,53624,17.85598,300314
3091,codyde,3,0.00100,53627,17.85698,300314
3092,cospeedster,3,0.00100,53630,17.85798,300314
3093,coultenholt,3,0.00100,53633,17.85897,300314
3094,coyzeng,3,0.00100,53636,17.85997,300314
3095,cpressland,3,0.00100,53639,17.86097,300314
3096,CptDaniel,3,0.00100,53642,17.86197,300314
3097,Cretezy,3,0.00100,53645,17.86297,300314
3098,crisesw,3,0.00100,53648,17.86397,300314
3099,cristianburca,3,0.00100,53651,17.86497,300314
3100,crockk,3,0.00100,53654,17.86597,300314
3101,crosvera,3,0.00100,53657,17.86697,300314
3102,cseader,3,0.00100,53660,17.86796,300314
3103,csiepka,3,0.00100,53663,17.86896,300314
3104,csjiang,3,0.00100,53666,17.86996,300314
3105,cslovell,3,0.00100,53669,17.87096,300314
3106,cten,3,0.00100,53672,17.87196,300314
3107,ctrahey,3,0.00100,53675,17.87296,300314
3108,Cyberhan123,3,0.00100,53678,17.87396,300314
3109,d46,3,0.00100,53681,17.87496,300314
3110,d7561985,3,0.00100,53684,17.87596,300314
3111,dabdada,3,0.00100,53687,17.87696,300314
3112,dalegaspi,3,0.00100,53690,17.87795,300314
3113,damobrisbane,3,0.00100,53693,17.87895,300314
3114,dancnfoo,3,0.00100,53696,17.87995,300314
3115,DanCNo,3,0.00100,53699,17.88095,300314
3116,dangoscomb,3,0.00100,53702,17.88195,300314
3117,danielywong,3,0.00100,53705,17.88295,300314
3118,dannytranlx,3,0.00100,53708,17.88395,300314
3119,danoshi,3,0.00100,53711,17.88495,300314
3120,danpoland,3,0.00100,53714,17.88595,300314
3121,DanStough,3,0.00100,53717,17.88694,300314
3122,dantingl,3,0.00100,53720,17.88794,300314
3123,dariosanna,3,0.00100,53723,17.88894,300314
3124,darrenfurr,3,0.00100,53726,17.88994,300314
3125,darren-rose,3,0.00100,53729,17.89094,300314
3126,dasl-,3,0.00100,53732,17.89194,300314
3127,davecardwell,3,0.00100,53735,17.89294,300314
3128,david99world,3,0.00100,53738,17.89394,300314
3129,david-caro,3,0.00100,53741,17.89494,300314
3130,daviddyball,3,0.00100,53744,17.89594,300314
3131,davidshaw2018,3,0.00100,53747,17.89693,300314
3132,DavidSimner,3,0.00100,53750,17.89793,300314
3133,dbacinski,3,0.00100,53753,17.89893,300314
3134,dblate,3,0.00100,53756,17.89993,300314
3135,dbluxo,3,0.00100,53759,17.90093,300314
3136,dbpolito,3,0.00100,53762,17.90193,300314
3137,dcmiddle,3,0.00100,53765,17.90293,300314
3138,deepskyblue86,3,0.00100,53768,17.90393,300314
3139,defaultbr,3,0.00100,53771,17.90493,300314
3140,dellThejas,3,0.00100,53774,17.90593,300314
3141,dengjeffrey,3,0.00100,53777,17.90692,300314
3142,deorder,3,0.00100,53780,17.90792,300314
3143,DerMuedeJoe,3,0.00100,53783,17.90892,300314
3144,DevOpJadeja,3,0.00100,53786,17.90992,300314
3145,devzx,3,0.00100,53789,17.91092,300314
3146,dfinkel,3,0.00100,53792,17.91192,300314
3147,dfishburn,3,0.00100,53795,17.91292,300314
3148,dfreese,3,0.00100,53798,17.91392,300314
3149,dgiebert,3,0.00100,53801,17.91492,300314
3150,dianawilde,3,0.00100,53804,17.91591,300314
3151,digibank-rons,3,0.00100,53807,17.91691,300314
3152,dinesh,3,0.00100,53810,17.91791,300314
3153,dinvlad,3,0.00100,53813,17.91891,300314
3154,dirkm,3,0.00100,53816,17.91991,300314
3155,Disturbing,3,0.00100,53819,17.92091,300314
3156,djungyvr,3,0.00100,53822,17.92191,300314
3157,dkulig,3,0.00100,53825,17.92291,300314
3158,dlopes7,3,0.00100,53828,17.92391,300314
3159,dlouks,3,0.00100,53831,17.92491,300314
3160,dmelliot,3,0.00100,53834,17.92590,300314
3161,dmeytin,3,0.00100,53837,17.92690,300314
3162,dmitry-ee,3,0.00100,53840,17.92790,300314
3163,dotsuber,3,0.00100,53843,17.92890,300314
3164,dowster,3,0.00100,53846,17.92990,300314
3165,dpengla,3,0.00100,53849,17.93090,300314
3166,draco2003,3,0.00100,53852,17.93190,300314
3167,DreamDZhu,3,0.00100,53855,17.93290,300314
3168,drehpehs,3,0.00100,53858,17.93390,300314
3169,drivelikebrazil,3,0.00100,53861,17.93489,300314
3170,drkhosla,3,0.00100,53864,17.93589,300314
3171,drmorr0,3,0.00100,53867,17.93689,300314
3172,dsargent3220,3,0.00100,53870,17.93789,300314
3173,dsaydon90,3,0.00100,53873,17.93889,300314
3174,dsoguet,3,0.00100,53876,17.93989,300314
3175,dspencer-kc,3,0.00100,53879,17.94089,300314
3176,dur3x,3,0.00100,53882,17.94189,300314
3177,dweber019,3,0.00100,53885,17.94289,300314
3178,dwindsor,3,0.00100,53888,17.94389,300314
3179,dyipon,3,0.00100,53891,17.94488,300314
3180,dyv,3,0.00100,53894,17.94588,300314
3181,dzkaraka,3,0.00100,53897,17.94688,300314
3182,e06084,3,0.00100,53900,17.94788,300314
3183,ealves-pt,3,0.00100,53903,17.94888,300314
3184,Earsil,3,0.00100,53906,17.94988,300314
3185,eastwd,3,0.00100,53909,17.95088,300314
3186,eckelon,3,0.00100,53912,17.95188,300314
3187,ed10vi,3,0.00100,53915,17.95288,300314
3188,eddie1030,3,0.00100,53918,17.95387,300314
3189,edespong,3,0.00100,53921,17.95487,300314
3190,edify42,3,0.00100,53924,17.95587,300314
3191,eexwhyzee,3,0.00100,53927,17.95687,300314
3192,efrainsteinbach,3,0.00100,53930,17.95787,300314
3193,egara,3,0.00100,53933,17.95887,300314
3194,elias5000,3,0.00100,53936,17.95987,300314
3195,elpablete,3,0.00100,53939,17.96087,300314
3196,elsexo32003,3,0.00100,53942,17.96187,300314
3197,elvis-cai,3,0.00100,53945,17.96287,300314
3198,ElytrA8,3,0.00100,53948,17.96386,300314
3199,em135,3,0.00100,53951,17.96486,300314
3200,enajeeb,3,0.00100,53954,17.96586,300314
3201,encryptblockr,3,0.00100,53957,17.96686,300314
3202,endlesstravel,3,0.00100,53960,17.96786,300314
3203,enribd,3,0.00100,53963,17.96886,300314
3204,epacke,3,0.00100,53966,17.96986,300314
3205,EPNW,3,0.00100,53969,17.97086,300314
3206,eregon,3,0.00100,53972,17.97186,300314
3207,eresende-nuodb,3,0.00100,53975,17.97286,300314
3208,EricStG,3,0.00100,53978,17.97385,300314
3209,erkules,3,0.00100,53981,17.97485,300314
3210,ernani,3,0.00100,53984,17.97585,300314
3211,ethanagold,3,0.00100,53987,17.97685,300314
3212,evanskinner,3,0.00100,53990,17.97785,300314
3213,eyanulis,3,0.00100,53993,17.97885,300314
3214,ezeeyahoo,3,0.00100,53996,17.97985,300314
3215,f9n,3,0.00100,53999,17.98085,300314
3216,fanfansama,3,0.00100,54002,17.98185,300314
3217,FaustUser,3,0.00100,54005,17.98284,300314
3218,fcrozat,3,0.00100,54008,17.98384,300314
3219,fei922,3,0.00100,54011,17.98484,300314
3220,FelixRodriguezJara,3,0.00100,54014,17.98584,300314
3221,ficcaglia,3,0.00100,54017,17.98684,300314
3222,filipdavidovic,3,0.00100,54020,17.98784,300314
3223,fimbulvetr,3,0.00100,54023,17.98884,300314
3224,fishy,3,0.00100,54026,17.98984,300314
3225,fiskhest,3,0.00100,54029,17.99084,300314
3226,flaviolemos78,3,0.00100,54032,17.99184,300314
3227,flobz,3,0.00100,54035,17.99283,300314
3228,fmarceau-imagia,3,0.00100,54038,17.99383,300314
3229,foosinn,3,0.00100,54041,17.99483,300314
3230,fourstepper,3,0.00100,54044,17.99583,300314
3231,fowlay,3,0.00100,54047,17.99683,300314
3232,fr33kvanderwand,3,0.00100,54050,17.99783,300314
3233,frankxieke,3,0.00100,54053,17.99883,300314
3234,fredwangwang,3,0.00100,54056,17.99983,300314
3235,freebrowser1,3,0.00100,54059,18.00083,300314
3236,freegroup,3,0.00100,54062,18.00182,300314
3237,frittenlab,3,0.00100,54065,18.00282,300314
3238,fwhezfwhez,3,0.00100,54068,18.00382,300314
3239,fzhan,3,0.00100,54071,18.00482,300314
3240,g00nix,3,0.00100,54074,18.00582,300314
3241,g1bl3t,3,0.00100,54077,18.00682,300314
3242,g3rzi,3,0.00100,54080,18.00782,300314
3243,gabrilabs75,3,0.00100,54083,18.00882,300314
3244,gaitoubawang,3,0.00100,54086,18.00982,300314
3245,gamestart,3,0.00100,54089,18.01082,300314
3246,gangstead,3,0.00100,54092,18.01181,300314
3247,GaoJiasheng,3,0.00100,54095,18.01281,300314
3248,garimaanurag,3,0.00100,54098,18.01381,300314
3249,GAS85,3,0.00100,54101,18.01481,300314
3250,gauravachatrath,3,0.00100,54104,18.01581,300314
3251,gbschenkel,3,0.00100,54107,18.01681,300314
3252,gburton1,3,0.00100,54110,18.01781,300314
3253,gdexlab,3,0.00100,54113,18.01881,300314
3254,Geethree,3,0.00100,54116,18.01981,300314
3255,gejunqiang,3,0.00100,54119,18.02080,300314
3256,Gevorgisk,3,0.00100,54122,18.02180,300314
3257,girafferiel,3,0.00100,54125,18.02280,300314
3258,gireeshkumarkg,3,0.00100,54128,18.02380,300314
3259,gitsang,3,0.00100,54131,18.02480,300314
3260,gl-ihorkoblan,3,0.00100,54134,18.02580,300314
3261,glitterlip,3,0.00100,54137,18.02680,300314
3262,GNtousakis,3,0.00100,54140,18.02780,300314
3263,goacid,3,0.00100,54143,18.02880,300314
3264,goeranu,3,0.00100,54146,18.02980,300314
3265,goku321,3,0.00100,54149,18.03079,300314
3266,golthitarun,3,0.00100,54152,18.03179,300314
3267,gongwk,3,0.00100,54155,18.03279,300314
3268,gontard,3,0.00100,54158,18.03379,300314
3269,gowrisankar22,3,0.00100,54161,18.03479,300314
3270,gpettey,3,0.00100,54164,18.03579,300314
3271,gpkc,3,0.00100,54167,18.03679,300314
3272,gpriyank1,3,0.00100,54170,18.03779,300314
3273,g-rabah,3,0.00100,54173,18.03879,300314
3274,greg-dennis,3,0.00100,54176,18.03979,300314
3275,GregMefford,3,0.00100,54179,18.04078,300314
3276,gris-gris,3,0.00100,54182,18.04178,300314
3277,Grrui,3,0.00100,54185,18.04278,300314
3278,grzegorz-mirek,3,0.00100,54188,18.04378,300314
3279,gsquared94,3,0.00100,54191,18.04478,300314
3280,guidoffm,3,0.00100,54194,18.04578,300314
3281,guidtz,3,0.00100,54197,18.04678,300314
3282,guillaumelfv,3,0.00100,54200,18.04778,300314
3283,GuiTeK,3,0.00100,54203,18.04878,300314
3284,guoziqin,3,0.00100,54206,18.04977,300314
3285,gururajrkatti,3,0.00100,54209,18.05077,300314
3286,gvital3230,3,0.00100,54212,18.05177,300314
3287,gxglls,3,0.00100,54215,18.05277,300314
3288,h0jeZvgoxFepBQ2C,3,0.00100,54218,18.05377,300314
3289,h1z3y3,3,0.00100,54221,18.05477,300314
3290,hacker65536,3,0.00100,54224,18.05577,300314
3291,hackers365,3,0.00100,54227,18.05677,300314
3292,hamburgerbun,3,0.00100,54230,18.05777,300314
3293,hamdiallam,3,0.00100,54233,18.05877,300314
3294,HappyZombies,3,0.00100,54236,18.05976,300314
3295,HarishankarYellapragada,3,0.00100,54239,18.06076,300314
3296,harrisjoseph,3,0.00100,54242,18.06176,300314
3297,HaunHsiung,3,0.00100,54245,18.06276,300314
3298,hbahadorzadeh,3,0.00100,54248,18.06376,300314
3299,Henni,3,0.00100,54251,18.06476,300314
3300,henriqcabral,3,0.00100,54254,18.06576,300314
3301,henrytseng,3,0.00100,54257,18.06676,300314
3302,hensur,3,0.00100,54260,18.06776,300314
3303,hetalsonavane,3,0.00100,54263,18.06875,300314
3304,hhsnow,3,0.00100,54266,18.06975,300314
3305,hinyinlam-pivotal,3,0.00100,54269,18.07075,300314
3306,HiremathPanchaxari,3,0.00100,54272,18.07175,300314
3307,hiroygo,3,0.00100,54275,18.07275,300314
3308,Hitesh-Agrawal,3,0.00100,54278,18.07375,300314
3309,hitzhangjie,3,0.00100,54281,18.07475,300314
3310,hjanuschka,3,0.00100,54284,18.07575,300314
3311,hostsamurai,3,0.00100,54287,18.07675,300314
3312,hubstairs-admin,3,0.00100,54290,18.07775,300314
3313,hughluo,3,0.00100,54293,18.07874,300314
3314,hugo345816,3,0.00100,54296,18.07974,300314
3315,hurshpatel,3,0.00100,54299,18.08074,300314
3316,hyder,3,0.00100,54302,18.08174,300314
3317,iahmad94,3,0.00100,54305,18.08274,300314
3318,iamfrankjie,3,0.00100,54308,18.08374,300314
3319,iamnoah,3,0.00100,54311,18.08474,300314
3320,iancote,3,0.00100,54314,18.08574,300314
3321,IanEdington,3,0.00100,54317,18.08674,300314
3322,Ibn-coulibaly,3,0.00100,54320,18.08773,300314
3323,ica10888,3,0.00100,54323,18.08873,300314
3324,icepic1984,3,0.00100,54326,18.08973,300314
3325,idsulik,3,0.00100,54329,18.09073,300314
3326,iercan,3,0.00100,54332,18.09173,300314
3327,igorkatz,3,0.00100,54335,18.09273,300314
3328,igortas,3,0.00100,54338,18.09373,300314
3329,ihsinme,3,0.00100,54341,18.09473,300314
3330,ikirianov,3,0.00100,54344,18.09573,300314
3331,ilanni2460,3,0.00100,54347,18.09673,300314
3332,ilyakaznacheev,3,0.00100,54350,18.09772,300314
3333,IlyaNakhaichuk,3,0.00100,54353,18.09872,300314
3334,imalik8088,3,0.00100,54356,18.09972,300314
3335,imperial-fists,3,0.00100,54359,18.10072,300314
3336,indreek,3,0.00100,54362,18.10172,300314
3337,inglemr94,3,0.00100,54365,18.10272,300314
3338,inistor,3,0.00100,54368,18.10372,300314
3339,innad11,3,0.00100,54371,18.10472,300314
3340,insanemal,3,0.00100,54374,18.10572,300314
3341,iorys,3,0.00100,54377,18.10671,300314
3342,irom77,3,0.00100,54380,18.10771,300314
3343,IshaDave,3,0.00100,54383,18.10871,300314
3344,isodude,3,0.00100,54386,18.10971,300314
3345,iss0,3,0.00100,54389,18.11071,300314
3346,iTaybb,3,0.00100,54392,18.11171,300314
3347,ItsDrike,3,0.00100,54395,18.11271,300314
3348,itsLucario,3,0.00100,54398,18.11371,300314
3349,itsmatinx,3,0.00100,54401,18.11471,300314
3350,iwita,3,0.00100,54404,18.11571,300314
3351,jagguli,3,0.00100,54407,18.11670,300314
3352,jaibheem,3,0.00100,54410,18.11770,300314
3353,jainhitesh9998,3,0.00100,54413,18.11870,300314
3354,jangraefen,3,0.00100,54416,18.11970,300314
3355,janzantinge,3,0.00100,54419,18.12070,300314
3356,jaredclarke,3,0.00100,54422,18.12170,300314
3357,jared-wilkinson,3,0.00100,54425,18.12270,300314
3358,jarrodcal,3,0.00100,54428,18.12370,300314
3359,jasonbunch,3,0.00100,54431,18.12470,300314
3360,jasonpaige,3,0.00100,54434,18.12570,300314
3361,jasonrosy,3,0.00100,54437,18.12669,300314
3362,jasons42,3,0.00100,54440,18.12769,300314
3363,jaunruh,3,0.00100,54443,18.12869,300314
3364,jbaojunior,3,0.00100,54446,18.12969,300314
3365,JCzz,3,0.00100,54449,18.13069,300314
3366,jdgeisler,3,0.00100,54452,18.13169,300314
3367,jeffreyvdhondel,3,0.00100,54455,18.13269,300314
3368,jelmd,3,0.00100,54458,18.13369,300314
3369,jeloba,3,0.00100,54461,18.13469,300314
3370,jemag,3,0.00100,54464,18.13568,300314
3371,jensdt,3,0.00100,54467,18.13668,300314
3372,jepperson2,3,0.00100,54470,18.13768,300314
3373,Jeremy-boo,3,0.00100,54473,18.13868,300314
3374,JeremyGHutchins,3,0.00100,54476,18.13968,300314
3375,jestallin,3,0.00100,54479,18.14068,300314
3376,jfbai,3,0.00100,54482,18.14168,300314
3377,jgalliers,3,0.00100,54485,18.14268,300314
3378,jianh619,3,0.00100,54488,18.14368,300314
3379,jianwang-beijing,3,0.00100,54491,18.14468,300314
3380,jihyun00,3,0.00100,54494,18.14567,300314
3381,jkralik,3,0.00100,54497,18.14667,300314
3382,jlandowner,3,0.00100,54500,18.14767,300314
3383,jlpedrosa,3,0.00100,54503,18.14867,300314
3384,jluque0101,3,0.00100,54506,18.14967,300314
3385,joac,3,0.00100,54509,18.15067,300314
3386,JoergM,3,0.00100,54512,18.15167,300314
3387,JoeSainsburys,3,0.00100,54515,18.15267,300314
3388,johnerikhalse,3,0.00100,54518,18.15367,300314
3389,Johnny850807,3,0.00100,54521,18.15466,300314
3390,johnqa,3,0.00100,54524,18.15566,300314
3391,jopfeffe,3,0.00100,54527,18.15666,300314
3392,joshi95,3,0.00100,54530,18.15766,300314
3393,JoshKeegan,3,0.00100,54533,18.15866,300314
3394,joshm91,3,0.00100,54536,18.15966,300314
3395,joweich,3,0.00100,54539,18.16066,300314
3396,joyciep,3,0.00100,54542,18.16166,300314
3397,jpaulodit,3,0.00100,54545,18.16266,300314
3398,JrSchild,3,0.00100,54548,18.16366,300314
3399,jsato8094,3,0.00100,54551,18.16465,300314
3400,jschwinger23,3,0.00100,54554,18.16565,300314
3401,jseiser,3,0.00100,54557,18.16665,300314
3402,jtwill98,3,0.00100,54560,18.16765,300314
3403,juanpardo,3,0.00100,54563,18.16865,300314
3404,julienchouinard,3,0.00100,54566,18.16965,300314
3405,juozasg,3,0.00100,54569,18.17065,300314
3406,jurgenweber,3,0.00100,54572,18.17165,300314
3407,just1900,3,0.00100,54575,18.17265,300314
3408,justinkillen,3,0.00100,54578,18.17364,300314
3409,kakyoism,3,0.00100,54581,18.17464,300314
3410,kanelv,3,0.00100,54584,18.17564,300314
3411,kanupriya-hub,3,0.00100,54587,18.17664,300314
3412,karthik012,3,0.00100,54590,18.17764,300314
3413,karthikinamanamelluri,3,0.00100,54593,18.17864,300314
3414,karunasagark,3,0.00100,54596,18.17964,300314
3415,kaviarasan-ex2,3,0.00100,54599,18.18064,300314
3416,kentpachi,3,0.00100,54602,18.18164,300314
3417,kevin-hao,3,0.00100,54605,18.18264,300314
3418,KingKunn,3,0.00100,54608,18.18363,300314
3419,KinglyWayne,3,0.00100,54611,18.18463,300314
3420,kiranpatel11,3,0.00100,54614,18.18563,300314
3421,kobanda123,3,0.00100,54617,18.18663,300314
3422,kochetov-dmitrij,3,0.00100,54620,18.18763,300314
3423,konradjurk,3,0.00100,54623,18.18863,300314
3424,koobs,3,0.00100,54626,18.18963,300314
3425,kotx,3,0.00100,54629,18.19063,300314
3426,krisgradz,3,0.00100,54632,18.19163,300314
3427,krtk6160,3,0.00100,54635,18.19263,300314
3428,Krzysztof-Lempicki,3,0.00100,54638,18.19362,300314
3429,kshang510,3,0.00100,54641,18.19462,300314
3430,KunalAdu,3,0.00100,54644,18.19562,300314
3431,Kupstas,3,0.00100,54647,18.19662,300314
3432,Kurounin,3,0.00100,54650,18.19762,300314
3433,lalitkr90,3,0.00100,54653,18.19862,300314
3434,lambertpan,3,0.00100,54656,18.19962,300314
3435,LargeOrange,3,0.00100,54659,18.20062,300314
3436,Laurianti,3,0.00100,54662,18.20162,300314
3437,lazedo,3,0.00100,54665,18.20261,300314
3438,lcasi,3,0.00100,54668,18.20361,300314
3439,Leavrth,3,0.00100,54671,18.20461,300314
3440,Lechnio,3,0.00100,54674,18.20561,300314
3441,leiter-jakab,3,0.00100,54677,18.20661,300314
3442,leizhag,3,0.00100,54680,18.20761,300314
3443,LeiZhang-Hunter,3,0.00100,54683,18.20861,300314
3444,leo-lee-4231,3,0.00100,54686,18.20961,300314
3445,leon3452,3,0.00100,54689,18.21061,300314
3446,leonicode,3,0.00100,54692,18.21161,300314
3447,leoppro,3,0.00100,54695,18.21260,300314
3448,lepistone,3,0.00100,54698,18.21360,300314
3449,letoams,3,0.00100,54701,18.21460,300314
3450,letran3691,3,0.00100,54704,18.21560,300314
3451,leviisfool,3,0.00100,54707,18.21660,300314
3452,levinxo,3,0.00100,54710,18.21760,300314
3453,lillieMaiBauer,3,0.00100,54713,18.21860,300314
3454,linuxpham,3,0.00100,54716,18.21960,300314
3455,linxuyalun,3,0.00100,54719,18.22060,300314
3456,liuximu,3,0.00100,54722,18.22159,300314
3457,lixiaoxi-coder,3,0.00100,54725,18.22259,300314
3458,lixin9311,3,0.00100,54728,18.22359,300314
3459,liz-acosta,3,0.00100,54731,18.22459,300314
3460,lledey,3,0.00100,54734,18.22559,300314
3461,llhhbc,3,0.00100,54737,18.22659,300314
3462,lllamnyp,3,0.00100,54740,18.22759,300314
3463,lmajercak-wish,3,0.00100,54743,18.22859,300314
3464,lodow,3,0.00100,54746,18.22959,300314
3465,lokeshdubeyin,3,0.00100,54749,18.23059,300314
3466,lomboboo,3,0.00100,54752,18.23158,300314
3467,longXboy,3,0.00100,54755,18.23258,300314
3468,lotharschulz,3,0.00100,54758,18.23358,300314
3469,LouisJULIEN,3,0.00100,54761,18.23458,300314
3470,LouisStAmour,3,0.00100,54764,18.23558,300314
3471,lpossamai,3,0.00100,54767,18.23658,300314
3472,lrul,3,0.00100,54770,18.23758,300314
3473,LuChenjing,3,0.00100,54773,18.23858,300314
3474,lucianozablocki,3,0.00100,54776,18.23958,300314
3475,lucky4ever2,3,0.00100,54779,18.24057,300314
3476,luckyxiaoqiang,3,0.00100,54782,18.24157,300314
3477,lukepighetti,3,0.00100,54785,18.24257,300314
3478,luong-komorebi,3,0.00100,54788,18.24357,300314
3479,lurkie,3,0.00100,54791,18.24457,300314
3480,luvncoco,3,0.00100,54794,18.24557,300314
3481,m1keil,3,0.00100,54797,18.24657,300314
3482,mab,3,0.00100,54800,18.24757,300314
3483,madelinef,3,0.00100,54803,18.24857,300314
3484,maennchen,3,0.00100,54806,18.24957,300314
3485,makusu2,3,0.00100,54809,18.25056,300314
3486,mamiu,3,0.00100,54812,18.25156,300314
3487,mantuliu,3,0.00100,54815,18.25256,300314
3488,marcaurele,3,0.00100,54818,18.25356,300314
3489,marciogmorales,3,0.00100,54821,18.25456,300314
3490,marcodoordash,3,0.00100,54824,18.25556,300314
3491,MarinaGg23,3,0.00100,54827,18.25656,300314
3492,mariusmitrofan,3,0.00100,54830,18.25756,300314
3493,marjakm,3,0.00100,54833,18.25856,300314
3494,mark-nc,3,0.00100,54836,18.25955,300314
3495,marshall007,3,0.00100,54839,18.26055,300314
3496,marshields,3,0.00100,54842,18.26155,300314
3497,Martijnvos,3,0.00100,54845,18.26255,300314
3498,martinbeentjes,3,0.00100,54848,18.26355,300314
3499,martinknechtel,3,0.00100,54851,18.26455,300314
3500,martinliu,3,0.00100,54854,18.26555,300314
3501,masingh-19,3,0.00100,54857,18.26655,300314
3502,MasseGuillaume,3,0.00100,54860,18.26755,300314
3503,MatheoDumont,3,0.00100,54863,18.26855,300314
3504,MathieuCesbron,3,0.00100,54866,18.26954,300314
3505,matthawley,3,0.00100,54869,18.27054,300314
3506,matthewhembree,3,0.00100,54872,18.27154,300314
3507,Mattimax20,3,0.00100,54875,18.27254,300314
3508,mattygyk,3,0.00100,54878,18.27354,300314
3509,mavenraven,3,0.00100,54881,18.27454,300314
3510,maxedmands,3,0.00100,54884,18.27554,300314
3511,MaxTaggart,3,0.00100,54887,18.27654,300314
3512,maxweisel,3,0.00100,54890,18.27754,300314
3513,maxweisspoker,3,0.00100,54893,18.27854,300314
3514,max-wittig,3,0.00100,54896,18.27953,300314
3515,mayur040993,3,0.00100,54899,18.28053,300314
3516,maZahaca,3,0.00100,54902,18.28153,300314
3517,mbevc1,3,0.00100,54905,18.28253,300314
3518,mcginne,3,0.00100,54908,18.28353,300314
3519,mcipperly,3,0.00100,54911,18.28453,300314
3520,mdable2,3,0.00100,54914,18.28553,300314
3521,mdiez-modus,3,0.00100,54917,18.28653,300314
3522,meastp,3,0.00100,54920,18.28753,300314
3523,medabalimi,3,0.00100,54923,18.28852,300314
3524,melisatanrverdi,3,0.00100,54926,18.28952,300314
3525,mengxiangyue,3,0.00100,54929,18.29052,300314
3526,Mentat420,3,0.00100,54932,18.29152,300314
3527,mestuddtc,3,0.00100,54935,18.29252,300314
3528,meyergondelsheim,3,0.00100,54938,18.29352,300314
3529,MFAshby,3,0.00100,54941,18.29452,300314
3530,mf-lit,3,0.00100,54944,18.29552,300314
3531,mforgues,3,0.00100,54947,18.29652,300314
3532,mgj,3,0.00100,54950,18.29752,300314
3533,mhirsch,3,0.00100,54953,18.29851,300314
3534,mhmohona,3,0.00100,54956,18.29951,300314
3535,michael-bouvy,3,0.00100,54959,18.30051,300314
3536,michaelpearce-gain,3,0.00100,54962,18.30151,300314
3537,michaelurban,3,0.00100,54965,18.30251,300314
3538,micw,3,0.00100,54968,18.30351,300314
3539,miguelgmalpha,3,0.00100,54971,18.30451,300314
3540,mihirvijdeshpande,3,0.00100,54974,18.30551,300314
3541,mikeczech,3,0.00100,54977,18.30651,300314
3542,mikeparker,3,0.00100,54980,18.30750,300314
3543,mike-somethingnooneelsehasusedyet,3,0.00100,54983,18.30850,300314
3544,mikonse,3,0.00100,54986,18.30950,300314
3545,mikosa,3,0.00100,54989,18.31050,300314
3546,milgradesec,3,0.00100,54992,18.31150,300314
3547,milindw96,3,0.00100,54995,18.31250,300314
3548,MinhDuc010194,3,0.00100,54998,18.31350,300314
3549,miroswan,3,0.00100,55001,18.31450,300314
3550,MittWillson,3,0.00100,55004,18.31550,300314
3551,mjallday,3,0.00100,55007,18.31650,300314
3552,mleegwt,3,0.00100,55010,18.31749,300314
3553,mlkmhd,3,0.00100,55013,18.31849,300314
3554,mmanciop,3,0.00100,55016,18.31949,300314
3555,mmottaghi,3,0.00100,55019,18.32049,300314
3556,MoeHamdan,3,0.00100,55022,18.32149,300314
3557,mohafarooq,3,0.00100,55025,18.32249,300314
3558,mohjam2004,3,0.00100,55028,18.32349,300314
3559,monsteredc,3,0.00100,55031,18.32449,300314
3560,mooction,3,0.00100,55034,18.32549,300314
3561,moonovo,3,0.00100,55037,18.32648,300314
3562,MrBlaise,3,0.00100,55040,18.32748,300314
3563,mrethers,3,0.00100,55043,18.32848,300314
3564,MrPallaBall,3,0.00100,55046,18.32948,300314
3565,mrsiejas,3,0.00100,55049,18.33048,300314
3566,mrwalters1988,3,0.00100,55052,18.33148,300314
3567,ms-choudhary,3,0.00100,55055,18.33248,300314
3568,msgeissler,3,0.00100,55058,18.33348,300314
3569,MSNev,3,0.00100,55061,18.33448,300314
3570,mu5341,3,0.00100,55064,18.33548,300314
3571,muffl0n,3,0.00100,55067,18.33647,300314
3572,mukhoakash,3,0.00100,55070,18.33747,300314
3573,MullinsN,3,0.00100,55073,18.33847,300314
3574,muyi1024b,3,0.00100,55076,18.33947,300314
3575,mwiora,3,0.00100,55079,18.34047,300314
3576,MyBruso,3,0.00100,55082,18.34147,300314
3577,myee111,3,0.00100,55085,18.34247,300314
3578,nagarajmanjunath,3,0.00100,55088,18.34347,300314
3579,na-ka-na,3,0.00100,55091,18.34447,300314
3580,narenreddycs,3,0.00100,55094,18.34547,300314
3581,nataizya-s,3,0.00100,55097,18.34646,300314
3582,nbon12,3,0.00100,55100,18.34746,300314
3583,nbrink91,3,0.00100,55103,18.34846,300314
3584,ndhcoder,3,0.00100,55106,18.34946,300314
3585,Nebulazhang,3,0.00100,55109,18.35046,300314
3586,neilharris123,3,0.00100,55112,18.35146,300314
3587,nelsonspbr,3,0.00100,55115,18.35246,300314
3588,neo502721,3,0.00100,55118,18.35346,300314
3589,nevido,3,0.00100,55121,18.35446,300314
3590,nflaig,3,0.00100,55124,18.35545,300314
3591,nhathoangvy,3,0.00100,55127,18.35645,300314
3592,Nicholaswang,3,0.00100,55130,18.35745,300314
3593,nick-oconnor,3,0.00100,55133,18.35845,300314
3594,nick-oh,3,0.00100,55136,18.35945,300314
3595,nicksc423,3,0.00100,55139,18.36045,300314
3596,nickvanw,3,0.00100,55142,18.36145,300314
3597,niebomin,3,0.00100,55145,18.36245,300314
3598,nigurr,3,0.00100,55148,18.36345,300314
3599,nils1k,3,0.00100,55151,18.36445,300314
3600,NinaMulkijanyan,3,0.00100,55154,18.36544,300314
3601,nirarg,3,0.00100,55157,18.36644,300314
3602,nitrotm,3,0.00100,55160,18.36744,300314
3603,nkhine,3,0.00100,55163,18.36844,300314
3604,nniikkoollaaii,3,0.00100,55166,18.36944,300314
3605,noahkawasakigoogle,3,0.00100,55169,18.37044,300314
3606,nokome,3,0.00100,55172,18.37144,300314
3607,norafang52,3,0.00100,55175,18.37244,300314
3608,novalagung,3,0.00100,55178,18.37344,300314
3609,npampaloni,3,0.00100,55181,18.37443,300314
3610,n-rodriguez,3,0.00100,55184,18.37543,300314
3611,ns-jisorce,3,0.00100,55187,18.37643,300314
3612,ntkme,3,0.00100,55190,18.37743,300314
3613,ntoofu,3,0.00100,55193,18.37843,300314
3614,ntx-ben,3,0.00100,55196,18.37943,300314
3615,nuno-silva,3,0.00100,55199,18.38043,300314
3616,nutzhub,3,0.00100,55202,18.38143,300314
3617,nycnewman,3,0.00100,55205,18.38243,300314
3618,oakad,3,0.00100,55208,18.38343,300314
3619,ocuto,3,0.00100,55211,18.38442,300314
3620,OfirYaron,3,0.00100,55214,18.38542,300314
3621,oholdswo,3,0.00100,55217,18.38642,300314
3622,OldBlackJoe,3,0.00100,55220,18.38742,300314
3623,olegtrautvein,3,0.00100,55223,18.38842,300314
3624,Oliver-Sellwood,3,0.00100,55226,18.38942,300314
3625,Olli73773,3,0.00100,55229,18.39042,300314
3626,olliezhu,3,0.00100,55232,18.39142,300314
3627,omegion,3,0.00100,55235,18.39242,300314
3628,omertuc,3,0.00100,55238,18.39341,300314
3629,onelittlenightmusic,3,0.00100,55241,18.39441,300314
3630,onespacer,3,0.00100,55244,18.39541,300314
3631,onweru,3,0.00100,55247,18.39641,300314
3632,ooeunz,3,0.00100,55250,18.39741,300314
3633,openJT,3,0.00100,55253,18.39841,300314
3634,OscarDHdz,3,0.00100,55256,18.39941,300314
3635,oussama-mechlaoui,3,0.00100,55259,18.40041,300314
3636,owen2016,3,0.00100,55262,18.40141,300314
3637,pabloopez,3,0.00100,55265,18.40241,300314
3638,packetmpm,3,0.00100,55268,18.40340,300314
3639,PacoDu,3,0.00100,55271,18.40440,300314
3640,paleozogt,3,0.00100,55274,18.40540,300314
3641,Palerion,3,0.00100,55277,18.40640,300314
3642,pan3793,3,0.00100,55280,18.40740,300314
3643,pancudaniel7,3,0.00100,55283,18.40840,300314
3644,papanmanna,3,0.00100,55286,18.40940,300314
3645,PatMis16,3,0.00100,55289,18.41040,300314
3646,patramsey,3,0.00100,55292,18.41140,300314
3647,patrickmen,3,0.00100,55295,18.41240,300314
3648,paulsbruce,3,0.00100,55298,18.41339,300314
3649,paurosello,3,0.00100,55301,18.41439,300314
3650,Pavel910,3,0.00100,55304,18.41539,300314
3651,pavlelee,3,0.00100,55307,18.41639,300314
3652,pbradly,3,0.00100,55310,18.41739,300314
3653,pcolazurdo,3,0.00100,55313,18.41839,300314
3654,pcurewitz,3,0.00100,55316,18.41939,300314
3655,pearj,3,0.00100,55319,18.42039,300314
3656,pedro-brentan,3,0.00100,55322,18.42139,300314
3657,pettersv,3,0.00100,55325,18.42238,300314
3658,philomory,3,0.00100,55328,18.42338,300314
3659,PicoCreator,3,0.00100,55331,18.42438,300314
3660,pinkyjpainadath,3,0.00100,55334,18.42538,300314
3661,pkalever,3,0.00100,55337,18.42638,300314
3662,pmartinou,3,0.00100,55340,18.42738,300314
3663,pmenon53,3,0.00100,55343,18.42838,300314
3664,pncps99,3,0.00100,55346,18.42938,300314
3665,poblahblahblah,3,0.00100,55349,18.43038,300314
3666,polskikiel,3,0.00100,55352,18.43138,300314
3667,PolyProgrammist,3,0.00100,55355,18.43237,300314
3668,PrabhuMathi,3,0.00100,55358,18.43337,300314
3669,prakashshp92,3,0.00100,55361,18.43437,300314
3670,prashanth26,3,0.00100,55364,18.43537,300314
3671,pravb,3,0.00100,55367,18.43637,300314
3672,prelipceang,3,0.00100,55370,18.43737,300314
3673,projuri,3,0.00100,55373,18.43837,300314
3674,prophen,3,0.00100,55376,18.43937,300314
3675,prprasad2020,3,0.00100,55379,18.44037,300314
3676,pruthvichow,3,0.00100,55382,18.44136,300314
3677,psandhu79,3,0.00100,55385,18.44236,300314
3678,purusottam16,3,0.00100,55388,18.44336,300314
3679,qingsong-cn,3,0.00100,55391,18.44436,300314
3680,qmhu,3,0.00100,55394,18.44536,300314
3681,quickerdevops,3,0.00100,55397,18.44636,300314
3682,qw4990,3,0.00100,55400,18.44736,300314
3683,Qyw-a,3,0.00100,55403,18.44836,300314
3684,RafalMaleska,3,0.00100,55406,18.44936,300314
3685,ragashreeshekar,3,0.00100,55409,18.45036,300314
3686,RageZBla,3,0.00100,55412,18.45135,300314
3687,rainerjung,3,0.00100,55415,18.45235,300314
3688,rajdeepbhattacharya,3,0.00100,55418,18.45335,300314
3689,RajeshDasari,3,0.00100,55421,18.45435,300314
3690,RajKuni,3,0.00100,55424,18.45535,300314
3691,rakshith91,3,0.00100,55427,18.45635,300314
3692,ramonssarmento,3,0.00100,55430,18.45735,300314
3693,randxie,3,0.00100,55433,18.45835,300314
3694,ranjankhanna,3,0.00100,55436,18.45935,300314
3695,raunaqgupta,3,0.00100,55439,18.46034,300314
3696,raysaini19,3,0.00100,55442,18.46134,300314
3697,rd185276,3,0.00100,55445,18.46234,300314
3698,rdavyd,3,0.00100,55448,18.46334,300314
3699,rdpa,3,0.00100,55451,18.46434,300314
3700,redwolf2019,3,0.00100,55454,18.46534,300314
3701,ReillyTevera,3,0.00100,55457,18.46634,300314
3702,reinoudk,3,0.00100,55460,18.46734,300314
3703,reinvantveer,3,0.00100,55463,18.46834,300314
3704,ReiZ-X,3,0.00100,55466,18.46934,300314
3705,relferreira,3,0.00100,55469,18.47033,300314
3706,renanqts,3,0.00100,55472,18.47133,300314
3707,Retrospection,3,0.00100,55475,18.47233,300314
3708,rexxars,3,0.00100,55478,18.47333,300314
3709,rgadeev,3,0.00100,55481,18.47433,300314
3710,ricardoprins,3,0.00100,55484,18.47533,300314
3711,RiccardoManfrin,3,0.00100,55487,18.47633,300314
3712,Richard-Hansen,3,0.00100,55490,18.47733,300314
3713,Richa-Srivastava,3,0.00100,55493,18.47833,300314
3714,rickardgranberg,3,0.00100,55496,18.47932,300314
3715,risinger,3,0.00100,55499,18.48032,300314
3716,ritpanjw,3,0.00100,55502,18.48132,300314
3717,rjulian,3,0.00100,55505,18.48232,300314
3718,rk3rn3r,3,0.00100,55508,18.48332,300314
3719,rkennedy-tpl,3,0.00100,55511,18.48432,300314
3720,rkmathi,3,0.00100,55514,18.48532,300314
3721,rkubik-hostersi,3,0.00100,55517,18.48632,300314
3722,robertsonai,3,0.00100,55520,18.48732,300314
3723,robrosillo,3,0.00100,55523,18.48832,300314
3724,Rock981119,3,0.00100,55526,18.48931,300314
3725,RohitRox,3,0.00100,55529,18.49031,300314
3726,rohrit,3,0.00100,55532,18.49131,300314
3727,romfreiman,3,0.00100,55535,18.49231,300314
3728,rootmout,3,0.00100,55538,18.49331,300314
3729,rosespecs,3,0.00100,55541,18.49431,300314
3730,roshpr,3,0.00100,55544,18.49531,300314
3731,rosstimothy,3,0.00100,55547,18.49631,300314
3732,rquinlivan,3,0.00100,55550,18.49731,300314
3733,rramadoss4,3,0.00100,55553,18.49831,300314
3734,rsafonseca,3,0.00100,55556,18.49930,300314
3735,ruicao93,3,0.00100,55559,18.50030,300314
3736,rust84,3,0.00100,55562,18.50130,300314
3737,ryanmvazquez,3,0.00100,55565,18.50230,300314
3738,RyanW8,3,0.00100,55568,18.50330,300314
3739,ryjones,3,0.00100,55571,18.50430,300314
3740,SabySen,3,0.00100,55574,18.50530,300314
3741,sachinkakatkar,3,0.00100,55577,18.50630,300314
3742,saitoy1,3,0.00100,55580,18.50730,300314
3743,Sallyan,3,0.00100,55583,18.50829,300314
3744,SamarSidharth,3,0.00100,55586,18.50929,300314
3745,samene,3,0.00100,55589,18.51029,300314
3746,samiyaakhtar,3,0.00100,55592,18.51129,300314
3747,samwho,3,0.00100,55595,18.51229,300314
3748,sankala-dremio,3,0.00100,55598,18.51329,300314
3749,santiagocardin,3,0.00100,55601,18.51429,300314
3750,SantosVictorero,3,0.00100,55604,18.51529,300314
3751,SaschaHeyer,3,0.00100,55607,18.51629,300314
3752,sata,3,0.00100,55610,18.51729,300314
3753,sathiyajith,3,0.00100,55613,18.51828,300314
3754,SatishBala,3,0.00100,55616,18.51928,300314
3755,Sbou,3,0.00100,55619,18.52028,300314
3756,sccblue,3,0.00100,55622,18.52128,300314
3757,schlomo,3,0.00100,55625,18.52228,300314
3758,scholtz,3,0.00100,55628,18.52328,300314
3759,scirner22,3,0.00100,55631,18.52428,300314
3760,ScruffyProdigy,3,0.00100,55634,18.52528,300314
3761,sd2020bs,3,0.00100,55637,18.52628,300314
3762,seb-bah,3,0.00100,55640,18.52727,300314
3763,sedmelluq,3,0.00100,55643,18.52827,300314
3764,seifeddinehammouda,3,0.00100,55646,18.52927,300314
3765,seiyuricardohiga,3,0.00100,55649,18.53027,300314
3766,sergeymavrin,3,0.00100,55652,18.53127,300314
3767,sergioregueira,3,0.00100,55655,18.53227,300314
3768,servo1x,3,0.00100,55658,18.53327,300314
3769,sevaho,3,0.00100,55661,18.53427,300314
3770,sgavrylenko,3,0.00100,55664,18.53527,300314
3771,shamsimam,3,0.00100,55667,18.53627,300314
3772,shane-lawrence,3,0.00100,55670,18.53726,300314
3773,shantanuchaudhary24,3,0.00100,55673,18.53826,300314
3774,sharpyy,3,0.00100,55676,18.53926,300314
3775,shenmuxiaosen,3,0.00100,55679,18.54026,300314
3776,ShooterIT,3,0.00100,55682,18.54126,300314
3777,shortmann,3,0.00100,55685,18.54226,300314
3778,shubham-pampattiwar,3,0.00100,55688,18.54326,300314
3779,shubhmah57,3,0.00100,55691,18.54426,300314
3780,siarhei-karanets-epam,3,0.00100,55694,18.54526,300314
3781,Siddharthav1,3,0.00100,55697,18.54625,300314
3782,sid-maddy,3,0.00100,55700,18.54725,300314
3783,simon-an,3,0.00100,55703,18.54825,300314
3784,SimonCqk,3,0.00100,55706,18.54925,300314
3785,SimoneFalzone,3,0.00100,55709,18.55025,300314
3786,simonfxr,3,0.00100,55712,18.55125,300314
3787,sirwio,3,0.00100,55715,18.55225,300314
3788,sitaramkm,3,0.00100,55718,18.55325,300314
3789,situzhiheng,3,0.00100,55721,18.55425,300314
3790,sivaramsk,3,0.00100,55724,18.55525,300314
3791,sixeIa,3,0.00100,55727,18.55624,300314
3792,skadefro,3,0.00100,55730,18.55724,300314
3793,skiptomyliu,3,0.00100,55733,18.55824,300314
3794,skjindal93,3,0.00100,55736,18.55924,300314
3795,skoppers,3,0.00100,55739,18.56024,300314
3796,SkullTech,3,0.00100,55742,18.56124,300314
3797,sky29,3,0.00100,55745,18.56224,300314
3798,skyshaokai,3,0.00100,55748,18.56324,300314
3799,slagiewka,3,0.00100,55751,18.56424,300314
3800,slavonnet,3,0.00100,55754,18.56524,300314
3801,Slijkhuis,3,0.00100,55757,18.56623,300314
3802,smarcu92,3,0.00100,55760,18.56723,300314
3803,smitcham,3,0.00100,55763,18.56823,300314
3804,Smitholi67,3,0.00100,55766,18.56923,300314
3805,snow-with-tea,3,0.00100,55769,18.57023,300314
3806,sOblivionsCall,3,0.00100,55772,18.57123,300314
3807,somethingw,3,0.00100,55775,18.57223,300314
3808,Sonam11,3,0.00100,55778,18.57323,300314
3809,sondinhnwv,3,0.00100,55781,18.57423,300314
3810,sonowz,3,0.00100,55784,18.57522,300314
3811,speedyguy17,3,0.00100,55787,18.57622,300314
3812,spencer-bos,3,0.00100,55790,18.57722,300314
3813,spielkind,3,0.00100,55793,18.57822,300314
3814,spohner,3,0.00100,55796,18.57922,300314
3815,SpringLeee,3,0.00100,55799,18.58022,300314
3816,Squidtoon99,3,0.00100,55802,18.58122,300314
3817,srajappa,3,0.00100,55805,18.58222,300314
3818,srfaytkn,3,0.00100,55808,18.58322,300314
3819,sshiba,3,0.00100,55811,18.58422,300314
3820,starcraft66,3,0.00100,55814,18.58521,300314
3821,Static-Flow,3,0.00100,55817,18.58621,300314
3822,stealthHat,3,0.00100,55820,18.58721,300314
3823,stefanhenseler,3,0.00100,55823,18.58821,300314
3824,stefan-scheidewig,3,0.00100,55826,18.58921,300314
3825,StepanKuksenko,3,0.00100,55829,18.59021,300314
3826,Stephan-Walter,3,0.00100,55832,18.59121,300314
3827,stephen-dexda,3,0.00100,55835,18.59221,300314
3828,StephenLiuYa,3,0.00100,55838,18.59321,300314
3829,StephenWeber,3,0.00100,55841,18.59420,300314
3830,stepin,3,0.00100,55844,18.59520,300314
3831,stfnbstl,3,0.00100,55847,18.59620,300314
3832,stinkypoosasd,3,0.00100,55850,18.59720,300314
3833,storagezhang,3,0.00100,55853,18.59820,300314
3834,storyicon,3,0.00100,55856,18.59920,300314
3835,strideynet,3,0.00100,55859,18.60020,300314
3836,stuartpreston,3,0.00100,55862,18.60120,300314
3837,sujaykulkarn,3,0.00100,55865,18.60220,300314
3838,sundbgit,3,0.00100,55868,18.60320,300314
3839,sunfuze,3,0.00100,55871,18.60419,300314
3840,Sven-bg,3,0.00100,55874,18.60519,300314
3841,svetlanatiffonet,3,0.00100,55877,18.60619,300314
3842,svk-28,3,0.00100,55880,18.60719,300314
3843,syou6162,3,0.00100,55883,18.60819,300314
3844,syphr42,3,0.00100,55886,18.60919,300314
3845,syrusakbary,3,0.00100,55889,18.61019,300314
3846,sysadmiral,3,0.00100,55892,18.61119,300314
3847,szimonek,3,0.00100,55895,18.61219,300314
3848,tacerus,3,0.00100,55898,18.61318,300314
3849,tahaozket,3,0.00100,55901,18.61418,300314
3850,tam-nguyen-senseye,3,0.00100,55904,18.61518,300314
3851,tamseo,3,0.00100,55907,18.61618,300314
3852,Tanemahuta,3,0.00100,55910,18.61718,300314
3853,TangRufus,3,0.00100,55913,18.61818,300314
3854,taobaez,3,0.00100,55916,18.61918,300314
3855,Tarrowren,3,0.00100,55919,18.62018,300314
3856,Tasmana-banana,3,0.00100,55922,18.62118,300314
3857,tastypackets,3,0.00100,55925,18.62218,300314
3858,tbolon,3,0.00100,55928,18.62317,300314
3859,tcrst,3,0.00100,55931,18.62417,300314
3860,TDanielsHL,3,0.00100,55934,18.62517,300314
3861,tdinucci,3,0.00100,55937,18.62617,300314
3862,tejasrao97,3,0.00100,55940,18.62717,300314
3863,tenstad,3,0.00100,55943,18.62817,300314
3864,teoyaomiqui,3,0.00100,55946,18.62917,300314
3865,testmailmrk,3,0.00100,55949,18.63017,300314
3866,teuno,3,0.00100,55952,18.63117,300314
3867,tfrancisci,3,0.00100,55955,18.63217,300314
3868,tfy15jst,3,0.00100,55958,18.63316,300314
3869,tgaehkjteqgdjhki,3,0.00100,55961,18.63416,300314
3870,tgwizard,3,0.00100,55964,18.63516,300314
3871,thekoma,3,0.00100,55967,18.63616,300314
3872,TheLazyIt,3,0.00100,55970,18.63716,300314
3873,theperm,3,0.00100,55973,18.63816,300314
3874,thetechnick,3,0.00100,55976,18.63916,300314
3875,TheWilhelm,3,0.00100,55979,18.64016,300314
3876,thisisbenwoo,3,0.00100,55982,18.64116,300314
3877,ThommyH,3,0.00100,55985,18.64215,300314
3878,thundering-herd,3,0.00100,55988,18.64315,300314
3879,tiketafif,3,0.00100,55991,18.64415,300314
3880,timbuchwaldt,3,0.00100,55994,18.64515,300314
3881,tkleczek,3,0.00100,55997,18.64615,300314
3882,tkob,3,0.00100,56000,18.64715,300314
3883,tmr-prestolabs,3,0.00100,56003,18.64815,300314
3884,tobunka-git,3,0.00100,56006,18.64915,300314
3885,toby-allsopp,3,0.00100,56009,18.65015,300314
3886,TomasKohout,3,0.00100,56012,18.65115,300314
3887,TomasVojacek,3,0.00100,56015,18.65214,300314
3888,tomaszliptak,3,0.00100,56018,18.65314,300314
3889,Tom-E,3,0.00100,56021,18.65414,300314
3890,TomKeur,3,0.00100,56024,18.65514,300314
3891,tommyk,3,0.00100,56027,18.65614,300314
3892,tompatib,3,0.00100,56030,18.65714,300314
3893,TonyDou,3,0.00100,56033,18.65814,300314
3894,torniker,3,0.00100,56036,18.65914,300314
3895,traviscrist,3,0.00100,56039,18.66014,300314
3896,trevorwhitney,3,0.00100,56042,18.66113,300314
3897,tricky42,3,0.00100,56045,18.66213,300314
3898,tringuyen-yw,3,0.00100,56048,18.66313,300314
3899,tristan-tsl,3,0.00100,56051,18.66413,300314
3900,ttben,3,0.00100,56054,18.66513,300314
3901,tx-kstav,3,0.00100,56057,18.66613,300314
3902,typecampo,3,0.00100,56060,18.66713,300314
3903,ubergesundheit,3,0.00100,56063,18.66813,300314
3904,Ueland,3,0.00100,56066,18.66913,300314
3905,ulfox,3,0.00100,56069,18.67013,300314
3906,unixtommy,3,0.00100,56072,18.67112,300314
3907,urfin78,3,0.00100,56075,18.67212,300314
3908,usrbinkat,3,0.00100,56078,18.67312,300314
3909,UVV-gh,3,0.00100,56081,18.67412,300314
3910,V0idk,3,0.00100,56084,18.67512,300314
3911,vaccarium,3,0.00100,56087,18.67612,300314
3912,vadbluedata,3,0.00100,56090,18.67712,300314
3913,vaibhavraizada-hcl,3,0.00100,56093,18.67812,300314
3914,ValeriiVozniuk,3,0.00100,56096,18.67912,300314
3915,vanyarock01,3,0.00100,56099,18.68011,300314
3916,vaskozl,3,0.00100,56102,18.68111,300314
3917,vbabitskiy,3,0.00100,56105,18.68211,300314
3918,vd-rd,3,0.00100,56108,18.68311,300314
3919,Velyks,3,0.00100,56111,18.68411,300314
3920,venuthang03,3,0.00100,56114,18.68511,300314
3921,vg250156,3,0.00100,56117,18.68611,300314
3922,vglushkov8,3,0.00100,56120,18.68711,300314
3923,ViBiOh,3,0.00100,56123,18.68811,300314
3924,vicmania2007,3,0.00100,56126,18.68911,300314
3925,vidyadharreddy18,3,0.00100,56129,18.69010,300314
3926,VijayRod,3,0.00100,56132,18.69110,300314
3927,vijtrip2,3,0.00100,56135,18.69210,300314
3928,viktoryi,3,0.00100,56138,18.69310,300314
3929,Vilsafur,3,0.00100,56141,18.69410,300314
3930,vinayakj-kaidee,3,0.00100,56144,18.69510,300314
3931,vinothav,3,0.00100,56147,18.69610,300314
3932,VisanthSampath,3,0.00100,56150,18.69710,300314
3933,vittico,3,0.00100,56153,18.69810,300314
3934,vkovacik,3,0.00100,56156,18.69909,300314
3935,vladdoster,3,0.00100,56159,18.70009,300314
3936,Volodymyr-Maiboroda-Imprivata,3,0.00100,56162,18.70109,300314
3937,voltbit,3,0.00100,56165,18.70209,300314
3938,vooon,3,0.00100,56168,18.70309,300314
3939,vtremblay,3,0.00100,56171,18.70409,300314
3940,vvdvortsova,3,0.00100,56174,18.70509,300314
3941,vvydier,3,0.00100,56177,18.70609,300314
3942,vxst,3,0.00100,56180,18.70709,300314
3943,vzool,3,0.00100,56183,18.70809,300314
3944,waitstory,3,0.00100,56186,18.70908,300314
3945,wallabyies,3,0.00100,56189,18.71008,300314
3946,wanliyi,3,0.00100,56192,18.71108,300314
3947,waytoharish,3,0.00100,56195,18.71208,300314
3948,weakcamel,3,0.00100,56198,18.71308,300314
3949,weiqingy,3,0.00100,56201,18.71408,300314
3950,WeiWang120,3,0.00100,56204,18.71508,300314
3951,werne2j,3,0.00100,56207,18.71608,300314
3952,WesternStar,3,0.00100,56210,18.71708,300314
3953,wfelipew,3,0.00100,56213,18.71808,300314
3954,whaakman,3,0.00100,56216,18.71907,300314
3955,whereswaldon,3,0.00100,56219,18.72007,300314
3956,whyvez,3,0.00100,56222,18.72107,300314
3957,wiegandf,3,0.00100,56225,18.72207,300314
3958,windmark,3,0.00100,56228,18.72307,300314
3959,withshubh,3,0.00100,56231,18.72407,300314
3960,wknapik,3,0.00100,56234,18.72507,300314
3961,wmgroot,3,0.00100,56237,18.72607,300314
3962,woodliu,3,0.00100,56240,18.72707,300314
3963,woollybear917,3,0.00100,56243,18.72806,300314
3964,woshihaoren,3,0.00100,56246,18.72906,300314
3965,wuxueyi19,3,0.00100,56249,18.73006,300314
3966,wuzhengxuan,3,0.00100,56252,18.73106,300314
3967,wzm74110,3,0.00100,56255,18.73206,300314
3968,xiaoweihong,3,0.00100,56258,18.73306,300314
3969,Xia-Zhao-rh,3,0.00100,56261,18.73406,300314
3970,xinyanw409,3,0.00100,56264,18.73506,300314
3971,xinyanwu409,3,0.00100,56267,18.73606,300314
3972,XpLoDiuM,3,0.00100,56270,18.73706,300314
3973,xuanyunhui,3,0.00100,56273,18.73805,300314
3974,Yangjian-hunan,3,0.00100,56276,18.73905,300314
3975,yash97,3,0.00100,56279,18.74005,300314
3976,yasuki0707,3,0.00100,56282,18.74105,300314
3977,Yaytay,3,0.00100,56285,18.74205,300314
3978,yckaolalala,3,0.00100,56288,18.74305,300314
3979,yejinmo,3,0.00100,56291,18.74405,300314
3980,yiminmv,3,0.00100,56294,18.74505,300314
3981,YorickH,3,0.00100,56297,18.74605,300314
3982,yorikya,3,0.00100,56300,18.74704,300314
3983,Yu-HaoYu,3,0.00100,56303,18.74804,300314
3984,YuJuncen,3,0.00100,56306,18.74904,300314
3985,yutinghua,3,0.00100,56309,18.75004,300314
3986,yuzhouliu-solace,3,0.00100,56312,18.75104,300314
3987,ZacharyChang,3,0.00100,56315,18.75204,300314
3988,zacyang,3,0.00100,56318,18.75304,300314
3989,zadigus,3,0.00100,56321,18.75404,300314
3990,zdzichu,3,0.00100,56324,18.75504,300314
3991,zemek,3,0.00100,56327,18.75604,300314
3992,zereraz,3,0.00100,56330,18.75703,300314
3993,zerodayz,3,0.00100,56333,18.75803,300314
3994,zeusro,3,0.00100,56336,18.75903,300314
3995,Zhang21,3,0.00100,56339,18.76003,300314
3996,zhangqiongjie,3,0.00100,56342,18.76103,300314
3997,zhech2,3,0.00100,56345,18.76203,300314
3998,zhenxiu,3,0.00100,56348,18.76303,300314
3999,ZhilinS,3,0.00100,56351,18.76403,300314
4000,zhugelianglongming,3,0.00100,56354,18.76503,300314
4001,zhuwenxing,3,0.00100,56357,18.76602,300314
4002,zhwei820,3,0.00100,56360,18.76702,300314
4003,ZijianHan-VolvoCars,3,0.00100,56363,18.76802,300314
4004,zishen,3,0.00100,56366,18.76902,300314
4005,zq-david-wang,3,0.00100,56369,18.77002,300314
4006,zubairalimansoor,3,0.00100,56372,18.77102,300314
4007,zucher,3,0.00100,56375,18.77202,300314
4008,zzswang,3,0.00100,56378,18.77302,300314
4009,09jvilla,2,0.00067,56380,18.77368,300314
4010,0m1xa,2,0.00067,56382,18.77435,300314
4011,120742056,2,0.00067,56384,18.77502,300314
4012,4220182,2,0.00067,56386,18.77568,300314
4013,4ss3g4f,2,0.00067,56388,18.77635,300314
4014,657323134,2,0.00067,56390,18.77701,300314
4015,94noni,2,0.00067,56392,18.77768,300314
4016,AaronME,2,0.00067,56394,18.77835,300314
4017,aashrit93,2,0.00067,56396,18.77901,300314
4018,AbderrahimBouhdida,2,0.00067,56398,18.77968,300314
4019,abdukhashimov,2,0.00067,56400,18.78034,300314
4020,abdulakhter,2,0.00067,56402,18.78101,300314
4021,abhi005,2,0.00067,56404,18.78168,300314
4022,abhijitchaudhari1,2,0.00067,56406,18.78234,300314
4023,abhivaidya07,2,0.00067,56408,18.78301,300314
4024,Abikjose,2,0.00067,56410,18.78367,300314
4025,able8,2,0.00067,56412,18.78434,300314
4026,abrden,2,0.00067,56414,18.78501,300314
4027,abunchlotus,2,0.00067,56416,18.78567,300314
4028,achontzo,2,0.00067,56418,18.78634,300314
4029,ackjing,2,0.00067,56420,18.78700,300314
4030,acoulton,2,0.00067,56422,18.78767,300314
4031,AdaLiszk,2,0.00067,56424,18.78833,300314
4032,AdiJohn,2,0.00067,56426,18.78900,300314
4033,adriananeci,2,0.00067,56428,18.78967,300314
4034,adrian-gierakowski,2,0.00067,56430,18.79033,300314
4035,adrian-kiwibank,2,0.00067,56432,18.79100,300314
4036,adrianosela,2,0.00067,56434,18.79166,300314
4037,adriantaut,2,0.00067,56436,18.79233,300314
4038,adthonb,2,0.00067,56438,18.79300,300314
4039,aelath,2,0.00067,56440,18.79366,300314
4040,afsanjar,2,0.00067,56442,18.79433,300314
4041,agavrilov76,2,0.00067,56444,18.79499,300314
4042,ahamez,2,0.00067,56446,18.79566,300314
4043,ahmetgeymen,2,0.00067,56448,18.79633,300314
4044,aiaiai-czh,2,0.00067,56450,18.79699,300314
4045,aido123,2,0.00067,56452,18.79766,300314
4046,AimAlex,2,0.00067,56454,18.79832,300314
4047,ajeetas,2,0.00067,56456,18.79899,300314
4048,ajvondrak,2,0.00067,56458,18.79966,300314
4049,ak89224,2,0.00067,56460,18.80032,300314
4050,akaris-redhat,2,0.00067,56462,18.80099,300314
4051,akirn,2,0.00067,56464,18.80165,300314
4052,akshaybhatt14495,2,0.00067,56466,18.80232,300314
4053,akshayshelke18,2,0.00067,56468,18.80299,300314
4054,akshitgrover,2,0.00067,56470,18.80365,300314
4055,Alaguayyappan,2,0.00067,56472,18.80432,300314
4056,Alan01252,2,0.00067,56474,18.80498,300314
4057,alanbrent,2,0.00067,56476,18.80565,300314
4058,alegmal,2,0.00067,56478,18.80632,300314
4059,alemonmk,2,0.00067,56480,18.80698,300314
4060,alen-z,2,0.00067,56482,18.80765,300314
4061,alenzen,2,0.00067,56484,18.80831,300314
4062,alexey-medvedchikov,2,0.00067,56486,18.80898,300314
4063,alexeyzhuchkov,2,0.00067,56488,18.80965,300314
4064,alex-lx,2,0.00067,56490,18.81031,300314
4065,alexrs,2,0.00067,56492,18.81098,300314
4066,AlexSnet,2,0.00067,56494,18.81164,300314
4067,alexviktorov,2,0.00067,56496,18.81231,300314
4068,alfsch,2,0.00067,56498,18.81298,300314
4069,alim-akbashev,2,0.00067,56500,18.81364,300314
4070,aliorouji,2,0.00067,56502,18.81431,300314
4071,alishir,2,0.00067,56504,18.81497,300314
4072,alkanna,2,0.00067,56506,18.81564,300314
4073,allanhung,2,0.00067,56508,18.81631,300314
4074,allenjol,2,0.00067,56510,18.81697,300314
4075,almahmoud,2,0.00067,56512,18.81764,300314
4076,AlohaPoster,2,0.00067,56514,18.81830,300314
4077,alter,2,0.00067,56516,18.81897,300314
4078,AmirHossein1372,2,0.00067,56518,18.81964,300314
4079,amirkhonov,2,0.00067,56520,18.82030,300314
4080,amithapa,2,0.00067,56522,18.82097,300314
4081,amje,2,0.00067,56524,18.82163,300314
4082,AMontagu,2,0.00067,56526,18.82230,300314
4083,amycuicui,2,0.00067,56528,18.82297,300314
4084,anankun,2,0.00067,56530,18.82363,300314
4085,Andipandi111,2,0.00067,56532,18.82430,300314
4086,andreatosato,2,0.00067,56534,18.82496,300314
4087,andrecp,2,0.00067,56536,18.82563,300314
4088,andreib1,2,0.00067,56538,18.82630,300314
4089,andrejbranch,2,0.00067,56540,18.82696,300314
4090,andrekiba,2,0.00067,56542,18.82763,300314
4091,andreshamedfernandez,2,0.00067,56544,18.82829,300314
4092,andre-taveira,2,0.00067,56546,18.82896,300314
4093,Andrewangeta,2,0.00067,56548,18.82962,300314
4094,andrewlock,2,0.00067,56550,18.83029,300314
4095,AndrewRissing,2,0.00067,56552,18.83096,300314
4096,andrewzah,2,0.00067,56554,18.83162,300314
4097,andrzejsolarwinds,2,0.00067,56556,18.83229,300314
4098,andylwelch,2,0.00067,56558,18.83295,300314
4099,AndyMender,2,0.00067,56560,18.83362,300314
4100,andy-paine,2,0.00067,56562,18.83429,300314
4101,angristan,2,0.00067,56564,18.83495,300314
4102,aniket202,2,0.00067,56566,18.83562,300314
4103,AnilKumarBandi27,2,0.00067,56568,18.83628,300314
4104,ankh6,2,0.00067,56570,18.83695,300314
4105,anmaxvl,2,0.00067,56572,18.83762,300314
4106,ansinlee,2,0.00067,56574,18.83828,300314
4107,anson627,2,0.00067,56576,18.83895,300314
4108,Anthonyzou,2,0.00067,56578,18.83961,300314
4109,anto-n,2,0.00067,56580,18.84028,300314
4110,AntonBlomstrom,2,0.00067,56582,18.84095,300314
4111,AntonDobshikov,2,0.00067,56584,18.84161,300314
4112,AntonioDan,2,0.00067,56586,18.84228,300314
4113,aperrot42,2,0.00067,56588,18.84294,300314
4114,apmcasai,2,0.00067,56590,18.84361,300314
4115,apurvabhandari,2,0.00067,56592,18.84428,300314
4116,arctouch-lauracarvalho,2,0.00067,56594,18.84494,300314
4117,arindas,2,0.00067,56596,18.84561,300314
4118,arjuncreativo,2,0.00067,56598,18.84627,300314
4119,arnaud-tincelin,2,0.00067,56600,18.84694,300314
4120,Artfire,2,0.00067,56602,18.84761,300314
4121,arunmat,2,0.00067,56604,18.84827,300314
4122,asaf1602,2,0.00067,56606,18.84894,300314
4123,asankov-cb,2,0.00067,56608,18.84960,300314
4124,ashishmiyapuram,2,0.00067,56610,18.85027,300314
4125,ashithwilson,2,0.00067,56612,18.85094,300314
4126,ash-man,2,0.00067,56614,18.85160,300314
4127,Ashtonian,2,0.00067,56616,18.85227,300314
4128,AshwiniSwain,2,0.00067,56618,18.85293,300314
4129,asipras,2,0.00067,56620,18.85360,300314
4130,aspanner,2,0.00067,56622,18.85427,300314
4131,astlock,2,0.00067,56624,18.85493,300314
4132,atenciom,2,0.00067,56626,18.85560,300314
4133,AthinaKyriakou,2,0.00067,56628,18.85626,300314
4134,atif1996,2,0.00067,56630,18.85693,300314
4135,atompi,2,0.00067,56632,18.85760,300314
4136,attachmentgenie,2,0.00067,56634,18.85826,300314
4137,aviorma,2,0.00067,56636,18.85893,300314
4138,awan1,2,0.00067,56638,18.85959,300314
4139,awreece,2,0.00067,56640,18.86026,300314
4140,aykutkardas,2,0.00067,56642,18.86093,300314
4141,aysylu,2,0.00067,56644,18.86159,300314
4142,ayushi-inno,2,0.00067,56646,18.86226,300314
4143,azizonick,2,0.00067,56648,18.86292,300314
4144,badsmoke,2,0.00067,56650,18.86359,300314
4145,bahamat,2,0.00067,56652,18.86426,300314
4146,bajosiaa,2,0.00067,56654,18.86492,300314
4147,baklpc,2,0.00067,56656,18.86559,300314
4148,balajivenkataraman,2,0.00067,56658,18.86625,300314
4149,bartusz01,2,0.00067,56660,18.86692,300314
4150,bbi8,2,0.00067,56662,18.86759,300314
4151,bbl,2,0.00067,56664,18.86825,300314
4152,bcouetil,2,0.00067,56666,18.86892,300314
4153,behrtam,2,0.00067,56668,18.86958,300314
4154,bellyhold,2,0.00067,56670,18.87025,300314
4155,belsakn,2,0.00067,56672,18.87092,300314
4156,benjyiw,2,0.00067,56674,18.87158,300314
4157,benridley,2,0.00067,56676,18.87225,300314
4158,BenS-Move,2,0.00067,56678,18.87291,300314
4159,bergner,2,0.00067,56680,18.87358,300314
4160,bethforsyth,2,0.00067,56682,18.87424,300314
4161,betonmoewe,2,0.00067,56684,18.87491,300314
4162,bforbis,2,0.00067,56686,18.87558,300314
4163,bharangit,2,0.00067,56688,18.87624,300314
4164,bhavith,2,0.00067,56690,18.87691,300314
4165,BhuvanB,2,0.00067,56692,18.87757,300314
4166,bidianqing,2,0.00067,56694,18.87824,300314
4167,billybraga,2,0.00067,56696,18.87891,300314
4168,billysegarloka,2,0.00067,56698,18.87957,300314
4169,bilzard,2,0.00067,56700,18.88024,300314
4170,birdiesanders,2,0.00067,56702,18.88090,300314
4171,bjartek,2,0.00067,56704,18.88157,300314
4172,bjtuchenmin,2,0.00067,56706,18.88224,300314
4173,bjung82,2,0.00067,56708,18.88290,300314
4174,bkanuka,2,0.00067,56710,18.88357,300314
4175,bkeelan,2,0.00067,56712,18.88423,300314
4176,bkumar73,2,0.00067,56714,18.88490,300314
4177,bliof-fc,2,0.00067,56716,18.88557,300314
4178,bluelurker,2,0.00067,56718,18.88623,300314
4179,BobinMathew,2,0.00067,56720,18.88690,300314
4180,bobrossthepainter,2,0.00067,56722,18.88756,300314
4181,bocajim,2,0.00067,56724,18.88823,300314
4182,bogdansandu,2,0.00067,56726,18.88890,300314
4183,bohrasd,2,0.00067,56728,18.88956,300314
4184,bokysan,2,0.00067,56730,18.89023,300314
4185,bonclay7,2,0.00067,56732,18.89089,300314
4186,bondif,2,0.00067,56734,18.89156,300314
4187,boonware,2,0.00067,56736,18.89223,300314
4188,bostjan,2,0.00067,56738,18.89289,300314
4189,bovy89,2,0.00067,56740,18.89356,300314
4190,boxidilshan,2,0.00067,56742,18.89422,300314
4191,bozzo,2,0.00067,56744,18.89489,300314
4192,bpmct,2,0.00067,56746,18.89556,300314
4193,bponi,2,0.00067,56748,18.89622,300314
4194,bradfrosty,2,0.00067,56750,18.89689,300314
4195,brandonaikey,2,0.00067,56752,18.89755,300314
4196,brandonganem,2,0.00067,56754,18.89822,300314
4197,breaksilence,2,0.00067,56756,18.89889,300314
4198,Brice187,2,0.00067,56758,18.89955,300314
4199,brokencode64,2,0.00067,56760,18.90022,300314
4200,brosev,2,0.00067,56762,18.90088,300314
4201,BryanDollery,2,0.00067,56764,18.90155,300314
4202,Bryce-huang,2,0.00067,56766,18.90222,300314
4203,bshh,2,0.00067,56768,18.90288,300314
4204,bugzyz,2,0.00067,56770,18.90355,300314
4205,Bujail,2,0.00067,56772,18.90421,300314
4206,bukowa,2,0.00067,56774,18.90488,300314
4207,Burt-L,2,0.00067,56776,18.90555,300314
4208,buzzdan,2,0.00067,56778,18.90621,300314
4209,caddac,2,0.00067,56780,18.90688,300314
4210,cahityusuf,2,0.00067,56782,18.90754,300314
4211,cailiang9,2,0.00067,56784,18.90821,300314
4212,caiwc,2,0.00067,56786,18.90888,300314
4213,calegari-adriano,2,0.00067,56788,18.90954,300314
4214,cal-pratt,2,0.00067,56790,18.91021,300314
4215,calvinpark,2,0.00067,56792,18.91087,300314
4216,caoyang001,2,0.00067,56794,18.91154,300314
4217,caoyukun0430,2,0.00067,56796,18.91221,300314
4218,capacman,2,0.00067,56798,18.91287,300314
4219,CarloGarcia,2,0.00067,56800,18.91354,300314
4220,carlosalca,2,0.00067,56802,18.91420,300314
4221,carloscao0928,2,0.00067,56804,18.91487,300314
4222,Caroga,2,0.00067,56806,18.91554,300314
4223,carrieyang1212,2,0.00067,56808,18.91620,300314
4224,casperisfine,2,0.00067,56810,18.91687,300314
4225,cawilliamson,2,0.00067,56812,18.91753,300314
4226,cbcoutinho,2,0.00067,56814,18.91820,300314
4227,cboothe,2,0.00067,56816,18.91886,300314
4228,cbrand,2,0.00067,56818,18.91953,300314
4229,cdbesten,2,0.00067,56820,18.92020,300314
4230,cdmetcalf,2,0.00067,56822,18.92086,300314
4231,cdobinsky,2,0.00067,56824,18.92153,300314
4232,cdyue,2,0.00067,56826,18.92219,300314
4233,cebald,2,0.00067,56828,18.92286,300314
4234,centromere,2,0.00067,56830,18.92353,300314
4235,cfz,2,0.00067,56832,18.92419,300314
4236,chaholl,2,0.00067,56834,18.92486,300314
4237,ChampionZP,2,0.00067,56836,18.92552,300314
4238,ChampiYann,2,0.00067,56838,18.92619,300314
4239,Chandandhani,2,0.00067,56840,18.92686,300314
4240,ChanSays,2,0.00067,56842,18.92752,300314
4241,charlesgreen,2,0.00067,56844,18.92819,300314
4242,charlesxu2000,2,0.00067,56846,18.92885,300314
4243,chenlrambus,2,0.00067,56848,18.92952,300314
4244,chenyg0911,2,0.00067,56850,18.93019,300314
4245,cheslijones,2,0.00067,56852,18.93085,300314
4246,chetanrz,2,0.00067,56854,18.93152,300314
4247,chienfuchen32,2,0.00067,56856,18.93218,300314
4248,chmielas,2,0.00067,56858,18.93285,300314
4249,chrisahl,2,0.00067,56860,18.93352,300314
4250,chrishyc,2,0.00067,56862,18.93418,300314
4251,chrisjwhiteley,2,0.00067,56864,18.93485,300314
4252,ChristianKlass,2,0.00067,56866,18.93551,300314
4253,christinajochum,2,0.00067,56868,18.93618,300314
4254,ciuffoly,2,0.00067,56870,18.93685,300314
4255,Cjcascade,2,0.00067,56872,18.93751,300314
4256,cjcox17,2,0.00067,56874,18.93818,300314
4257,cjyyb,2,0.00067,56876,18.93884,300314
4258,ckahi,2,0.00067,56878,18.93951,300314
4259,clarkdoan,2,0.00067,56880,18.94018,300314
4260,clh-cod,2,0.00067,56882,18.94084,300314
4261,cmacrae,2,0.00067,56884,18.94151,300314
4262,cmanzur,2,0.00067,56886,18.94217,300314
4263,cmartinez85,2,0.00067,56888,18.94284,300314
4264,cmcarthur,2,0.00067,56890,18.94351,300314
4265,cnwaldron,2,0.00067,56892,18.94417,300314
4266,coadler,2,0.00067,56894,18.94484,300314
4267,code1305,2,0.00067,56896,18.94550,300314
4268,code-merc,2,0.00067,56898,18.94617,300314
4269,codescale,2,0.00067,56900,18.94684,300314
4270,coldfire84,2,0.00067,56902,18.94750,300314
4271,colloquepourlapaix,2,0.00067,56904,18.94817,300314
4272,compnerd,2,0.00067,56906,18.94883,300314
4273,CondormanFr,2,0.00067,56908,18.94950,300314
4274,Confusingboat,2,0.00067,56910,18.95017,300314
4275,contrun,2,0.00067,56912,18.95083,300314
4276,ConverJens,2,0.00067,56914,18.95150,300314
4277,conwayok,2,0.00067,56916,18.95216,300314
4278,corani,2,0.00067,56918,18.95283,300314
4279,Corgi-Google,2,0.00067,56920,18.95350,300314
4280,corhere,2,0.00067,56922,18.95416,300314
4281,CosmoMyzrailGorynych,2,0.00067,56924,18.95483,300314
4282,couldntcatchthebus,2,0.00067,56926,18.95549,300314
4283,cpmoore,2,0.00067,56928,18.95616,300314
4284,cranzy,2,0.00067,56930,18.95683,300314
4285,Creator1024,2,0.00067,56932,18.95749,300314
4286,creydr,2,0.00067,56934,18.95816,300314
4287,crileroro,2,0.00067,56936,18.95882,300314
4288,cseufert,2,0.00067,56938,18.95949,300314
4289,ctolon22,2,0.00067,56940,18.96016,300314
4290,cujo,2,0.00067,56942,18.96082,300314
4291,cumirror,2,0.00067,56944,18.96149,300314
4292,curioustolearn,2,0.00067,56946,18.96215,300314
4293,cxuu,2,0.00067,56948,18.96282,300314
4294,Cyral,2,0.00067,56950,18.96348,300314
4295,d47zm3,2,0.00067,56952,18.96415,300314
4296,da-edra,2,0.00067,56954,18.96482,300314
4297,daemon1024,2,0.00067,56956,18.96548,300314
4298,daFritz84,2,0.00067,56958,18.96615,300314
4299,dahoum,2,0.00067,56960,18.96681,300314
4300,dalew75,2,0.00067,56962,18.96748,300314
4301,danaucpe,2,0.00067,56964,18.96815,300314
4302,dancronintix,2,0.00067,56966,18.96881,300314
4303,DanielBatteryStapler,2,0.00067,56968,18.96948,300314
4304,danielgrist,2,0.00067,56970,18.97014,300314
4305,DanielHabenicht,2,0.00067,56972,18.97081,300314
4306,danielyaa5,2,0.00067,56974,18.97148,300314
4307,daninthewoods,2,0.00067,56976,18.97214,300314
4308,DanPhonovation,2,0.00067,56978,18.97281,300314
4309,DanWiseProgramming,2,0.00067,56980,18.97347,300314
4310,dapiaoke2021,2,0.00067,56982,18.97414,300314
4311,Darshnadas,2,0.00067,56984,18.97481,300314
4312,dashjay,2,0.00067,56986,18.97547,300314
4313,dav3ydoo,2,0.00067,56988,18.97614,300314
4314,daveabrock,2,0.00067,56990,18.97680,300314
4315,davegarvey,2,0.00067,56992,18.97747,300314
4316,davehayes,2,0.00067,56994,18.97814,300314
4317,davejhahn,2,0.00067,56996,18.97880,300314
4318,DavidBadura,2,0.00067,56998,18.97947,300314
4319,davidbnk,2,0.00067,57000,18.98013,300314
4320,davidboybob,2,0.00067,57002,18.98080,300314
4321,davidmateos,2,0.00067,57004,18.98147,300314
4322,davidmorley,2,0.00067,57006,18.98213,300314
4323,davidpickup,2,0.00067,57008,18.98280,300314
4324,davidqhr,2,0.00067,57010,18.98346,300314
4325,Davidrjx,2,0.00067,57012,18.98413,300314
4326,davidshtian,2,0.00067,57014,18.98480,300314
4327,davidstrauss,2,0.00067,57016,18.98546,300314
4328,david-yu,2,0.00067,57018,18.98613,300314
4329,dbaltor,2,0.00067,57020,18.98679,300314
4330,dberkov,2,0.00067,57022,18.98746,300314
4331,dbingham,2,0.00067,57024,18.98813,300314
4332,dboshardy,2,0.00067,57026,18.98879,300314
4333,dcrty90,2,0.00067,57028,18.98946,300314
4334,dcwbq,2,0.00067,57030,18.99012,300314
4335,dearchap,2,0.00067,57032,18.99079,300314
4336,deeghuge,2,0.00067,57034,18.99146,300314
4337,deeluk,2,0.00067,57036,18.99212,300314
4338,deepk2u,2,0.00067,57038,18.99279,300314
4339,deesejohn,2,0.00067,57040,18.99345,300314
4340,dekim,2,0.00067,57042,18.99412,300314
4341,DerekFoulk,2,0.00067,57044,18.99479,300314
4342,derekrprice,2,0.00067,57046,18.99545,300314
4343,derTobsch,2,0.00067,57048,18.99612,300314
4344,destanyinside,2,0.00067,57050,18.99678,300314
4345,Dev25,2,0.00067,57052,18.99745,300314
4346,devfreddy,2,0.00067,57054,18.99812,300314
4347,devincd,2,0.00067,57056,18.99878,300314
4348,devjoes,2,0.00067,57058,18.99945,300314
4349,dfl-erik,2,0.00067,57060,19.00011,300314
4350,dgeorgievski,2,0.00067,57062,19.00078,300314
4351,DgoNascimento,2,0.00067,57064,19.00145,300314
4352,dgsardina,2,0.00067,57066,19.00211,300314
4353,dguendisch,2,0.00067,57068,19.00278,300314
4354,dhaiducek,2,0.00067,57070,19.00344,300314
4355,DhairyaBahl,2,0.00067,57072,19.00411,300314
4356,dharmendrakariya,2,0.00067,57074,19.00478,300314
4357,dicolasi,2,0.00067,57076,19.00544,300314
4358,DiegoLelis,2,0.00067,57078,19.00611,300314
4359,diegonat,2,0.00067,57080,19.00677,300314
4360,diegosalvi,2,0.00067,57082,19.00744,300314
4361,Dieken,2,0.00067,57084,19.00810,300314
4362,difrost,2,0.00067,57086,19.00877,300314
4363,Dimigergo,2,0.00067,57088,19.00944,300314
4364,DiniMad,2,0.00067,57090,19.01010,300314
4365,DiogoMCampos,2,0.00067,57092,19.01077,300314
4366,dionysius,2,0.00067,57094,19.01143,300314
4367,dirien,2,0.00067,57096,19.01210,300314
4368,djfinnoy,2,0.00067,57098,19.01277,300314
4369,dkimdon,2,0.00067,57100,19.01343,300314
4370,dlandis,2,0.00067,57102,19.01410,300314
4371,dmndru,2,0.00067,57104,19.01476,300314
4372,dnaranjor,2,0.00067,57106,19.01543,300314
4373,dnate-ifs,2,0.00067,57108,19.01610,300314
4374,DocX,2,0.00067,57110,19.01676,300314
4375,dodwmd,2,0.00067,57112,19.01743,300314
4376,donatelloOo,2,0.00067,57114,19.01809,300314
4377,dorroddorrod,2,0.00067,57116,19.01876,300314
4378,dorr-vonage,2,0.00067,57118,19.01943,300314
4379,dosten,2,0.00067,57120,19.02009,300314
4380,doubleyewdee,2,0.00067,57122,19.02076,300314
4381,dpalmeira,2,0.00067,57124,19.02142,300314
4382,dpwrussell,2,0.00067,57126,19.02209,300314
4383,DR9885,2,0.00067,57128,19.02276,300314
4384,DrackThor,2,0.00067,57130,19.02342,300314
4385,dragon2611,2,0.00067,57132,19.02409,300314
4386,dragonchaser,2,0.00067,57134,19.02475,300314
4387,dragoneena12,2,0.00067,57136,19.02542,300314
4388,drewfisher314,2,0.00067,57138,19.02609,300314
4389,drewz-aware,2,0.00067,57140,19.02675,300314
4390,DrewZhang13,2,0.00067,57142,19.02742,300314
4391,drexler,2,0.00067,57144,19.02808,300314
4392,driosalido,2,0.00067,57146,19.02875,300314
4393,DrMcTaco,2,0.00067,57148,19.02942,300314
4394,dsalisbury,2,0.00067,57150,19.03008,300314
4395,dudilugasi,2,0.00067,57152,19.03075,300314
4396,dwbrown2,2,0.00067,57154,19.03141,300314
4397,dwrip,2,0.00067,57156,19.03208,300314
4398,dxh9845,2,0.00067,57158,19.03275,300314
4399,dy009,2,0.00067,57160,19.03341,300314
4400,echupriyanov,2,0.00067,57162,19.03408,300314
4401,EdGue42,2,0.00067,57164,19.03474,300314
4402,EdKingscote,2,0.00067,57166,19.03541,300314
4403,edmv-everis,2,0.00067,57168,19.03608,300314
4404,edouardb,2,0.00067,57170,19.03674,300314
4405,EduardMaghakyan,2,0.00067,57172,19.03741,300314
4406,eduardocp,2,0.00067,57174,19.03807,300314
4407,eeijlar,2,0.00067,57176,19.03874,300314
4408,egodigitus,2,0.00067,57178,19.03941,300314
4409,egoroof,2,0.00067,57180,19.04007,300314
4410,ehlo550,2,0.00067,57182,19.04074,300314
4411,eilonmonday,2,0.00067,57184,19.04140,300314
4412,ekj1711,2,0.00067,57186,19.04207,300314
4413,ekrucio,2,0.00067,57188,19.04274,300314
4414,elanv,2,0.00067,57190,19.04340,300314
4415,ElectricVampire,2,0.00067,57192,19.04407,300314
4416,elenz97,2,0.00067,57194,19.04473,300314
4417,elessar-ch,2,0.00067,57196,19.04540,300314
4418,elkbullwinkle,2,0.00067,57198,19.04607,300314
4419,elkh510,2,0.00067,57200,19.04673,300314
4420,elsbrock,2,0.00067,57202,19.04740,300314
4421,emike922,2,0.00067,57204,19.04806,300314
4422,emirisman,2,0.00067,57206,19.04873,300314
4423,eoswald,2,0.00067,57208,19.04939,300314
4424,EraYaN,2,0.00067,57210,19.05006,300314
4425,ErezYalon,2,0.00067,57212,19.05073,300314
4426,ericjohansson89,2,0.00067,57214,19.05139,300314
4427,ericmagna,2,0.00067,57216,19.05206,300314
4428,erkist,2,0.00067,57218,19.05272,300314
4429,eryugey,2,0.00067,57220,19.05339,300314
4430,esakat,2,0.00067,57222,19.05406,300314
4431,evandrix,2,0.00067,57224,19.05472,300314
4432,Eweol,2,0.00067,57226,19.05539,300314
4433,exi,2,0.00067,57228,19.05605,300314
4434,ezamriy,2,0.00067,57230,19.05672,300314
4435,f2calv,2,0.00067,57232,19.05739,300314
4436,f4t,2,0.00067,57234,19.05805,300314
4437,FabianCretton,2,0.00067,57236,19.05872,300314
4438,fabiendelpierre,2,0.00067,57238,19.05938,300314
4439,fabiojapa,2,0.00067,57240,19.06005,300314
4440,fabricev,2,0.00067,57242,19.06072,300314
4441,faceair,2,0.00067,57244,19.06138,300314
4442,faec,2,0.00067,57246,19.06205,300314
4443,failytaler,2,0.00067,57248,19.06271,300314
4444,falahatiali,2,0.00067,57250,19.06338,300314
4445,falterfriday,2,0.00067,57252,19.06405,300314
4446,farhan5900,2,0.00067,57254,19.06471,300314
4447,faust64,2,0.00067,57256,19.06538,300314
4448,fbridger,2,0.00067,57258,19.06604,300314
4449,fcanovai,2,0.00067,57260,19.06671,300314
4450,fcoquelet,2,0.00067,57262,19.06738,300314
4451,fdamstra,2,0.00067,57264,19.06804,300314
4452,fduran,2,0.00067,57266,19.06871,300314
4453,feature-id,2,0.00067,57268,19.06937,300314
4454,FedericoAntoniazzi,2,0.00067,57270,19.07004,300314
4455,FeliciaXmL,2,0.00067,57272,19.07071,300314
4456,felschr,2,0.00067,57274,19.07137,300314
4457,fernandoanael,2,0.00067,57276,19.07204,300314
4458,fgendc,2,0.00067,57278,19.07270,300314
4459,finalspy,2,0.00067,57280,19.07337,300314
4460,fkoehler,2,0.00067,57282,19.07404,300314
4461,fkpwolf,2,0.00067,57284,19.07470,300314
4462,fl0wm0ti0n,2,0.00067,57286,19.07537,300314
4463,Flasheh,2,0.00067,57288,19.07603,300314
4464,fld-opensource,2,0.00067,57290,19.07670,300314
4465,flf2ko,2,0.00067,57292,19.07737,300314
4466,floriankammermann,2,0.00067,57294,19.07803,300314
4467,flozzone,2,0.00067,57296,19.07870,300314
4468,fmontaldo87,2,0.00067,57298,19.07936,300314
4469,Folyd,2,0.00067,57300,19.08003,300314
4470,fomin-zhu,2,0.00067,57302,19.08070,300314
4471,ForsakenHarmony,2,0.00067,57304,19.08136,300314
4472,FrankAtHexagon,2,0.00067,57306,19.08203,300314
4473,frans42,2,0.00067,57308,19.08269,300314
4474,frcai,2,0.00067,57310,19.08336,300314
4475,freehck-codefresh,2,0.00067,57312,19.08403,300314
4476,FreeLoopC,2,0.00067,57314,19.08469,300314
4477,freeznet,2,0.00067,57316,19.08536,300314
4478,Freshwood,2,0.00067,57318,19.08602,300314
4479,fridim,2,0.00067,57320,19.08669,300314
4480,friedrich-brunzema,2,0.00067,57322,19.08736,300314
4481,fshadid96,2,0.00067,57324,19.08802,300314
4482,fuine6,2,0.00067,57326,19.08869,300314
4483,furesoft,2,0.00067,57328,19.08935,300314
4484,fvillain,2,0.00067,57330,19.09002,300314
4485,fvogl,2,0.00067,57332,19.09069,300314
4486,fyudelgado,2,0.00067,57334,19.09135,300314
4487,FZambia,2,0.00067,57336,19.09202,300314
4488,fzyzcjy,2,0.00067,57338,19.09268,300314
4489,garrying,2,0.00067,57340,19.09335,300314
4490,gauravAggrhari,2,0.00067,57342,19.09401,300314
4491,gauravmeena83,2,0.00067,57344,19.09468,300314
4492,gccio,2,0.00067,57346,19.09535,300314
4493,gcxfd,2,0.00067,57348,19.09601,300314
4494,Gdewilde,2,0.00067,57350,19.09668,300314
4495,gdiet,2,0.00067,57352,19.09734,300314
4496,gearnode,2,0.00067,57354,19.09801,300314
4497,g-easy,2,0.00067,57356,19.09868,300314
4498,generatz,2,0.00067,57358,19.09934,300314
4499,gengwg,2,0.00067,57360,19.10001,300314
4500,geoff-coppertop,2,0.00067,57362,19.10067,300314
4501,geo-matheou,2,0.00067,57364,19.10134,300314
4502,geotransformer,2,0.00067,57366,19.10201,300314
4503,gfiasco,2,0.00067,57368,19.10267,300314
4504,ggerrit,2,0.00067,57370,19.10334,300314
4505,ghevge,2,0.00067,57372,19.10400,300314
4506,gionapaolini,2,0.00067,57374,19.10467,300314
4507,GiottoLee,2,0.00067,57376,19.10534,300314
4508,girishgrover2008,2,0.00067,57378,19.10600,300314
4509,giri-varma,2,0.00067,57380,19.10667,300314
4510,githubUser-k8,2,0.00067,57382,19.10733,300314
4511,gitkent,2,0.00067,57384,19.10800,300314
4512,gitromba,2,0.00067,57386,19.10867,300314
4513,gladiatr72,2,0.00067,57388,19.10933,300314
4514,glennpratt,2,0.00067,57390,19.11000,300314
4515,g-linville,2,0.00067,57392,19.11066,300314
4516,Glitchfix,2,0.00067,57394,19.11133,300314
4517,gngeorgiev,2,0.00067,57396,19.11200,300314
4518,gogovan-vincentngai,2,0.00067,57398,19.11266,300314
4519,goldenpine,2,0.00067,57400,19.11333,300314
4520,GolubevV,2,0.00067,57402,19.11399,300314
4521,gordonyoon,2,0.00067,57404,19.11466,300314
4522,goyalmohit,2,0.00067,57406,19.11533,300314
4523,graciborski,2,0.00067,57408,19.11599,300314
4524,gravufo,2,0.00067,57410,19.11666,300314
4525,grawlinson,2,0.00067,57412,19.11732,300314
4526,graywolf-at-work,2,0.00067,57414,19.11799,300314
4527,greglanthier,2,0.00067,57416,19.11866,300314
4528,greijal18,2,0.00067,57418,19.11932,300314
4529,grifx,2,0.00067,57420,19.11999,300314
4530,gruppferi,2,0.00067,57422,19.12065,300314
4531,gsdevme,2,0.00067,57424,19.12132,300314
4532,gtolarc,2,0.00067,57426,19.12199,300314
4533,guanchaoli,2,0.00067,57428,19.12265,300314
4534,guibrazlima,2,0.00067,57430,19.12332,300314
4535,guidao,2,0.00067,57432,19.12398,300314
4536,Guillermogsjc,2,0.00067,57434,19.12465,300314
4537,guojing013214,2,0.00067,57436,19.12532,300314
4538,gurdeepsira,2,0.00067,57438,19.12598,300314
4539,Gvg14u147,2,0.00067,57440,19.12665,300314
4540,GwynethLlewelyn,2,0.00067,57442,19.12731,300314
4541,gxthrj,2,0.00067,57444,19.12798,300314
4542,gyoza,2,0.00067,57446,19.12865,300314
4543,gzhhong,2,0.00067,57448,19.12931,300314
4544,haf-tech,2,0.00067,57450,19.12998,300314
4545,hagaiovadia,2,0.00067,57452,19.13064,300314
4546,hagenhandtke,2,0.00067,57454,19.13131,300314
4547,hairongGao,2,0.00067,57456,19.13198,300314
4548,HallsHolicker,2,0.00067,57458,19.13264,300314
4549,hangsucho,2,0.00067,57460,19.13331,300314
4550,hanoisteve,2,0.00067,57462,19.13397,300314
4551,hansanghoon,2,0.00067,57464,19.13464,300314
4552,hanzala1234,2,0.00067,57466,19.13531,300314
4553,hanzo,2,0.00067,57468,19.13597,300314
4554,haraldng,2,0.00067,57470,19.13664,300314
4555,harekal7,2,0.00067,57472,19.13730,300314
4556,harrisa1,2,0.00067,57474,19.13797,300314
4557,harrisonchu,2,0.00067,57476,19.13863,300314
4558,Harrysk,2,0.00067,57478,19.13930,300314
4559,harshaperera532,2,0.00067,57480,19.13997,300314
4560,Harshita-Kanal,2,0.00067,57482,19.14063,300314
4561,hasanhaja,2,0.00067,57484,19.14130,300314
4562,hasonhai,2,0.00067,57486,19.14196,300314
4563,hatharom,2,0.00067,57488,19.14263,300314
4564,hbrls,2,0.00067,57490,19.14330,300314
4565,hdlife007,2,0.00067,57492,19.14396,300314
4566,hdp617,2,0.00067,57494,19.14463,300314
4567,hect1995,2,0.00067,57496,19.14529,300314
4568,helenosheaa,2,0.00067,57498,19.14596,300314
4569,Hello-Linux,2,0.00067,57500,19.14663,300314
4570,HEllRZA,2,0.00067,57502,19.14729,300314
4571,hemantdindi,2,0.00067,57504,19.14796,300314
4572,henrikb123,2,0.00067,57506,19.14862,300314
4573,henryzhangsta,2,0.00067,57508,19.14929,300314
4574,hequ,2,0.00067,57510,19.14996,300314
4575,herbertgoto,2,0.00067,57512,19.15062,300314
4576,hermanhobnob,2,0.00067,57514,19.15129,300314
4577,heshengyuan1311,2,0.00067,57516,19.15195,300314
4578,hetii,2,0.00067,57518,19.15262,300314
4579,heungh,2,0.00067,57520,19.15329,300314
4580,heyc-iot-chinamobile,2,0.00067,57522,19.15395,300314
4581,hgautam,2,0.00067,57524,19.15462,300314
4582,hidu,2,0.00067,57526,19.15528,300314
4583,hienha,2,0.00067,57528,19.15595,300314
4584,hienle-ntt,2,0.00067,57530,19.15662,300314
4585,hijerusalem,2,0.00067,57532,19.15728,300314
4586,hintofbasil,2,0.00067,57534,19.15795,300314
4587,hlee5zebra,2,0.00067,57536,19.15861,300314
4588,hmojicag,2,0.00067,57538,19.15928,300314
4589,HongliBu,2,0.00067,57540,19.15995,300314
4590,hongli-my,2,0.00067,57542,19.16061,300314
4591,HontoNoRoger,2,0.00067,57544,19.16128,300314
4592,hooksie1,2,0.00067,57546,19.16194,300314
4593,hopik007,2,0.00067,57548,19.16261,300314
4594,Horkyze,2,0.00067,57550,19.16328,300314
4595,hot3eed,2,0.00067,57552,19.16394,300314
4596,hotpothot,2,0.00067,57554,19.16461,300314
4597,houshym,2,0.00067,57556,19.16527,300314
4598,houstonheat,2,0.00067,57558,19.16594,300314
4599,hrezilo,2,0.00067,57560,19.16661,300314
4600,httaotao,2,0.00067,57562,19.16727,300314
4601,huan,2,0.00067,57564,19.16794,300314
4602,huanggx-sea,2,0.00067,57566,19.16860,300314
4603,hubwoop,2,0.00067,57568,19.16927,300314
4604,hullarb,2,0.00067,57570,19.16994,300314
4605,hungptit,2,0.00067,57572,19.17060,300314
4606,hunsche,2,0.00067,57574,19.17127,300314
4607,Hunter-Thompson,2,0.00067,57576,19.17193,300314
4608,huornlmj,2,0.00067,57578,19.17260,300314
4609,husky-parul,2,0.00067,57580,19.17327,300314
4610,hussainsaify,2,0.00067,57582,19.17393,300314
4611,hypnobear33,2,0.00067,57584,19.17460,300314
4612,iamish,2,0.00067,57586,19.17526,300314
4613,Iamleos,2,0.00067,57588,19.17593,300314
4614,ianonavy,2,0.00067,57590,19.17660,300314
4615,Icedroid,2,0.00067,57592,19.17726,300314
4616,Id2ndR,2,0.00067,57594,19.17793,300314
4617,idealtech-i3dlabs,2,0.00067,57596,19.17859,300314
4618,idobry,2,0.00067,57598,19.17926,300314
4619,ido-namely,2,0.00067,57600,19.17993,300314
4620,iflamed,2,0.00067,57602,19.18059,300314
4621,iH8c0ff33,2,0.00067,57604,19.18126,300314
4622,Ihjaz,2,0.00067,57606,19.18192,300314
4623,ijajmulani,2,0.00067,57608,19.18259,300314
4624,IJustWorkHere,2,0.00067,57610,19.18325,300314
4625,ikogan,2,0.00067,57612,19.18392,300314
4626,ilhaan,2,0.00067,57614,19.18459,300314
4627,IlllIIIIlIIllIl,2,0.00067,57616,19.18525,300314
4628,imdhruva,2,0.00067,57618,19.18592,300314
4629,imesic-kolibree,2,0.00067,57620,19.18658,300314
4630,immanetize,2,0.00067,57622,19.18725,300314
4631,Imunhatep,2,0.00067,57624,19.18792,300314
4632,inboxamitraj,2,0.00067,57626,19.18858,300314
4633,infa-kparida,2,0.00067,57628,19.18925,300314
4634,inikulshin,2,0.00067,57630,19.18991,300314
4635,inspur-wyd,2,0.00067,57632,19.19058,300314
4636,invent-lwj,2,0.00067,57634,19.19125,300314
4637,is6769,2,0.00067,57636,19.19191,300314
4638,ishaan-rd,2,0.00067,57638,19.19258,300314
4639,ishan16696,2,0.00067,57640,19.19324,300314
4640,IshaqIdris,2,0.00067,57642,19.19391,300314
4641,IskandarNabiev,2,0.00067,57644,19.19458,300314
4642,isma3ilovich,2,0.00067,57646,19.19524,300314
4643,itai-codefresh,2,0.00067,57648,19.19591,300314
4644,itay,2,0.00067,57650,19.19657,300314
4645,itkq,2,0.00067,57652,19.19724,300314
4646,jack-evans,2,0.00067,57654,19.19791,300314
4647,jacky15,2,0.00067,57656,19.19857,300314
4648,jacobhagstedt,2,0.00067,57658,19.19924,300314
4649,jadelafuente,2,0.00067,57660,19.19990,300314
4650,jaekunchoi,2,0.00067,57662,19.20057,300314
4651,jagodzinska,2,0.00067,57664,19.20124,300314
4652,jakobsvenning,2,0.00067,57666,19.20190,300314
4653,jamesalucas,2,0.00067,57668,19.20257,300314
4654,james-m-henderson,2,0.00067,57670,19.20323,300314
4655,JarnoRFB,2,0.00067,57672,19.20390,300314
4656,jason8399,2,0.00067,57674,19.20457,300314
4657,jasondamour,2,0.00067,57676,19.20523,300314
4658,jasonstack,2,0.00067,57678,19.20590,300314
4659,jason-truter,2,0.00067,57680,19.20656,300314
4660,JasonTruter,2,0.00067,57682,19.20723,300314
4661,jasper-d,2,0.00067,57684,19.20790,300314
4662,jatan28,2,0.00067,57686,19.20856,300314
4663,jattgurpreet,2,0.00067,57688,19.20923,300314
4664,jayaddison,2,0.00067,57690,19.20989,300314
4665,jayanmn,2,0.00067,57692,19.21056,300314
4666,jbonafide623,2,0.00067,57694,19.21123,300314
4667,jbotelho2-bb,2,0.00067,57696,19.21189,300314
4668,jbury,2,0.00067,57698,19.21256,300314
4669,Jc2k,2,0.00067,57700,19.21322,300314
4670,jcambronero,2,0.00067,57702,19.21389,300314
4671,jchen45,2,0.00067,57704,19.21456,300314
4672,jcrsilva,2,0.00067,57706,19.21522,300314
4673,jebter,2,0.00067,57708,19.21589,300314
4674,jeevanm87,2,0.00067,57710,19.21655,300314
4675,jefflaifu,2,0.00067,57712,19.21722,300314
4676,Jeff-Rowell,2,0.00067,57714,19.21789,300314
4677,jejb,2,0.00067,57716,19.21855,300314
4678,jendrikjoe,2,0.00067,57718,19.21922,300314
4679,jeremyzahner,2,0.00067,57720,19.21988,300314
4680,jerinrathnam,2,0.00067,57722,19.22055,300314
4681,JeroenVanOort,2,0.00067,57724,19.22122,300314
4682,jessebond2,2,0.00067,57726,19.22188,300314
4683,jethrogb,2,0.00067,57728,19.22255,300314
4684,jfiedler,2,0.00067,57730,19.22321,300314
4685,jgargallo-air,2,0.00067,57732,19.22388,300314
4686,jgoeres,2,0.00067,57734,19.22454,300314
4687,jgregmac,2,0.00067,57736,19.22521,300314
4688,JGuille,2,0.00067,57738,19.22588,300314
4689,jherman3,2,0.00067,57740,19.22654,300314
4690,jhrv,2,0.00067,57742,19.22721,300314
4691,Jiajing-Hu,2,0.00067,57744,19.22787,300314
4692,jiangliu,2,0.00067,57746,19.22854,300314
4693,jiangxianliang007,2,0.00067,57748,19.22921,300314
4694,jiapeish,2,0.00067,57750,19.22987,300314
4695,jiarongxu1,2,0.00067,57752,19.23054,300314
4696,jidalong,2,0.00067,57754,19.23120,300314
4697,jimmy0,2,0.00067,57756,19.23187,300314
4698,Jimmyd84,2,0.00067,57758,19.23254,300314
4699,jinjiaw,2,0.00067,57760,19.23320,300314
4700,jiping-s,2,0.00067,57762,19.23387,300314
4701,jkagarise,2,0.00067,57764,19.23453,300314
4702,jkaldon,2,0.00067,57766,19.23520,300314
4703,jkupferer,2,0.00067,57768,19.23587,300314
4704,jlevensalor,2,0.00067,57770,19.23653,300314
4705,jm1223kim,2,0.00067,57772,19.23720,300314
4706,jmarhee,2,0.00067,57774,19.23786,300314
4707,jmguzik,2,0.00067,57776,19.23853,300314
4708,jmorcar,2,0.00067,57778,19.23920,300314
4709,jnunham,2,0.00067,57780,19.23986,300314
4710,joaovitor,2,0.00067,57782,19.24053,300314
4711,jobenvil,2,0.00067,57784,19.24119,300314
4712,joblo2021,2,0.00067,57786,19.24186,300314
4713,joelthompson,2,0.00067,57788,19.24253,300314
4714,joeykhashab,2,0.00067,57790,19.24319,300314
4715,JohanElmis,2,0.00067,57792,19.24386,300314
4716,JohannesOlsson,2,0.00067,57794,19.24452,300314
4717,johnjamie,2,0.00067,57796,19.24519,300314
4718,johnseekins,2,0.00067,57798,19.24586,300314
4719,johnsimcall,2,0.00067,57800,19.24652,300314
4720,johny-mnemonic,2,0.00067,57802,19.24719,300314
4721,jokerZhou,2,0.00067,57804,19.24785,300314
4722,jomenxiao,2,0.00067,57806,19.24852,300314
4723,jomyemmanuel,2,0.00067,57808,19.24919,300314
4724,jonathanalvares9009,2,0.00067,57810,19.24985,300314
4725,JonZeolla,2,0.00067,57812,19.25052,300314
4726,JoonasSa,2,0.00067,57814,19.25118,300314
4727,JorisEdia,2,0.00067,57816,19.25185,300314
4728,joschi36,2,0.00067,57818,19.25252,300314
4729,jose-ledesma,2,0.00067,57820,19.25318,300314
4730,josephmcgovern-wf,2,0.00067,57822,19.25385,300314
4731,joshpollara,2,0.00067,57824,19.25451,300314
4732,joshua-barnett,2,0.00067,57826,19.25518,300314
4733,joshuafc,2,0.00067,57828,19.25585,300314
4734,JoshuaJackson-jobvite,2,0.00067,57830,19.25651,300314
4735,joshuamataaraya,2,0.00067,57832,19.25718,300314
4736,joshuastagner,2,0.00067,57834,19.25784,300314
4737,jot-hub,2,0.00067,57836,19.25851,300314
4738,joyliu-q,2,0.00067,57838,19.25918,300314
4739,jp-gouin,2,0.00067,57840,19.25984,300314
4740,jrab66,2,0.00067,57842,19.26051,300314
4741,JRaver,2,0.00067,57844,19.26117,300314
4742,jrcasso,2,0.00067,57846,19.26184,300314
4743,js8080,2,0.00067,57848,19.26251,300314
4744,jscode017,2,0.00067,57850,19.26317,300314
4745,jseba,2,0.00067,57852,19.26384,300314
4746,jt185133,2,0.00067,57854,19.26450,300314
4747,jthiatt,2,0.00067,57856,19.26517,300314
4748,jtprom,2,0.00067,57858,19.26584,300314
4749,juanpmarin,2,0.00067,57860,19.26650,300314
4750,juanvasquezreyes,2,0.00067,57862,19.26717,300314
4751,JukkaKeisala,2,0.00067,57864,19.26783,300314
4752,julianocosta89,2,0.00067,57866,19.26850,300314
4753,jumpeiMano,2,0.00067,57868,19.26916,300314
4754,junDD,2,0.00067,57870,19.26983,300314
4755,jurgen-weber-deltatre,2,0.00067,57872,19.27050,300314
4756,justinas-b,2,0.00067,57874,19.27116,300314
4757,jvassev,2,0.00067,57876,19.27183,300314
4758,jvilhuber,2,0.00067,57878,19.27249,300314
4759,jvns,2,0.00067,57880,19.27316,300314
4760,jvolkman,2,0.00067,57882,19.27383,300314
4761,jwangyangls,2,0.00067,57884,19.27449,300314
4762,JWilh,2,0.00067,57886,19.27516,300314
4763,jwitko,2,0.00067,57888,19.27582,300314
4764,Ka0o0,2,0.00067,57890,19.27649,300314
4765,KaiReichart,2,0.00067,57892,19.27716,300314
4766,kaivalya-d,2,0.00067,57894,19.27782,300314
4767,kakarotbyte,2,0.00067,57896,19.27849,300314
4768,kamuops,2,0.00067,57898,19.27915,300314
4769,kannanvr,2,0.00067,57900,19.27982,300314
4770,kaparwan,2,0.00067,57902,19.28049,300314
4771,karamba-brgs,2,0.00067,57904,19.28115,300314
4772,karimiehsan90,2,0.00067,57906,19.28182,300314
4773,karthicgit,2,0.00067,57908,19.28248,300314
4774,Kavuti,2,0.00067,57910,19.28315,300314
4775,kcnet-kguru,2,0.00067,57912,19.28382,300314
4776,KCSesh,2,0.00067,57914,19.28448,300314
4777,keifgwinn,2,0.00067,57916,19.28515,300314
4778,keithlayne,2,0.00067,57918,19.28581,300314
4779,keithmattix,2,0.00067,57920,19.28648,300314
4780,kele1997,2,0.00067,57922,19.28715,300314
4781,kennethredler,2,0.00067,57924,19.28781,300314
4782,KentFujii,2,0.00067,57926,19.28848,300314
4783,kenyee,2,0.00067,57928,19.28914,300314
4784,kerberoszhan,2,0.00067,57930,19.28981,300314
4785,kerrygunn,2,0.00067,57932,19.29048,300314
4786,KetraKrato,2,0.00067,57934,19.29114,300314
4787,Kevin1515-ENG,2,0.00067,57936,19.29181,300314
4788,kevinayres,2,0.00067,57938,19.29247,300314
4789,kevin-ghd,2,0.00067,57940,19.29314,300314
4790,kevingosse,2,0.00067,57942,19.29381,300314
4791,kevsully5,2,0.00067,57944,19.29447,300314
4792,khabalevskyi,2,0.00067,57946,19.29514,300314
4793,khaledE,2,0.00067,57948,19.29580,300314
4794,khalsa-ji,2,0.00067,57950,19.29647,300314
4795,khs1994,2,0.00067,57952,19.29714,300314
4796,kingdevnl,2,0.00067,57954,19.29780,300314
4797,kirk-patton,2,0.00067,57956,19.29847,300314
4798,Kirow,2,0.00067,57958,19.29913,300314
4799,kishoregv,2,0.00067,57960,19.29980,300314
4800,kitt1987,2,0.00067,57962,19.30047,300314
4801,kjvalencik,2,0.00067,57964,19.30113,300314
4802,kkobayachi,2,0.00067,57966,19.30180,300314
4803,kkoppel,2,0.00067,57968,19.30246,300314
4804,kleini,2,0.00067,57970,19.30313,300314
4805,kmb385,2,0.00067,57972,19.30380,300314
4806,kmorkans,2,0.00067,57974,19.30446,300314
4807,knowings,2,0.00067,57976,19.30513,300314
4808,kolloch,2,0.00067,57978,19.30579,300314
4809,kolly83,2,0.00067,57980,19.30646,300314
4810,kopwei,2,0.00067,57982,19.30713,300314
4811,korabum,2,0.00067,57984,19.30779,300314
4812,kornelbicskei,2,0.00067,57986,19.30846,300314
4813,Kostavro,2,0.00067,57988,19.30912,300314
4814,kpanic9,2,0.00067,57990,19.30979,300314
4815,kpouget,2,0.00067,57992,19.31046,300314
4816,kramik1,2,0.00067,57994,19.31112,300314
4817,kriansa,2,0.00067,57996,19.31179,300314
4818,krzysztofantczak,2,0.00067,57998,19.31245,300314
4819,kschzt,2,0.00067,58000,19.31312,300314
4820,kuiwang02,2,0.00067,58002,19.31378,300314
4821,kulinskyvs,2,0.00067,58004,19.31445,300314
4822,kumarabd,2,0.00067,58006,19.31512,300314
4823,kumarvijendar,2,0.00067,58008,19.31578,300314
4824,kvp-cs,2,0.00067,58010,19.31645,300314
4825,KyanWang,2,0.00067,58012,19.31711,300314
4826,l903404160,2,0.00067,58014,19.31778,300314
4827,labarje,2,0.00067,58016,19.31845,300314
4828,lackhoa,2,0.00067,58018,19.31911,300314
4829,Laichj,2,0.00067,58020,19.31978,300314
4830,lalex,2,0.00067,58022,19.32044,300314
4831,lamroger,2,0.00067,58024,19.32111,300314
4832,lancelothuxi,2,0.00067,58026,19.32178,300314
4833,landreasyan,2,0.00067,58028,19.32244,300314
4834,langecode,2,0.00067,58030,19.32311,300314
4835,languitar,2,0.00067,58032,19.32377,300314
4836,lapo-luchini,2,0.00067,58034,19.32444,300314
4837,lazywhite,2,0.00067,58036,19.32511,300314
4838,LeagueLugas,2,0.00067,58038,19.32577,300314
4839,LeeStephen,2,0.00067,58040,19.32644,300314
4840,LeFrosch,2,0.00067,58042,19.32710,300314
4841,legendecas,2,0.00067,58044,19.32777,300314
4842,lelix,2,0.00067,58046,19.32844,300314
4843,LemonHX,2,0.00067,58048,19.32910,300314
4844,Lemonn,2,0.00067,58050,19.32977,300314
4845,lengrongfu,2,0.00067,58052,19.33043,300314
4846,lens0021,2,0.00067,58054,19.33110,300314
4847,leonardo-albertovich,2,0.00067,58056,19.33177,300314
4848,lesio999,2,0.00067,58058,19.33243,300314
4849,lewislbr,2,0.00067,58060,19.33310,300314
4850,lework,2,0.00067,58062,19.33376,300314
4851,lfreijo,2,0.00067,58064,19.33443,300314
4852,LHoBiz,2,0.00067,58066,19.33510,300314
4853,lichuan0620,2,0.00067,58068,19.33576,300314
4854,lightmans2,2,0.00067,58070,19.33643,300314
4855,lihang212010,2,0.00067,58072,19.33709,300314
4856,linmic30,2,0.00067,58074,19.33776,300314
4857,linuslukia,2,0.00067,58076,19.33843,300314
4858,little-guy-lxr,2,0.00067,58078,19.33909,300314
4859,liulanzheng,2,0.00067,58080,19.33976,300314
4860,liuquanliang520,2,0.00067,58082,19.34042,300314
4861,L-JunSakai,2,0.00067,58084,19.34109,300314
4862,llech,2,0.00067,58086,19.34176,300314
4863,lliuhaomin,2,0.00067,58088,19.34242,300314
4864,lmcdasi,2,0.00067,58090,19.34309,300314
4865,lmx-Hexagram,2,0.00067,58092,19.34375,300314
4866,LockLi,2,0.00067,58094,19.34442,300314
4867,logici,2,0.00067,58096,19.34509,300314
4868,loic-rgt,2,0.00067,58098,19.34575,300314
4869,lokiwins,2,0.00067,58100,19.34642,300314
4870,Lord-Y,2,0.00067,58102,19.34708,300314
4871,lorenzleutgeb,2,0.00067,58104,19.34775,300314
4872,lovingcodesk,2,0.00067,58106,19.34842,300314
4873,lpgc,2,0.00067,58108,19.34908,300314
4874,lrskyum,2,0.00067,58110,19.34975,300314
4875,lsolovey,2,0.00067,58112,19.35041,300314
4876,Luap99,2,0.00067,58114,19.35108,300314
4877,luciamota,2,0.00067,58116,19.35175,300314
4878,luciferhs,2,0.00067,58118,19.35241,300314
4879,luckerby,2,0.00067,58120,19.35308,300314
4880,luistilingue,2,0.00067,58122,19.35374,300314
4881,LukasBlu1,2,0.00067,58124,19.35441,300314
4882,lukeplausin,2,0.00067,58126,19.35508,300314
4883,Lunik,2,0.00067,58128,19.35574,300314
4884,luodw,2,0.00067,58130,19.35641,300314
4885,luoenzhen,2,0.00067,58132,19.35707,300314
4886,luoqian1999,2,0.00067,58134,19.35774,300314
4887,luwang-vmware,2,0.00067,58136,19.35840,300314
4888,lvchangqi,2,0.00067,58138,19.35907,300314
4889,lwintermelon,2,0.00067,58140,19.35974,300314
4890,LY1806620741,2,0.00067,58142,19.36040,300314
4891,M0n7y5,2,0.00067,58144,19.36107,300314
4892,m1o1,2,0.00067,58146,19.36173,300314
4893,m4dm4rtig4n,2,0.00067,58148,19.36240,300314
4894,m7onov,2,0.00067,58150,19.36307,300314
4895,MadDoxXimba,2,0.00067,58152,19.36373,300314
4896,madhu-shankar,2,0.00067,58154,19.36440,300314
4897,madhusudhan-patha,2,0.00067,58156,19.36506,300314
4898,maemigh,2,0.00067,58158,19.36573,300314
4899,magnusja,2,0.00067,58160,19.36640,300314
4900,MahnoorAsghar,2,0.00067,58162,19.36706,300314
4901,MainPoser,2,0.00067,58164,19.36773,300314
4902,malacoss,2,0.00067,58166,19.36839,300314
4903,malikkal,2,0.00067,58168,19.36906,300314
4904,mali-nuist,2,0.00067,58170,19.36973,300314
4905,malloth,2,0.00067,58172,19.37039,300314
4906,manderson23,2,0.00067,58174,19.37106,300314
4907,manibh-kong,2,0.00067,58176,19.37172,300314
4908,manjotsidhu,2,0.00067,58178,19.37239,300314
4909,mansiRM,2,0.00067,58180,19.37306,300314
4910,manute,2,0.00067,58182,19.37372,300314
4911,mapdegree,2,0.00067,58184,19.37439,300314
4912,marcdejonge,2,0.00067,58186,19.37505,300314
4913,marcellippmann,2,0.00067,58188,19.37572,300314
4914,marcospereira,2,0.00067,58190,19.37639,300314
4915,Marco-Zheng,2,0.00067,58192,19.37705,300314
4916,Marcus1911,2,0.00067,58194,19.37772,300314
4917,marcuz,2,0.00067,58196,19.37838,300314
4918,marenero1974,2,0.00067,58198,19.37905,300314
4919,MariachiForHire,2,0.00067,58200,19.37972,300314
4920,mario-op,2,0.00067,58202,19.38038,300314
4921,markmsmith,2,0.00067,58204,19.38105,300314
4922,markramach,2,0.00067,58206,19.38171,300314
4923,markush81,2,0.00067,58208,19.38238,300314
4924,marlon-sousa,2,0.00067,58210,19.38305,300314
4925,maronghe,2,0.00067,58212,19.38371,300314
4926,marsdalesa,2,0.00067,58214,19.38438,300314
4927,Marswin,2,0.00067,58216,19.38504,300314
4928,MartinEmrich,2,0.00067,58218,19.38571,300314
4929,martinstraesser,2,0.00067,58220,19.38638,300314
4930,Marx2,2,0.00067,58222,19.38704,300314
4931,marymakau5,2,0.00067,58224,19.38771,300314
4932,masaru2604,2,0.00067,58226,19.38837,300314
4933,mason-liu,2,0.00067,58228,19.38904,300314
4934,matandomuertos,2,0.00067,58230,19.38971,300314
4935,maticue,2,0.00067,58232,19.39037,300314
4936,matn,2,0.00067,58234,19.39104,300314
4937,matt88s,2,0.00067,58236,19.39170,300314
4938,matt-carr,2,0.00067,58238,19.39237,300314
4939,mattdowdell,2,0.00067,58240,19.39304,300314
4940,matthew-walker-prolucid,2,0.00067,58242,19.39370,300314
4941,MatthiasSchilder,2,0.00067,58244,19.39437,300314
4942,mattjamese,2,0.00067,58246,19.39503,300314
4943,mattrapa,2,0.00067,58248,19.39570,300314
4944,matusnovak,2,0.00067,58250,19.39637,300314
4945,maurizio-lattuada,2,0.00067,58252,19.39703,300314
4946,max77p,2,0.00067,58254,19.39770,300314
4947,maxballenger,2,0.00067,58256,19.39836,300314
4948,maximchukm,2,0.00067,58258,19.39903,300314
4949,mayocream,2,0.00067,58260,19.39969,300314
4950,mbard,2,0.00067,58262,19.40036,300314
4951,McCoyAle,2,0.00067,58264,19.40103,300314
4952,mckornfield,2,0.00067,58266,19.40169,300314
4953,mclosson-lsf,2,0.00067,58268,19.40236,300314
4954,mcmartins,2,0.00067,58270,19.40302,300314
4955,mcpomm,2,0.00067,58272,19.40369,300314
4956,mdraijer,2,0.00067,58274,19.40436,300314
4957,Meegada-Mahesh,2,0.00067,58276,19.40502,300314
4958,mermetbt,2,0.00067,58278,19.40569,300314
4959,MesaCrush,2,0.00067,58280,19.40635,300314
4960,messiahUA,2,0.00067,58282,19.40702,300314
4961,metasim,2,0.00067,58284,19.40769,300314
4962,MG2R,2,0.00067,58286,19.40835,300314
4963,mhensley-cls,2,0.00067,58288,19.40902,300314
4964,mhobotpplnet,2,0.00067,58290,19.40968,300314
4965,mhrbmr,2,0.00067,58292,19.41035,300314
4966,mhristache,2,0.00067,58294,19.41102,300314
4967,michaelcourcy,2,0.00067,58296,19.41168,300314
4968,MichaelDavisTSN,2,0.00067,58298,19.41235,300314
4969,michaelperel,2,0.00067,58300,19.41301,300314
4970,michaelswierszcz,2,0.00067,58302,19.41368,300314
4971,Micost,2,0.00067,58304,19.41435,300314
4972,mig4,2,0.00067,58306,19.41501,300314
4973,mihaisee,2,0.00067,58308,19.41568,300314
4974,mikeroySoft,2,0.00067,58310,19.41634,300314
4975,Mikey032,2,0.00067,58312,19.41701,300314
4976,mikhailknyazev,2,0.00067,58314,19.41768,300314
4977,mikkel1156,2,0.00067,58316,19.41834,300314
4978,milhcbt,2,0.00067,58318,19.41901,300314
4979,minaevmike,2,0.00067,58320,19.41967,300314
4980,mindkeep,2,0.00067,58322,19.42034,300314
4981,minnsoe,2,0.00067,58324,19.42101,300314
4982,mintchkin,2,0.00067,58326,19.42167,300314
4983,miro-grapeup,2,0.00067,58328,19.42234,300314
4984,mitsos1os,2,0.00067,58330,19.42300,300314
4985,MjAbuz,2,0.00067,58332,19.42367,300314
4986,mkl262,2,0.00067,58334,19.42434,300314
4987,mkreidenweis-schulmngr,2,0.00067,58336,19.42500,300314
4988,mlaver,2,0.00067,58338,19.42567,300314
4989,m-lima,2,0.00067,58340,19.42633,300314
4990,mmckane,2,0.00067,58342,19.42700,300314
4991,mmslkr,2,0.00067,58344,19.42767,300314
4992,mnasyrov,2,0.00067,58346,19.42833,300314
4993,mndrix,2,0.00067,58348,19.42900,300314
4994,mneil,2,0.00067,58350,19.42966,300314
4995,mnencia,2,0.00067,58352,19.43033,300314
4996,mogul,2,0.00067,58354,19.43100,300314
4997,mohanagandlla,2,0.00067,58356,19.43166,300314
4998,mohapsub,2,0.00067,58358,19.43233,300314
4999,MoienTajik,2,0.00067,58360,19.43299,300314
5000,mojojoji,2,0.00067,58362,19.43366,300314
5001,moltamas93,2,0.00067,58364,19.43433,300314
5002,moorthi07,2,0.00067,58366,19.43499,300314
5003,morgoved,2,0.00067,58368,19.43566,300314
5004,morgwai,2,0.00067,58370,19.43632,300314
5005,mortenn,2,0.00067,58372,19.43699,300314
5006,moserware,2,0.00067,58374,19.43766,300314
5007,Mosibi,2,0.00067,58376,19.43832,300314
5008,Mostafa-Elmenbawy,2,0.00067,58378,19.43899,300314
5009,mostcowbell,2,0.00067,58380,19.43965,300314
5010,mothershipper,2,0.00067,58382,19.44032,300314
5011,mottibec,2,0.00067,58384,19.44099,300314
5012,mprimeaux,2,0.00067,58386,19.44165,300314
5013,MrDeej,2,0.00067,58388,19.44232,300314
5014,mr-sour,2,0.00067,58390,19.44298,300314
5015,MrYueQ,2,0.00067,58392,19.44365,300314
5016,msflash,2,0.00067,58394,19.44431,300314
5017,MTBorg,2,0.00067,58396,19.44498,300314
5018,mtb-xt,2,0.00067,58398,19.44565,300314
5019,mthalman,2,0.00067,58400,19.44631,300314
5020,mtorromeo,2,0.00067,58402,19.44698,300314
5021,muecahit94,2,0.00067,58404,19.44764,300314
5022,Multiply,2,0.00067,58406,19.44831,300314
5023,mumrau,2,0.00067,58408,19.44898,300314
5024,muranant,2,0.00067,58410,19.44964,300314
5025,Muscule,2,0.00067,58412,19.45031,300314
5026,mustache1up,2,0.00067,58414,19.45097,300314
5027,muuki88,2,0.00067,58416,19.45164,300314
5028,mvbakker,2,0.00067,58418,19.45231,300314
5029,n0-1,2,0.00067,58420,19.45297,300314
5030,nagyv,2,0.00067,58422,19.45364,300314
5031,NamanJain8,2,0.00067,58424,19.45430,300314
5032,namelessvoid,2,0.00067,58426,19.45497,300314
5033,nanonyme,2,0.00067,58428,19.45564,300314
5034,narcolepticsnowman,2,0.00067,58430,19.45630,300314
5035,narenarjun,2,0.00067,58432,19.45697,300314
5036,NasAmin,2,0.00067,58434,19.45763,300314
5037,natchaphon-r,2,0.00067,58436,19.45830,300314
5038,natitomattis,2,0.00067,58438,19.45897,300314
5039,naveen-mindtree,2,0.00067,58440,19.45963,300314
5040,nbaztec,2,0.00067,58442,19.46030,300314
5041,nberkley,2,0.00067,58444,19.46096,300314
5042,NBNARADHYA,2,0.00067,58446,19.46163,300314
5043,ncabanis,2,0.00067,58448,19.46230,300314
5044,ncapps,2,0.00067,58450,19.46296,300314
5045,Neakxs,2,0.00067,58452,19.46363,300314
5046,necrolyte2,2,0.00067,58454,19.46429,300314
5047,nehatomar12,2,0.00067,58456,19.46496,300314
5048,nekottyo,2,0.00067,58458,19.46563,300314
5049,Nello-Angelo,2,0.00067,58460,19.46629,300314
5050,neoaisac,2,0.00067,58462,19.46696,300314
5051,neocorp,2,0.00067,58464,19.46762,300314
5052,neuromantik33,2,0.00067,58466,19.46829,300314
5053,neuyilan,2,0.00067,58468,19.46896,300314
5054,nextMJ,2,0.00067,58470,19.46962,300314
5055,nguyenlamlll,2,0.00067,58472,19.47029,300314
5056,nic-6443,2,0.00067,58474,19.47095,300314
5057,nicholaswilde,2,0.00067,58476,19.47162,300314
5058,nick-lehmann,2,0.00067,58478,19.47229,300314
5059,nickngch,2,0.00067,58480,19.47295,300314
5060,NickScottKortical,2,0.00067,58482,19.47362,300314
5061,niclarkin,2,0.00067,58484,19.47428,300314
5062,nicolacdnll,2,0.00067,58486,19.47495,300314
5063,nicolas-vivot,2,0.00067,58488,19.47562,300314
5064,NiekPeeters,2,0.00067,58490,19.47628,300314
5065,nikhil-rajan-neu,2,0.00067,58492,19.47695,300314
5066,nikkrg,2,0.00067,58494,19.47761,300314
5067,nikobearrr,2,0.00067,58496,19.47828,300314
5068,nilayasiktoprak,2,0.00067,58498,19.47895,300314
5069,nimajafroodi,2,0.00067,58500,19.47961,300314
5070,nishanksogani,2,0.00067,58502,19.48028,300314
5071,Nitesh-vaidyanath,2,0.00067,58504,19.48094,300314
5072,nitrag,2,0.00067,58506,19.48161,300314
5073,NoFWayMan,2,0.00067,58508,19.48228,300314
5074,NovichikhinAlexey,2,0.00067,58510,19.48294,300314
5075,NOWYOU,2,0.00067,58512,19.48361,300314
5076,npawelek,2,0.00067,58514,19.48427,300314
5077,ntith,2,0.00067,58516,19.48494,300314
5078,nuharaf,2,0.00067,58518,19.48561,300314
5079,nupplaphil,2,0.00067,58520,19.48627,300314
5080,Nuru,2,0.00067,58522,19.48694,300314
5081,nurzhan86,2,0.00067,58524,19.48760,300314
5082,nwbirnie,2,0.00067,58526,19.48827,300314
5083,Nyefan,2,0.00067,58528,19.48893,300314
5084,oguzhanun,2,0.00067,58530,19.48960,300314
5085,ohauer,2,0.00067,58532,19.49027,300314
5086,Okhoshi,2,0.00067,58534,19.49093,300314
5087,oleg-kulyk,2,0.00067,58536,19.49160,300314
5088,OliverCole,2,0.00067,58538,19.49226,300314
5089,omaidb,2,0.00067,58540,19.49293,300314
5090,omer-sd,2,0.00067,58542,19.49360,300314
5091,omlomloml,2,0.00067,58544,19.49426,300314
5092,onlynone,2,0.00067,58546,19.49493,300314
5093,onthedock,2,0.00067,58548,19.49559,300314
5094,OrangeLoveGitHub,2,0.00067,58550,19.49626,300314
5095,orencohendev,2,0.00067,58552,19.49693,300314
5096,orzlc,2,0.00067,58554,19.49759,300314
5097,osherdp,2,0.00067,58556,19.49826,300314
5098,ostrolucky,2,0.00067,58558,19.49892,300314
5099,outinspace,2,0.00067,58560,19.49959,300314
5100,oveits,2,0.00067,58562,19.50026,300314
5101,ovidiubuligan,2,0.00067,58564,19.50092,300314
5102,owen-kuai,2,0.00067,58566,19.50159,300314
5103,oxr463,2,0.00067,58568,19.50225,300314
5104,ozang,2,0.00067,58570,19.50292,300314
5105,ozayss,2,0.00067,58572,19.50359,300314
5106,OzySky,2,0.00067,58574,19.50425,300314
5107,p7r12,2,0.00067,58576,19.50492,300314
5108,pabloheigvd,2,0.00067,58578,19.50558,300314
5109,pablo-ruth,2,0.00067,58580,19.50625,300314
5110,paddy-hack,2,0.00067,58582,19.50692,300314
5111,palexster,2,0.00067,58584,19.50758,300314
5112,Pallavi-PH,2,0.00067,58586,19.50825,300314
5113,pamelin,2,0.00067,58588,19.50891,300314
5114,pandaji,2,0.00067,58590,19.50958,300314
5115,pankajch82,2,0.00067,58592,19.51025,300314
5116,pankrator,2,0.00067,58594,19.51091,300314
5117,pantaoran,2,0.00067,58596,19.51158,300314
5118,pantinor,2,0.00067,58598,19.51224,300314
5119,panyang1217,2,0.00067,58600,19.51291,300314
5120,paprickar,2,0.00067,58602,19.51358,300314
5121,pari-p19,2,0.00067,58604,19.51424,300314
5122,Parrryy,2,0.00067,58606,19.51491,300314
5123,parthsharma2,2,0.00067,58608,19.51557,300314
5124,patrickhuy,2,0.00067,58610,19.51624,300314
5125,pattrickrice,2,0.00067,58612,19.51691,300314
5126,Paul424,2,0.00067,58614,19.51757,300314
5127,paulgrav,2,0.00067,58616,19.51824,300314
5128,paullaffitte,2,0.00067,58618,19.51890,300314
5129,paul-r-gall,2,0.00067,58620,19.51957,300314
5130,PaulRudin,2,0.00067,58622,19.52024,300314
5131,paulstelian97,2,0.00067,58624,19.52090,300314
5132,Pavel-Durov,2,0.00067,58626,19.52157,300314
5133,pavelsimo,2,0.00067,58628,19.52223,300314
5134,paymog,2,0.00067,58630,19.52290,300314
5135,pbaderia01,2,0.00067,58632,19.52357,300314
5136,pbalajiips,2,0.00067,58634,19.52423,300314
5137,PBug90,2,0.00067,58636,19.52490,300314
5138,pburgisser,2,0.00067,58638,19.52556,300314
5139,pdabrowski-it-solutions,2,0.00067,58640,19.52623,300314
5140,pduchnovsky,2,0.00067,58642,19.52690,300314
5141,pedrobragioni,2,0.00067,58644,19.52756,300314
5142,Pedrocho,2,0.00067,58646,19.52823,300314
5143,pedroleaoc,2,0.00067,58648,19.52889,300314
5144,pensarguet,2,0.00067,58650,19.52956,300314
5145,Pepo-BG,2,0.00067,58652,19.53023,300314
5146,perosb,2,0.00067,58654,19.53089,300314
5147,peter-bankuti-trinckle,2,0.00067,58656,19.53156,300314
5148,PG2000,2,0.00067,58658,19.53222,300314
5149,pgy11,2,0.00067,58660,19.53289,300314
5150,philchia,2,0.00067,58662,19.53355,300314
5151,pickfire,2,0.00067,58664,19.53422,300314
5152,pietrodimaggio,2,0.00067,58666,19.53489,300314
5153,Pindar,2,0.00067,58668,19.53555,300314
5154,pitabwire,2,0.00067,58670,19.53622,300314
5155,pito-svk,2,0.00067,58672,19.53688,300314
5156,piyush94,2,0.00067,58674,19.53755,300314
5157,pkoltermann,2,0.00067,58676,19.53822,300314
5158,Planutim,2,0.00067,58678,19.53888,300314
5159,pleiadesian,2,0.00067,58680,19.53955,300314
5160,pmanno,2,0.00067,58682,19.54021,300314
5161,pmichna,2,0.00067,58684,19.54088,300314
5162,pommelinho,2,0.00067,58686,19.54155,300314
5163,poul1x,2,0.00067,58688,19.54221,300314
5164,prakashmirji,2,0.00067,58690,19.54288,300314
5165,praminda,2,0.00067,58692,19.54354,300314
5166,pratnaparkhi2000,2,0.00067,58694,19.54421,300314
5167,Praveenrajmani,2,0.00067,58696,19.54488,300314
5168,prikesh-patel,2,0.00067,58698,19.54554,300314
5169,PrimalPimmy,2,0.00067,58700,19.54621,300314
5170,primeroz,2,0.00067,58702,19.54687,300314
5171,prithvi1307,2,0.00067,58704,19.54754,300314
5172,protess,2,0.00067,58706,19.54821,300314
5173,prydeep,2,0.00067,58708,19.54887,300314
5174,psarossy,2,0.00067,58710,19.54954,300314
5175,psganni,2,0.00067,58712,19.55020,300314
5176,pslobo,2,0.00067,58714,19.55087,300314
5177,psoares,2,0.00067,58716,19.55154,300314
5178,pszmytka-viacom,2,0.00067,58718,19.55220,300314
5179,PugTheBlack,2,0.00067,58720,19.55287,300314
5180,Puneethgr,2,0.00067,58722,19.55353,300314
5181,punycode,2,0.00067,58724,19.55420,300314
5182,pymongo,2,0.00067,58726,19.55487,300314
5183,pyssling,2,0.00067,58728,19.55553,300314
5184,pzheng1025,2,0.00067,58730,19.55620,300314
5185,QAQ-rookie,2,0.00067,58732,19.55686,300314
5186,qeternity,2,0.00067,58734,19.55753,300314
5187,qinxx108,2,0.00067,58736,19.55820,300314
5188,qiuhui,2,0.00067,58738,19.55886,300314
5189,qlisc,2,0.00067,58740,19.55953,300314
5190,qmloong,2,0.00067,58742,19.56019,300314
5191,qnuw,2,0.00067,58744,19.56086,300314
5192,qoobic,2,0.00067,58746,19.56153,300314
5193,qsyqian,2,0.00067,58748,19.56219,300314
5194,quanghuy4994,2,0.00067,58750,19.56286,300314
5195,quentingodeau,2,0.00067,58752,19.56352,300314
5196,r0kas,2,0.00067,58754,19.56419,300314
5197,R37ribution,2,0.00067,58756,19.56486,300314
5198,ra1u,2,0.00067,58758,19.56552,300314
5199,rafadesu,2,0.00067,58760,19.56619,300314
5200,RafaelCavazza,2,0.00067,58762,19.56685,300314
5201,rafaelcaviquioli,2,0.00067,58764,19.56752,300314
5202,ragarcia26,2,0.00067,58766,19.56819,300314
5203,raghuP9,2,0.00067,58768,19.56885,300314
5204,rahulvinodsharma,2,0.00067,58770,19.56952,300314
5205,rainerfrey,2,0.00067,58772,19.57018,300314
5206,Raj-Dharwadkar,2,0.00067,58774,19.57085,300314
5207,rajeshkudaka,2,0.00067,58776,19.57152,300314
5208,RAJMITTAL,2,0.00067,58778,19.57218,300314
5209,RajuMedpur,2,0.00067,58780,19.57285,300314
5210,randomk,2,0.00067,58782,19.57351,300314
5211,randym13,2,0.00067,58784,19.57418,300314
5212,randysimplist,2,0.00067,58786,19.57484,300314
5213,rannyh,2,0.00067,58788,19.57551,300314
5214,ranyuanyuan,2,0.00067,58790,19.57618,300314
5215,rasberrypie,2,0.00067,58792,19.57684,300314
5216,raspitakesovertheworld,2,0.00067,58794,19.57751,300314
5217,ratripathi,2,0.00067,58796,19.57817,300314
5218,RavjotSandhu,2,0.00067,58798,19.57884,300314
5219,raythang,2,0.00067,58800,19.57951,300314
5220,raz08,2,0.00067,58802,19.58017,300314
5221,rbalagopalakrishna,2,0.00067,58804,19.58084,300314
5222,recipedude,2,0.00067,58806,19.58150,300314
5223,redcometchar,2,0.00067,58808,19.58217,300314
5224,reddog335,2,0.00067,58810,19.58284,300314
5225,redNixon,2,0.00067,58812,19.58350,300314
5226,reingart,2,0.00067,58814,19.58417,300314
5227,rektide,2,0.00067,58816,19.58483,300314
5228,remort,2,0.00067,58818,19.58550,300314
5229,reorx,2,0.00067,58820,19.58617,300314
5230,rgulden,2,0.00067,58822,19.58683,300314
5231,rhysm,2,0.00067,58824,19.58750,300314
5232,ribrdb,2,0.00067,58826,19.58816,300314
5233,riccardone,2,0.00067,58828,19.58883,300314
5234,Rick-yi,2,0.00067,58830,19.58950,300314
5235,Ridder24,2,0.00067,58832,19.59016,300314
5236,riklopfer,2,0.00067,58834,19.59083,300314
5237,rileyrohloff,2,0.00067,58836,19.59149,300314
5238,rinini,2,0.00067,58838,19.59216,300314
5239,rionmonster,2,0.00067,58840,19.59283,300314
5240,rishm069,2,0.00067,58842,19.59349,300314
5241,riyashah17,2,0.00067,58844,19.59416,300314
5242,rizwank23,2,0.00067,58846,19.59482,300314
5243,rjgotten,2,0.00067,58848,19.59549,300314
5244,rkage,2,0.00067,58850,19.59616,300314
5245,r-kgy,2,0.00067,58852,19.59682,300314
5246,rkpattnaik780,2,0.00067,58854,19.59749,300314
5247,rm3l,2,0.00067,58856,19.59815,300314
5248,rmalenko,2,0.00067,58858,19.59882,300314
5249,rmanny,2,0.00067,58860,19.59949,300314
5250,rminnich,2,0.00067,58862,19.60015,300314
5251,rmoesbergen,2,0.00067,58864,19.60082,300314
5252,rmorampudi,2,0.00067,58866,19.60148,300314
5253,Ro0tk1t,2,0.00067,58868,19.60215,300314
5254,robinmarechal,2,0.00067,58870,19.60282,300314
5255,robstradling,2,0.00067,58872,19.60348,300314
5256,robtayl0r,2,0.00067,58874,19.60415,300314
5257,rockaut,2,0.00067,58876,19.60481,300314
5258,rocksun,2,0.00067,58878,19.60548,300314
5259,rodgarcialima,2,0.00067,58880,19.60615,300314
5260,roere,2,0.00067,58882,19.60681,300314
5261,rohank2502,2,0.00067,58884,19.60748,300314
5262,rohanliston,2,0.00067,58886,19.60814,300314
5263,rohitsakala,2,0.00067,58888,19.60881,300314
5264,RoiSightfull,2,0.00067,58890,19.60948,300314
5265,romeokienzler,2,0.00067,58892,19.61014,300314
5266,romerod,2,0.00067,58894,19.61081,300314
5267,ron1,2,0.00067,58896,19.61147,300314
5268,ronf,2,0.00067,58898,19.61214,300314
5269,ronitP12,2,0.00067,58900,19.61281,300314
5270,roobre,2,0.00067,58902,19.61347,300314
5271,rootdeep,2,0.00067,58904,19.61414,300314
5272,rosatarraga,2,0.00067,58906,19.61480,300314
5273,RothAndrew,2,0.00067,58908,19.61547,300314
5274,RouNNdeL,2,0.00067,58910,19.61614,300314
5275,roycyz,2,0.00067,58912,19.61680,300314
5276,royeo,2,0.00067,58914,19.61747,300314
5277,rpledger,2,0.00067,58916,19.61813,300314
5278,rudeblunt,2,0.00067,58918,19.61880,300314
5279,ruiengana,2,0.00067,58920,19.61946,300314
5280,Ruilkyu,2,0.00067,58922,19.62013,300314
5281,Ruimingwang,2,0.00067,58924,19.62080,300314
5282,ruiyaoOps,2,0.00067,58926,19.62146,300314
5283,rukatm,2,0.00067,58928,19.62213,300314
5284,ruvenmil89,2,0.00067,58930,19.62279,300314
5285,rwong2888,2,0.00067,58932,19.62346,300314
5286,ryanbamford,2,0.00067,58934,19.62413,300314
5287,ryancastle,2,0.00067,58936,19.62479,300314
5288,ryanrupp,2,0.00067,58938,19.62546,300314
5289,ryansimmen,2,0.00067,58940,19.62612,300314
5290,RyanSusana,2,0.00067,58942,19.62679,300314
5291,ryhinchey,2,0.00067,58944,19.62746,300314
5292,rymancl,2,0.00067,58946,19.62812,300314
5293,SagarHuli,2,0.00067,58948,19.62879,300314
5294,sagarpatil23192,2,0.00067,58950,19.62945,300314
5295,sahejsingh,2,0.00067,58952,19.63012,300314
5296,saikiran9824,2,0.00067,58954,19.63079,300314
5297,saintdle,2,0.00067,58956,19.63145,300314
5298,sakno,2,0.00067,58958,19.63212,300314
5299,salmanisd,2,0.00067,58960,19.63278,300314
5300,saltbo,2,0.00067,58962,19.63345,300314
5301,salzig,2,0.00067,58964,19.63412,300314
5302,samilko,2,0.00067,58966,19.63478,300314
5303,samsk,2,0.00067,58968,19.63545,300314
5304,samsp-msft,2,0.00067,58970,19.63611,300314
5305,samuelcolvin,2,0.00067,58972,19.63678,300314
5306,samwightt,2,0.00067,58974,19.63745,300314
5307,sandangel,2,0.00067,58976,19.63811,300314
5308,sandipchitale,2,0.00067,58978,19.63878,300314
5309,sandord,2,0.00067,58980,19.63944,300314
5310,santisaez,2,0.00067,58982,19.64011,300314
5311,sar99,2,0.00067,58984,19.64078,300314
5312,saradocasar,2,0.00067,58986,19.64144,300314
5313,saretta,2,0.00067,58988,19.64211,300314
5314,sarthak40,2,0.00067,58990,19.64277,300314
5315,sashko-do,2,0.00067,58992,19.64344,300314
5316,sass1997,2,0.00067,58994,19.64411,300314
5317,satishnaidu,2,0.00067,58996,19.64477,300314
5318,satrox28,2,0.00067,58998,19.64544,300314
5319,sauravvijay,2,0.00067,59000,19.64610,300314
5320,sayotte,2,0.00067,59002,19.64677,300314
5321,sblgo,2,0.00067,59004,19.64744,300314
5322,sbrichardson,2,0.00067,59006,19.64810,300314
5323,schmidtdu,2,0.00067,59008,19.64877,300314
5324,scottbuckel,2,0.00067,59010,19.64943,300314
5325,sdwerwed,2,0.00067,59012,19.65010,300314
5326,sebastien-coavoux,2,0.00067,59014,19.65077,300314
5327,sebas-w,2,0.00067,59016,19.65143,300314
5328,sebaszczen,2,0.00067,59018,19.65210,300314
5329,Sebor,2,0.00067,59020,19.65276,300314
5330,sedhossein,2,0.00067,59022,19.65343,300314
5331,sedlund,2,0.00067,59024,19.65410,300314
5332,selek55,2,0.00067,59026,19.65476,300314
5333,semoac,2,0.00067,59028,19.65543,300314
5334,sempervictus,2,0.00067,59030,19.65609,300314
5335,seperman,2,0.00067,59032,19.65676,300314
5336,serain,2,0.00067,59034,19.65743,300314
5337,sergeiepam,2,0.00067,59036,19.65809,300314
5338,sergey-safarov,2,0.00067,59038,19.65876,300314
5339,SergeySevruk,2,0.00067,59040,19.65942,300314
5340,SeriyBg,2,0.00067,59042,19.66009,300314
5341,sfc-gh-jburns,2,0.00067,59044,19.66076,300314
5342,sfgroups-k8s,2,0.00067,59046,19.66142,300314
5343,shaikadilmd,2,0.00067,59048,19.66209,300314
5344,shaipan,2,0.00067,59050,19.66275,300314
5345,Shaked,2,0.00067,59052,19.66342,300314
5346,shakuzen,2,0.00067,59054,19.66408,300314
5347,sharadpattanshetti,2,0.00067,59056,19.66475,300314
5348,sharonngetich,2,0.00067,59058,19.66542,300314
5349,shenbimaniang,2,0.00067,59060,19.66608,300314
5350,shijianjs,2,0.00067,59062,19.66675,300314
5351,shireresident,2,0.00067,59064,19.66741,300314
5352,shirodkara,2,0.00067,59066,19.66808,300314
5353,shivaylamba,2,0.00067,59068,19.66875,300314
5354,shmelkin,2,0.00067,59070,19.66941,300314
5355,shrgabor,2,0.00067,59072,19.67008,300314
5356,shteou,2,0.00067,59074,19.67074,300314
5357,shybbko,2,0.00067,59076,19.67141,300314
5358,sicheng216,2,0.00067,59078,19.67208,300314
5359,SiegfredRodriguez,2,0.00067,59080,19.67274,300314
5360,Siegfriedk,2,0.00067,59082,19.67341,300314
5361,signinred,2,0.00067,59084,19.67407,300314
5362,simon28li,2,0.00067,59086,19.67474,300314
5363,simonbonnefoy,2,0.00067,59088,19.67541,300314
5364,simonc6372,2,0.00067,59090,19.67607,300314
5365,SimonForsman,2,0.00067,59092,19.67674,300314
5366,simonshi2016,2,0.00067,59094,19.67740,300314
5367,simonvanbernem,2,0.00067,59096,19.67807,300314
5368,SimplySeth,2,0.00067,59098,19.67874,300314
5369,sipasing,2,0.00067,59100,19.67940,300314
5370,sirpeanut,2,0.00067,59102,19.68007,300314
5371,SivaTharun,2,0.00067,59104,19.68073,300314
5372,skadem07,2,0.00067,59106,19.68140,300314
5373,skamchiline,2,0.00067,59108,19.68207,300314
5374,Skillshot,2,0.00067,59110,19.68273,300314
5375,skiransk,2,0.00067,59112,19.68340,300314
5376,skpenpen,2,0.00067,59114,19.68406,300314
5377,skrech,2,0.00067,59116,19.68473,300314
5378,sksingh20,2,0.00067,59118,19.68540,300314
5379,skuethe,2,0.00067,59120,19.68606,300314
5380,Skullflow,2,0.00067,59122,19.68673,300314
5381,sky-philipalmeida,2,0.00067,59124,19.68739,300314
5382,SLavaLL,2,0.00067,59126,19.68806,300314
5383,slinstaedt,2,0.00067,59128,19.68873,300314
5384,smacl,2,0.00067,59130,19.68939,300314
5385,smalchow,2,0.00067,59132,19.69006,300314
5386,smart33690,2,0.00067,59134,19.69072,300314
5387,SmartHammer,2,0.00067,59136,19.69139,300314
5388,s-matyukevich,2,0.00067,59138,19.69206,300314
5389,smcaine,2,0.00067,59140,19.69272,300314
5390,SmedbergM,2,0.00067,59142,19.69339,300314
5391,SmokeDawg92967,2,0.00067,59144,19.69405,300314
5392,SMoravcik,2,0.00067,59146,19.69472,300314
5393,smrutiranjantripathy,2,0.00067,59148,19.69539,300314
5394,snowzach,2,0.00067,59150,19.69605,300314
5395,sohrabkhan,2,0.00067,59152,19.69672,300314
5396,solarmosaic-kflorence,2,0.00067,59154,19.69738,300314
5397,somombo,2,0.00067,59156,19.69805,300314
5398,sonalkr132,2,0.00067,59158,19.69872,300314
5399,SoniCoder,2,0.00067,59160,19.69938,300314
5400,Sooryaa-A,2,0.00067,59162,19.70005,300314
5401,sovbangit,2,0.00067,59164,19.70071,300314
5402,sp0cket,2,0.00067,59166,19.70138,300314
5403,spam-n-eggs,2,0.00067,59168,19.70205,300314
5404,speedst3r,2,0.00067,59170,19.70271,300314
5405,sponte,2,0.00067,59172,19.70338,300314
5406,Spritekin,2,0.00067,59174,19.70404,300314
5407,sravya-a,2,0.00067,59176,19.70471,300314
5408,sreeja2018,2,0.00067,59178,19.70538,300314
5409,srhaber,2,0.00067,59180,19.70604,300314
5410,srikantheee,2,0.00067,59182,19.70671,300314
5411,sriramachelankuri,2,0.00067,59184,19.70737,300314
5412,sschne,2,0.00067,59186,19.70804,300314
5413,ssiano,2,0.00067,59188,19.70870,300314
5414,s-spindler,2,0.00067,59190,19.70937,300314
5415,ssyuan,2,0.00067,59192,19.71004,300314
5416,stephenhong,2,0.00067,59194,19.71070,300314
5417,stephenrob,2,0.00067,59196,19.71137,300314
5418,stevek-pro,2,0.00067,59198,19.71203,300314
5419,stevenelleman,2,0.00067,59200,19.71270,300314
5420,StevenLeiZhang,2,0.00067,59202,19.71337,300314
5421,steve-todorov,2,0.00067,59204,19.71403,300314
5422,stevo-f3,2,0.00067,59206,19.71470,300314
5423,StiviiK,2,0.00067,59208,19.71536,300314
5424,Stoakes,2,0.00067,59210,19.71603,300314
5425,Stolr,2,0.00067,59212,19.71670,300314
5426,ston1th,2,0.00067,59214,19.71736,300314
5427,stoned,2,0.00067,59216,19.71803,300314
5428,storozhukBM,2,0.00067,59218,19.71869,300314
5429,stucky101,2,0.00067,59220,19.71936,300314
5430,Subreptivus,2,0.00067,59222,19.72003,300314
5431,sudeep1607,2,0.00067,59224,19.72069,300314
5432,sudeeptoroy,2,0.00067,59226,19.72136,300314
5433,sudivate,2,0.00067,59228,19.72202,300314
5434,sudvid78,2,0.00067,59230,19.72269,300314
5435,Suedo,2,0.00067,59232,19.72336,300314
5436,suhaibmalik,2,0.00067,59234,19.72402,300314
5437,suizman,2,0.00067,59236,19.72469,300314
5438,SunilManthenaG01,2,0.00067,59238,19.72535,300314
5439,sunkai-XDD,2,0.00067,59240,19.72602,300314
5440,sunnythepatel,2,0.00067,59242,19.72669,300314
5441,sunny-xiao,2,0.00067,59244,19.72735,300314
5442,suojy,2,0.00067,59246,19.72802,300314
5443,supernova2468,2,0.00067,59248,19.72868,300314
5444,SuperSandro2000,2,0.00067,59250,19.72935,300314
5445,susinmotion,2,0.00067,59252,19.73002,300314
5446,svoegeli,2,0.00067,59254,19.73068,300314
5447,syntapy,2,0.00067,59256,19.73135,300314
5448,syyama-net,2,0.00067,59258,19.73201,300314
5449,t3hprofit,2,0.00067,59260,19.73268,300314
5450,tachang,2,0.00067,59262,19.73335,300314
5451,TaharInfo,2,0.00067,59264,19.73401,300314
5452,tajchert,2,0.00067,59266,19.73468,300314
5453,Talador12,2,0.00067,59268,19.73534,300314
5454,tangcfrank,2,0.00067,59270,19.73601,300314
5455,taojwmware,2,0.00067,59272,19.73668,300314
5456,taozytroy,2,0.00067,59274,19.73734,300314
5457,tbobm,2,0.00067,59276,19.73801,300314
5458,TBSnapLogic,2,0.00067,59278,19.73867,300314
5459,Tchoupinax,2,0.00067,59280,19.73934,300314
5460,techknowlogick,2,0.00067,59282,19.74001,300314
5461,Tecktron,2,0.00067,59284,19.74067,300314
5462,tejohnson123,2,0.00067,59286,19.74134,300314
5463,Temikus,2,0.00067,59288,19.74200,300314
5464,tgulacsi,2,0.00067,59290,19.74267,300314
5465,ThaDaVos,2,0.00067,59292,19.74334,300314
5466,thanhpd-teko,2,0.00067,59294,19.74400,300314
5467,thao-wish,2,0.00067,59296,19.74467,300314
5468,theabmitra,2,0.00067,59298,19.74533,300314
5469,thecooldrop,2,0.00067,59300,19.74600,300314
5470,TheDiveO,2,0.00067,59302,19.74667,300314
5471,theduke,2,0.00067,59304,19.74733,300314
5472,TheNakedZealot,2,0.00067,59306,19.74800,300314
5473,theNewFlesh,2,0.00067,59308,19.74866,300314
5474,thesamet,2,0.00067,59310,19.74933,300314
5475,the-scott-hand,2,0.00067,59312,19.75000,300314
5476,thiago4int,2,0.00067,59314,19.75066,300314
5477,thibautcharry,2,0.00067,59316,19.75133,300314
5478,ThinkBriK,2,0.00067,59318,19.75199,300314
5479,this-is-r-gaurav,2,0.00067,59320,19.75266,300314
5480,thoism,2,0.00067,59322,19.75332,300314
5481,thomasdba,2,0.00067,59324,19.75399,300314
5482,ThomasRasmussen,2,0.00067,59326,19.75466,300314
5483,threestoneliu,2,0.00067,59328,19.75532,300314
5484,thyarles,2,0.00067,59330,19.75599,300314
5485,tigerlily-he,2,0.00067,59332,19.75665,300314
5486,till,2,0.00067,59334,19.75732,300314
5487,timmyers,2,0.00067,59336,19.75799,300314
5488,timonbimon,2,0.00067,59338,19.75865,300314
5489,tingeltangelthomas,2,0.00067,59340,19.75932,300314
5490,tjkirch,2,0.00067,59342,19.75998,300314
5491,tlamr,2,0.00067,59344,19.76065,300314
5492,tmitchell10,2,0.00067,59346,19.76132,300314
5493,tnguyen14,2,0.00067,59348,19.76198,300314
5494,tobiaskohlbau,2,0.00067,59350,19.76265,300314
5495,Tolsto,2,0.00067,59352,19.76331,300314
5496,ToMe25,2,0.00067,59354,19.76398,300314
5497,TomeHirata,2,0.00067,59356,19.76465,300314
5498,tom-halpin,2,0.00067,59358,19.76531,300314
5499,tomkivlin,2,0.00067,59360,19.76598,300314
5500,tommasopozzetti,2,0.00067,59362,19.76664,300314
5501,tomoveu,2,0.00067,59364,19.76731,300314
5502,toneill818,2,0.00067,59366,19.76798,300314
5503,tonglv,2,0.00067,59368,19.76864,300314
5504,tonial,2,0.00067,59370,19.76931,300314
5505,tonybenchsci,2,0.00067,59372,19.76997,300314
5506,tonyredondo,2,0.00067,59374,19.77064,300314
5507,topher1120,2,0.00067,59376,19.77131,300314
5508,torenware,2,0.00067,59378,19.77197,300314
5509,torgeirl,2,0.00067,59380,19.77264,300314
5510,tozka,2,0.00067,59382,19.77330,300314
5511,TPX01,2,0.00067,59384,19.77397,300314
5512,TracyRagan,2,0.00067,59386,19.77464,300314
5513,treid314,2,0.00067,59388,19.77530,300314
5514,trevor15,2,0.00067,59390,19.77597,300314
5515,trevorackerman,2,0.00067,59392,19.77663,300314
5516,triantium,2,0.00067,59394,19.77730,300314
5517,trierra,2,0.00067,59396,19.77797,300314
5518,trojandg,2,0.00067,59398,19.77863,300314
5519,trynity,2,0.00067,59400,19.77930,300314
5520,tsanders-rh,2,0.00067,59402,19.77996,300314
5521,tsibley,2,0.00067,59404,19.78063,300314
5522,tsmock,2,0.00067,59406,19.78130,300314
5523,tuptaker,2,0.00067,59408,19.78196,300314
5524,turbotankist,2,0.00067,59410,19.78263,300314
5525,tushar-dubey,2,0.00067,59412,19.78329,300314
5526,TvdW,2,0.00067,59414,19.78396,300314
5527,tverboon,2,0.00067,59416,19.78463,300314
5528,tweing,2,0.00067,59418,19.78529,300314
5529,tyggna,2,0.00067,59420,19.78596,300314
5530,tylern91,2,0.00067,59422,19.78662,300314
5531,Tzaphkiel,2,0.00067,59424,19.78729,300314
5532,Ubereil,2,0.00067,59426,19.78796,300314
5533,unnati914,2,0.00067,59428,19.78862,300314
5534,uo-no-cry,2,0.00067,59430,19.78929,300314
5535,uptownaravi,2,0.00067,59432,19.78995,300314
5536,usrlocalang,2,0.00067,59434,19.79062,300314
5537,ustrugany,2,0.00067,59436,19.79129,300314
5538,UtkarshMathur05,2,0.00067,59438,19.79195,300314
5539,utp887,2,0.00067,59440,19.79262,300314
5540,UXabre,2,0.00067,59442,19.79328,300314
5541,v1b1,2,0.00067,59444,19.79395,300314
5542,vajdaz,2,0.00067,59446,19.79461,300314
5543,valeraf23,2,0.00067,59448,19.79528,300314
5544,vanugrah,2,0.00067,59450,19.79595,300314
5545,VA-PLE,2,0.00067,59452,19.79661,300314
5546,vavallee,2,0.00067,59454,19.79728,300314
5547,vdimir,2,0.00067,59456,19.79794,300314
5548,vdksystem,2,0.00067,59458,19.79861,300314
5549,vengadanathan-s,2,0.00067,59460,19.79928,300314
5550,Vepk17,2,0.00067,59462,19.79994,300314
5551,vibgy,2,0.00067,59464,19.80061,300314
5552,VictorDC92,2,0.00067,59466,19.80127,300314
5553,vigohe,2,0.00067,59468,19.80194,300314
5554,viktoriaas,2,0.00067,59470,19.80261,300314
5555,vineshkamble,2,0.00067,59472,19.80327,300314
5556,viorelflorian,2,0.00067,59474,19.80394,300314
5557,vipulnewaskar7,2,0.00067,59476,19.80460,300314
5558,virenrshah,2,0.00067,59478,19.80527,300314
5559,vishutrilio,2,0.00067,59480,19.80594,300314
5560,vishwasKadam,2,0.00067,59482,19.80660,300314
5561,vitalyfilatov,2,0.00067,59484,19.80727,300314
5562,Vitorspk,2,0.00067,59486,19.80793,300314
5563,vizcay,2,0.00067,59488,19.80860,300314
5564,vk990,2,0.00067,59490,19.80927,300314
5565,vknelluri,2,0.00067,59492,19.80993,300314
5566,vkozjak,2,0.00067,59494,19.81060,300314
5567,vlad-ro,2,0.00067,59496,19.81126,300314
5568,vlopezferrando,2,0.00067,59498,19.81193,300314
5569,voidlily,2,0.00067,59500,19.81260,300314
5570,volwei,2,0.00067,59502,19.81326,300314
5571,VorobyevS,2,0.00067,59504,19.81393,300314
5572,Voultapher,2,0.00067,59506,19.81459,300314
5573,vrodomista,2,0.00067,59508,19.81526,300314
5574,vsafonkin,2,0.00067,59510,19.81593,300314
5575,vthk,2,0.00067,59512,19.81659,300314
5576,vukasin-nikodijevic,2,0.00067,59514,19.81726,300314
5577,vwedesam,2,0.00067,59516,19.81792,300314
5578,vzardlloo,2,0.00067,59518,19.81859,300314
5579,waiariki-koia,2,0.00067,59520,19.81926,300314
5580,walkbooth,2,0.00067,59522,19.81992,300314
5581,WANGJIANGA,2,0.00067,59524,19.82059,300314
5582,wangjianxiang,2,0.00067,59526,19.82125,300314
5583,wanglong001,2,0.00067,59528,19.82192,300314
5584,WangMosquito,2,0.00067,59530,19.82259,300314
5585,wangyd1988,2,0.00067,59532,19.82325,300314
5586,wangzhao765,2,0.00067,59534,19.82392,300314
5587,wasker,2,0.00067,59536,19.82458,300314
5588,watermelon-brother,2,0.00067,59538,19.82525,300314
5589,wavezhang,2,0.00067,59540,19.82592,300314
5590,waynesun09,2,0.00067,59542,19.82658,300314
5591,wazzamatazz,2,0.00067,59544,19.82725,300314
5592,wdv4758h,2,0.00067,59546,19.82791,300314
5593,Weil0ng,2,0.00067,59548,19.82858,300314
5594,wentao-zh,2,0.00067,59550,19.82925,300314
5595,WenxingLai,2,0.00067,59552,19.82991,300314
5596,wenxinlee2015,2,0.00067,59554,19.83058,300314
5597,wesleyhillyext,2,0.00067,59556,19.83124,300314
5598,willemswang,2,0.00067,59558,19.83191,300314
5599,williamcodes,2,0.00067,59560,19.83258,300314
5600,William-Luo0,2,0.00067,59562,19.83324,300314
5601,WilliamWCYoung,2,0.00067,59564,19.83391,300314
5602,will-sargent-eero,2,0.00067,59566,19.83457,300314
5603,wilminator,2,0.00067,59568,19.83524,300314
5604,wingatekr,2,0.00067,59570,19.83591,300314
5605,wingsofovnia,2,0.00067,59572,19.83657,300314
5606,winmillwill,2,0.00067,59574,19.83724,300314
5607,wiseelf,2,0.00067,59576,19.83790,300314
5608,wisheen,2,0.00067,59578,19.83857,300314
5609,WisWang,2,0.00067,59580,19.83923,300314
5610,witemple-msft,2,0.00067,59582,19.83990,300314
5611,withnale,2,0.00067,59584,19.84057,300314
5612,wochanda,2,0.00067,59586,19.84123,300314
5613,woelfman,2,0.00067,59588,19.84190,300314
5614,worcsrcsgg,2,0.00067,59590,19.84256,300314
5615,wouter2397,2,0.00067,59592,19.84323,300314
5616,woz5999,2,0.00067,59594,19.84390,300314
5617,wpwoodjr,2,0.00067,59596,19.84456,300314
5618,wsscc2021,2,0.00067,59598,19.84523,300314
5619,wswind,2,0.00067,59600,19.84589,300314
5620,wu105,2,0.00067,59602,19.84656,300314
5621,wuestkamp,2,0.00067,59604,19.84723,300314
5622,wvxvw,2,0.00067,59606,19.84789,300314
5623,wwitzel3,2,0.00067,59608,19.84856,300314
5624,xabufr,2,0.00067,59610,19.84922,300314
5625,xaionaro,2,0.00067,59612,19.84989,300314
5626,Xartos,2,0.00067,59614,19.85056,300314
5627,Xeiro,2,0.00067,59616,19.85122,300314
5628,XI1062-abhisheksinghal,2,0.00067,59618,19.85189,300314
5629,xianglujun,2,0.00067,59620,19.85255,300314
5630,XinYao1994,2,0.00067,59622,19.85322,300314
5631,xirzec,2,0.00067,59624,19.85389,300314
5632,xjtian,2,0.00067,59626,19.85455,300314
5633,Xphobia,2,0.00067,59628,19.85522,300314
5634,xtreme-jesse-malone,2,0.00067,59630,19.85588,300314
5635,xuanyuanaosheng,2,0.00067,59632,19.85655,300314
5636,xuhrc,2,0.00067,59634,19.85722,300314
5637,xuhui-lu,2,0.00067,59636,19.85788,300314
5638,xx132917,2,0.00067,59638,19.85855,300314
5639,xxx0624,2,0.00067,59640,19.85921,300314
5640,xybuty,2,0.00067,59642,19.85988,300314
5641,yakiduck,2,0.00067,59644,19.86055,300314
5642,yalctay93,2,0.00067,59646,19.86121,300314
5643,yan636,2,0.00067,59648,19.86188,300314
5644,YanivD,2,0.00067,59650,19.86254,300314
5645,yardensachs,2,0.00067,59652,19.86321,300314
5646,yartat,2,0.00067,59654,19.86388,300314
5647,yashpanchalecosmob,2,0.00067,59656,19.86454,300314
5648,yashwant121,2,0.00067,59658,19.86521,300314
5649,yasn77,2,0.00067,59660,19.86587,300314
5650,yasushi-saito,2,0.00067,59662,19.86654,300314
5651,Yatufo,2,0.00067,59664,19.86721,300314
5652,ycjcl868,2,0.00067,59666,19.86787,300314
5653,ydayagi,2,0.00067,59668,19.86854,300314
5654,yelhouti,2,0.00067,59670,19.86920,300314
5655,Yellow-L,2,0.00067,59672,19.86987,300314
5656,yimin-zhao,2,0.00067,59674,19.87054,300314
5657,yingjianjian,2,0.00067,59676,19.87120,300314
5658,ykulazhenkov,2,0.00067,59678,19.87187,300314
5659,ylamgarchal,2,0.00067,59680,19.87253,300314
5660,ymkins,2,0.00067,59682,19.87320,300314
5661,ynsta,2,0.00067,59684,19.87387,300314
5662,yokomizor,2,0.00067,59686,19.87453,300314
5663,yonch,2,0.00067,59688,19.87520,300314
5664,yosiat,2,0.00067,59690,19.87586,300314
5665,younes199511,2,0.00067,59692,19.87653,300314
5666,youngchaena,2,0.00067,59694,19.87720,300314
5667,younky-yang,2,0.00067,59696,19.87786,300314
5668,yovizzle,2,0.00067,59698,19.87853,300314
5669,ypl75,2,0.00067,59700,19.87919,300314
5670,ypyly,2,0.00067,59702,19.87986,300314
5671,Yriuns,2,0.00067,59704,19.88053,300314
5672,yspro,2,0.00067,59706,19.88119,300314
5673,YuFengxin229,2,0.00067,59708,19.88186,300314
5674,YuriiBarninets,2,0.00067,59710,19.88252,300314
5675,yuriydzobak,2,0.00067,59712,19.88319,300314
5676,yurkeen,2,0.00067,59714,19.88385,300314
5677,yurymuski,2,0.00067,59716,19.88452,300314
5678,yu-sun-77,2,0.00067,59718,19.88519,300314
5679,yuta-ron,2,0.00067,59720,19.88585,300314
5680,yuzhang17,2,0.00067,59722,19.88652,300314
5681,yuzujoe,2,0.00067,59724,19.88718,300314
5682,zacscoding,2,0.00067,59726,19.88785,300314
5683,zamog,2,0.00067,59728,19.88852,300314
5684,zasgar,2,0.00067,59730,19.88918,300314
5685,zcrisler,2,0.00067,59732,19.88985,300314
5686,zerols,2,0.00067,59734,19.89051,300314
5687,Zethzer,2,0.00067,59736,19.89118,300314
5688,zezaeoh,2,0.00067,59738,19.89185,300314
5689,zhaminglei,2,0.00067,59740,19.89251,300314
5690,zhanglei216,2,0.00067,59742,19.89318,300314
5691,zhaobei,2,0.00067,59744,19.89384,300314
5692,zhoney,2,0.00067,59746,19.89451,300314
5693,zhongqishang,2,0.00067,59748,19.89518,300314
5694,zhouwenbin00,2,0.00067,59750,19.89584,300314
5695,zhushenhang,2,0.00067,59752,19.89651,300314
5696,zhuyouzhufu,2,0.00067,59754,19.89717,300314
5697,zhxd163,2,0.00067,59756,19.89784,300314
5698,zifter,2,0.00067,59758,19.89851,300314
5699,zmapleshine,2,0.00067,59760,19.89917,300314
5700,zoemac11,2,0.00067,59762,19.89984,300314
5701,zsoltion,2,0.00067,59764,19.90050,300314
5702,ztaylor797,2,0.00067,59766,19.90117,300314
5703,zvier,2,0.00067,59768,19.90184,300314
5704,zwass,2,0.00067,59770,19.90250,300314
5705,zxdvd,2,0.00067,59772,19.90317,300314
5706,01000001-01001110,1,0.00033,59773,19.90350,300314
5707,0x0badc0de,1,0.00033,59774,19.90383,300314
5708,108356037,1,0.00033,59775,19.90417,300314
5709,123BLiN,1,0.00033,59776,19.90450,300314
5710,123xiaodong,1,0.00033,59777,19.90483,300314
5711,131,1,0.00033,59778,19.90517,300314
5712,13667285528,1,0.00033,59779,19.90550,300314
5713,16g,1,0.00033,59780,19.90583,300314
5714,1995parham,1,0.00033,59781,19.90616,300314
5715,1vanzamarripa,1,0.00033,59782,19.90650,300314
5716,20049941,1,0.00033,59783,19.90683,300314
5717,212850a,1,0.00033,59784,19.90716,300314
5718,21andrewmitchell,1,0.00033,59785,19.90750,300314
5719,24-komal,1,0.00033,59786,19.90783,300314
5720,44smkn,1,0.00033,59787,19.90816,300314
5721,542928492,1,0.00033,59788,19.90850,300314
5722,644755,1,0.00033,59789,19.90883,300314
5723,951p,1,0.00033,59790,19.90916,300314
5724,979156,1,0.00033,59791,19.90949,300314
5725,aabbdev,1,0.00033,59792,19.90983,300314
5726,Aaishpra,1,0.00033,59793,19.91016,300314
5727,AALOON,1,0.00033,59794,19.91049,300314
5728,aamirbutt,1,0.00033,59795,19.91083,300314
5729,aandryashin,1,0.00033,59796,19.91116,300314
5730,aandvalenzuela,1,0.00033,59797,19.91149,300314
5731,aantn,1,0.00033,59798,19.91183,300314
5732,Aaron-Gemperline,1,0.00033,59799,19.91216,300314
5733,aashankar,1,0.00033,59800,19.91249,300314
5734,abatilo,1,0.00033,59801,19.91282,300314
5735,abdellahseddikpro,1,0.00033,59802,19.91316,300314
5736,abdessamadrajad,1,0.00033,59803,19.91349,300314
5737,AberDerBart,1,0.00033,59804,19.91382,300314
5738,abhayJava,1,0.00033,59805,19.91416,300314
5739,abhaykatheria,1,0.00033,59806,19.91449,300314
5740,abhi14nexu,1,0.00033,59807,19.91482,300314
5741,abhi1git,1,0.00033,59808,19.91516,300314
5742,abhiabhi94,1,0.00033,59809,19.91549,300314
5743,abhichandra21,1,0.00033,59810,19.91582,300314
5744,abhinavthula,1,0.00033,59811,19.91615,300314
5745,abhinaybyrisetty,1,0.00033,59812,19.91649,300314
5746,abhishekdhotre,1,0.00033,59813,19.91682,300314
5747,abhishek-ramanujan,1,0.00033,59814,19.91715,300314
5748,abhisheksurpur2,1,0.00033,59815,19.91749,300314
5749,abkierstein,1,0.00033,59816,19.91782,300314
5750,ablx,1,0.00033,59817,19.91815,300314
5751,abonzo,1,0.00033,59818,19.91849,300314
5752,aboutte,1,0.00033,59819,19.91882,300314
5753,abstrask,1,0.00033,59820,19.91915,300314
5754,abudavis,1,0.00033,59821,19.91948,300314
5755,aca,1,0.00033,59822,19.91982,300314
5756,acamilleri,1,0.00033,59823,19.92015,300314
5757,achernev,1,0.00033,59824,19.92048,300314
5758,achichenin,1,0.00033,59825,19.92082,300314
5759,acmore,1,0.00033,59826,19.92115,300314
5760,acodetailor,1,0.00033,59827,19.92148,300314
5761,ad22,1,0.00033,59828,19.92182,300314
5762,adalrsjr1,1,0.00033,59829,19.92215,300314
5763,Adamak90,1,0.00033,59830,19.92248,300314
5764,adamdonahue,1,0.00033,59831,19.92281,300314
5765,AdamDorwart,1,0.00033,59832,19.92315,300314
5766,adamegyed,1,0.00033,59833,19.92348,300314
5767,adamhathcock,1,0.00033,59834,19.92381,300314
5768,Adam-Jin,1,0.00033,59835,19.92415,300314
5769,AdamSLevy,1,0.00033,59836,19.92448,300314
5770,adamulacha,1,0.00033,59837,19.92481,300314
5771,adduarte,1,0.00033,59838,19.92515,300314
5772,adedejisalim,1,0.00033,59839,19.92548,300314
5773,adeelahmadch,1,0.00033,59840,19.92581,300314
5774,adelbot,1,0.00033,59841,19.92614,300314
5775,adelca,1,0.00033,59842,19.92648,300314
5776,adelerhof,1,0.00033,59843,19.92681,300314
5777,adhocore,1,0.00033,59844,19.92714,300314
5778,adi0509,1,0.00033,59845,19.92748,300314
5779,adinaclaudia,1,0.00033,59846,19.92781,300314
5780,adithyapaib,1,0.00033,59847,19.92814,300314
5781,adityakakliya,1,0.00033,59848,19.92847,300314
5782,Adityawayve,1,0.00033,59849,19.92881,300314
5783,adream307,1,0.00033,59850,19.92914,300314
5784,adrianiacob22,1,0.00033,59851,19.92947,300314
5785,adrijshikhar,1,0.00033,59852,19.92981,300314
5786,adsilva-ivre,1,0.00033,59853,19.93014,300314
5787,adux6991,1,0.00033,59854,19.93047,300314
5788,adziura-ledger,1,0.00033,59855,19.93081,300314
5789,aelij,1,0.00033,59856,19.93114,300314
5790,aeriksson,1,0.00033,59857,19.93147,300314
5791,Aesylwinn,1,0.00033,59858,19.93180,300314
5792,afcollins,1,0.00033,59859,19.93214,300314
5793,afdesk,1,0.00033,59860,19.93247,300314
5794,afghanistanyn,1,0.00033,59861,19.93280,300314
5795,afine,1,0.00033,59862,19.93314,300314
5796,after99,1,0.00033,59863,19.93347,300314
5797,agramon-vu,1,0.00033,59864,19.93380,300314
5798,agutkin,1,0.00033,59865,19.93414,300314
5799,agwermann,1,0.00033,59866,19.93447,300314
5800,ahadjidj,1,0.00033,59867,19.93480,300314
5801,ahmedbouja,1,0.00033,59868,19.93513,300314
5802,ahmsb8884,1,0.00033,59869,19.93547,300314
5803,aholbreich,1,0.00033,59870,19.93580,300314
5804,ai2017,1,0.00033,59871,19.93613,300314
5805,aianus,1,0.00033,59872,19.93647,300314
5806,aidinhass,1,0.00033,59873,19.93680,300314
5807,aido93,1,0.00033,59874,19.93713,300314
5808,aikoven,1,0.00033,59875,19.93747,300314
5809,airbjorn,1,0.00033,59876,19.93780,300314
5810,airdry,1,0.00033,59877,19.93813,300314
5811,airhorns,1,0.00033,59878,19.93846,300314
5812,aitorpazos,1,0.00033,59879,19.93880,300314
5813,aiyijing,1,0.00033,59880,19.93913,300314
5814,ajay516,1,0.00033,59881,19.93946,300314
5815,ajaykumarmandapati,1,0.00033,59882,19.93980,300314
5816,ajaymaity,1,0.00033,59883,19.94013,300314
5817,ajonathan,1,0.00033,59884,19.94046,300314
5818,ajoskowski,1,0.00033,59885,19.94080,300314
5819,ajsalow,1,0.00033,59886,19.94113,300314
5820,ajsharma,1,0.00033,59887,19.94146,300314
5821,ak2766,1,0.00033,59888,19.94179,300314
5822,aka-achu,1,0.00033,59889,19.94213,300314
5823,akamac,1,0.00033,59890,19.94246,300314
5824,akamensky,1,0.00033,59891,19.94279,300314
5825,AkarshES,1,0.00033,59892,19.94313,300314
5826,AkarshSatija,1,0.00033,59893,19.94346,300314
5827,akowald,1,0.00033,59894,19.94379,300314
5828,aksenk,1,0.00033,59895,19.94413,300314
5829,akshayhiremath,1,0.00033,59896,19.94446,300314
5830,akshayn94,1,0.00033,59897,19.94479,300314
5831,al8ba,1,0.00033,59898,19.94512,300314
5832,aladdin-add,1,0.00033,59899,19.94546,300314
5833,Alan-Cha,1,0.00033,59900,19.94579,300314
5834,alanmiller,1,0.00033,59901,19.94612,300314
5835,alanrainer,1,0.00033,59902,19.94646,300314
5836,albertvimlet,1,0.00033,59903,19.94679,300314
5837,aldojimenez,1,0.00033,59904,19.94712,300314
5838,alejandro-delgado-garcia,1,0.00033,59905,19.94745,300314
5839,aleksandrovpa,1,0.00033,59906,19.94779,300314
5840,alekseiplotnikov,1,0.00033,59907,19.94812,300314
5841,aleskandro,1,0.00033,59908,19.94845,300314
5842,alessfg,1,0.00033,59909,19.94879,300314
5843,alexanderccc,1,0.00033,59910,19.94912,300314
5844,alexanderniebuhr,1,0.00033,59911,19.94945,300314
5845,alexanderturner,1,0.00033,59912,19.94979,300314
5846,AlexanderYastrebov,1,0.00033,59913,19.95012,300314
5847,AlexanderZhou01,1,0.00033,59914,19.95045,300314
5848,alexandru-ersenie,1,0.00033,59915,19.95078,300314
5849,alex-borkun,1,0.00033,59916,19.95112,300314
5850,alexcristi,1,0.00033,59917,19.95145,300314
5851,alexdepalex,1,0.00033,59918,19.95178,300314
5852,alexey-ban,1,0.00033,59919,19.95212,300314
5853,alexey-tr,1,0.00033,59920,19.95245,300314
5854,alexforster,1,0.00033,59921,19.95278,300314
5855,alexfrancavilla,1,0.00033,59922,19.95312,300314
5856,alexgleason,1,0.00033,59923,19.95345,300314
5857,alexksbr,1,0.00033,59924,19.95378,300314
5858,AlexOQ,1,0.00033,59925,19.95411,300314
5859,alexrashed,1,0.00033,59926,19.95445,300314
5860,alexrudd,1,0.00033,59927,19.95478,300314
5861,AlexStocks,1,0.00033,59928,19.95511,300314
5862,alexxed,1,0.00033,59929,19.95545,300314
5863,alialperak,1,0.00033,59930,19.95578,300314
5864,alidasomi,1,0.00033,59931,19.95611,300314
5865,alieunang,1,0.00033,59932,19.95645,300314
5866,alindada,1,0.00033,59933,19.95678,300314
5867,alirezarpi,1,0.00033,59934,19.95711,300314
5868,AlistairB,1,0.00033,59935,19.95744,300314
5869,alittlec,1,0.00033,59936,19.95778,300314
5870,allensiho,1,0.00033,59937,19.95811,300314
5871,almereyda,1,0.00033,59938,19.95844,300314
5872,alongfield,1,0.00033,59939,19.95878,300314
5873,alphakevin,1,0.00033,59940,19.95911,300314
5874,alphaWizard,1,0.00033,59941,19.95944,300314
5875,alphaxo,1,0.00033,59942,19.95978,300314
5876,altenx,1,0.00033,59943,19.96011,300314
5877,altonchuzhan,1,0.00033,59944,19.96044,300314
5878,alvinsw,1,0.00033,59945,19.96077,300314
5879,alxndr13,1,0.00033,59946,19.96111,300314
5880,Alxndr3,1,0.00033,59947,19.96144,300314
5881,Aman1994,1,0.00033,59948,19.96177,300314
5882,amandabhmg,1,0.00033,59949,19.96211,300314
5883,amanludhwaniatgithub,1,0.00033,59950,19.96244,300314
5884,amarbs,1,0.00033,59951,19.96277,300314
5885,a-marchenko,1,0.00033,59952,19.96311,300314
5886,amarine7882,1,0.00033,59953,19.96344,300314
5887,amaters-easy,1,0.00033,59954,19.96377,300314
5888,AmazingSkyLine,1,0.00033,59955,19.96410,300314
5889,amer-saffo-careem,1,0.00033,59956,19.96444,300314
5890,AmilaDevops,1,0.00033,59957,19.96477,300314
5891,amit4aws,1,0.00033,59958,19.96510,300314
5892,amitca71,1,0.00033,59959,19.96544,300314
5893,amitkatti,1,0.00033,59960,19.96577,300314
5894,amitlevy21,1,0.00033,59961,19.96610,300314
5895,amitmahbubani,1,0.00033,59962,19.96644,300314
5896,Amit-Prajapati,1,0.00033,59963,19.96677,300314
5897,amjad-Alhusseini,1,0.00033,59964,19.96710,300314
5898,amjanoni,1,0.00033,59965,19.96743,300314
5899,amk43,1,0.00033,59966,19.96777,300314
5900,ammerzon,1,0.00033,59967,19.96810,300314
5901,AmnaIrfan,1,0.00033,59968,19.96843,300314
5902,amouhadi,1,0.00033,59969,19.96877,300314
5903,amsoedal,1,0.00033,59970,19.96910,300314
5904,amukherj1,1,0.00033,59971,19.96943,300314
5905,AmundsenJunior,1,0.00033,59972,19.96976,300314
5906,anaconda2196,1,0.00033,59973,19.97010,300314
5907,Anand-Chandan,1,0.00033,59974,19.97043,300314
5908,anandnilkal,1,0.00033,59975,19.97076,300314
5909,anandsunderraman,1,0.00033,59976,19.97110,300314
5910,Ananya-1106,1,0.00033,59977,19.97143,300314
5911,ancientmodern,1,0.00033,59978,19.97176,300314
5912,andreas-ahman,1,0.00033,59979,19.97210,300314
5913,andreas-baus,1,0.00033,59980,19.97243,300314
5914,andreasgremm,1,0.00033,59981,19.97276,300314
5915,andreaspoldi,1,0.00033,59982,19.97309,300314
5916,andreibelov,1,0.00033,59983,19.97343,300314
5917,andrei-r-juniper,1,0.00033,59984,19.97376,300314
5918,andrei-verdes,1,0.00033,59985,19.97409,300314
5919,andrej-marec,1,0.00033,59986,19.97443,300314
5920,AndreKoepke,1,0.00033,59987,19.97476,300314
5921,andre-lx,1,0.00033,59988,19.97509,300314
5922,andremcdecarvalho,1,0.00033,59989,19.97543,300314
5923,AndresC46,1,0.00033,59990,19.97576,300314
5924,andresmazzo,1,0.00033,59991,19.97609,300314
5925,andrewjstone,1,0.00033,59992,19.97642,300314
5926,andrewk-iq,1,0.00033,59993,19.97676,300314
5927,andrewm659,1,0.00033,59994,19.97709,300314
5928,andrewmcgr,1,0.00033,59995,19.97742,300314
5929,andrewnazarov,1,0.00033,59996,19.97776,300314
5930,AndrewNiven,1,0.00033,59997,19.97809,300314
5931,AndrewOttavianoAbb,1,0.00033,59998,19.97842,300314
5932,andrew-pickin-epi,1,0.00033,59999,19.97876,300314
5933,AndreZiviani,1,0.00033,60000,19.97909,300314
5934,andridzi,1,0.00033,60001,19.97942,300314
5935,andriktr,1,0.00033,60002,19.97975,300314
5936,andruwa13,1,0.00033,60003,19.98009,300314
5937,andrzejczepiel,1,0.00033,60004,19.98042,300314
5938,Andycharalambous,1,0.00033,60005,19.98075,300314
5939,andydfleming,1,0.00033,60006,19.98109,300314
5940,andyxhadji,1,0.00033,60007,19.98142,300314
5941,aneeshpanoli,1,0.00033,60008,19.98175,300314
5942,angelmejiabrito,1,0.00033,60009,19.98209,300314
5943,angeloskaltsikis,1,0.00033,60010,19.98242,300314
5944,anhongyang125,1,0.00033,60011,19.98275,300314
5945,aNickPlx,1,0.00033,60012,19.98308,300314
5946,anilchandana,1,0.00033,60013,19.98342,300314
5947,anilkonduru,1,0.00033,60014,19.98375,300314
5948,anish-gupta1811,1,0.00033,60015,19.98408,300314
5949,ankitgaur-cer,1,0.00033,60016,19.98442,300314
5950,ankitjain87,1,0.00033,60017,19.98475,300314
5951,ankitm123,1,0.00033,60018,19.98508,300314
5952,ankitzm,1,0.00033,60019,19.98542,300314
5953,annabellegoth2boss,1,0.00033,60020,19.98575,300314
5954,anselmhou,1,0.00033,60021,19.98608,300314
5955,anshulsri12,1,0.00033,60022,19.98641,300314
5956,ansromanov,1,0.00033,60023,19.98675,300314
5957,anthonyrea,1,0.00033,60024,19.98708,300314
5958,anthraxn8b,1,0.00033,60025,19.98741,300314
5959,anthraxx,1,0.00033,60026,19.98775,300314
5960,antoine-duval,1,0.00033,60027,19.98808,300314
5961,antondollmaier,1,0.00033,60028,19.98841,300314
5962,antonimmo,1,0.00033,60029,19.98875,300314
5963,antoniobonifacio,1,0.00033,60030,19.98908,300314
5964,antoniocascais,1,0.00033,60031,19.98941,300314
5965,AntonioCayulao,1,0.00033,60032,19.98974,300314
5966,AntonioNaranjo1,1,0.00033,60033,19.99008,300314
5967,AntonOfTheWoods,1,0.00033,60034,19.99041,300314
5968,anupam128,1,0.00033,60035,19.99074,300314
5969,anupamdialpad,1,0.00033,60036,19.99108,300314
5970,anusha-kandepu,1,0.00033,60037,19.99141,300314
5971,anyname2,1,0.00033,60038,19.99174,300314
5972,Anynou,1,0.00033,60039,19.99207,300314
5973,apmartins85,1,0.00033,60040,19.99241,300314
5974,apo2k7,1,0.00033,60041,19.99274,300314
5975,Apokalypser,1,0.00033,60042,19.99307,300314
5976,Apon77,1,0.00033,60043,19.99341,300314
5977,APoniatowski,1,0.00033,60044,19.99374,300314
5978,apoorva11029,1,0.00033,60045,19.99407,300314
5979,appachhi,1,0.00033,60046,19.99441,300314
5980,appdashishmehta,1,0.00033,60047,19.99474,300314
5981,appleciderjack,1,0.00033,60048,19.99507,300314
5982,aradyaron,1,0.00033,60049,19.99540,300314
5983,araj-cloud,1,0.00033,60050,19.99574,300314
5984,arakis,1,0.00033,60051,19.99607,300314
5985,aramakrishnan19,1,0.00033,60052,19.99640,300314
5986,aramperes,1,0.00033,60053,19.99674,300314
5987,aravsun,1,0.00033,60054,19.99707,300314
5988,ArchieHunter,1,0.00033,60055,19.99740,300314
5989,argeas,1,0.00033,60056,19.99774,300314
5990,argvk,1,0.00033,60057,19.99807,300314
5991,Aricg,1,0.00033,60058,19.99840,300314
5992,arisjr,1,0.00033,60059,19.99873,300314
5993,AriSweedler,1,0.00033,60060,19.99907,300314
5994,arithmetic1728,1,0.00033,60061,19.99940,300314
5995,arj22,1,0.00033,60062,19.99973,300314
5996,arjaiswa,1,0.00033,60063,20.00007,300314
5997,arjav-desai,1,0.00033,60064,20.00040,300314
5998,arjunbiswas21289,1,0.00033,60065,20.00073,300314
5999,arjunkrishnasb,1,0.00033,60066,20.00107,300314
6000,arjunlondhey,1,0.00033,60067,20.00140,300314
6001,arkhipovds,1,0.00033,60068,20.00173,300314
6002,arl7,1,0.00033,60069,20.00206,300314
6003,arnaudlacour,1,0.00033,60070,20.00240,300314
6004,arnitolog,1,0.00033,60071,20.00273,300314
6005,aronneagu,1,0.00033,60072,20.00306,300314
6006,arora-kushal,1,0.00033,60073,20.00340,300314
6007,arramos84,1,0.00033,60074,20.00373,300314
6008,arrowfeng,1,0.00033,60075,20.00406,300314
6009,ars-burov,1,0.00033,60076,20.00440,300314
6010,arshiamalek,1,0.00033,60077,20.00473,300314
6011,arsiesys,1,0.00033,60078,20.00506,300314
6012,arthruwelkin,1,0.00033,60079,20.00539,300314
6013,artifactron,1,0.00033,60080,20.00573,300314
6014,artificial-aidan,1,0.00033,60081,20.00606,300314
6015,artiship,1,0.00033,60082,20.00639,300314
6016,Arttuv,1,0.00033,60083,20.00673,300314
6017,arturenault,1,0.00033,60084,20.00706,300314
6018,arul-gupta,1,0.00033,60085,20.00739,300314
6019,arul-jegadish,1,0.00033,60086,20.00773,300314
6020,arungeorge101,1,0.00033,60087,20.00806,300314
6021,arunlouie,1,0.00033,60088,20.00839,300314
6022,arun-vasudev,1,0.00033,60089,20.00872,300314
6023,arusso,1,0.00033,60090,20.00906,300314
6024,aryeh-looker,1,0.00033,60091,20.00939,300314
6025,asaaki,1,0.00033,60092,20.00972,300314
6026,asafm,1,0.00033,60093,20.01006,300314
6027,asarafi1,1,0.00033,60094,20.01039,300314
6028,asardaes,1,0.00033,60095,20.01072,300314
6029,asbiin,1,0.00033,60096,20.01106,300314
6030,aschaber1,1,0.00033,60097,20.01139,300314
6031,ascmt,1,0.00033,60098,20.01172,300314
6032,asddongmen,1,0.00033,60099,20.01205,300314
6033,ashfondu,1,0.00033,60100,20.01239,300314
6034,ashishsanjaysharma,1,0.00033,60101,20.01272,300314
6035,Ashjoker24,1,0.00033,60102,20.01305,300314
6036,ashlyrclark,1,0.00033,60103,20.01339,300314
6037,ashwanth1109,1,0.00033,60104,20.01372,300314
6038,asjanib,1,0.00033,60105,20.01405,300314
6039,asokone,1,0.00033,60106,20.01438,300314
6040,asw101,1,0.00033,60107,20.01472,300314
6041,athak,1,0.00033,60108,20.01505,300314
6042,a-thaler,1,0.00033,60109,20.01538,300314
6043,atitan,1,0.00033,60110,20.01572,300314
6044,atmask,1,0.00033,60111,20.01605,300314
6045,ATofighi,1,0.00033,60112,20.01638,300314
6046,attila123,1,0.00033,60113,20.01672,300314
6047,augustin-dt,1,0.00033,60114,20.01705,300314
6048,austinpray-mixpanel,1,0.00033,60115,20.01738,300314
6049,avacaru,1,0.00033,60116,20.01771,300314
6050,avairavan,1,0.00033,60117,20.01805,300314
6051,AvasDream,1,0.00033,60118,20.01838,300314
6052,avazhnov-griddynamics,1,0.00033,60119,20.01871,300314
6053,avinashkumar1289,1,0.00033,60120,20.01905,300314
6054,Avital1014,1,0.00033,60121,20.01938,300314
6055,avivgold098,1,0.00033,60122,20.01971,300314
6056,avvertix,1,0.00033,60123,20.02005,300314
6057,awcchungster,1,0.00033,60124,20.02038,300314
6058,awesomepras,1,0.00033,60125,20.02071,300314
6059,awiesner4,1,0.00033,60126,20.02104,300314
6060,axbarsan,1,0.00033,60127,20.02138,300314
6061,ayeganov,1,0.00033,60128,20.02171,300314
6062,aymericDD,1,0.00033,60129,20.02204,300314
6063,aytrack,1,0.00033,60130,20.02238,300314
6064,AyushmatiGit,1,0.00033,60131,20.02271,300314
6065,Ayzrian,1,0.00033,60132,20.02304,300314
6066,azepeda-caylent,1,0.00033,60133,20.02338,300314
6067,azui007,1,0.00033,60134,20.02371,300314
6068,b26,1,0.00033,60135,20.02404,300314
6069,b3nb1,1,0.00033,60136,20.02437,300314
6070,ba32107,1,0.00033,60137,20.02471,300314
6071,babo,1,0.00033,60138,20.02504,300314
6072,babyalpha-icentric,1,0.00033,60139,20.02537,300314
6073,bachradsusi,1,0.00033,60140,20.02571,300314
6074,bademux,1,0.00033,60141,20.02604,300314
6075,badrange,1,0.00033,60142,20.02637,300314
6076,BAGELreflex,1,0.00033,60143,20.02671,300314
6077,bahaa161,1,0.00033,60144,20.02704,300314
6078,bakalor,1,0.00033,60145,20.02737,300314
6079,bakshigit,1,0.00033,60146,20.02770,300314
6080,balazzii,1,0.00033,60147,20.02804,300314
6081,baldugus,1,0.00033,60148,20.02837,300314
6082,balnbibarbi,1,0.00033,60149,20.02870,300314
6083,bangbang2333,1,0.00033,60150,20.02904,300314
6084,banish1979,1,0.00033,60151,20.02937,300314
6085,bansalsurya,1,0.00033,60152,20.02970,300314
6086,Banyc,1,0.00033,60153,20.03004,300314
6087,baptiste-bonnaudet,1,0.00033,60154,20.03037,300314
6088,barbaluc,1,0.00033,60155,20.03070,300314
6089,barryrobison,1,0.00033,60156,20.03103,300314
6090,bartoszcisek,1,0.00033,60157,20.03137,300314
6091,barucoh,1,0.00033,60158,20.03170,300314
6092,bas2k,1,0.00033,60159,20.03203,300314
6093,BassFaceIV,1,0.00033,60160,20.03237,300314
6094,BassinD,1,0.00033,60161,20.03270,300314
6095,batodev,1,0.00033,60162,20.03303,300314
6096,baxiaoshi,1,0.00033,60163,20.03337,300314
6097,baygaillardclasspass,1,0.00033,60164,20.03370,300314
6098,bbarclay,1,0.00033,60165,20.03403,300314
6099,bbeausej,1,0.00033,60166,20.03436,300314
6100,bbockelm,1,0.00033,60167,20.03470,300314
6101,bboychev,1,0.00033,60168,20.03503,300314
6102,bchess,1,0.00033,60169,20.03536,300314
6103,bc-jcarlson,1,0.00033,60170,20.03570,300314
6104,bdsoha,1,0.00033,60171,20.03603,300314
6105,beandrad,1,0.00033,60172,20.03636,300314
6106,beatrausch,1,0.00033,60173,20.03669,300314
6107,beatsbybre,1,0.00033,60174,20.03703,300314
6108,beavenj,1,0.00033,60175,20.03736,300314
6109,beingamarnath,1,0.00033,60176,20.03769,300314
6110,BellonXiao,1,0.00033,60177,20.03803,300314
6111,belov3004,1,0.00033,60178,20.03836,300314
6112,belyaevsa,1,0.00033,60179,20.03869,300314
6113,Belyenochi,1,0.00033,60180,20.03903,300314
6114,ben1009,1,0.00033,60181,20.03936,300314
6115,benjah1,1,0.00033,60182,20.03969,300314
6116,benjamin658,1,0.00033,60183,20.04002,300314
6117,benny659,1,0.00033,60184,20.04036,300314
6118,bennyandresen,1,0.00033,60185,20.04069,300314
6119,benny-bp,1,0.00033,60186,20.04102,300314
6120,BenoitKnecht,1,0.00033,60187,20.04136,300314
6121,BENSARI-Fathi,1,0.00033,60188,20.04169,300314
6122,bensusman,1,0.00033,60189,20.04202,300314
6123,bentastic27,1,0.00033,60190,20.04236,300314
6124,berlin-ab,1,0.00033,60191,20.04269,300314
6125,berteundamman,1,0.00033,60192,20.04302,300314
6126,BetimBeja,1,0.00033,60193,20.04335,300314
6127,betterphp,1,0.00033,60194,20.04369,300314
6128,BEvgeniyS,1,0.00033,60195,20.04402,300314
6129,bfarayev,1,0.00033,60196,20.04435,300314
6130,bfelaco,1,0.00033,60197,20.04469,300314
6131,Bfoster-melrok,1,0.00033,60198,20.04502,300314
6132,bfreuden,1,0.00033,60199,20.04535,300314
6133,bgarber,1,0.00033,60200,20.04569,300314
6134,bgjoseluis,1,0.00033,60201,20.04602,300314
6135,bgulla,1,0.00033,60202,20.04635,300314
6136,bgweber,1,0.00033,60203,20.04668,300314
6137,bhamail,1,0.00033,60204,20.04702,300314
6138,bharathramaprasad-okta,1,0.00033,60205,20.04735,300314
6139,BhaRgav-MoRadiya,1,0.00033,60206,20.04768,300314
6140,bharrisaurora,1,0.00033,60207,20.04802,300314
6141,Bhashit,1,0.00033,60208,20.04835,300314
6142,bhops,1,0.00033,60209,20.04868,300314
6143,bhxandr,1,0.00033,60210,20.04902,300314
6144,bigbrovar,1,0.00033,60211,20.04935,300314
6145,bil9000,1,0.00033,60212,20.04968,300314
6146,bin-chen-techlabs,1,0.00033,60213,20.05001,300314
6147,Bingwenlin,1,0.00033,60214,20.05035,300314
6148,binhvcom,1,0.00033,60215,20.05068,300314
6149,BioGeek,1,0.00033,60216,20.05101,300314
6150,biomassa7x,1,0.00033,60217,20.05135,300314
6151,biostone,1,0.00033,60218,20.05168,300314
6152,biqas,1,0.00033,60219,20.05201,300314
6153,bisakhmondal,1,0.00033,60220,20.05235,300314
6154,bishoybassem,1,0.00033,60221,20.05268,300314
6155,bistaastha,1,0.00033,60222,20.05301,300314
6156,Biswajee,1,0.00033,60223,20.05334,300314
6157,bitsofishan,1,0.00033,60224,20.05368,300314
6158,bitti,1,0.00033,60225,20.05401,300314
6159,bittrance,1,0.00033,60226,20.05434,300314
6160,bitvilag,1,0.00033,60227,20.05468,300314
6161,bkaimal,1,0.00033,60228,20.05501,300314
6162,bkbwese,1,0.00033,60229,20.05534,300314
6163,Blackclaws,1,0.00033,60230,20.05568,300314
6164,blackgold,1,0.00033,60231,20.05601,300314
6165,blackluck,1,0.00033,60232,20.05634,300314
6166,blacksd,1,0.00033,60233,20.05667,300314
6167,blained3,1,0.00033,60234,20.05701,300314
6168,blaluc,1,0.00033,60235,20.05734,300314
6169,blanet,1,0.00033,60236,20.05767,300314
6170,blanorama,1,0.00033,60237,20.05801,300314
6171,blayet,1,0.00033,60238,20.05834,300314
6172,blejdfist,1,0.00033,60239,20.05867,300314
6173,Blondbadass,1,0.00033,60240,20.05900,300314
6174,bloodberrys,1,0.00033,60241,20.05934,300314
6175,BloodyIron,1,0.00033,60242,20.05967,300314
6176,Bluefitdev,1,0.00033,60243,20.06000,300314
6177,BlueIcarus,1,0.00033,60244,20.06034,300314
6178,bluejam0303,1,0.00033,60245,20.06067,300314
6179,bluemalkin,1,0.00033,60246,20.06100,300314
6180,bluzioo,1,0.00033,60247,20.06134,300314
6181,bm13kk,1,0.00033,60248,20.06167,300314
6182,b-mad,1,0.00033,60249,20.06200,300314
6183,bmalynovytch,1,0.00033,60250,20.06233,300314
6184,bmidgley,1,0.00033,60251,20.06267,300314
6185,bnb,1,0.00033,60252,20.06300,300314
6186,bo0ts,1,0.00033,60253,20.06333,300314
6187,bob-bins,1,0.00033,60254,20.06367,300314
6188,bobbygryzynger,1,0.00033,60255,20.06400,300314
6189,bobbymlp,1,0.00033,60256,20.06433,300314
6190,bobleujr,1,0.00033,60257,20.06467,300314
6191,bodilb,1,0.00033,60258,20.06500,300314
6192,bogd,1,0.00033,60259,20.06533,300314
6193,boindil,1,0.00033,60260,20.06566,300314
6194,bolsunovskyi,1,0.00033,60261,20.06600,300314
6195,bongo360,1,0.00033,60262,20.06633,300314
6196,BoOgatti,1,0.00033,60263,20.06666,300314
6197,boogiefromzk,1,0.00033,60264,20.06700,300314
6198,boonyong-appspace,1,0.00033,60265,20.06733,300314
6199,BoopBoopBeepBoop,1,0.00033,60266,20.06766,300314
6200,bortek,1,0.00033,60267,20.06800,300314
6201,Boskovits,1,0.00033,60268,20.06833,300314
6202,BoxuanChen,1,0.00033,60269,20.06866,300314
6203,bozoli,1,0.00033,60270,20.06899,300314
6204,bpalaya,1,0.00033,60271,20.06933,300314
6205,bpb54321,1,0.00033,60272,20.06966,300314
6206,bpickard22,1,0.00033,60273,20.06999,300314
6207,bplasmeijer,1,0.00033,60274,20.07033,300314
6208,bplaxco,1,0.00033,60275,20.07066,300314
6209,bpstelios10,1,0.00033,60276,20.07099,300314
6210,bputt-e,1,0.00033,60277,20.07133,300314
6211,bradfol,1,0.00033,60278,20.07166,300314
6212,BradleyBoutcher,1,0.00033,60279,20.07199,300314
6213,brahmastra-1305,1,0.00033,60280,20.07232,300314
6214,brandonbloom,1,0.00033,60281,20.07266,300314
6215,brandon-dd,1,0.00033,60282,20.07299,300314
6216,brandon-leapyear,1,0.00033,60283,20.07332,300314
6217,brandon-miles,1,0.00033,60284,20.07366,300314
6218,BrandonWeng,1,0.00033,60285,20.07399,300314
6219,breunigs,1,0.00033,60286,20.07432,300314
6220,briancaffey,1,0.00033,60287,20.07466,300314
6221,brian-fa,1,0.00033,60288,20.07499,300314
6222,Brian-McM,1,0.00033,60289,20.07532,300314
6223,brianmoore180,1,0.00033,60290,20.07565,300314
6224,brianpsr,1,0.00033,60291,20.07599,300314
6225,brkane,1,0.00033,60292,20.07632,300314
6226,brobare,1,0.00033,60293,20.07665,300314
6227,brodmerkle,1,0.00033,60294,20.07699,300314
6228,browgregpa,1,0.00033,60295,20.07732,300314
6229,brskq,1,0.00033,60296,20.07765,300314
6230,brucetech627,1,0.00033,60297,20.07799,300314
6231,brumer,1,0.00033,60298,20.07832,300314
6232,brumhard,1,0.00033,60299,20.07865,300314
6233,brunda27anaji,1,0.00033,60300,20.07898,300314
6234,bruno-anjos,1,0.00033,60301,20.07932,300314
6235,brunoripa,1,0.00033,60302,20.07965,300314
6236,bryanhuntesl,1,0.00033,60303,20.07998,300314
6237,bryanisgreat,1,0.00033,60304,20.08032,300314
6238,bs444,1,0.00033,60305,20.08065,300314
6239,bspark8,1,0.00033,60306,20.08098,300314
6240,bssantiago,1,0.00033,60307,20.08131,300314
6241,bstrdsmkr,1,0.00033,60308,20.08165,300314
6242,btinnel,1,0.00033,60309,20.08198,300314
6243,bts-verta,1,0.00033,60310,20.08231,300314
6244,bubba,1,0.00033,60311,20.08265,300314
6245,buckner,1,0.00033,60312,20.08298,300314
6246,buggyhunter,1,0.00033,60313,20.08331,300314
6247,bumarcell,1,0.00033,60314,20.08365,300314
6248,bunny98,1,0.00033,60315,20.08398,300314
6249,butterycroissant,1,0.00033,60316,20.08431,300314
6250,bverschueren,1,0.00033,60317,20.08464,300314
6251,bweissman,1,0.00033,60318,20.08498,300314
6252,bwh-mind,1,0.00033,60319,20.08531,300314
6253,bwobbones,1,0.00033,60320,20.08564,300314
6254,bwoolf1,1,0.00033,60321,20.08598,300314
6255,bynare,1,0.00033,60322,20.08631,300314
6256,byustephen,1,0.00033,60323,20.08664,300314
6257,c0ffeec0der,1,0.00033,60324,20.08698,300314
6258,c3ivodujmovic,1,0.00033,60325,20.08731,300314
6259,c4m4,1,0.00033,60326,20.08764,300314
6260,Cablerun,1,0.00033,60327,20.08797,300314
6261,cacorriere,1,0.00033,60328,20.08831,300314
6262,caihy05,1,0.00033,60329,20.08864,300314
6263,caiorcferreira,1,0.00033,60330,20.08897,300314
6264,cakiem8x,1,0.00033,60331,20.08931,300314
6265,cakoolen,1,0.00033,60332,20.08964,300314
6266,calebespinoza,1,0.00033,60333,20.08997,300314
6267,callmeadi,1,0.00033,60334,20.09031,300314
6268,cambierr,1,0.00033,60335,20.09064,300314
6269,CameronNemo,1,0.00033,60336,20.09097,300314
6270,CamilleGR,1,0.00033,60337,20.09130,300314
6271,cangchen8180,1,0.00033,60338,20.09164,300314
6272,CannibalVox,1,0.00033,60339,20.09197,300314
6273,CaptainFreak,1,0.00033,60340,20.09230,300314
6274,cardosocristian,1,0.00033,60341,20.09264,300314
6275,Carlangueitor,1,0.00033,60342,20.09297,300314
6276,carlocab,1,0.00033,60343,20.09330,300314
6277,carlosrmendes,1,0.00033,60344,20.09364,300314
6278,carolili,1,0.00033,60345,20.09397,300314
6279,carroarmato0,1,0.00033,60346,20.09430,300314
6280,carryonrewardless,1,0.00033,60347,20.09463,300314
6281,carte7000,1,0.00033,60348,20.09497,300314
6282,caryan,1,0.00033,60349,20.09530,300314
6283,castarco,1,0.00033,60350,20.09563,300314
6284,CatalinAdlerDF,1,0.00033,60351,20.09597,300314
6285,catfalls,1,0.00033,60352,20.09630,300314
6286,catija,1,0.00033,60353,20.09663,300314
6287,CBenoit,1,0.00033,60354,20.09697,300314
6288,cbishopvelti,1,0.00033,60355,20.09730,300314
6289,cboyle-vmware,1,0.00033,60356,20.09763,300314
6290,ccampo133,1,0.00033,60357,20.09796,300314
6291,ccc7574,1,0.00033,60358,20.09830,300314
6292,ccmcbeck,1,0.00033,60359,20.09863,300314
6293,ccmwa,1,0.00033,60360,20.09896,300314
6294,ccw1078,1,0.00033,60361,20.09930,300314
6295,ccww552017,1,0.00033,60362,20.09963,300314
6296,cdelacruzpinto,1,0.00033,60363,20.09996,300314
6297,cdevrell,1,0.00033,60364,20.10030,300314
6298,cebidhem,1,0.00033,60365,20.10063,300314
6299,cede87,1,0.00033,60366,20.10096,300314
6300,cedriclaudrel,1,0.00033,60367,20.10129,300314
6301,cedws,1,0.00033,60368,20.10163,300314
6302,CeeBeeCee,1,0.00033,60369,20.10196,300314
6303,ceekumar,1,0.00033,60370,20.10229,300314
6304,Celebrate-future,1,0.00033,60371,20.10263,300314
6305,CezarManea,1,0.00033,60372,20.10296,300314
6306,cfilleke,1,0.00033,60373,20.10329,300314
6307,cfraenkel,1,0.00033,60374,20.10362,300314
6308,cfredri4,1,0.00033,60375,20.10396,300314
6309,cgafool,1,0.00033,60376,20.10429,300314
6310,cgawron1,1,0.00033,60377,20.10462,300314
6311,cg-cri-gl,1,0.00033,60378,20.10496,300314
6312,cguertin14,1,0.00033,60379,20.10529,300314
6313,Chainsaw-does-brr,1,0.00033,60380,20.10562,300314
6314,chaiyd,1,0.00033,60381,20.10596,300314
6315,chalcrow,1,0.00033,60382,20.10629,300314
6316,champak,1,0.00033,60383,20.10662,300314
6317,Champ-Goblem,1,0.00033,60384,20.10695,300314
6318,chanced,1,0.00033,60385,20.10729,300314
6319,chandankashyap19,1,0.00033,60386,20.10762,300314
6320,ChangYinHan,1,0.00033,60387,20.10795,300314
6321,ChAnYaNG97,1,0.00033,60388,20.10829,300314
6322,chao1301,1,0.00033,60389,20.10862,300314
6323,chaoscn,1,0.00033,60390,20.10895,300314
6324,chaosunsfx,1,0.00033,60391,20.10929,300314
6325,charconstpointer,1,0.00033,60392,20.10962,300314
6326,CharleyHsiung,1,0.00033,60393,20.10995,300314
6327,charliedmcb,1,0.00033,60394,20.11028,300314
6328,CharlieReitzel,1,0.00033,60395,20.11062,300314
6329,charnet1019,1,0.00033,60396,20.11095,300314
6330,chauhanshubham,1,0.00033,60397,20.11128,300314
6331,CHCP,1,0.00033,60398,20.11162,300314
6332,cheddarwhizzy,1,0.00033,60399,20.11195,300314
6333,CheesyFeet,1,0.00033,60400,20.11228,300314
6334,chelomontilla,1,0.00033,60401,20.11262,300314
6335,chema-cabana,1,0.00033,60402,20.11295,300314
6336,chengtangzheng2021,1,0.00033,60403,20.11328,300314
6337,ChenHaoHu,1,0.00033,60404,20.11361,300314
6338,chenmin1992,1,0.00033,60405,20.11395,300314
6339,chenxianpao,1,0.00033,60406,20.11428,300314
6340,chenyahui,1,0.00033,60407,20.11461,300314
6341,chewi,1,0.00033,60408,20.11495,300314
6342,chilicat,1,0.00033,60409,20.11528,300314
6343,ChillinSpines666,1,0.00033,60410,20.11561,300314
6344,chillosu,1,0.00033,60411,20.11595,300314
6345,Chinaren-Wei,1,0.00033,60412,20.11628,300314
6346,chittu11,1,0.00033,60413,20.11661,300314
6347,chiwenchen,1,0.00033,60414,20.11694,300314
6348,chokhareganesh,1,0.00033,60415,20.11728,300314
6349,cho-m,1,0.00033,60416,20.11761,300314
6350,chr-b,1,0.00033,60417,20.11794,300314
6351,chris93111,1,0.00033,60418,20.11828,300314
6352,chris-barbour-as,1,0.00033,60419,20.11861,300314
6353,ChrisCooney1,1,0.00033,60420,20.11894,300314
6354,ChrisEdel,1,0.00033,60421,20.11928,300314
6355,chrisedrego,1,0.00033,60422,20.11961,300314
6356,chrisguest75,1,0.00033,60423,20.11994,300314
6357,ChrisHaPunkt,1,0.00033,60424,20.12027,300314
6358,chris-heath,1,0.00033,60425,20.12061,300314
6359,ChrisJBurns,1,0.00033,60426,20.12094,300314
6360,chrisk700,1,0.00033,60427,20.12127,300314
6361,chrisliu1995,1,0.00033,60428,20.12161,300314
6362,chrismetz09,1,0.00033,60429,20.12194,300314
6363,chrispduck,1,0.00033,60430,20.12227,300314
6364,chrisroat,1,0.00033,60431,20.12261,300314
6365,christian-korneck,1,0.00033,60432,20.12294,300314
6366,christianr11,1,0.00033,60433,20.12327,300314
6367,ChristopheBougere,1,0.00033,60434,20.12360,300314
6368,ChristopherPisz,1,0.00033,60435,20.12394,300314
6369,chris-tw-m,1,0.00033,60436,20.12427,300314
6370,ChrisZieba,1,0.00033,60437,20.12460,300314
6371,chrko,1,0.00033,60438,20.12494,300314
6372,chuanqisun,1,0.00033,60439,20.12527,300314
6373,chuanran,1,0.00033,60440,20.12560,300314
6374,chughes29,1,0.00033,60441,20.12593,300314
6375,chutz,1,0.00033,60442,20.12627,300314
6376,cianiandreadev,1,0.00033,60443,20.12660,300314
6377,cijohnson,1,0.00033,60444,20.12693,300314
6378,cindy-lt,1,0.00033,60445,20.12727,300314
6379,cippaciong,1,0.00033,60446,20.12760,300314
6380,circulosmeos,1,0.00033,60447,20.12793,300314
6381,cist,1,0.00033,60448,20.12827,300314
6382,cjbaar,1,0.00033,60449,20.12860,300314
6383,cjdelisle,1,0.00033,60450,20.12893,300314
6384,cjreyn,1,0.00033,60451,20.12926,300314
6385,ckadiyala,1,0.00033,60452,20.12960,300314
6386,ckeragala,1,0.00033,60453,20.12993,300314
6387,ckulacoglu,1,0.00033,60454,20.13026,300314
6388,cl51287,1,0.00033,60455,20.13060,300314
6389,ClareChu,1,0.00033,60456,20.13093,300314
6390,clarkzinzow,1,0.00033,60457,20.13126,300314
6391,clayvan,1,0.00033,60458,20.13160,300314
6392,cldfzn,1,0.00033,60459,20.13193,300314
6393,clearclaw,1,0.00033,60460,20.13226,300314
6394,cleardemon,1,0.00033,60461,20.13259,300314
6395,clementnuss,1,0.00033,60462,20.13293,300314
6396,cleverndbest,1,0.00033,60463,20.13326,300314
6397,clock21am,1,0.00033,60464,20.13359,300314
6398,clong-,1,0.00033,60465,20.13393,300314
6399,cloud-66,1,0.00033,60466,20.13426,300314
6400,cloudbow,1,0.00033,60467,20.13459,300314
6401,CloudXiaobai,1,0.00033,60468,20.13493,300314
6402,clundquist-stripe,1,0.00033,60469,20.13526,300314
6403,cmaster11,1,0.00033,60470,20.13559,300314
6404,cmonty14,1,0.00033,60471,20.13592,300314
6405,cn-sunletian,1,0.00033,60472,20.13626,300314
6406,cobb-tx,1,0.00033,60473,20.13659,300314
6407,Cobertos,1,0.00033,60474,20.13692,300314
6408,cocheok,1,0.00033,60475,20.13726,300314
6409,Coconut105,1,0.00033,60476,20.13759,300314
6410,cocoonkid,1,0.00033,60477,20.13792,300314
6411,codeandmedia,1,0.00033,60478,20.13826,300314
6412,codemanufaktur,1,0.00033,60479,20.13859,300314
6413,coder0028,1,0.00033,60480,20.13892,300314
6414,coder2213,1,0.00033,60481,20.13925,300314
6415,codergs90,1,0.00033,60482,20.13959,300314
6416,CoderPoet,1,0.00033,60483,20.13992,300314
6417,codesuperstarr,1,0.00033,60484,20.14025,300314
6418,codexetreme,1,0.00033,60485,20.14059,300314
6419,codi0987,1,0.00033,60486,20.14092,300314
6420,cokegen,1,0.00033,60487,20.14125,300314
6421,colearendt,1,0.00033,60488,20.14159,300314
6422,collimarco,1,0.00033,60489,20.14192,300314
6423,colprog,1,0.00033,60490,20.14225,300314
6424,comotion,1,0.00033,60491,20.14258,300314
6425,comphilip,1,0.00033,60492,20.14292,300314
6426,computerphilosopher,1,0.00033,60493,20.14325,300314
6427,ConeyLiu,1,0.00033,60494,20.14358,300314
6428,congim,1,0.00033,60495,20.14392,300314
6429,ConnorDY,1,0.00033,60496,20.14425,300314
6430,cookiengineer,1,0.00033,60497,20.14458,300314
6431,CormickKneey,1,0.00033,60498,20.14491,300314
6432,cosmingugoasa,1,0.00033,60499,20.14525,300314
6433,cospotato,1,0.00033,60500,20.14558,300314
6434,costiser,1,0.00033,60501,20.14591,300314
6435,couling,1,0.00033,60502,20.14625,300314
6436,courageJ,1,0.00033,60503,20.14658,300314
6437,coury-clark,1,0.00033,60504,20.14691,300314
6438,covalentbond,1,0.00033,60505,20.14725,300314
6439,Covariance,1,0.00033,60506,20.14758,300314
6440,cpdeethree,1,0.00033,60507,20.14791,300314
6441,cpflaume,1,0.00033,60508,20.14824,300314
6442,cpl,1,0.00033,60509,20.14858,300314
6443,cppforlife,1,0.00033,60510,20.14891,300314
6444,crablab,1,0.00033,60511,20.14924,300314
6445,crapson0889,1,0.00033,60512,20.14958,300314
6446,CrazyMushu,1,0.00033,60513,20.14991,300314
6447,Creatone,1,0.00033,60514,20.15024,300314
6448,crechandan,1,0.00033,60515,20.15058,300314
6449,criescrisis,1,0.00033,60516,20.15091,300314
6450,crpotter,1,0.00033,60517,20.15124,300314
6451,cscurtesc,1,0.00033,60518,20.15157,300314
6452,csi0n,1,0.00033,60519,20.15191,300314
6453,csib,1,0.00033,60520,20.15224,300314
6454,csmykay,1,0.00033,60521,20.15257,300314
6455,ctalledo,1,0.00033,60522,20.15291,300314
6456,cThrice,1,0.00033,60523,20.15324,300314
6457,cuongrep,1,0.00033,60524,20.15357,300314
6458,curtisr7,1,0.00033,60525,20.15391,300314
6459,curusarn,1,0.00033,60526,20.15424,300314
6460,cutecutecat,1,0.00033,60527,20.15457,300314
6461,cuttingedge1109,1,0.00033,60528,20.15490,300314
6462,cwijnekus,1,0.00033,60529,20.15524,300314
6463,cwildman,1,0.00033,60530,20.15557,300314
6464,cybacolt,1,0.00033,60531,20.15590,300314
6465,cyberbliss,1,0.00033,60532,20.15624,300314
6466,Cyb-Shubham,1,0.00033,60533,20.15657,300314
6467,CyprianFusi,1,0.00033,60534,20.15690,300314
6468,CyrilAll,1,0.00033,60535,20.15724,300314
6469,CyrilDevOps,1,0.00033,60536,20.15757,300314
6470,Cytrian,1,0.00033,60537,20.15790,300314
6471,czerasz,1,0.00033,60538,20.15823,300314
6472,czhu-wish,1,0.00033,60539,20.15857,300314
6473,D1abloRUS,1,0.00033,60540,20.15890,300314
6474,dabeeeenster,1,0.00033,60541,20.15923,300314
6475,dabing1986,1,0.00033,60542,20.15957,300314
6476,DadaHiT,1,0.00033,60543,20.15990,300314
6477,dafenko,1,0.00033,60544,20.16023,300314
6478,dagobertdocker,1,0.00033,60545,20.16057,300314
6479,dajulia3,1,0.00033,60546,20.16090,300314
6480,damoncheng,1,0.00033,60547,20.16123,300314
6481,Danafrid,1,0.00033,60548,20.16156,300314
6482,dandlake,1,0.00033,60549,20.16190,300314
6483,DangChien,1,0.00033,60550,20.16223,300314
6484,DanGritter,1,0.00033,60551,20.16256,300314
6485,danielamlins,1,0.00033,60552,20.16290,300314
6486,danielchicote,1,0.00033,60553,20.16323,300314
6487,Daniel-Fan,1,0.00033,60554,20.16356,300314
6488,danielfernandez,1,0.00033,60555,20.16390,300314
6489,danielgblanco,1,0.00033,60556,20.16423,300314
6490,DanielGorlo,1,0.00033,60557,20.16456,300314
6491,danielhabakkuk,1,0.00033,60558,20.16489,300314
6492,daniel-shukuya,1,0.00033,60559,20.16523,300314
6493,daniel-sullivan,1,0.00033,60560,20.16556,300314
6494,danielwindit,1,0.00033,60561,20.16589,300314
6495,danilo-lopes,1,0.00033,60562,20.16623,300314
6496,danilomo,1,0.00033,60563,20.16656,300314
6497,DanilStepa,1,0.00033,60564,20.16689,300314
6498,danisafta,1,0.00033,60565,20.16722,300314
6499,dan-j,1,0.00033,60566,20.16756,300314
6500,dan-m8t,1,0.00033,60567,20.16789,300314
6501,DannyKR,1,0.00033,60568,20.16822,300314
6502,dannystommen,1,0.00033,60569,20.16856,300314
6503,danquah,1,0.00033,60570,20.16889,300314
6504,dant24,1,0.00033,60571,20.16922,300314
6505,danthegoodman1,1,0.00033,60572,20.16956,300314
6506,dany74q,1,0.00033,60573,20.16989,300314
6507,dapolloxp,1,0.00033,60574,20.17022,300314
6508,darc1,1,0.00033,60575,20.17055,300314
6509,darioef,1,0.00033,60576,20.17089,300314
6510,darkstone-delivery,1,0.00033,60577,20.17122,300314
6511,darktempla,1,0.00033,60578,20.17155,300314
6512,darkTomz,1,0.00033,60579,20.17189,300314
6513,darodriguez,1,0.00033,60580,20.17222,300314
6514,darrenjennings,1,0.00033,60581,20.17255,300314
6515,dash042,1,0.00033,60582,20.17289,300314
6516,dashingsat,1,0.00033,60583,20.17322,300314
6517,Dashrath18,1,0.00033,60584,20.17355,300314
6518,data-dude,1,0.00033,60585,20.17388,300314
6519,daugustin,1,0.00033,60586,20.17422,300314
6520,davecozz,1,0.00033,60587,20.17455,300314
6521,davedoering,1,0.00033,60588,20.17488,300314
6522,davehouser1,1,0.00033,60589,20.17522,300314
6523,davendu,1,0.00033,60590,20.17555,300314
6524,davesave,1,0.00033,60591,20.17588,300314
6525,Davetech74,1,0.00033,60592,20.17622,300314
6526,davidazael,1,0.00033,60593,20.17655,300314
6527,david-becher,1,0.00033,60594,20.17688,300314
6528,davidboweninrupt,1,0.00033,60595,20.17721,300314
6529,davide-bolcioni,1,0.00033,60596,20.17755,300314
6530,davidfernandezm,1,0.00033,60597,20.17788,300314
6531,davidfloresv,1,0.00033,60598,20.17821,300314
6532,david-freistrom,1,0.00033,60599,20.17855,300314
6533,davidhoelzel,1,0.00033,60600,20.17888,300314
6534,davidkulak,1,0.00033,60601,20.17921,300314
6535,davidlanouette,1,0.00033,60602,20.17955,300314
6536,davidnewhall,1,0.00033,60603,20.17988,300314
6537,DavidNix,1,0.00033,60604,20.18021,300314
6538,davidpestana,1,0.00033,60605,20.18054,300314
6539,davidshen84,1,0.00033,60606,20.18088,300314
6540,DavidSpek,1,0.00033,60607,20.18121,300314
6541,DavidUser,1,0.00033,60608,20.18154,300314
6542,daviwil2,1,0.00033,60609,20.18188,300314
6543,dawncold,1,0.00033,60610,20.18221,300314
6544,DawnElixir,1,0.00033,60611,20.18254,300314
6545,dbarreda,1,0.00033,60612,20.18288,300314
6546,dbbhat,1,0.00033,60613,20.18321,300314
6547,dbettin,1,0.00033,60614,20.18354,300314
6548,DBX12,1,0.00033,60615,20.18387,300314
6549,dcharbon,1,0.00033,60616,20.18421,300314
6550,dchoy,1,0.00033,60617,20.18454,300314
6551,dcioccarelli,1,0.00033,60618,20.18487,300314
6552,dcomas,1,0.00033,60619,20.18521,300314
6553,dcu,1,0.00033,60620,20.18554,300314
6554,ddelange,1,0.00033,60621,20.18587,300314
6555,ddobrin,1,0.00033,60622,20.18621,300314
6556,deamwork,1,0.00033,60623,20.18654,300314
6557,dean-alphafx,1,0.00033,60624,20.18687,300314
6558,DeanCaspySE,1,0.00033,60625,20.18720,300314
6559,deathname,1,0.00033,60626,20.18754,300314
6560,deavid,1,0.00033,60627,20.18787,300314
6561,debbyku,1,0.00033,60628,20.18820,300314
6562,debtcollapse,1,0.00033,60629,20.18854,300314
6563,deekshahegde86,1,0.00033,60630,20.18887,300314
6564,DeepakArora76,1,0.00033,60631,20.18920,300314
6565,deflorator1980,1,0.00033,60632,20.18953,300314
6566,degibenz,1,0.00033,60633,20.18987,300314
6567,dehaansa,1,0.00033,60634,20.19020,300314
6568,deliahu,1,0.00033,60635,20.19053,300314
6569,deliciouslytyped,1,0.00033,60636,20.19087,300314
6570,DelphineJoyneer,1,0.00033,60637,20.19120,300314
6571,demcaNative,1,0.00033,60638,20.19153,300314
6572,dengruilong,1,0.00033,60639,20.19187,300314
6573,denis111,1,0.00033,60640,20.19220,300314
6574,denisgolius,1,0.00033,60641,20.19253,300314
6575,denisgranha,1,0.00033,60642,20.19286,300314
6576,denisok,1,0.00033,60643,20.19320,300314
6577,DenisPuzik,1,0.00033,60644,20.19353,300314
6578,denist-huma,1,0.00033,60645,20.19386,300314
6579,den-saw,1,0.00033,60646,20.19420,300314
6580,derekpedersen,1,0.00033,60647,20.19453,300314
6581,derektamsen,1,0.00033,60648,20.19486,300314
6582,deromemont,1,0.00033,60649,20.19520,300314
6583,descrepes,1,0.00033,60650,20.19553,300314
6584,devamtech,1,0.00033,60651,20.19586,300314
6585,devdattakulkarni,1,0.00033,60652,20.19619,300314
6586,Deveshb15,1,0.00033,60653,20.19653,300314
6587,devfaz,1,0.00033,60654,20.19686,300314
6588,dev-hana,1,0.00033,60655,20.19719,300314
6589,devillove084,1,0.00033,60656,20.19753,300314
6590,Devivaralakshmi,1,0.00033,60657,20.19786,300314
6591,devjgm,1,0.00033,60658,20.19819,300314
6592,devkanro,1,0.00033,60659,20.19853,300314
6593,devrck,1,0.00033,60660,20.19886,300314
6594,dfsdevops,1,0.00033,60661,20.19919,300314
6595,dg424,1,0.00033,60662,20.19952,300314
6596,Dgadavin,1,0.00033,60663,20.19986,300314
6597,dgard1981,1,0.00033,60664,20.20019,300314
6598,dgrechka,1,0.00033,60665,20.20052,300314
6599,Dhairya-Dudhatra,1,0.00033,60666,20.20086,300314
6600,dHannasch,1,0.00033,60667,20.20119,300314
6601,dharapvj,1,0.00033,60668,20.20152,300314
6602,dhcn,1,0.00033,60669,20.20186,300314
6603,Dheerajcode2016,1,0.00033,60670,20.20219,300314
6604,DheerajDang,1,0.00033,60671,20.20252,300314
6605,dh-ironsec,1,0.00033,60672,20.20285,300314
6606,dhnukem,1,0.00033,60673,20.20319,300314
6607,dhohengassner,1,0.00033,60674,20.20352,300314
6608,dhruvp-8,1,0.00033,60675,20.20385,300314
6609,dhuesmann89,1,0.00033,60676,20.20419,300314
6610,diabg,1,0.00033,60677,20.20452,300314
6611,diamonwiggins,1,0.00033,60678,20.20485,300314
6612,diaosichen,1,0.00033,60679,20.20519,300314
6613,Diatrus,1,0.00033,60680,20.20552,300314
6614,diegoNutmeg,1,0.00033,60681,20.20585,300314
6615,digvijay2040,1,0.00033,60682,20.20618,300314
6616,dikokob,1,0.00033,60683,20.20652,300314
6617,DimaMTR,1,0.00033,60684,20.20685,300314
6618,dimitri-devops,1,0.00033,60685,20.20718,300314
6619,DimitrijeManic,1,0.00033,60686,20.20752,300314
6620,DinaYakovlev,1,0.00033,60687,20.20785,300314
6621,dineshpatilcloud,1,0.00033,60688,20.20818,300314
6622,dingzhixue,1,0.00033,60689,20.20852,300314
6623,DisaPadla,1,0.00033,60690,20.20885,300314
6624,disconnect3d,1,0.00033,60691,20.20918,300314
6625,discourseai,1,0.00033,60692,20.20951,300314
6626,diskun00,1,0.00033,60693,20.20985,300314
6627,dizecto,1,0.00033,60694,20.21018,300314
6628,djeikyb,1,0.00033,60695,20.21051,300314
6629,djexp,1,0.00033,60696,20.21085,300314
6630,djghosthd,1,0.00033,60697,20.21118,300314
6631,djkazic,1,0.00033,60698,20.21151,300314
6632,djknowles21,1,0.00033,60699,20.21184,300314
6633,DJoliet,1,0.00033,60700,20.21218,300314
6634,dlminvestments,1,0.00033,60701,20.21251,300314
6635,dlmorais-pbh,1,0.00033,60702,20.21284,300314
6636,dlotterman,1,0.00033,60703,20.21318,300314
6637,dlucasd,1,0.00033,60704,20.21351,300314
6638,d-luu,1,0.00033,60705,20.21384,300314
6639,dlwhitehurst,1,0.00033,60706,20.21418,300314
6640,d-m,1,0.00033,60707,20.21451,300314
6641,dmacvicar,1,0.00033,60708,20.21484,300314
6642,d-malko,1,0.00033,60709,20.21517,300314
6643,dmarar,1,0.00033,60710,20.21551,300314
6644,dmedinag,1,0.00033,60711,20.21584,300314
6645,dmeyerholt,1,0.00033,60712,20.21617,300314
6646,dmglennie-diveplane,1,0.00033,60713,20.21651,300314
6647,dmitrievav,1,0.00033,60714,20.21684,300314
6648,DmitriyMurzin,1,0.00033,60715,20.21717,300314
6649,dmittriy13,1,0.00033,60716,20.21751,300314
6650,DmytroKozlovskyi,1,0.00033,60717,20.21784,300314
6651,dnalborczyk,1,0.00033,60718,20.21817,300314
6652,dnskr,1,0.00033,60719,20.21850,300314
6653,DOboznyi,1,0.00033,60720,20.21884,300314
6654,docfactory37,1,0.00033,60721,20.21917,300314
6655,doczico,1,0.00033,60722,20.21950,300314
6656,dodwyer,1,0.00033,60723,20.21984,300314
6657,dogbertai,1,0.00033,60724,20.22017,300314
6658,DominicReuter-FIT,1,0.00033,60725,20.22050,300314
6659,dominiquemongelli,1,0.00033,60726,20.22084,300314
6660,don-attilio,1,0.00033,60727,20.22117,300314
6661,donkeyDau,1,0.00033,60728,20.22150,300314
6662,DorChen,1,0.00033,60729,20.22183,300314
6663,doronmak,1,0.00033,60730,20.22217,300314
6664,Dorsosiv,1,0.00033,60731,20.22250,300314
6665,dotbalo,1,0.00033,60732,20.22283,300314
6666,dotkrnl,1,0.00033,60733,20.22317,300314
6667,doublespaces,1,0.00033,60734,20.22350,300314
6668,dove-young,1,0.00033,60735,20.22383,300314
6669,doyelese,1,0.00033,60736,20.22417,300314
6670,dozer47528,1,0.00033,60737,20.22450,300314
6671,dpedu,1,0.00033,60738,20.22483,300314
6672,dpinchukov-ueni,1,0.00033,60739,20.22516,300314
6673,dplacinta,1,0.00033,60740,20.22550,300314
6674,dploop,1,0.00033,60741,20.22583,300314
6675,dprateek1991,1,0.00033,60742,20.22616,300314
6676,dpuig,1,0.00033,60743,20.22650,300314
6677,dpwolfe,1,0.00033,60744,20.22683,300314
6678,dragonly,1,0.00033,60745,20.22716,300314
6679,dragonsinth,1,0.00033,60746,20.22750,300314
6680,drauschenbach,1,0.00033,60747,20.22783,300314
6681,drawn4427,1,0.00033,60748,20.22816,300314
6682,DrBushyTop,1,0.00033,60749,20.22849,300314
6683,Dream2Land,1,0.00033,60750,20.22883,300314
6684,dreamer820,1,0.00033,60751,20.22916,300314
6685,drewboswell,1,0.00033,60752,20.22949,300314
6686,drewhoskins-stripe,1,0.00033,60753,20.22983,300314
6687,DriesVerachtert,1,0.00033,60754,20.23016,300314
6688,Dringho,1,0.00033,60755,20.23049,300314
6689,dropsonic,1,0.00033,60756,20.23083,300314
6690,drpmma,1,0.00033,60757,20.23116,300314
6691,dsabsay,1,0.00033,60758,20.23149,300314
6692,dsavineau,1,0.00033,60759,20.23182,300314
6693,dsharp-pivotal,1,0.00033,60760,20.23216,300314
6694,Dsiddhesh,1,0.00033,60761,20.23249,300314
6695,dstoffel,1,0.00033,60762,20.23282,300314
6696,dtbartle,1,0.00033,60763,20.23316,300314
6697,duckman,1,0.00033,60764,20.23349,300314
6698,duculete,1,0.00033,60765,20.23382,300314
6699,dududko,1,0.00033,60766,20.23415,300314
6700,dujiashu,1,0.00033,60767,20.23449,300314
6701,dullasuresh37,1,0.00033,60768,20.23482,300314
6702,duncangrist,1,0.00033,60769,20.23515,300314
6703,dundee,1,0.00033,60770,20.23549,300314
6704,dunkymole,1,0.00033,60771,20.23582,300314
6705,durasame,1,0.00033,60772,20.23615,300314
6706,durera,1,0.00033,60773,20.23649,300314
6707,durkmurder,1,0.00033,60774,20.23682,300314
6708,Duske,1,0.00033,60775,20.23715,300314
6709,dustyhorizon,1,0.00033,60776,20.23748,300314
6710,duwuwansch,1,0.00033,60777,20.23782,300314
6711,dvcanton,1,0.00033,60778,20.23815,300314
6712,dv-sharma,1,0.00033,60779,20.23848,300314
6713,dwa012-zmi,1,0.00033,60780,20.23882,300314
6714,Dweston88,1,0.00033,60781,20.23915,300314
6715,dyaa,1,0.00033,60782,20.23948,300314
6716,dystopiandev,1,0.00033,60783,20.23982,300314
6717,dzirg44,1,0.00033,60784,20.24015,300314
6718,eamonryan,1,0.00033,60785,20.24048,300314
6719,easyCZ,1,0.00033,60786,20.24081,300314
6720,EAvila34,1,0.00033,60787,20.24115,300314
6721,ebr,1,0.00033,60788,20.24148,300314
6722,ebullient,1,0.00033,60789,20.24181,300314
6723,eckara,1,0.00033,60790,20.24215,300314
6724,ecktom,1,0.00033,60791,20.24248,300314
6725,ecliptik,1,0.00033,60792,20.24281,300314
6726,ectogon,1,0.00033,60793,20.24315,300314
6727,EdAtomicRaccon,1,0.00033,60794,20.24348,300314
6728,edbighead,1,0.00033,60795,20.24381,300314
6729,eddieparker,1,0.00033,60796,20.24414,300314
6730,edeliot-fr,1,0.00033,60797,20.24448,300314
6731,edeNFed,1,0.00033,60798,20.24481,300314
6732,edersonbadeca,1,0.00033,60799,20.24514,300314
6733,edgarkz,1,0.00033,60800,20.24548,300314
6734,EdinHodzic1105,1,0.00033,60801,20.24581,300314
6735,eduardoriveror,1,0.00033,60802,20.24614,300314
6736,educhastenier,1,0.00033,60803,20.24648,300314
6737,edudley,1,0.00033,60804,20.24681,300314
6738,edward2a,1,0.00033,60805,20.24714,300314
6739,edward653,1,0.00033,60806,20.24747,300314
6740,effigies,1,0.00033,60807,20.24781,300314
6741,eggsbenjamin,1,0.00033,60808,20.24814,300314
6742,eguiller-pr,1,0.00033,60809,20.24847,300314
6743,ehershey,1,0.00033,60810,20.24881,300314
6744,EHJ-52n,1,0.00033,60811,20.24914,300314
6745,ehrktia,1,0.00033,60812,20.24947,300314
6746,eidans,1,0.00033,60813,20.24981,300314
6747,eisig,1,0.00033,60814,20.25014,300314
6748,ekuric,1,0.00033,60815,20.25047,300314
6749,Elaine-LiWu,1,0.00033,60816,20.25080,300314
6750,elatt,1,0.00033,60817,20.25114,300314
6751,ElDavoo,1,0.00033,60818,20.25147,300314
6752,electron0zero,1,0.00033,60819,20.25180,300314
6753,Elegant996,1,0.00033,60820,20.25214,300314
6754,elelel,1,0.00033,60821,20.25247,300314
6755,Elettronik,1,0.00033,60822,20.25280,300314
6756,elgamal2020,1,0.00033,60823,20.25314,300314
6757,eliekoren,1,0.00033,60824,20.25347,300314
6758,EliezerIsrael,1,0.00033,60825,20.25380,300314
6759,eligosfx,1,0.00033,60826,20.25413,300314
6760,eli-schwartz,1,0.00033,60827,20.25447,300314
6761,elliottc,1,0.00033,60828,20.25480,300314
6762,elnebuloso,1,0.00033,60829,20.25513,300314
6763,elqueffo,1,0.00033,60830,20.25547,300314
6764,eluricharter,1,0.00033,60831,20.25580,300314
6765,EmadMokhtar,1,0.00033,60832,20.25613,300314
6766,emcay,1,0.00033,60833,20.25646,300314
6767,emctl,1,0.00033,60834,20.25680,300314
6768,emeraldbay,1,0.00033,60835,20.25713,300314
6769,emerdan,1,0.00033,60836,20.25746,300314
6770,Emeryao,1,0.00033,60837,20.25780,300314
6771,eMGabriel,1,0.00033,60838,20.25813,300314
6772,emmaroberts-nbs,1,0.00033,60839,20.25846,300314
6773,emontemayor2,1,0.00033,60840,20.25880,300314
6774,EmperorYP7,1,0.00033,60841,20.25913,300314
6775,empinator,1,0.00033,60842,20.25946,300314
6776,encodeflush,1,0.00033,60843,20.25979,300314
6777,encron,1,0.00033,60844,20.26013,300314
6778,encyphered,1,0.00033,60845,20.26046,300314
6779,enkeyz,1,0.00033,60846,20.26079,300314
6780,envybee,1,0.00033,60847,20.26113,300314
6781,eon01,1,0.00033,60848,20.26146,300314
6782,epikhinm,1,0.00033,60849,20.26179,300314
6783,EpLiar,1,0.00033,60850,20.26213,300314
6784,epogrebnyak,1,0.00033,60851,20.26246,300314
6785,epsteina16,1,0.00033,60852,20.26279,300314
6786,ErezT94,1,0.00033,60853,20.26312,300314
6787,erhhung,1,0.00033,60854,20.26346,300314
6788,eric-d-brown,1,0.00033,60855,20.26379,300314
6789,Eric-Fontana-Tjx,1,0.00033,60856,20.26412,300314
6790,ericjee,1,0.00033,60857,20.26446,300314
6791,ericrrath,1,0.00033,60858,20.26479,300314
6792,eriklagerholm,1,0.00033,60859,20.26512,300314
6793,erinaboyd,1,0.00033,60860,20.26546,300314
6794,erkkkkkkkkk,1,0.00033,60861,20.26579,300314
6795,ErmakovDmitriy,1,0.00033,60862,20.26612,300314
6796,ermalbaj,1,0.00033,60863,20.26645,300314
6797,ernest-ux,1,0.00033,60864,20.26679,300314
6798,erwan-b,1,0.00033,60865,20.26712,300314
6799,ErwinSteffens,1,0.00033,60866,20.26745,300314
6800,es1o,1,0.00033,60867,20.26779,300314
6801,Esardes,1,0.00033,60868,20.26812,300314
6802,es-karthic,1,0.00033,60869,20.26845,300314
6803,EsoPhoenix,1,0.00033,60870,20.26879,300314
6804,esrrhs,1,0.00033,60871,20.26912,300314
6805,esse,1,0.00033,60872,20.26945,300314
6806,eternalmatt,1,0.00033,60873,20.26978,300314
6807,etherandrius,1,0.00033,60874,20.27012,300314
6808,etherealvisage,1,0.00033,60875,20.27045,300314
6809,etlfg,1,0.00033,60876,20.27078,300314
6810,eugeniyk,1,0.00033,60877,20.27112,300314
6811,eugentius,1,0.00033,60878,20.27145,300314
6812,EusebiusAditya,1,0.00033,60879,20.27178,300314
6813,euyuil,1,0.00033,60880,20.27212,300314
6814,evansche,1,0.00033,60881,20.27245,300314
6815,eve658,1,0.00033,60882,20.27278,300314
6816,everflux,1,0.00033,60883,20.27311,300314
6817,evhan,1,0.00033,60884,20.27345,300314
6818,evil2in,1,0.00033,60885,20.27378,300314
6819,EvilAcid,1,0.00033,60886,20.27411,300314
6820,ewnetu,1,0.00033,60887,20.27445,300314
6821,ewolz3,1,0.00033,60888,20.27478,300314
6822,eXeDK,1,0.00033,60889,20.27511,300314
6823,eysi09,1,0.00033,60890,20.27545,300314
6824,ezloj,1,0.00033,60891,20.27578,300314
6825,faameunier,1,0.00033,60892,20.27611,300314
6826,FabianNiehaus,1,0.00033,60893,20.27644,300314
6827,fableg3ds,1,0.00033,60894,20.27678,300314
6828,facundo-tul,1,0.00033,60895,20.27711,300314
6829,fagaillard,1,0.00033,60896,20.27744,300314
6830,falkheiland,1,0.00033,60897,20.27778,300314
6831,FalkWinkler,1,0.00033,60898,20.27811,300314
6832,fams,1,0.00033,60899,20.27844,300314
6833,famz,1,0.00033,60900,20.27877,300314
6834,fandujar,1,0.00033,60901,20.27911,300314
6835,farhanmkhan,1,0.00033,60902,20.27944,300314
6836,Farkal,1,0.00033,60903,20.27977,300314
6837,farzadmf,1,0.00033,60904,20.28011,300314
6838,fasih,1,0.00033,60905,20.28044,300314
6839,fasmat,1,0.00033,60906,20.28077,300314
6840,Fatme,1,0.00033,60907,20.28111,300314
6841,favourch,1,0.00033,60908,20.28144,300314
6842,FCarvMobil,1,0.00033,60909,20.28177,300314
6843,fcervantes2,1,0.00033,60910,20.28210,300314
6844,fdamken,1,0.00033,60911,20.28244,300314
6845,fdc-viktor-luft,1,0.00033,60912,20.28277,300314
6846,feenst,1,0.00033,60913,20.28310,300314
6847,feiluojiang,1,0.00033,60914,20.28344,300314
6848,feiyushi,1,0.00033,60915,20.28377,300314
6849,felipegfalcao,1,0.00033,60916,20.28410,300314
6850,FelipeMFlores,1,0.00033,60917,20.28444,300314
6851,felix,1,0.00033,60918,20.28477,300314
6852,felixzh2020,1,0.00033,60919,20.28510,300314
6853,fengmingxing,1,0.00033,60920,20.28543,300314
6854,feranwq,1,0.00033,60921,20.28577,300314
6855,ferbar,1,0.00033,60922,20.28610,300314
6856,Ferdzzzzzzzz,1,0.00033,60923,20.28643,300314
6857,fergaldonlon,1,0.00033,60924,20.28677,300314
6858,FerminCastro,1,0.00033,60925,20.28710,300314
6859,FeynmanZhou,1,0.00033,60926,20.28743,300314
6860,FFMMM,1,0.00033,60927,20.28777,300314
6861,ffsclyh,1,0.00033,60928,20.28810,300314
6862,fhkong,1,0.00033,60929,20.28843,300314
6863,fhriley,1,0.00033,60930,20.28876,300314
6864,Fhwang0926,1,0.00033,60931,20.28910,300314
6865,filippomc,1,0.00033,60932,20.28943,300314
6866,FiloSottile,1,0.00033,60933,20.28976,300314
6867,finnickkim,1,0.00033,60934,20.29010,300314
6868,fishhead108,1,0.00033,60935,20.29043,300314
6869,fission-autobot,1,0.00033,60936,20.29076,300314
6870,fjmacagno,1,0.00033,60937,20.29110,300314
6871,flaahokiller,1,0.00033,60938,20.29143,300314
6872,flacatus,1,0.00033,60939,20.29176,300314
6873,flashyang,1,0.00033,60940,20.29209,300314
6874,flassagn,1,0.00033,60941,20.29243,300314
6875,FlorianBuchegger,1,0.00033,60942,20.29276,300314
6876,florisvdg,1,0.00033,60943,20.29309,300314
6877,flouthoc,1,0.00033,60944,20.29343,300314
6878,FlowColwyn,1,0.00033,60945,20.29376,300314
6879,flupke,1,0.00033,60946,20.29409,300314
6880,flvritski,1,0.00033,60947,20.29443,300314
6881,FlxPeters,1,0.00033,60948,20.29476,300314
6882,flyingcanopy,1,0.00033,60949,20.29509,300314
6883,flyinprogrammer,1,0.00033,60950,20.29542,300314
6884,fmad,1,0.00033,60951,20.29576,300314
6885,focaaby,1,0.00033,60952,20.29609,300314
6886,folkersj,1,0.00033,60953,20.29642,300314
6887,forest5013,1,0.00033,60954,20.29676,300314
6888,formatlos,1,0.00033,60955,20.29709,300314
6889,fossdd,1,0.00033,60956,20.29742,300314
6890,FotiadisM,1,0.00033,60957,20.29776,300314
6891,fpessolano,1,0.00033,60958,20.29809,300314
6892,fr4nkR,1,0.00033,60959,20.29842,300314
6893,frabe1579,1,0.00033,60960,20.29875,300314
6894,francescortiz,1,0.00033,60961,20.29909,300314
6895,francescov1,1,0.00033,60962,20.29942,300314
6896,franciscosuca,1,0.00033,60963,20.29975,300314
6897,frankjkelly,1,0.00033,60964,20.30009,300314
6898,franklesniak,1,0.00033,60965,20.30042,300314
6899,fredcooke,1,0.00033,60966,20.30075,300314
6900,freddygv,1,0.00033,60967,20.30108,300314
6901,fredsuvn,1,0.00033,60968,20.30142,300314
6902,FreebeJan,1,0.00033,60969,20.30175,300314
6903,freedomofkeima,1,0.00033,60970,20.30208,300314
6904,FreeSpirit9009,1,0.00033,60971,20.30242,300314
6905,FrelDX,1,0.00033,60972,20.30275,300314
6906,Freundschaft,1,0.00033,60973,20.30308,300314
6907,fristonio,1,0.00033,60974,20.30342,300314
6908,FritschAuctores,1,0.00033,60975,20.30375,300314
6909,FrogIf,1,0.00033,60976,20.30408,300314
6910,frol,1,0.00033,60977,20.30441,300314
6911,frossie,1,0.00033,60978,20.30475,300314
6912,fr-ser,1,0.00033,60979,20.30508,300314
6913,Fryguy,1,0.00033,60980,20.30541,300314
6914,FStefanni,1,0.00033,60981,20.30575,300314
6915,ftclausen,1,0.00033,60982,20.30608,300314
6916,fthzkrtn,1,0.00033,60983,20.30641,300314
6917,fubarhouse,1,0.00033,60984,20.30675,300314
6918,fuhrmannd,1,0.00033,60985,20.30708,300314
6919,FujishigeTemma,1,0.00033,60986,20.30741,300314
6920,fukuda151,1,0.00033,60987,20.30774,300314
6921,furdarius,1,0.00033,60988,20.30808,300314
6922,furlongce,1,0.00033,60989,20.30841,300314
6923,furqan4545,1,0.00033,60990,20.30874,300314
6924,futuretea,1,0.00033,60991,20.30908,300314
6925,fyxemmmm,1,0.00033,60992,20.30941,300314
6926,g13013,1,0.00033,60993,20.30974,300314
6927,Gaardsholt,1,0.00033,60994,20.31008,300314
6928,gaborfinta,1,0.00033,60995,20.31041,300314
6929,gaborho,1,0.00033,60996,20.31074,300314
6930,gaboucher,1,0.00033,60997,20.31107,300314
6931,gabrielbatir,1,0.00033,60998,20.31141,300314
6932,gabrielcmarinho,1,0.00033,60999,20.31174,300314
6933,GabrielGhe,1,0.00033,61000,20.31207,300314
6934,gabrieltamavicius,1,0.00033,61001,20.31241,300314
6935,gaima8,1,0.00033,61002,20.31274,300314
6936,gamggi,1,0.00033,61003,20.31307,300314
6937,ganeshnadar92,1,0.00033,61004,20.31341,300314
6938,Gangaram-Dewasi,1,0.00033,61005,20.31374,300314
6939,GaoyangWang,1,0.00033,61006,20.31407,300314
6940,Garrybest,1,0.00033,61007,20.31440,300314
6941,garyedwards,1,0.00033,61008,20.31474,300314
6942,garypen,1,0.00033,61009,20.31507,300314
6943,garyyang2002,1,0.00033,61010,20.31540,300314
6944,gauravhub,1,0.00033,61011,20.31574,300314
6945,GaurPeeyush,1,0.00033,61012,20.31607,300314
6946,gautam-ergo,1,0.00033,61013,20.31640,300314
6947,gautamnankani,1,0.00033,61014,20.31674,300314
6948,gautamsoni17990,1,0.00033,61015,20.31707,300314
6949,gautaz,1,0.00033,61016,20.31740,300314
6950,gavinmead,1,0.00033,61017,20.31773,300314
6951,gbanasiak,1,0.00033,61018,20.31807,300314
6952,gbarazer,1,0.00033,61019,20.31840,300314
6953,gbbr,1,0.00033,61020,20.31873,300314
6954,gbuirel,1,0.00033,61021,20.31907,300314
6955,gc5388,1,0.00033,61022,20.31940,300314
6956,gdams,1,0.00033,61023,20.31973,300314
6957,gedalyahreback,1,0.00033,61024,20.32006,300314
6958,gelezniyden,1,0.00033,61025,20.32040,300314
6959,gemscoder,1,0.00033,61026,20.32073,300314
6960,genofire,1,0.00033,61027,20.32106,300314
6961,georgelza,1,0.00033,61028,20.32140,300314
6962,GeorgeTsagk,1,0.00033,61029,20.32173,300314
6963,georlav,1,0.00033,61030,20.32206,300314
6964,GerardRM,1,0.00033,61031,20.32240,300314
6965,gerbrand,1,0.00033,61032,20.32273,300314
6966,GerkinDev,1,0.00033,61033,20.32306,300314
6967,germel,1,0.00033,61034,20.32339,300314
6968,Gerthum,1,0.00033,61035,20.32373,300314
6969,GETandSELECT,1,0.00033,61036,20.32406,300314
6970,GezimSejdiu,1,0.00033,61037,20.32439,300314
6971,gfrankliu,1,0.00033,61038,20.32473,300314
6972,GGGxie,1,0.00033,61039,20.32506,300314
6973,ggilley,1,0.00033,61040,20.32539,300314
6974,ggPeti,1,0.00033,61041,20.32573,300314
6975,ghelyar,1,0.00033,61042,20.32606,300314
6976,ghosh9691,1,0.00033,61043,20.32639,300314
6977,GhostInThePotato,1,0.00033,61044,20.32672,300314
6978,ghsyeung,1,0.00033,61045,20.32706,300314
6979,Ghvstcode,1,0.00033,61046,20.32739,300314
6980,gideontong,1,0.00033,61047,20.32772,300314
6981,gigi-at-zymergen,1,0.00033,61048,20.32806,300314
6982,giliao,1,0.00033,61049,20.32839,300314
6983,gillius,1,0.00033,61050,20.32872,300314
6984,Gilwe,1,0.00033,61051,20.32906,300314
6985,gingermusketeer,1,0.00033,61052,20.32939,300314
6986,ginokurian87,1,0.00033,61053,20.32972,300314
6987,giovannirco,1,0.00033,61054,20.33005,300314
6988,giridhark507,1,0.00033,61055,20.33039,300314
6989,giskou,1,0.00033,61056,20.33072,300314
6990,githorse,1,0.00033,61057,20.33105,300314
6991,githubuser99999,1,0.00033,61058,20.33139,300314
6992,gitlijian,1,0.00033,61059,20.33172,300314
6993,gkarthek,1,0.00033,61060,20.33205,300314
6994,gkaurea,1,0.00033,61061,20.33239,300314
6995,glehmann,1,0.00033,61062,20.33272,300314
6996,gleichda,1,0.00033,61063,20.33305,300314
6997,glopal,1,0.00033,61064,20.33338,300314
6998,gmaiztegi,1,0.00033,61065,20.33372,300314
6999,gmflore,1,0.00033,61066,20.33405,300314
7000,gnadaban,1,0.00033,61067,20.33438,300314
7001,gnana03,1,0.00033,61068,20.33472,300314
7002,goldranjith,1,0.00033,61069,20.33505,300314
7003,Gollam,1,0.00033,61070,20.33538,300314
7004,goodqinjin,1,0.00033,61071,20.33572,300314
7005,googolgl,1,0.00033,61072,20.33605,300314
7006,gopisaba,1,0.00033,61073,20.33638,300314
7007,gordonbondon,1,0.00033,61074,20.33671,300314
7008,gorkemozlu,1,0.00033,61075,20.33705,300314
7009,goto1134,1,0.00033,61076,20.33738,300314
7010,gowtham9b,1,0.00033,61077,20.33771,300314
7011,gowthamshashank,1,0.00033,61078,20.33805,300314
7012,gowthamsubbu,1,0.00033,61079,20.33838,300314
7013,gpathak,1,0.00033,61080,20.33871,300314
7014,gquintard,1,0.00033,61081,20.33905,300314
7015,GrahamSH-LLK,1,0.00033,61082,20.33938,300314
7016,grantholly,1,0.00033,61083,20.33971,300314
7017,GrapeBaBa,1,0.00033,61084,20.34004,300314
7018,grazius,1,0.00033,61085,20.34038,300314
7019,Greg0,1,0.00033,61086,20.34071,300314
7020,gregdobedobedo,1,0.00033,61087,20.34104,300314
7021,gregopenit,1,0.00033,61088,20.34138,300314
7022,gregsterin,1,0.00033,61089,20.34171,300314
7023,gregswift,1,0.00033,61090,20.34204,300314
7024,grelas,1,0.00033,61091,20.34237,300314
7025,grischa,1,0.00033,61092,20.34271,300314
7026,gruffyn,1,0.00033,61093,20.34304,300314
7027,grv231,1,0.00033,61094,20.34337,300314
7028,gsmith-sas,1,0.00033,61095,20.34371,300314
7029,gsusI,1,0.00033,61096,20.34404,300314
7030,gtappetize,1,0.00033,61097,20.34437,300314
7031,gtourkas,1,0.00033,61098,20.34471,300314
7032,gtracer,1,0.00033,61099,20.34504,300314
7033,guAnsunyata,1,0.00033,61100,20.34537,300314
7034,gudari,1,0.00033,61101,20.34570,300314
7035,guhaneswaran,1,0.00033,61102,20.34604,300314
7036,Guidonet,1,0.00033,61103,20.34637,300314
7037,guillaume-roland-cd,1,0.00033,61104,20.34670,300314
7038,gujiwork,1,0.00033,61105,20.34704,300314
7039,GuoqiangZ,1,0.00033,61106,20.34737,300314
7040,gurmitsa,1,0.00033,61107,20.34770,300314
7041,guru1306,1,0.00033,61108,20.34804,300314
7042,Guru-arnav,1,0.00033,61109,20.34837,300314
7043,Guzzi,1,0.00033,61110,20.34870,300314
7044,gvfnix,1,0.00033,61111,20.34903,300314
7045,gvk88,1,0.00033,61112,20.34937,300314
7046,gws,1,0.00033,61113,20.34970,300314
7047,gyurobenjamin,1,0.00033,61114,20.35003,300314
7048,h2ho,1,0.00033,61115,20.35037,300314
7049,Hablapatabla,1,0.00033,61116,20.35070,300314
7050,hacker-qian,1,0.00033,61117,20.35103,300314
7051,hackerx15,1,0.00033,61118,20.35137,300314
7052,hadjiski,1,0.00033,61119,20.35170,300314
7053,hadleyrich,1,0.00033,61120,20.35203,300314
7054,Haim-Bi,1,0.00033,61121,20.35236,300314
7055,hainesc,1,0.00033,61122,20.35270,300314
7056,Hajime-Sugiuchi,1,0.00033,61123,20.35303,300314
7057,hak33m16,1,0.00033,61124,20.35336,300314
7058,haliliceylan,1,0.00033,61125,20.35370,300314
7059,halradaideh,1,0.00033,61126,20.35403,300314
7060,hameno,1,0.00033,61127,20.35436,300314
7061,HamidEDD,1,0.00033,61128,20.35470,300314
7062,hammer2j2,1,0.00033,61129,20.35503,300314
7063,hampsterx,1,0.00033,61130,20.35536,300314
7064,haneychad,1,0.00033,61131,20.35569,300314
7065,Hanggi,1,0.00033,61132,20.35603,300314
7066,hanieh-m,1,0.00033,61133,20.35636,300314
7067,hanming-nls,1,0.00033,61134,20.35669,300314
7068,HansK-p,1,0.00033,61135,20.35703,300314
7069,haofan-ms,1,0.00033,61136,20.35736,300314
7070,HaoLiuHust,1,0.00033,61137,20.35769,300314
7071,hariharanrbn,1,0.00033,61138,20.35803,300314
7072,Hariharasuthan99,1,0.00033,61139,20.35836,300314
7073,haroon3rd,1,0.00033,61140,20.35869,300314
7074,harry671003,1,0.00033,61141,20.35902,300314
7075,HarryGogonis,1,0.00033,61142,20.35936,300314
7076,HarshCasper,1,0.00033,61143,20.35969,300314
7077,harshit-singh88,1,0.00033,61144,20.36002,300314
7078,haseebH,1,0.00033,61145,20.36036,300314
7079,hashworks,1,0.00033,61146,20.36069,300314
7080,hassanbabaie,1,0.00033,61147,20.36102,300314
7081,hausliu,1,0.00033,61148,20.36136,300314
7082,Hawaiideveloper,1,0.00033,61149,20.36169,300314
7083,HawkerOH,1,0.00033,61150,20.36202,300314
7084,hazcod,1,0.00033,61151,20.36235,300314
7085,hazelnutsgz,1,0.00033,61152,20.36269,300314
7086,hazzik,1,0.00033,61153,20.36302,300314
7087,hbagwas,1,0.00033,61154,20.36335,300314
7088,hdonnay,1,0.00033,61155,20.36369,300314
7089,hecomlilong,1,0.00033,61156,20.36402,300314
7090,HeGaoYuan,1,0.00033,61157,20.36435,300314
7091,HeikoOnnebrink,1,0.00033,61158,20.36468,300314
7092,HelenGreul,1,0.00033,61159,20.36502,300314
7093,helenrai,1,0.00033,61160,20.36535,300314
7094,helloguille,1,0.00033,61161,20.36568,300314
7095,HelloWorld3031,1,0.00033,61162,20.36602,300314
7096,Helmut-Onna,1,0.00033,61163,20.36635,300314
7097,Hemant0601,1,0.00033,61164,20.36668,300314
7098,hemanthboyina,1,0.00033,61165,20.36702,300314
7099,HendrikFreund85,1,0.00033,61166,20.36735,300314
7100,heng1025,1,0.00033,61167,20.36768,300314
7101,HenningCash,1,0.00033,61168,20.36801,300314
7102,henrik-m,1,0.00033,61169,20.36835,300314
7103,henryfoster,1,0.00033,61170,20.36868,300314
7104,hergi2004,1,0.00033,61171,20.36901,300314
7105,herman-d,1,0.00033,61172,20.36935,300314
7106,hermansje,1,0.00033,61173,20.36968,300314
7107,herrbpl,1,0.00033,61174,20.37001,300314
7108,herveleclerc,1,0.00033,61175,20.37035,300314
7109,hervelemeur,1,0.00033,61176,20.37068,300314
7110,hetpats,1,0.00033,61177,20.37101,300314
7111,heyakyra,1,0.00033,61178,20.37134,300314
7112,hferreira23,1,0.00033,61179,20.37168,300314
7113,hgye,1,0.00033,61180,20.37201,300314
7114,hholst80,1,0.00033,61181,20.37234,300314
7115,hhstu,1,0.00033,61182,20.37268,300314
7116,hibby50,1,0.00033,61183,20.37301,300314
7117,Hichem-BenJeddi,1,0.00033,61184,20.37334,300314
7118,hidalgopl,1,0.00033,61185,20.37368,300314
7119,hiepndd,1,0.00033,61186,20.37401,300314
7120,hikergit,1,0.00033,61187,20.37434,300314
7121,himanshu1380,1,0.00033,61188,20.37467,300314
7122,himslm01,1,0.00033,61189,20.37501,300314
7123,Hinodeya69,1,0.00033,61190,20.37534,300314
7124,hirunatan,1,0.00033,61191,20.37567,300314
7125,hjorth,1,0.00033,61192,20.37601,300314
7126,hjpotter92,1,0.00033,61193,20.37634,300314
7127,hkadayam,1,0.00033,61194,20.37667,300314
7128,hlesesne,1,0.00033,61195,20.37701,300314
7129,hmih,1,0.00033,61196,20.37734,300314
7130,hmklabs-dclow,1,0.00033,61197,20.37767,300314
7131,hnhbwlp,1,0.00033,61198,20.37800,300314
7132,hnlzq163,1,0.00033,61199,20.37834,300314
7133,hoantv,1,0.00033,61200,20.37867,300314
7134,hodge-devops,1,0.00033,61201,20.37900,300314
7135,hoempf,1,0.00033,61202,20.37934,300314
7136,hoffie,1,0.00033,61203,20.37967,300314
7137,hoibuikms,1,0.00033,61204,20.38000,300314
7138,holgerstolzenberg,1,0.00033,61205,20.38034,300314
7139,hollowimage,1,0.00033,61206,20.38067,300314
7140,homebysix,1,0.00033,61207,20.38100,300314
7141,HoneyryderChuck,1,0.00033,61208,20.38133,300314
7142,hongaar,1,0.00033,61209,20.38167,300314
7143,HongjiangHuang,1,0.00033,61210,20.38200,300314
7144,HormyAJP,1,0.00033,61211,20.38233,300314
7145,HoustonPagtakhan1,1,0.00033,61212,20.38267,300314
7146,howey,1,0.00033,61213,20.38300,300314
7147,hoyho,1,0.00033,61214,20.38333,300314
7148,hristomanolov,1,0.00033,61215,20.38367,300314
7149,hrnciar,1,0.00033,61216,20.38400,300314
7150,hrodic,1,0.00033,61217,20.38433,300314
7151,hrvatskibogmars,1,0.00033,61218,20.38466,300314
7152,hsdp-smulford,1,0.00033,61219,20.38500,300314
7153,hsj1606,1,0.00033,61220,20.38533,300314
7154,HtcOrange,1,0.00033,61221,20.38566,300314
7155,huanbd,1,0.00033,61222,20.38600,300314
7156,HuanGong,1,0.00033,61223,20.38633,300314
7157,huangqiangxiong,1,0.00033,61224,20.38666,300314
7158,huangwei2013,1,0.00033,61225,20.38699,300314
7159,huangyingxian,1,0.00033,61226,20.38733,300314
7160,huangyitong,1,0.00033,61227,20.38766,300314
7161,huats,1,0.00033,61228,20.38799,300314
7162,HubertBos,1,0.00033,61229,20.38833,300314
7163,hudson741,1,0.00033,61230,20.38866,300314
7164,hughpearse,1,0.00033,61231,20.38899,300314
7165,hugomcfonseca,1,0.00033,61232,20.38933,300314
7166,hugree,1,0.00033,61233,20.38966,300314
7167,huifeng-kooboo,1,0.00033,61234,20.38999,300314
7168,humblewolf,1,0.00033,61235,20.39032,300314
7169,hunterfff,1,0.00033,61236,20.39066,300314
7170,hurricane1988,1,0.00033,61237,20.39099,300314
7171,huskar-t,1,0.00033,61238,20.39132,300314
7172,husseinferas,1,0.00033,61239,20.39166,300314
7173,Hvitgar,1,0.00033,61240,20.39199,300314
7174,hwaastad,1,0.00033,61241,20.39232,300314
7175,hxalid,1,0.00033,61242,20.39266,300314
7176,hyde404,1,0.00033,61243,20.39299,300314
7177,hydrapolic,1,0.00033,61244,20.39332,300314
7178,hykych,1,0.00033,61245,20.39365,300314
7179,hysyzq,1,0.00033,61246,20.39399,300314
7180,hyunil-shin,1,0.00033,61247,20.39432,300314
7181,hyutota,1,0.00033,61248,20.39465,300314
7182,iamayushdas,1,0.00033,61249,20.39499,300314
7183,IamGabrielWu,1,0.00033,61250,20.39532,300314
7184,iamnogada,1,0.00033,61251,20.39565,300314
7185,iamtakingiteasy,1,0.00033,61252,20.39599,300314
7186,ian-fox,1,0.00033,61253,20.39632,300314
7187,ianroberts,1,0.00033,61254,20.39665,300314
7188,IanRobertson-wpe,1,0.00033,61255,20.39698,300314
7189,ianschorr,1,0.00033,61256,20.39732,300314
7190,iarjunphp,1,0.00033,61257,20.39765,300314
7191,ibeckermayer,1,0.00033,61258,20.39798,300314
7192,icyi2i,1,0.00033,61259,20.39832,300314
7193,idanshm,1,0.00033,61260,20.39865,300314
7194,ideceddy,1,0.00033,61261,20.39898,300314
7195,id-id-id,1,0.00033,61262,20.39932,300314
7196,idjemaoune,1,0.00033,61263,20.39965,300314
7197,iferca,1,0.00033,61264,20.39998,300314
7198,ignacio83,1,0.00033,61265,20.40031,300314
7199,igoodful,1,0.00033,61266,20.40065,300314
7200,igorcalabria,1,0.00033,61267,20.40098,300314
7201,igormishsky,1,0.00033,61268,20.40131,300314
7202,igorpalant,1,0.00033,61269,20.40165,300314
7203,igor-susic,1,0.00033,61270,20.40198,300314
7204,igtsekov,1,0.00033,61271,20.40231,300314
7205,igurel,1,0.00033,61272,20.40265,300314
7206,iivansmaliakou,1,0.00033,61273,20.40298,300314
7207,ijungmann,1,0.00033,61274,20.40331,300314
7208,ikandars,1,0.00033,61275,20.40364,300314
7209,iketiunn,1,0.00033,61276,20.40398,300314
7210,ilboud,1,0.00033,61277,20.40431,300314
7211,IlianIliev,1,0.00033,61278,20.40464,300314
7212,ilicmilan,1,0.00033,61279,20.40498,300314
7213,iliyahoo,1,0.00033,61280,20.40531,300314
7214,illeatmyhat,1,0.00033,61281,20.40564,300314
7215,ilnurkhal,1,0.00033,61282,20.40598,300314
7216,ilovemysillybanana,1,0.00033,61283,20.40631,300314
7217,ilya-git,1,0.00033,61284,20.40664,300314
7218,IlyaKiselevKolibri,1,0.00033,61285,20.40697,300314
7219,ilyesAj,1,0.00033,61286,20.40731,300314
7220,imacks,1,0.00033,61287,20.40764,300314
7221,imaravind007,1,0.00033,61288,20.40797,300314
7222,imharshita,1,0.00033,61289,20.40831,300314
7223,imiller0,1,0.00033,61290,20.40864,300314
7224,imoladavide,1,0.00033,61291,20.40897,300314
7225,imonthercks,1,0.00033,61292,20.40930,300314
7226,imranrazakhan,1,0.00033,61293,20.40964,300314
7227,inallib,1,0.00033,61294,20.40997,300314
7228,Indamutsa,1,0.00033,61295,20.41030,300314
7229,indrajithgihan,1,0.00033,61296,20.41064,300314
7230,indu-subbaraj,1,0.00033,61297,20.41097,300314
7231,infa-anisrini,1,0.00033,61298,20.41130,300314
7232,infa-ddeore,1,0.00033,61299,20.41164,300314
7233,infavor,1,0.00033,61300,20.41197,300314
7234,InfluencerNGZK,1,0.00033,61301,20.41230,300314
7235,Insighter2k,1,0.00033,61302,20.41263,300314
7236,Insvald,1,0.00033,61303,20.41297,300314
7237,interfan7,1,0.00033,61304,20.41330,300314
7238,intonet,1,0.00033,61305,20.41363,300314
7239,investisocial,1,0.00033,61306,20.41397,300314
7240,ioannisgk,1,0.00033,61307,20.41430,300314
7241,iogrids,1,0.00033,61308,20.41463,300314
7242,iomarcovalente,1,0.00033,61309,20.41497,300314
7243,ionir-cloud,1,0.00033,61310,20.41530,300314
7244,iosifnicolae2,1,0.00033,61311,20.41563,300314
7245,iraj465,1,0.00033,61312,20.41596,300314
7246,iravivarma,1,0.00033,61313,20.41630,300314
7247,irivera007,1,0.00033,61314,20.41663,300314
7248,ironashram,1,0.00033,61315,20.41696,300314
7249,IronCore864,1,0.00033,61316,20.41730,300314
7250,irons,1,0.00033,61317,20.41763,300314
7251,IronSideSec,1,0.00033,61318,20.41796,300314
7252,ironytr,1,0.00033,61319,20.41830,300314
7253,iror00,1,0.00033,61320,20.41863,300314
7254,IsaackRasmussen,1,0.00033,61321,20.41896,300314
7255,Isan-Rivkin,1,0.00033,61322,20.41929,300314
7256,ishustava,1,0.00033,61323,20.41963,300314
7257,ismaelpuerto,1,0.00033,61324,20.41996,300314
7258,Isolus,1,0.00033,61325,20.42029,300314
7259,isqrd,1,0.00033,61326,20.42063,300314
7260,isurusiri,1,0.00033,61327,20.42096,300314
7261,IT247PRO,1,0.00033,61328,20.42129,300314
7262,Itai-Rosenmann,1,0.00033,61329,20.42163,300314
7263,itaydj,1,0.00033,61330,20.42196,300314
7264,itdove,1,0.00033,61331,20.42229,300314
7265,ITonyLi,1,0.00033,61332,20.42262,300314
7266,itsecforu,1,0.00033,61333,20.42296,300314
7267,itselavia,1,0.00033,61334,20.42329,300314
7268,itskaizad,1,0.00033,61335,20.42362,300314
7269,itssimon,1,0.00033,61336,20.42396,300314
7270,ItsVixano,1,0.00033,61337,20.42429,300314
7271,ittacco,1,0.00033,61338,20.42462,300314
7272,iuriipro,1,0.00033,61339,20.42496,300314
7273,ivan-galaviz-discovery,1,0.00033,61340,20.42529,300314
7274,IvanMartinezVega,1,0.00033,61341,20.42562,300314
7275,ivanov-aleksander,1,0.00033,61342,20.42595,300314
7276,ivanovishado,1,0.00033,61343,20.42629,300314
7277,ivanthelad,1,0.00033,61344,20.42662,300314
7278,Ivan-Z,1,0.00033,61345,20.42695,300314
7279,ivishalvarshney,1,0.00033,61346,20.42729,300314
7280,ivorscott,1,0.00033,61347,20.42762,300314
7281,iWangJiaxiang,1,0.00033,61348,20.42795,300314
7282,iyumeg,1,0.00033,61349,20.42829,300314
7283,J0WI,1,0.00033,61350,20.42862,300314
7284,j3ffyang,1,0.00033,61351,20.42895,300314
7285,j3pic,1,0.00033,61352,20.42928,300314
7286,jabf0923,1,0.00033,61353,20.42962,300314
7287,jabolina,1,0.00033,61354,20.42995,300314
7288,jabz-eks,1,0.00033,61355,20.43028,300314
7289,Jackbennett,1,0.00033,61356,20.43062,300314
7290,jackcaldwell,1,0.00033,61357,20.43095,300314
7291,jackchu123,1,0.00033,61358,20.43128,300314
7292,jackfarzan,1,0.00033,61359,20.43161,300314
7293,jackgege90,1,0.00033,61360,20.43195,300314
7294,jackhodkinson,1,0.00033,61361,20.43228,300314
7295,jackieli-tes,1,0.00033,61362,20.43261,300314
7296,jackybh,1,0.00033,61363,20.43295,300314
7297,JackyChenNgu,1,0.00033,61364,20.43328,300314
7298,jackyxie,1,0.00033,61365,20.43361,300314
7299,jacobbeasley,1,0.00033,61366,20.43395,300314
7300,jacobcrawford,1,0.00033,61367,20.43428,300314
7301,jacobscunn07,1,0.00033,61368,20.43461,300314
7302,jacoscaz,1,0.00033,61369,20.43494,300314
7303,jagdishpatil,1,0.00033,61370,20.43528,300314
7304,jageall,1,0.00033,61371,20.43561,300314
7305,JaikumarSelvaraj,1,0.00033,61372,20.43594,300314
7306,jainvishal520,1,0.00033,61373,20.43628,300314
7307,jairaju,1,0.00033,61374,20.43661,300314
7308,jaisers,1,0.00033,61375,20.43694,300314
7309,Jaja0624,1,0.00033,61376,20.43728,300314
7310,JakeColor,1,0.00033,61377,20.43761,300314
7311,jalavosus,1,0.00033,61378,20.43794,300314
7312,jalberti,1,0.00033,61379,20.43827,300314
7313,jamarior,1,0.00033,61380,20.43861,300314
7314,jamartincelis,1,0.00033,61381,20.43894,300314
7315,james2mid,1,0.00033,61382,20.43927,300314
7316,JamesB41,1,0.00033,61383,20.43961,300314
7317,JamesChenX,1,0.00033,61384,20.43994,300314
7318,james-crowley,1,0.00033,61385,20.44027,300314
7319,jamesliulondon,1,0.00033,61386,20.44061,300314
7320,jameslorda,1,0.00033,61387,20.44094,300314
7321,james-maloney,1,0.00033,61388,20.44127,300314
7322,james-mathiesen,1,0.00033,61389,20.44160,300314
7323,JamieHoSzeYui,1,0.00033,61390,20.44194,300314
7324,JaneJeon,1,0.00033,61391,20.44227,300314
7325,jangold-miovision,1,0.00033,61392,20.44260,300314
7326,JanGroot,1,0.00033,61393,20.44294,300314
7327,jankeesvanandel,1,0.00033,61394,20.44327,300314
7328,JanKerstens,1,0.00033,61395,20.44360,300314
7329,jankosecki,1,0.00033,61396,20.44394,300314
7330,jan-ludvik-deltatre,1,0.00033,61397,20.44427,300314
7331,janpeter123,1,0.00033,61398,20.44460,300314
7332,janpio,1,0.00033,61399,20.44493,300314
7333,jansenmcq,1,0.00033,61400,20.44527,300314
7334,JanSurft,1,0.00033,61401,20.44560,300314
7335,jargelo,1,0.00033,61402,20.44593,300314
7336,jarhat,1,0.00033,61403,20.44627,300314
7337,jaroli,1,0.00033,61404,20.44660,300314
7338,jarrett-confrey,1,0.00033,61405,20.44693,300314
7339,jasinner,1,0.00033,61406,20.44727,300314
7340,jasondeutsch,1,0.00033,61407,20.44760,300314
7341,JasonFreeberg,1,0.00033,61408,20.44793,300314
7342,jastabile,1,0.00033,61409,20.44826,300314
7343,jaxels10,1,0.00033,61410,20.44860,300314
7344,jaxesn,1,0.00033,61411,20.44893,300314
7345,jaylinski,1,0.00033,61412,20.44926,300314
7346,jaypalpatil,1,0.00033,61413,20.44960,300314
7347,jazevedo620,1,0.00033,61414,20.44993,300314
7348,jazoom,1,0.00033,61415,20.45026,300314
7349,jbaez,1,0.00033,61416,20.45060,300314
7350,jbartlet,1,0.00033,61417,20.45093,300314
7351,jbdeboer,1,0.00033,61418,20.45126,300314
7352,jb-dk,1,0.00033,61419,20.45159,300314
7353,jbemmel,1,0.00033,61420,20.45193,300314
7354,jbhennin,1,0.00033,61421,20.45226,300314
7355,jblackburn21,1,0.00033,61422,20.45259,300314
7356,jbw815,1,0.00033,61423,20.45293,300314
7357,jcaesar,1,0.00033,61424,20.45326,300314
7358,jcavalieri,1,0.00033,61425,20.45359,300314
7359,jcbagtas,1,0.00033,61426,20.45392,300314
7360,jcc2303,1,0.00033,61427,20.45426,300314
7361,jcgregorio,1,0.00033,61428,20.45459,300314
7362,jchau207,1,0.00033,61429,20.45492,300314
7363,jcheng-splunk,1,0.00033,61430,20.45526,300314
7364,jcleal,1,0.00033,61431,20.45559,300314
7365,jconway,1,0.00033,61432,20.45592,300314
7366,jcready,1,0.00033,61433,20.45626,300314
7367,JD557,1,0.00033,61434,20.45659,300314
7368,jdefaver,1,0.00033,61435,20.45692,300314
7369,jdemeyer,1,0.00033,61436,20.45725,300314
7370,jdeokar95,1,0.00033,61437,20.45759,300314
7371,jdnurme,1,0.00033,61438,20.45792,300314
7372,jdowens-commit,1,0.00033,61439,20.45825,300314
7373,jdrews,1,0.00033,61440,20.45859,300314
7374,jdshkolnik,1,0.00033,61441,20.45892,300314
7375,jDzames,1,0.00033,61442,20.45925,300314
7376,jecnua,1,0.00033,61443,20.45959,300314
7377,jeebendu,1,0.00033,61444,20.45992,300314
7378,jeff-cook,1,0.00033,61445,20.46025,300314
7379,jeffgran,1,0.00033,61446,20.46058,300314
7380,jeffy-mathew,1,0.00033,61447,20.46092,300314
7381,jeffzhu503,1,0.00033,61448,20.46125,300314
7382,Jeluchez,1,0.00033,61449,20.46158,300314
7383,jemc,1,0.00033,61450,20.46192,300314
7384,jengo,1,0.00033,61451,20.46225,300314
7385,Jenishk56,1,0.00033,61452,20.46258,300314
7386,Jennnnny,1,0.00033,61453,20.46292,300314
7387,jennydove,1,0.00033,61454,20.46325,300314
7388,JennyLJY,1,0.00033,61455,20.46358,300314
7389,Jensaarai,1,0.00033,61456,20.46391,300314
7390,jensengrey,1,0.00033,61457,20.46425,300314
7391,jerem0808,1,0.00033,61458,20.46458,300314
7392,JeremieRodon,1,0.00033,61459,20.46491,300314
7393,jeremy-verys,1,0.00033,61460,20.46525,300314
7394,Jeroen-Beljaars,1,0.00033,61461,20.46558,300314
7395,jerop,1,0.00033,61462,20.46591,300314
7396,jerryTJ,1,0.00033,61463,20.46625,300314
7397,JervyShi,1,0.00033,61464,20.46658,300314
7398,JesperBerggren,1,0.00033,61465,20.46691,300314
7399,JesseLiiu,1,0.00033,61466,20.46724,300314
7400,jessemillar,1,0.00033,61467,20.46758,300314
7401,JesseMirza,1,0.00033,61468,20.46791,300314
7402,jeunii,1,0.00033,61469,20.46824,300314
7403,jeuniii,1,0.00033,61470,20.46858,300314
7404,jfbrennan,1,0.00033,61471,20.46891,300314
7405,jfc-evs,1,0.00033,61472,20.46924,300314
7406,jfcoz,1,0.00033,61473,20.46958,300314
7407,jfg956,1,0.00033,61474,20.46991,300314
7408,jfoechsler,1,0.00033,61475,20.47024,300314
7409,jfpucheu,1,0.00033,61476,20.47057,300314
7410,jfroment,1,0.00033,61477,20.47091,300314
7411,jgavinray,1,0.00033,61478,20.47124,300314
7412,jgibson2,1,0.00033,61479,20.47157,300314
7413,jgrap,1,0.00033,61480,20.47191,300314
7414,jguerra,1,0.00033,61481,20.47224,300314
7415,jhadjar,1,0.00033,61482,20.47257,300314
7416,jhalleeupgrade,1,0.00033,61483,20.47291,300314
7417,jhass,1,0.00033,61484,20.47324,300314
7418,jhead-slg,1,0.00033,61485,20.47357,300314
7419,JhoLee,1,0.00033,61486,20.47390,300314
7420,jhonsfran1165,1,0.00033,61487,20.47424,300314
7421,jhughesjha,1,0.00033,61488,20.47457,300314
7422,jhuliano,1,0.00033,61489,20.47490,300314
7423,jhvst,1,0.00033,61490,20.47524,300314
7424,jiang-wei,1,0.00033,61491,20.47557,300314
7425,JiaoDean,1,0.00033,61492,20.47590,300314
7426,jiayihu,1,0.00033,61493,20.47623,300314
7427,jiefenghe,1,0.00033,61494,20.47657,300314
7428,JihadMotii-REISys,1,0.00033,61495,20.47690,300314
7429,jijotj,1,0.00033,61496,20.47723,300314
7430,jim-barber-he,1,0.00033,61497,20.47757,300314
7431,jimena-te,1,0.00033,61498,20.47790,300314
7432,jimmyyem,1,0.00033,61499,20.47823,300314
7433,jingczhang,1,0.00033,61500,20.47857,300314
7434,jingyic,1,0.00033,61501,20.47890,300314
7435,jinpu,1,0.00033,61502,20.47923,300314
7436,jinzishuai,1,0.00033,61503,20.47956,300314
7437,jirib,1,0.00033,61504,20.47990,300314
7438,Jishun,1,0.00033,61505,20.48023,300314
7439,jixuege,1,0.00033,61506,20.48056,300314
7440,jizusun,1,0.00033,61507,20.48090,300314
7441,jjbubudi,1,0.00033,61508,20.48123,300314
7442,jjdiazgarcia,1,0.00033,61509,20.48156,300314
7443,jjfeiler,1,0.00033,61510,20.48190,300314
7444,JJJJJones,1,0.00033,61511,20.48223,300314
7445,JJonesAtAvaya,1,0.00033,61512,20.48256,300314
7446,jjones-figure,1,0.00033,61513,20.48289,300314
7447,jkanczler,1,0.00033,61514,20.48323,300314
7448,jkbuster,1,0.00033,61515,20.48356,300314
7449,jkbuster-work19,1,0.00033,61516,20.48389,300314
7450,jketcham,1,0.00033,61517,20.48423,300314
7451,jkirkham-ratehub,1,0.00033,61518,20.48456,300314
7452,jkl92,1,0.00033,61519,20.48489,300314
7453,jklaw90,1,0.00033,61520,20.48523,300314
7454,jkone27,1,0.00033,61521,20.48556,300314
7455,jkylling,1,0.00033,61522,20.48589,300314
7456,jl98741,1,0.00033,61523,20.48622,300314
7457,j-land,1,0.00033,61524,20.48656,300314
7458,jlegido,1,0.00033,61525,20.48689,300314
7459,jlengelsen,1,0.00033,61526,20.48722,300314
7460,jlim0930,1,0.00033,61527,20.48756,300314
7461,jlisee,1,0.00033,61528,20.48789,300314
7462,jlosito,1,0.00033,61529,20.48822,300314
7463,jlunaq,1,0.00033,61530,20.48856,300314
7464,jmartindarient,1,0.00033,61531,20.48889,300314
7465,jmassardo,1,0.00033,61532,20.48922,300314
7466,jmatis-bullhorn,1,0.00033,61533,20.48955,300314
7467,jmclean-starburst,1,0.00033,61534,20.48989,300314
7468,jmhostalet,1,0.00033,61535,20.49022,300314
7469,jmjava,1,0.00033,61536,20.49055,300314
7470,jmjohnson-slalom,1,0.00033,61537,20.49089,300314
7471,jmmaloney4,1,0.00033,61538,20.49122,300314
7472,jmorfind,1,0.00033,61539,20.49155,300314
7473,jmzwcn,1,0.00033,61540,20.49189,300314
7474,jnehlmeier,1,0.00033,61541,20.49222,300314
7475,joaoarquimedes,1,0.00033,61542,20.49255,300314
7476,joaoestevinho,1,0.00033,61543,20.49288,300314
7477,JoaoPinheiro,1,0.00033,61544,20.49322,300314
7478,jobechoi,1,0.00033,61545,20.49355,300314
7479,jochenchrist,1,0.00033,61546,20.49388,300314
7480,joe-carpenter,1,0.00033,61547,20.49422,300314
7481,joekohut,1,0.00033,61548,20.49455,300314
7482,joell,1,0.00033,61549,20.49488,300314
7483,JoePacman,1,0.00033,61550,20.49522,300314
7484,joe-rajewski,1,0.00033,61551,20.49555,300314
7485,joesan,1,0.00033,61552,20.49588,300314
7486,joesantos418,1,0.00033,61553,20.49621,300314
7487,joeslow,1,0.00033,61554,20.49655,300314
7488,johanvdw,1,0.00033,61555,20.49688,300314
7489,JohanWork,1,0.00033,61556,20.49721,300314
7490,JohnAdamsy,1,0.00033,61557,20.49755,300314
7491,johnbwork,1,0.00033,61558,20.49788,300314
7492,JohnGalt1717,1,0.00033,61559,20.49821,300314
7493,johngrabner,1,0.00033,61560,20.49854,300314
7494,johnorourke,1,0.00033,61561,20.49888,300314
7495,johnsimons,1,0.00033,61562,20.49921,300314
7496,JohnStarich,1,0.00033,61563,20.49954,300314
7497,johnstcn,1,0.00033,61564,20.49988,300314
7498,johntdyer,1,0.00033,61565,20.50021,300314
7499,jojijohn,1,0.00033,61566,20.50054,300314
7500,jojofeng,1,0.00033,61567,20.50088,300314
7501,Jonas18175,1,0.00033,61568,20.50121,300314
7502,JonasMatos0,1,0.00033,61569,20.50154,300314
7503,Jonathan1,1,0.00033,61570,20.50187,300314
7504,jonathanheilmann,1,0.00033,61571,20.50221,300314
7505,jonathan-o,1,0.00033,61572,20.50254,300314
7506,jonenst,1,0.00033,61573,20.50287,300314
7507,jongarate,1,0.00033,61574,20.50321,300314
7508,JonghunBok,1,0.00033,61575,20.50354,300314
7509,Jonnymcc,1,0.00033,61576,20.50387,300314
7510,jonso4,1,0.00033,61577,20.50421,300314
7511,jopamora,1,0.00033,61578,20.50454,300314
7512,joprice,1,0.00033,61579,20.50487,300314
7513,JordanGoasdoue,1,0.00033,61580,20.50520,300314
7514,jordanhatcher,1,0.00033,61581,20.50554,300314
7515,JordanSinko,1,0.00033,61582,20.50587,300314
7516,jordan-thoms,1,0.00033,61583,20.50620,300314
7517,JordanYefet12,1,0.00033,61584,20.50654,300314
7518,jordicea,1,0.00033,61585,20.50687,300314
7519,jorgepsmatos,1,0.00033,61586,20.50720,300314
7520,jorgesece,1,0.00033,61587,20.50754,300314
7521,jorotg,1,0.00033,61588,20.50787,300314
7522,JosephGJ,1,0.00033,61589,20.50820,300314
7523,josephharrington,1,0.00033,61590,20.50853,300314
7524,joseph-levine,1,0.00033,61591,20.50887,300314
7525,josephlim75,1,0.00033,61592,20.50920,300314
7526,josharenberg,1,0.00033,61593,20.50953,300314
7527,joshdemoss,1,0.00033,61594,20.50987,300314
7528,josheinhorn,1,0.00033,61595,20.51020,300314
7529,joshi55,1,0.00033,61596,20.51053,300314
7530,joshq00,1,0.00033,61597,20.51087,300314
7531,joshross12,1,0.00033,61598,20.51120,300314
7532,joshuakraitberg,1,0.00033,61599,20.51153,300314
7533,joshuastern,1,0.00033,61600,20.51186,300314
7534,joshua-tso,1,0.00033,61601,20.51220,300314
7535,joulester,1,0.00033,61602,20.51253,300314
7536,Joustie,1,0.00033,61603,20.51286,300314
7537,JovanShandro,1,0.00033,61604,20.51320,300314
7538,Joyce-O,1,0.00033,61605,20.51353,300314
7539,jpigree,1,0.00033,61606,20.51386,300314
7540,jpiper,1,0.00033,61607,20.51420,300314
7541,jpmcb,1,0.00033,61608,20.51453,300314
7542,jpriebe,1,0.00033,61609,20.51486,300314
7543,jr0d,1,0.00033,61610,20.51519,300314
7544,jranjan,1,0.00033,61611,20.51553,300314
7545,jrdeboer,1,0.00033,61612,20.51586,300314
7546,jsaulalonso,1,0.00033,61613,20.51619,300314
7547,jscharp,1,0.00033,61614,20.51653,300314
7548,jschwartzentruber,1,0.00033,61615,20.51686,300314
7549,JScrivanich,1,0.00033,61616,20.51719,300314
7550,jsdevalx,1,0.00033,61617,20.51752,300314
7551,jsholzer,1,0.00033,61618,20.51786,300314
7552,jsmith50-sc,1,0.00033,61619,20.51819,300314
7553,jsmouret,1,0.00033,61620,20.51852,300314
7554,jsonmp-k8,1,0.00033,61621,20.51886,300314
7555,jt-nti,1,0.00033,61622,20.51919,300314
7556,jtweaver,1,0.00033,61623,20.51952,300314
7557,jtyberg,1,0.00033,61624,20.51986,300314
7558,juanluisrp,1,0.00033,61625,20.52019,300314
7559,juliangomez-samana,1,0.00033,61626,20.52052,300314
7560,julianguinard,1,0.00033,61627,20.52085,300314
7561,julien-aubert,1,0.00033,61628,20.52119,300314
7562,juliostanley,1,0.00033,61629,20.52152,300314
7563,junhojang,1,0.00033,61630,20.52185,300314
7564,junpark-vcanus,1,0.00033,61631,20.52219,300314
7565,junpengl,1,0.00033,61632,20.52252,300314
7566,jurgyy,1,0.00033,61633,20.52285,300314
7567,justbk,1,0.00033,61634,20.52319,300314
7568,justinfiore,1,0.00033,61635,20.52352,300314
7569,JustinHuang402490,1,0.00033,61636,20.52385,300314
7570,justinpchang,1,0.00033,61637,20.52418,300314
7571,justinsorubio,1,0.00033,61638,20.52452,300314
7572,JustinTArthur,1,0.00033,61639,20.52485,300314
7573,justkao,1,0.00033,61640,20.52518,300314
7574,justmy2centx,1,0.00033,61641,20.52552,300314
7575,juturupavankumar,1,0.00033,61642,20.52585,300314
7576,jvelasquez,1,0.00033,61643,20.52618,300314
7577,jvoeller,1,0.00033,61644,20.52652,300314
7578,JWebDev,1,0.00033,61645,20.52685,300314
7579,jwmoss,1,0.00033,61646,20.52718,300314
7580,Jyotshna9,1,0.00033,61647,20.52751,300314
7581,jystephan,1,0.00033,61648,20.52785,300314
7582,jyyoo0530,1,0.00033,61649,20.52818,300314
7583,jzding,1,0.00033,61650,20.52851,300314
7584,K1Hyve,1,0.00033,61651,20.52885,300314
7585,k3a,1,0.00033,61652,20.52918,300314
7586,k7h7k11,1,0.00033,61653,20.52951,300314
7587,k8sre,1,0.00033,61654,20.52985,300314
7588,kaaquist,1,0.00033,61655,20.53018,300314
7589,kadamkaustubh,1,0.00033,61656,20.53051,300314
7590,kadirsahan,1,0.00033,61657,20.53084,300314
7591,kadirselcuk,1,0.00033,61658,20.53118,300314
7592,kadomino,1,0.00033,61659,20.53151,300314
7593,kaelzhang,1,0.00033,61660,20.53184,300314
7594,Kagamia-MS,1,0.00033,61661,20.53218,300314
7595,kagaya85,1,0.00033,61662,20.53251,300314
7596,kago-dk,1,0.00033,61663,20.53284,300314
7597,kainwei,1,0.00033,61664,20.53318,300314
7598,kaitaklam,1,0.00033,61665,20.53351,300314
7599,kaiyoma,1,0.00033,61666,20.53384,300314
7600,kalexmills,1,0.00033,61667,20.53417,300314
7601,KalleJohansson,1,0.00033,61668,20.53451,300314
7602,Kalmac,1,0.00033,61669,20.53484,300314
7603,kalurikishore,1,0.00033,61670,20.53517,300314
7604,kam96,1,0.00033,61671,20.53551,300314
7605,kameshchauhan,1,0.00033,61672,20.53584,300314
7606,Kamforka,1,0.00033,61673,20.53617,300314
7607,kana112233,1,0.00033,61674,20.53651,300314
7608,karlcow,1,0.00033,61675,20.53684,300314
7609,karolinepauls,1,0.00033,61676,20.53717,300314
7610,karolzmijewski,1,0.00033,61677,20.53750,300314
7611,karstland,1,0.00033,61678,20.53784,300314
7612,KarthikReddy12345,1,0.00033,61679,20.53817,300314
7613,Karthons,1,0.00033,61680,20.53850,300314
7614,kartlee80,1,0.00033,61681,20.53884,300314
7615,katatonia911,1,0.00033,61682,20.53917,300314
7616,kbarrette,1,0.00033,61683,20.53950,300314
7617,kbelosevic,1,0.00033,61684,20.53983,300314
7618,kcburge,1,0.00033,61685,20.54017,300314
7619,kcheemz,1,0.00033,61686,20.54050,300314
7620,kchitrapu,1,0.00033,61687,20.54083,300314
7621,kdebisschop,1,0.00033,61688,20.54117,300314
7622,keatz55,1,0.00033,61689,20.54150,300314
7623,keawade,1,0.00033,61690,20.54183,300314
7624,kedmison,1,0.00033,61691,20.54217,300314
7625,Keith-Mange,1,0.00033,61692,20.54250,300314
7626,KeksBeskvitovich,1,0.00033,61693,20.54283,300314
7627,keliss,1,0.00033,61694,20.54316,300314
7628,kellyhair,1,0.00033,61695,20.54350,300314
7629,kelseiv,1,0.00033,61696,20.54383,300314
7630,kemvoueric,1,0.00033,61697,20.54416,300314
7631,kenessajr,1,0.00033,61698,20.54450,300314
7632,kennytrytek-wf,1,0.00033,61699,20.54483,300314
7633,kesavkolla,1,0.00033,61700,20.54516,300314
7634,KetchupBomb,1,0.00033,61701,20.54550,300314
7635,kev1n11,1,0.00033,61702,20.54583,300314
7636,kevchu3,1,0.00033,61703,20.54616,300314
7637,kevgrig,1,0.00033,61704,20.54649,300314
7638,kevinanderson1,1,0.00033,61705,20.54683,300314
7639,kevindong,1,0.00033,61706,20.54716,300314
7640,kevinlmadison,1,0.00033,61707,20.54749,300314
7641,kevinmichaelchen,1,0.00033,61708,20.54783,300314
7642,KevinWang15,1,0.00033,61709,20.54816,300314
7643,kevmando,1,0.00033,61710,20.54849,300314
7644,Keyproco,1,0.00033,61711,20.54883,300314
7645,kgb-financial-com,1,0.00033,61712,20.54916,300314
7646,khabdrick,1,0.00033,61713,20.54949,300314
7647,khacminh,1,0.00033,61714,20.54982,300314
7648,KhaledSakr,1,0.00033,61715,20.55016,300314
7649,khalid-davis,1,0.00033,61716,20.55049,300314
7650,kharouny,1,0.00033,61717,20.55082,300314
7651,kheraud,1,0.00033,61718,20.55116,300314
7652,khubaibalam2000,1,0.00033,61719,20.55149,300314
7653,kictto,1,0.00033,61720,20.55182,300314
7654,kiennguyen94,1,0.00033,61721,20.55216,300314
7655,kikicarbonell,1,0.00033,61722,20.55249,300314
7656,kingc1,1,0.00033,61723,20.55282,300314
7657,kingsd041,1,0.00033,61724,20.55315,300314
7658,kinsolee,1,0.00033,61725,20.55349,300314
7659,kipit,1,0.00033,61726,20.55382,300314
7660,kipit-puppet,1,0.00033,61727,20.55415,300314
7661,kiran009,1,0.00033,61728,20.55449,300314
7662,kit494way,1,0.00033,61729,20.55482,300314
7663,kitikhunp,1,0.00033,61730,20.55515,300314
7664,Kixa,1,0.00033,61731,20.55549,300314
7665,kjenney,1,0.00033,61732,20.55582,300314
7666,kjordy,1,0.00033,61733,20.55615,300314
7667,kkarthik23,1,0.00033,61734,20.55648,300314
7668,kkzxak47,1,0.00033,61735,20.55682,300314
7669,kladiv,1,0.00033,61736,20.55715,300314
7670,klausroo,1,0.00033,61737,20.55748,300314
7671,kldell,1,0.00033,61738,20.55782,300314
7672,kleinerator,1,0.00033,61739,20.55815,300314
7673,kli-abine,1,0.00033,61740,20.55848,300314
7674,klibr007,1,0.00033,61741,20.55882,300314
7675,klose4711,1,0.00033,61742,20.55915,300314
7676,kmandal-volvo,1,0.00033,61743,20.55948,300314
7677,kmarji,1,0.00033,61744,20.55981,300314
7678,kmille,1,0.00033,61745,20.56015,300314
7679,k-mitevski,1,0.00033,61746,20.56048,300314
7680,kmt,1,0.00033,61747,20.56081,300314
7681,kmx2,1,0.00033,61748,20.56115,300314
7682,knadh,1,0.00033,61749,20.56148,300314
7683,knepe,1,0.00033,61750,20.56181,300314
7684,knfoo,1,0.00033,61751,20.56214,300314
7685,KnotGud,1,0.00033,61752,20.56248,300314
7686,kodi1981,1,0.00033,61753,20.56281,300314
7687,kofiray,1,0.00033,61754,20.56314,300314
7688,konstantin-tkachuk,1,0.00033,61755,20.56348,300314
7689,koolwithk,1,0.00033,61756,20.56381,300314
7690,koo-taejin,1,0.00033,61757,20.56414,300314
7691,korncola,1,0.00033,61758,20.56448,300314
7692,koryaga,1,0.00033,61759,20.56481,300314
7693,Korzi,1,0.00033,61760,20.56514,300314
7694,Koshmaar,1,0.00033,61761,20.56547,300314
7695,KostadinAlmishev,1,0.00033,61762,20.56581,300314
7696,kostyanius,1,0.00033,61763,20.56614,300314
7697,kostyay,1,0.00033,61764,20.56647,300314
7698,koteesy,1,0.00033,61765,20.56681,300314
7699,Koulwa,1,0.00033,61766,20.56714,300314
7700,kowalczykp,1,0.00033,61767,20.56747,300314
7701,kozlou,1,0.00033,61768,20.56781,300314
7702,KqLLL,1,0.00033,61769,20.56814,300314
7703,kqsantacruz,1,0.00033,61770,20.56847,300314
7704,kqzh,1,0.00033,61771,20.56880,300314
7705,Kraego,1,0.00033,61772,20.56914,300314
7706,krak7602,1,0.00033,61773,20.56947,300314
7707,krdpk17,1,0.00033,61774,20.56980,300314
7708,krestofur,1,0.00033,61775,20.57014,300314
7709,krishna295,1,0.00033,61776,20.57047,300314
7710,krishnakumarakurathi,1,0.00033,61777,20.57080,300314
7711,kristelfung,1,0.00033,61778,20.57114,300314
7712,kristinnardal2,1,0.00033,61779,20.57147,300314
7713,krubenrc,1,0.00033,61780,20.57180,300314
7714,kruegerb-rv,1,0.00033,61781,20.57213,300314
7715,krunalsabnis,1,0.00033,61782,20.57247,300314
7716,ksahlmann,1,0.00033,61783,20.57280,300314
7717,ksaio,1,0.00033,61784,20.57313,300314
7718,kscherer,1,0.00033,61785,20.57347,300314
7719,ksed,1,0.00033,61786,20.57380,300314
7720,ksegun,1,0.00033,61787,20.57413,300314
7721,KSerrania,1,0.00033,61788,20.57447,300314
7722,ktaborski,1,0.00033,61789,20.57480,300314
7723,kthomas,1,0.00033,61790,20.57513,300314
7724,kt-pham,1,0.00033,61791,20.57546,300314
7725,kuburoman,1,0.00033,61792,20.57580,300314
7726,Kuldip-Nanda,1,0.00033,61793,20.57613,300314
7727,Kullu14,1,0.00033,61794,20.57646,300314
7728,kullu-ashish,1,0.00033,61795,20.57680,300314
7729,kumarlinux,1,0.00033,61796,20.57713,300314
7730,kumarshantanu,1,0.00033,61797,20.57746,300314
7731,kumar-subashp,1,0.00033,61798,20.57780,300314
7732,KumaTea,1,0.00033,61799,20.57813,300314
7733,kumoroku,1,0.00033,61800,20.57846,300314
7734,kunkka234,1,0.00033,61801,20.57879,300314
7735,kuratowskiy,1,0.00033,61802,20.57913,300314
7736,kurkop,1,0.00033,61803,20.57946,300314
7737,kutsyk-neocles,1,0.00033,61804,20.57979,300314
7738,Kvark1205,1,0.00033,61805,20.58013,300314
7739,kvrhdn,1,0.00033,61806,20.58046,300314
7740,k-weaver,1,0.00033,61807,20.58079,300314
7741,KyleMasterson,1,0.00033,61808,20.58113,300314
7742,KyleSanderson,1,0.00033,61809,20.58146,300314
7743,Kylsky,1,0.00033,61810,20.58179,300314
7744,kyuho24,1,0.00033,61811,20.58212,300314
7745,l00297133,1,0.00033,61812,20.58246,300314
7746,L3T,1,0.00033,61813,20.58279,300314
7747,laboger,1,0.00033,61814,20.58312,300314
7748,lacksfish,1,0.00033,61815,20.58346,300314
7749,laetho,1,0.00033,61816,20.58379,300314
7750,lafeber,1,0.00033,61817,20.58412,300314
7751,lagivan,1,0.00033,61818,20.58445,300314
7752,lahsivjar,1,0.00033,61819,20.58479,300314
7753,lailailee,1,0.00033,61820,20.58512,300314
7754,lakestonelabs,1,0.00033,61821,20.58545,300314
7755,lambdanis,1,0.00033,61822,20.58579,300314
7756,lambotchi,1,0.00033,61823,20.58612,300314
7757,lamhoangtung,1,0.00033,61824,20.58645,300314
7758,landorg,1,0.00033,61825,20.58679,300314
7759,langxiaopiao030,1,0.00033,61826,20.58712,300314
7760,Lapeyus,1,0.00033,61827,20.58745,300314
7761,larkee,1,0.00033,61828,20.58778,300314
7762,larsduelfer,1,0.00033,61829,20.58812,300314
7763,lathspell,1,0.00033,61830,20.58845,300314
7764,laukaichung,1,0.00033,61831,20.58878,300314
7765,laul7klau,1,0.00033,61832,20.58912,300314
7766,laurenegerton,1,0.00033,61833,20.58945,300314
7767,laurentguilbert,1,0.00033,61834,20.58978,300314
7768,laurovenancio,1,0.00033,61835,20.59012,300314
7769,lautou,1,0.00033,61836,20.59045,300314
7770,Laxminarayan1502,1,0.00033,61837,20.59078,300314
7771,lazystone,1,0.00033,61838,20.59111,300314
7772,lbm,1,0.00033,61839,20.59145,300314
7773,lbpdt,1,0.00033,61840,20.59178,300314
7774,lcapaldo,1,0.00033,61841,20.59211,300314
7775,lchastel,1,0.00033,61842,20.59245,300314
7776,lchimbili,1,0.00033,61843,20.59278,300314
7777,LDeemo,1,0.00033,61844,20.59311,300314
7778,Le0exxx,1,0.00033,61845,20.59345,300314
7779,leandroluk,1,0.00033,61846,20.59378,300314
7780,leandro-manifesto,1,0.00033,61847,20.59411,300314
7781,leapsky,1,0.00033,61848,20.59444,300314
7782,LEBATRUNG,1,0.00033,61849,20.59478,300314
7783,lecaros,1,0.00033,61850,20.59511,300314
7784,lecgts,1,0.00033,61851,20.59544,300314
7785,leebake,1,0.00033,61852,20.59578,300314
7786,lee-byeoksan,1,0.00033,61853,20.59611,300314
7787,Leena1666,1,0.00033,61854,20.59644,300314
7788,LeeZBug,1,0.00033,61855,20.59678,300314
7789,legend-zeratul,1,0.00033,61856,20.59711,300314
7790,LelandSindt,1,0.00033,61857,20.59744,300314
7791,lelandsindttouchnet,1,0.00033,61858,20.59777,300314
7792,leofischer,1,0.00033,61859,20.59811,300314
7793,leonK-BO,1,0.00033,61860,20.59844,300314
7794,Leon-pan,1,0.00033,61861,20.59877,300314
7795,leonsp-ai,1,0.00033,61862,20.59911,300314
7796,leoryu,1,0.00033,61863,20.59944,300314
7797,leosantosazevedo,1,0.00033,61864,20.59977,300314
7798,LeoYang90,1,0.00033,61865,20.60011,300314
7799,leshibily,1,0.00033,61866,20.60044,300314
7800,LesleyDebes,1,0.00033,61867,20.60077,300314
7801,LetsCodeCloud,1,0.00033,61868,20.60110,300314
7802,levesquejf,1,0.00033,61869,20.60144,300314
7803,leviathanbadger,1,0.00033,61870,20.60177,300314
7804,levin81,1,0.00033,61871,20.60210,300314
7805,levshvarts,1,0.00033,61872,20.60244,300314
7806,lexagigabit,1,0.00033,61873,20.60277,300314
7807,lexh,1,0.00033,61874,20.60310,300314
7808,leynebe,1,0.00033,61875,20.60344,300314
7809,lheinlen,1,0.00033,61876,20.60377,300314
7810,lhotari,1,0.00033,61877,20.60410,300314
7811,liammoat,1,0.00033,61878,20.60443,300314
7812,liamylian,1,0.00033,61879,20.60477,300314
7813,liaozhenlin,1,0.00033,61880,20.60510,300314
7814,liasece,1,0.00033,61881,20.60543,300314
7815,Liberski,1,0.00033,61882,20.60577,300314
7816,lichenglin,1,0.00033,61883,20.60610,300314
7817,lidajia,1,0.00033,61884,20.60643,300314
7818,lifepeer,1,0.00033,61885,20.60676,300314
7819,lijiansgit,1,0.00033,61886,20.60710,300314
7820,Limule,1,0.00033,61887,20.60743,300314
7821,linuxbasic,1,0.00033,61888,20.60776,300314
7822,liogate,1,0.00033,61889,20.60810,300314
7823,LiorLieberman,1,0.00033,61890,20.60843,300314
7824,liruishan,1,0.00033,61891,20.60876,300314
7825,Lisa1812,1,0.00033,61892,20.60910,300314
7826,lisenet,1,0.00033,61893,20.60943,300314
7827,litewhatever,1,0.00033,61894,20.60976,300314
7828,littleplus,1,0.00033,61895,20.61009,300314
7829,liuerfire,1,0.00033,61896,20.61043,300314
7830,liukun,1,0.00033,61897,20.61076,300314
7831,liulangwa,1,0.00033,61898,20.61109,300314
7832,LiuVII,1,0.00033,61899,20.61143,300314
7833,liuyanmei069,1,0.00033,61900,20.61176,300314
7834,Li-Vincent,1,0.00033,61901,20.61209,300314
7835,lixiangflyin,1,0.00033,61902,20.61243,300314
7836,lixuehui08,1,0.00033,61903,20.61276,300314
7837,liys87x,1,0.00033,61904,20.61309,300314
7838,lizhiyong2000,1,0.00033,61905,20.61342,300314
7839,lkrzyzanek,1,0.00033,61906,20.61376,300314
7840,lkskrt,1,0.00033,61907,20.61409,300314
7841,ll348900729,1,0.00033,61908,20.61442,300314
7842,lmakarov,1,0.00033,61909,20.61476,300314
7843,lmgray,1,0.00033,61910,20.61509,300314
7844,LminotWM,1,0.00033,61911,20.61542,300314
7845,lneuhaus,1,0.00033,61912,20.61576,300314
7846,logi85,1,0.00033,61913,20.61609,300314
7847,logsnaath,1,0.00033,61914,20.61642,300314
7848,loguido,1,0.00033,61915,20.61675,300314
7849,longwanbin,1,0.00033,61916,20.61709,300314
7850,lonnix,1,0.00033,61917,20.61742,300314
7851,loop-evgeny,1,0.00033,61918,20.61775,300314
7852,LordEvron,1,0.00033,61919,20.61809,300314
7853,lordzorn,1,0.00033,61920,20.61842,300314
7854,lorenzoaiello,1,0.00033,61921,20.61875,300314
7855,LostLaser,1,0.00033,61922,20.61909,300314
7856,lotress,1,0.00033,61923,20.61942,300314
7857,louicoder,1,0.00033,61924,20.61975,300314
7858,lovebutmiss,1,0.00033,61925,20.62008,300314
7859,lowkeyliesmyth,1,0.00033,61926,20.62042,300314
7860,lowkeyrd,1,0.00033,61927,20.62075,300314
7861,lpan,1,0.00033,61928,20.62108,300314
7862,lq08025107,1,0.00033,61929,20.62142,300314
7863,lsq645599166,1,0.00033,61930,20.62175,300314
7864,ltqb,1,0.00033,61931,20.62208,300314
7865,luanqi521-s,1,0.00033,61932,20.62242,300314
7866,lubingfeng,1,0.00033,61933,20.62275,300314
7867,luboszk,1,0.00033,61934,20.62308,300314
7868,lubyou,1,0.00033,61935,20.62341,300314
7869,lucacavazzana,1,0.00033,61936,20.62375,300314
7870,LucaLanziani,1,0.00033,61937,20.62408,300314
7871,LucasOliveiraS,1,0.00033,61938,20.62441,300314
7872,LucasRxTx,1,0.00033,61939,20.62475,300314
7873,lucassardois,1,0.00033,61940,20.62508,300314
7874,lucasvieirazup,1,0.00033,61941,20.62541,300314
7875,luckoseabraham,1,0.00033,61942,20.62575,300314
7876,lucwillems,1,0.00033,61943,20.62608,300314
7877,luhaopei,1,0.00033,61944,20.62641,300314
7878,luigisainini,1,0.00033,61945,20.62674,300314
7879,luismaximozup,1,0.00033,61946,20.62708,300314
7880,luisvelalopez,1,0.00033,61947,20.62741,300314
7881,luizrojo,1,0.00033,61948,20.62774,300314
7882,luk4z7,1,0.00033,61949,20.62808,300314
7883,lukashoffmannhb,1,0.00033,61950,20.62841,300314
7884,LukaszSwolkien,1,0.00033,61951,20.62874,300314
7885,lukeFalsina,1,0.00033,61952,20.62907,300314
7886,lukipro,1,0.00033,61953,20.62941,300314
7887,luo-ru,1,0.00033,61954,20.62974,300314
7888,lupusllc,1,0.00033,61955,20.63007,300314
7889,luthar64,1,0.00033,61956,20.63041,300314
7890,lvillis,1,0.00033,61957,20.63074,300314
7891,lweitzman,1,0.00033,61958,20.63107,300314
7892,lwmxiaobei,1,0.00033,61959,20.63141,300314
7893,lwsanty,1,0.00033,61960,20.63174,300314
7894,lxe,1,0.00033,61961,20.63207,300314
7895,lyind,1,0.00033,61962,20.63240,300314
7896,lyyao09,1,0.00033,61963,20.63274,300314
7897,lyzs90,1,0.00033,61964,20.63307,300314
7898,lzp0412,1,0.00033,61965,20.63340,300314
7899,m0rtalis,1,0.00033,61966,20.63374,300314
7900,M1ke,1,0.00033,61967,20.63407,300314
7901,m4nu56,1,0.00033,61968,20.63440,300314
7902,maarsaks,1,0.00033,61969,20.63474,300314
7903,maayaankk,1,0.00033,61970,20.63507,300314
7904,macchiang,1,0.00033,61971,20.63540,300314
7905,macdjord,1,0.00033,61972,20.63573,300314
7906,maclockard,1,0.00033,61973,20.63607,300314
7907,MacNale,1,0.00033,61974,20.63640,300314
7908,macompimul1982,1,0.00033,61975,20.63673,300314
7909,madarez,1,0.00033,61976,20.63707,300314
7910,madhukark,1,0.00033,61977,20.63740,300314
7911,madhurtrilio,1,0.00033,61978,20.63773,300314
7912,madneal,1,0.00033,61979,20.63807,300314
7913,madtrick,1,0.00033,61980,20.63840,300314
7914,magiccaptain,1,0.00033,61981,20.63873,300314
7915,magicmatatjahu,1,0.00033,61982,20.63906,300314
7916,maguowei,1,0.00033,61983,20.63940,300314
7917,mahmoud-abdelhafez,1,0.00033,61984,20.63973,300314
7918,mahonzhan,1,0.00033,61985,20.64006,300314
7919,mainred,1,0.00033,61986,20.64040,300314
7920,maintenance-vq8,1,0.00033,61987,20.64073,300314
7921,Maistho,1,0.00033,61988,20.64106,300314
7922,Maitreya29,1,0.00033,61989,20.64140,300314
7923,majid-taghdimi2,1,0.00033,61990,20.64173,300314
7924,majinghe,1,0.00033,61991,20.64206,300314
7925,Maju-Ketchup,1,0.00033,61992,20.64239,300314
7926,make,1,0.00033,61993,20.64273,300314
7927,makrelas,1,0.00033,61994,20.64306,300314
7928,maksym1hladkykh,1,0.00033,61995,20.64339,300314
7929,malevy,1,0.00033,61996,20.64373,300314
7930,malikumaliku,1,0.00033,61997,20.64406,300314
7931,mallman,1,0.00033,61998,20.64439,300314
7932,mameshini,1,0.00033,61999,20.64473,300314
7933,mandre,1,0.00033,62000,20.64506,300314
7934,Manish-Kumar317,1,0.00033,62001,20.64539,300314
7935,mankuen,1,0.00033,62002,20.64572,300314
7936,manmanxing,1,0.00033,62003,20.64606,300314
7937,ManpreetNanreh,1,0.00033,62004,20.64639,300314
7938,manpreetsnehra,1,0.00033,62005,20.64672,300314
7939,manuasir,1,0.00033,62006,20.64706,300314
7940,manuel-koch,1,0.00033,62007,20.64739,300314
7941,manuelpolacek,1,0.00033,62008,20.64772,300314
7942,marceloboeira,1,0.00033,62009,20.64806,300314
7943,Marcelverhoeven,1,0.00033,62010,20.64839,300314
7944,marchdaisy,1,0.00033,62011,20.64872,300314
7945,marcoboffi,1,0.00033,62012,20.64905,300314
7946,marco-claudino,1,0.00033,62013,20.64939,300314
7947,marcolan018,1,0.00033,62014,20.64972,300314
7948,marcosdiez,1,0.00033,62015,20.65005,300314
7949,margocrawf,1,0.00033,62016,20.65039,300314
7950,mariadb-JeffBachtel,1,0.00033,62017,20.65072,300314
7951,MarianZoll,1,0.00033,62018,20.65105,300314
7952,mariiaGnutova,1,0.00033,62019,20.65138,300314
7953,mariuskiessling,1,0.00033,62020,20.65172,300314
7954,mariusziemke,1,0.00033,62021,20.65205,300314
7955,markguan-stripe,1,0.00033,62022,20.65238,300314
7956,marklinders-planon,1,0.00033,62023,20.65272,300314
7957,markmorlino,1,0.00033,62024,20.65305,300314
7958,markrowsoft,1,0.00033,62025,20.65338,300314
7959,markthebault,1,0.00033,62026,20.65372,300314
7960,MarkusH,1,0.00033,62027,20.65405,300314
7961,MarkusTiede,1,0.00033,62028,20.65438,300314
7962,marleyg,1,0.00033,62029,20.65471,300314
7963,MartaSadowskaBarankiewicz,1,0.00033,62030,20.65505,300314
7964,martinduris,1,0.00033,62031,20.65538,300314
7965,martinezleoml,1,0.00033,62032,20.65571,300314
7966,martinothamar,1,0.00033,62033,20.65605,300314
7967,martin-weber,1,0.00033,62034,20.65638,300314
7968,Martin-Weiss,1,0.00033,62035,20.65671,300314
7969,martinzhou2015,1,0.00033,62036,20.65705,300314
7970,martyspiewak,1,0.00033,62037,20.65738,300314
7971,marwinski,1,0.00033,62038,20.65771,300314
7972,marziman,1,0.00033,62039,20.65804,300314
7973,masbaehr,1,0.00033,62040,20.65838,300314
7974,MashaSamoylova,1,0.00033,62041,20.65871,300314
7975,mastermanu,1,0.00033,62042,20.65904,300314
7976,mat-ej,1,0.00033,62043,20.65938,300314
7977,mateuszkwiatkowski,1,0.00033,62044,20.65971,300314
7978,matgn,1,0.00033,62045,20.66004,300314
7979,mathew-fleisch,1,0.00033,62046,20.66038,300314
7980,matt-byrne,1,0.00033,62047,20.66071,300314
7981,matteocalabro-tomtom,1,0.00033,62048,20.66104,300314
7982,matteocusinato,1,0.00033,62049,20.66137,300314
7983,matteoolivi,1,0.00033,62050,20.66171,300314
7984,MattGill98,1,0.00033,62051,20.66204,300314
7985,mattheidelbaugh,1,0.00033,62052,20.66237,300314
7986,MatthewBreeze45,1,0.00033,62053,20.66271,300314
7987,matthewd1826,1,0.00033,62054,20.66304,300314
7988,MatthewDolan,1,0.00033,62055,20.66337,300314
7989,matthew-mcdermott,1,0.00033,62056,20.66371,300314
7990,matthewmrichter,1,0.00033,62057,20.66404,300314
7991,matthiasdg,1,0.00033,62058,20.66437,300314
7992,matthias-huber,1,0.00033,62059,20.66470,300314
7993,matthiassb,1,0.00033,62060,20.66504,300314
7994,mattip,1,0.00033,62061,20.66537,300314
7995,mattmahn,1,0.00033,62062,20.66570,300314
7996,matt-mazzucato,1,0.00033,62063,20.66604,300314
7997,MattMencel,1,0.00033,62064,20.66637,300314
7998,mattnathan,1,0.00033,62065,20.66670,300314
7999,matt-psaltis,1,0.00033,62066,20.66704,300314
8000,Matts966,1,0.00033,62067,20.66737,300314
8001,mattsawyer77,1,0.00033,62068,20.66770,300314
8002,mattwelke,1,0.00033,62069,20.66803,300314
8003,mattwillsher,1,0.00033,62070,20.66837,300314
8004,MattyKuzyk,1,0.00033,62071,20.66870,300314
8005,maur1th,1,0.00033,62072,20.66903,300314
8006,maxaggedon,1,0.00033,62073,20.66937,300314
8007,max-cx,1,0.00033,62074,20.66970,300314
8008,maxianwei,1,0.00033,62075,20.67003,300314
8009,MaximilianMeister,1,0.00033,62076,20.67037,300314
8010,MaximMukhametov,1,0.00033,62077,20.67070,300314
8011,maxlegault,1,0.00033,62078,20.67103,300314
8012,MaxMelcher,1,0.00033,62079,20.67136,300314
8013,maxneaga,1,0.00033,62080,20.67170,300314
8014,maxrodkin,1,0.00033,62081,20.67203,300314
8015,MaxThom,1,0.00033,62082,20.67236,300314
8016,maxuellstalin,1,0.00033,62083,20.67270,300314
8017,Maxweston,1,0.00033,62084,20.67303,300314
8018,mayeuldalzon,1,0.00033,62085,20.67336,300314
8019,mazuninky,1,0.00033,62086,20.67369,300314
8020,mbeards,1,0.00033,62087,20.67403,300314
8021,mben19,1,0.00033,62088,20.67436,300314
8022,mberrueta,1,0.00033,62089,20.67469,300314
8023,mbigras,1,0.00033,62090,20.67503,300314
8024,mboukhalfa,1,0.00033,62091,20.67536,300314
8025,mboutet,1,0.00033,62092,20.67569,300314
8026,mbroadst,1,0.00033,62093,20.67603,300314
8027,mburst,1,0.00033,62094,20.67636,300314
8028,mbyio,1,0.00033,62095,20.67669,300314
8029,mc0,1,0.00033,62096,20.67702,300314
8030,mc256,1,0.00033,62097,20.67736,300314
8031,mccartney,1,0.00033,62098,20.67769,300314
8032,mcck,1,0.00033,62099,20.67802,300314
8033,mcgizmo,1,0.00033,62100,20.67836,300314
8034,m-chaturvedi,1,0.00033,62101,20.67869,300314
8035,mdconner,1,0.00033,62102,20.67902,300314
8036,mdedetrich,1,0.00033,62103,20.67936,300314
8037,mdenend,1,0.00033,62104,20.67969,300314
8038,mdepa,1,0.00033,62105,20.68002,300314
8039,mdrgeniebelt,1,0.00033,62106,20.68035,300314
8040,mdsgabriel,1,0.00033,62107,20.68069,300314
8041,mdufourneaud,1,0.00033,62108,20.68102,300314
8042,mduijm,1,0.00033,62109,20.68135,300314
8043,mederel,1,0.00033,62110,20.68169,300314
8044,medwards,1,0.00033,62111,20.68202,300314
8045,meghanabsrinath,1,0.00033,62112,20.68235,300314
8046,meghdivya,1,0.00033,62113,20.68269,300314
8047,mehtabhassan,1,0.00033,62114,20.68302,300314
8048,MehulKChaudhari,1,0.00033,62115,20.68335,300314
8049,mekza,1,0.00033,62116,20.68368,300314
8050,melalj,1,0.00033,62117,20.68402,300314
8051,melaurent,1,0.00033,62118,20.68435,300314
8052,melgl,1,0.00033,62119,20.68468,300314
8053,melodycho,1,0.00033,62120,20.68502,300314
8054,mengdodo,1,0.00033,62121,20.68535,300314
8055,mengjinmm,1,0.00033,62122,20.68568,300314
8056,MengS1024,1,0.00033,62123,20.68602,300314
8057,mengshi02,1,0.00033,62124,20.68635,300314
8058,mercer,1,0.00033,62125,20.68668,300314
8059,mersl,1,0.00033,62126,20.68701,300314
8060,MetalDent,1,0.00033,62127,20.68735,300314
8061,metalLeveller,1,0.00033,62128,20.68768,300314
8062,metao1,1,0.00033,62129,20.68801,300314
8063,metmet000,1,0.00033,62130,20.68835,300314
8064,mewawalaabdeali,1,0.00033,62131,20.68868,300314
8065,mfrancisc,1,0.00033,62132,20.68901,300314
8066,mfriess2,1,0.00033,62133,20.68935,300314
8067,mgibson323,1,0.00033,62134,20.68968,300314
8068,mgild,1,0.00033,62135,20.69001,300314
8069,mgomse-divante,1,0.00033,62136,20.69034,300314
8070,mgorsk1,1,0.00033,62137,20.69068,300314
8071,mgsweet,1,0.00033,62138,20.69101,300314
8072,mgudesblatart,1,0.00033,62139,20.69134,300314
8073,mguggi,1,0.00033,62140,20.69168,300314
8074,mgwismer,1,0.00033,62141,20.69201,300314
8075,mhingston,1,0.00033,62142,20.69234,300314
8076,mhr3,1,0.00033,62143,20.69268,300314
8077,mhumpula,1,0.00033,62144,20.69301,300314
8078,mianos,1,0.00033,62145,20.69334,300314
8079,miaozhongyin,1,0.00033,62146,20.69367,300314
8080,micaelgallego,1,0.00033,62147,20.69401,300314
8081,micah,1,0.00033,62148,20.69434,300314
8082,michaeljguarino,1,0.00033,62149,20.69467,300314
8083,michaltrmac,1,0.00033,62150,20.69501,300314
8084,mick62,1,0.00033,62151,20.69534,300314
8085,micya,1,0.00033,62152,20.69567,300314
8086,middlestone,1,0.00033,62153,20.69600,300314
8087,miffa,1,0.00033,62154,20.69634,300314
8088,mig4ng,1,0.00033,62155,20.69667,300314
8089,migka2012,1,0.00033,62156,20.69700,300314
8090,migmurillo,1,0.00033,62157,20.69734,300314
8091,migounette,1,0.00033,62158,20.69767,300314
8092,MiguelLucas,1,0.00033,62159,20.69800,300314
8093,miguelruizdev,1,0.00033,62160,20.69834,300314
8094,mihirk,1,0.00033,62161,20.69867,300314
8095,miicahjardine,1,0.00033,62162,20.69900,300314
8096,mikala3,1,0.00033,62163,20.69933,300314
8097,mikedougherty,1,0.00033,62164,20.69967,300314
8098,mikegajda,1,0.00033,62165,20.70000,300314
8099,mikestef9,1,0.00033,62166,20.70033,300314
8100,miketonks,1,0.00033,62167,20.70067,300314
8101,mikhailswift,1,0.00033,62168,20.70100,300314
8102,mikolajwalkiewicz,1,0.00033,62169,20.70133,300314
8103,mildmojo,1,0.00033,62170,20.70167,300314
8104,MildThing,1,0.00033,62171,20.70200,300314
8105,milunko,1,0.00033,62172,20.70233,300314
8106,minamijoyo,1,0.00033,62173,20.70266,300314
8107,minchao,1,0.00033,62174,20.70300,300314
8108,minchieh-fay,1,0.00033,62175,20.70333,300314
8109,mindlift,1,0.00033,62176,20.70366,300314
8110,mingfang,1,0.00033,62177,20.70400,300314
8111,mingrukang,1,0.00033,62178,20.70433,300314
8112,mingwill,1,0.00033,62179,20.70466,300314
8113,mini1989,1,0.00033,62180,20.70500,300314
8114,Miniland1333,1,0.00033,62181,20.70533,300314
8115,minnieshi,1,0.00033,62182,20.70566,300314
8116,MINQ1NG,1,0.00033,62183,20.70599,300314
8117,MintChocoO2C,1,0.00033,62184,20.70633,300314
8118,minxiaogang,1,0.00033,62185,20.70666,300314
8119,mipac,1,0.00033,62186,20.70699,300314
8120,mirii1994,1,0.00033,62187,20.70733,300314
8121,mirusky,1,0.00033,62188,20.70766,300314
8122,misha-fm,1,0.00033,62189,20.70799,300314
8123,mishoyama,1,0.00033,62190,20.70833,300314
8124,miso-belica,1,0.00033,62191,20.70866,300314
8125,misslucia,1,0.00033,62192,20.70899,300314
8126,mister2d,1,0.00033,62193,20.70932,300314
8127,misteruly,1,0.00033,62194,20.70966,300314
8128,Mistic92,1,0.00033,62195,20.70999,300314
8129,mistlxj,1,0.00033,62196,20.71032,300314
8130,misuka1234,1,0.00033,62197,20.71066,300314
8131,MitchDart,1,0.00033,62198,20.71099,300314
8132,mitesh51,1,0.00033,62199,20.71132,300314
8133,mjbright,1,0.00033,62200,20.71166,300314
8134,mjobin-mdsol,1,0.00033,62201,20.71199,300314
8135,mjuarez,1,0.00033,62202,20.71232,300314
8136,mknyszek,1,0.00033,62203,20.71265,300314
8137,mkostersitz,1,0.00033,62204,20.71299,300314
8138,mlgupta,1,0.00033,62205,20.71332,300314
8139,mlopez-eb,1,0.00033,62206,20.71365,300314
8140,mloskot,1,0.00033,62207,20.71399,300314
8141,mlrsyz,1,0.00033,62208,20.71432,300314
8142,mlthorne,1,0.00033,62209,20.71465,300314
8143,mmalcek,1,0.00033,62210,20.71498,300314
8144,MMeent,1,0.00033,62211,20.71532,300314
8145,mmelvin0,1,0.00033,62212,20.71565,300314
8146,mmerickel,1,0.00033,62213,20.71598,300314
8147,mmiklus,1,0.00033,62214,20.71632,300314
8148,mmiranda96,1,0.00033,62215,20.71665,300314
8149,mmontes11,1,0.00033,62216,20.71698,300314
8150,mmussett,1,0.00033,62217,20.71732,300314
8151,mnacharov,1,0.00033,62218,20.71765,300314
8152,MNashDev,1,0.00033,62219,20.71798,300314
8153,mnebus,1,0.00033,62220,20.71831,300314
8154,MnifR,1,0.00033,62221,20.71865,300314
8155,mnorrsken,1,0.00033,62222,20.71898,300314
8156,mnoseworthy,1,0.00033,62223,20.71931,300314
8157,mo4islona,1,0.00033,62224,20.71965,300314
8158,modzilla99,1,0.00033,62225,20.71998,300314
8159,mohamedalsherif,1,0.00033,62226,20.72031,300314
8160,mohanrao,1,0.00033,62227,20.72065,300314
8161,Mohitsharma44,1,0.00033,62228,20.72098,300314
8162,Mohkam,1,0.00033,62229,20.72131,300314
8163,moix,1,0.00033,62230,20.72164,300314
8164,mojili,1,0.00033,62231,20.72198,300314
8165,Monkman08,1,0.00033,62232,20.72231,300314
8166,monwolf,1,0.00033,62233,20.72264,300314
8167,moonkwoo,1,0.00033,62234,20.72298,300314
8168,moonseokho85,1,0.00033,62235,20.72331,300314
8169,moosh3,1,0.00033,62236,20.72364,300314
8170,moosilauke18-reify,1,0.00033,62237,20.72398,300314
8171,mootezbessifi,1,0.00033,62238,20.72431,300314
8172,Morgma,1,0.00033,62239,20.72464,300314
8173,morhook,1,0.00033,62240,20.72497,300314
8174,mortezaalizadeh,1,0.00033,62241,20.72531,300314
8175,mosesdd,1,0.00033,62242,20.72564,300314
8176,MostafaNegim,1,0.00033,62243,20.72597,300314
8177,motikan2010,1,0.00033,62244,20.72631,300314
8178,mouellet-coveo,1,0.00033,62245,20.72664,300314
8179,mp3monster,1,0.00033,62246,20.72697,300314
8180,mpecarina,1,0.00033,62247,20.72731,300314
8181,mping,1,0.00033,62248,20.72764,300314
8182,mpires,1,0.00033,62249,20.72797,300314
8183,mpreu,1,0.00033,62250,20.72830,300314
8184,mpritter76,1,0.00033,62251,20.72864,300314
8185,mpruefer,1,0.00033,62252,20.72897,300314
8186,mpucholblasco,1,0.00033,62253,20.72930,300314
8187,mr006-jq,1,0.00033,62254,20.72964,300314
8188,mradamhoward,1,0.00033,62255,20.72997,300314
8189,MrAprksn,1,0.00033,62256,20.73030,300314
8190,mrbusche,1,0.00033,62257,20.73064,300314
8191,MrFishFinger,1,0.00033,62258,20.73097,300314
8192,mrhallak,1,0.00033,62259,20.73130,300314
8193,mrjerzy,1,0.00033,62260,20.73163,300314
8194,mrkwtz,1,0.00033,62261,20.73197,300314
8195,mrothroc,1,0.00033,62262,20.73230,300314
8196,mrpowerus,1,0.00033,62263,20.73263,300314
8197,mrproper,1,0.00033,62264,20.73297,300314
8198,MrShiny608,1,0.00033,62265,20.73330,300314
8199,msessa,1,0.00033,62266,20.73363,300314
8200,msfidelis,1,0.00033,62267,20.73397,300314
8201,msfussell,1,0.00033,62268,20.73430,300314
8202,mshivaramie22,1,0.00033,62269,20.73463,300314
8203,mssokal,1,0.00033,62270,20.73496,300314
8204,mt35-rs,1,0.00033,62271,20.73530,300314
8205,mtalbot,1,0.00033,62272,20.73563,300314
8206,mtarcha,1,0.00033,62273,20.73596,300314
8207,mtenrero,1,0.00033,62274,20.73630,300314
8208,mtfsc,1,0.00033,62275,20.73663,300314
8209,mtimm,1,0.00033,62276,20.73696,300314
8210,mtt0,1,0.00033,62277,20.73729,300314
8211,mturde,1,0.00033,62278,20.73763,300314
8212,mturnshek,1,0.00033,62279,20.73796,300314
8213,Mtze,1,0.00033,62280,20.73829,300314
8214,muffin87,1,0.00033,62281,20.73863,300314
8215,MuhammadZeeshan34,1,0.00033,62282,20.73896,300314
8216,MuhammetDilmac,1,0.00033,62283,20.73929,300314
8217,mujtaba752,1,0.00033,62284,20.73963,300314
8218,muneernet,1,0.00033,62285,20.73996,300314
8219,mustafa-rean,1,0.00033,62286,20.74029,300314
8220,muzimuzi42,1,0.00033,62287,20.74062,300314
8221,mvanmeerbeck,1,0.00033,62288,20.74096,300314
8222,mvrhov,1,0.00033,62289,20.74129,300314
8223,mvukadinoff,1,0.00033,62290,20.74162,300314
8224,mwester117,1,0.00033,62291,20.74196,300314
8225,mwilmer,1,0.00033,62292,20.74229,300314
8226,mxchist,1,0.00033,62293,20.74262,300314
8227,my4381918,1,0.00033,62294,20.74296,300314
8228,myl82,1,0.00033,62295,20.74329,300314
8229,mylifelineio,1,0.00033,62296,20.74362,300314
8230,mynampatinaveen,1,0.00033,62297,20.74395,300314
8231,MyungChi,1,0.00033,62298,20.74429,300314
8232,myvelmurugan,1,0.00033,62299,20.74462,300314
8233,mzealey,1,0.00033,62300,20.74495,300314
8234,n0b0d3,1,0.00033,62301,20.74529,300314
8235,n0n0x,1,0.00033,62302,20.74562,300314
8236,naddame,1,0.00033,62303,20.74595,300314
8237,naeemarsalan,1,0.00033,62304,20.74629,300314
8238,Nagaraja-H,1,0.00033,62305,20.74662,300314
8239,nagstaku,1,0.00033,62306,20.74695,300314
8240,namaiiee2222,1,0.00033,62307,20.74728,300314
8241,namalk,1,0.00033,62308,20.74762,300314
8242,namevic,1,0.00033,62309,20.74795,300314
8243,namgk,1,0.00033,62310,20.74828,300314
8244,namku,1,0.00033,62311,20.74862,300314
8245,narkaTee,1,0.00033,62312,20.74895,300314
8246,narslan,1,0.00033,62313,20.74928,300314
8247,natdop,1,0.00033,62314,20.74962,300314
8248,nateinaction,1,0.00033,62315,20.74995,300314
8249,natesales,1,0.00033,62316,20.75028,300314
8250,nathanielks,1,0.00033,62317,20.75061,300314
8251,nathanperkins,1,0.00033,62318,20.75095,300314
8252,navi86,1,0.00033,62319,20.75128,300314
8253,Nazar910,1,0.00033,62320,20.75161,300314
8254,n-bes,1,0.00033,62321,20.75195,300314
8255,nconnolly1,1,0.00033,62322,20.75228,300314
8256,ncoonrod,1,0.00033,62323,20.75261,300314
8257,nearbyfly,1,0.00033,62324,20.75295,300314
8258,NearchPasipou,1,0.00033,62325,20.75328,300314
8259,nebulon42,1,0.00033,62326,20.75361,300314
8260,nee1esh,1,0.00033,62327,20.75394,300314
8261,need2buy,1,0.00033,62328,20.75428,300314
8262,neelabhm,1,0.00033,62329,20.75461,300314
8263,neerajaustin,1,0.00033,62330,20.75494,300314
8264,NeilMadden,1,0.00033,62331,20.75528,300314
8265,neilschelly,1,0.00033,62332,20.75561,300314
8266,nelboudjay,1,0.00033,62333,20.75594,300314
8267,nelsonpraveen,1,0.00033,62334,20.75628,300314
8268,Nemer-Naamneh,1,0.00033,62335,20.75661,300314
8269,nemethk,1,0.00033,62336,20.75694,300314
8270,neoakris,1,0.00033,62337,20.75727,300314
8271,nepomucen,1,0.00033,62338,20.75761,300314
8272,neredera,1,0.00033,62339,20.75794,300314
8273,NerijusVerseckas,1,0.00033,62340,20.75827,300314
8274,nescohen,1,0.00033,62341,20.75861,300314
8275,nestorsokil,1,0.00033,62342,20.75894,300314
8276,netcho,1,0.00033,62343,20.75927,300314
8277,netdevops-lucasun,1,0.00033,62344,20.75960,300314
8278,neumantm,1,0.00033,62345,20.75994,300314
8279,neuwerld3,1,0.00033,62346,20.76027,300314
8280,nevermore-muyi,1,0.00033,62347,20.76060,300314
8281,newhuangchuan,1,0.00033,62348,20.76094,300314
8282,newly12,1,0.00033,62349,20.76127,300314
8283,nextgen1607,1,0.00033,62350,20.76160,300314
8284,neza2017,1,0.00033,62351,20.76194,300314
8285,nfelger,1,0.00033,62352,20.76227,300314
8286,nfelicio1976,1,0.00033,62353,20.76260,300314
8287,nfstern02,1,0.00033,62354,20.76293,300314
8288,nglcode,1,0.00033,62355,20.76327,300314
8289,ngms06,1,0.00033,62356,20.76360,300314
8290,ngoyal16,1,0.00033,62357,20.76393,300314
8291,n-guitar,1,0.00033,62358,20.76427,300314
8292,nguyentung-199,1,0.00033,62359,20.76460,300314
8293,nhinds,1,0.00033,62360,20.76493,300314
8294,nickgerace,1,0.00033,62361,20.76527,300314
8295,nickhiggs,1,0.00033,62362,20.76560,300314
8296,nickjmv,1,0.00033,62363,20.76593,300314
8297,nickperry,1,0.00033,62364,20.76626,300314
8298,nickpetrovic,1,0.00033,62365,20.76660,300314
8299,NickPyae,1,0.00033,62366,20.76693,300314
8300,nicksu-kdkd,1,0.00033,62367,20.76726,300314
8301,NickyTope,1,0.00033,62368,20.76760,300314
8302,nicofuccella,1,0.00033,62369,20.76793,300314
8303,nicolaballotta,1,0.00033,62370,20.76826,300314
8304,nicolasgarfinkiel,1,0.00033,62371,20.76860,300314
8305,nicolass67,1,0.00033,62372,20.76893,300314
8306,nicolastakashi,1,0.00033,62373,20.76926,300314
8307,nicole-chen-fivestars,1,0.00033,62374,20.76959,300314
8308,nicovota,1,0.00033,62375,20.76993,300314
8309,nidomoko,1,0.00033,62376,20.77026,300314
8310,nielsavonds,1,0.00033,62377,20.77059,300314
8311,NielsKSchjoedt,1,0.00033,62378,20.77093,300314
8312,nightscape,1,0.00033,62379,20.77126,300314
8313,nigthnourse,1,0.00033,62380,20.77159,300314
8314,nija-at,1,0.00033,62381,20.77193,300314
8315,nijel,1,0.00033,62382,20.77226,300314
8316,nikitosiusis,1,0.00033,62383,20.77259,300314
8317,nikkelma,1,0.00033,62384,20.77292,300314
8318,niklasb,1,0.00033,62385,20.77326,300314
8319,NiklasWagner,1,0.00033,62386,20.77359,300314
8320,nikoladsp,1,0.00033,62387,20.77392,300314
8321,nikolaivanovnikolov,1,0.00033,62388,20.77426,300314
8322,nikolaydubina,1,0.00033,62389,20.77459,300314
8323,nikolay-o,1,0.00033,62390,20.77492,300314
8324,nikoul,1,0.00033,62391,20.77526,300314
8325,nilisha-jais,1,0.00033,62392,20.77559,300314
8326,NilMouraa,1,0.00033,62393,20.77592,300314
8327,nils-dehn,1,0.00033,62394,20.77625,300314
8328,nima-sharaf,1,0.00033,62395,20.77659,300314
8329,Nindaleth,1,0.00033,62396,20.77692,300314
8330,ning1875,1,0.00033,62397,20.77725,300314
8331,NinoFloris,1,0.00033,62398,20.77759,300314
8332,niranjan-gavade,1,0.00033,62399,20.77792,300314
8333,nirroz93,1,0.00033,62400,20.77825,300314
8334,Nitin052,1,0.00033,62401,20.77859,300314
8335,NitroCao,1,0.00033,62402,20.77892,300314
8336,nitrocode,1,0.00033,62403,20.77925,300314
8337,nitsujri,1,0.00033,62404,20.77958,300314
8338,Nivedita-coder,1,0.00033,62405,20.77992,300314
8339,niwinz,1,0.00033,62406,20.78025,300314
8340,nix-power,1,0.00033,62407,20.78058,300314
8341,njlkj,1,0.00033,62408,20.78092,300314
8342,nkaplatt,1,0.00033,62409,20.78125,300314
8343,nkraemer-sysdig,1,0.00033,62410,20.78158,300314
8344,nkrishnappa,1,0.00033,62411,20.78191,300314
8345,nmajin,1,0.00033,62412,20.78225,300314
8346,nmante,1,0.00033,62413,20.78258,300314
8347,nmiddendorff,1,0.00033,62414,20.78291,300314
8348,noamles,1,0.00033,62415,20.78325,300314
8349,noamyogev84,1,0.00033,62416,20.78358,300314
8350,noBlubb,1,0.00033,62417,20.78391,300314
8351,nobodyiam,1,0.00033,62418,20.78425,300314
8352,nocive,1,0.00033,62419,20.78458,300314
8353,n-oden,1,0.00033,62420,20.78491,300314
8354,Noemata,1,0.00033,62421,20.78524,300314
8355,Noksa,1,0.00033,62422,20.78558,300314
8356,Noly,1,0.00033,62423,20.78591,300314
8357,nomis-rzp,1,0.00033,62424,20.78624,300314
8358,nontster,1,0.00033,62425,20.78658,300314
8359,NoPrivilege,1,0.00033,62426,20.78691,300314
8360,NorseGaud,1,0.00033,62427,20.78724,300314
8361,No-Silver-J,1,0.00033,62428,20.78758,300314
8362,noskovao,1,0.00033,62429,20.78791,300314
8363,NotAFile,1,0.00033,62430,20.78824,300314
8364,notchairmk,1,0.00033,62431,20.78857,300314
8365,Nothing4You,1,0.00033,62432,20.78891,300314
8366,Novex,1,0.00033,62433,20.78924,300314
8367,nox,1,0.00033,62434,20.78957,300314
8368,noynir,1,0.00033,62435,20.78991,300314
8369,npdgm,1,0.00033,62436,20.79024,300314
8370,npolshakova,1,0.00033,62437,20.79057,300314
8371,nreisch,1,0.00033,62438,20.79091,300314
8372,ns-dlowkeen,1,0.00033,62439,20.79124,300314
8373,nshekhar221,1,0.00033,62440,20.79157,300314
8374,nsupathy,1,0.00033,62441,20.79190,300314
8375,ntaylor1781,1,0.00033,62442,20.79224,300314
8376,ntdt,1,0.00033,62443,20.79257,300314
8377,nunodsfernandes,1,0.00033,62444,20.79290,300314
8378,nunoguerreirorosa,1,0.00033,62445,20.79324,300314
8379,nvanhon,1,0.00033,62446,20.79357,300314
8380,nwalker-nvidia,1,0.00033,62447,20.79390,300314
8381,nwmcsween,1,0.00033,62448,20.79424,300314
8382,nwsparks,1,0.00033,62449,20.79457,300314
8383,oakal,1,0.00033,62450,20.79490,300314
8384,oappicgi,1,0.00033,62451,20.79523,300314
8385,obabec,1,0.00033,62452,20.79557,300314
8386,obasekiosa,1,0.00033,62453,20.79590,300314
8387,obenziane2,1,0.00033,62454,20.79623,300314
8388,ObjatieGroba,1,0.00033,62455,20.79657,300314
8389,object,1,0.00033,62456,20.79690,300314
8390,obliadp,1,0.00033,62457,20.79723,300314
8391,OBrienCommaJosh,1,0.00033,62458,20.79757,300314
8392,odeng888,1,0.00033,62459,20.79790,300314
8393,oDn,1,0.00033,62460,20.79823,300314
8394,Ogguz,1,0.00033,62461,20.79856,300314
8395,oglematt,1,0.00033,62462,20.79890,300314
8396,ogomezm,1,0.00033,62463,20.79923,300314
8397,ohadravid,1,0.00033,62464,20.79956,300314
8398,Oinari,1,0.00033,62465,20.79990,300314
8399,ojaswa1942,1,0.00033,62466,20.80023,300314
8400,okaybe,1,0.00033,62467,20.80056,300314
8401,okravets,1,0.00033,62468,20.80090,300314
8402,olearycrew,1,0.00033,62469,20.80123,300314
8403,oleg-andreyev,1,0.00033,62470,20.80156,300314
8404,Olegone23,1,0.00033,62471,20.80189,300314
8405,olfway,1,0.00033,62472,20.80223,300314
8406,OlivierDeRivoyre,1,0.00033,62473,20.80256,300314
8407,olivierk7,1,0.00033,62474,20.80289,300314
8408,oliviermichaelis,1,0.00033,62475,20.80323,300314
8409,olljanat,1,0.00033,62476,20.80356,300314
8410,OmarAlmighty,1,0.00033,62477,20.80389,300314
8411,omesser,1,0.00033,62478,20.80422,300314
8412,omg-sr,1,0.00033,62479,20.80456,300314
8413,omkarmahadar,1,0.00033,62480,20.80489,300314
8414,omnivagant,1,0.00033,62481,20.80522,300314
8415,onkeyi,1,0.00033,62482,20.80556,300314
8416,onthegit,1,0.00033,62483,20.80589,300314
8417,opa-updater-automation,1,0.00033,62484,20.80622,300314
8418,opsidao,1,0.00033,62485,20.80656,300314
8419,orange-jacky,1,0.00033,62486,20.80689,300314
8420,orangle,1,0.00033,62487,20.80722,300314
8421,orel509,1,0.00033,62488,20.80755,300314
8422,orlygh,1,0.00033,62489,20.80789,300314
8423,OrochW,1,0.00033,62490,20.80822,300314
8424,orxvan,1,0.00033,62491,20.80855,300314
8425,orzel,1,0.00033,62492,20.80889,300314
8426,OscardR,1,0.00033,62493,20.80922,300314
8427,osela,1,0.00033,62494,20.80955,300314
8428,Othniel-dell,1,0.00033,62495,20.80989,300314
8429,ottosulin,1,0.00033,62496,20.81022,300314
8430,ouliuquan,1,0.00033,62497,20.81055,300314
8431,outworlder,1,0.00033,62498,20.81088,300314
8432,override80,1,0.00033,62499,20.81122,300314
8433,oydddddd,1,0.00033,62500,20.81155,300314
8434,ozgunakalin,1,0.00033,62501,20.81188,300314
8435,ozialien,1,0.00033,62502,20.81222,300314
8436,ozkar99,1,0.00033,62503,20.81255,300314
8437,p2c2e,1,0.00033,62504,20.81288,300314
8438,p53,1,0.00033,62505,20.81322,300314
8439,pabbott-starbucks,1,0.00033,62506,20.81355,300314
8440,pablofiumara-azumo,1,0.00033,62507,20.81388,300314
8441,pabs3,1,0.00033,62508,20.81421,300314
8442,paco3346,1,0.00033,62509,20.81455,300314
8443,padraigconnolly,1,0.00033,62510,20.81488,300314
8444,pallavikarpaklu,1,0.00033,62511,20.81521,300314
8445,pallost,1,0.00033,62512,20.81555,300314
8446,palmtoy,1,0.00033,62513,20.81588,300314
8447,palsivertsen,1,0.00033,62514,20.81621,300314
8448,paltaa,1,0.00033,62515,20.81655,300314
8449,pan2za,1,0.00033,62516,20.81688,300314
8450,pandarrr,1,0.00033,62517,20.81721,300314
8451,pandomic,1,0.00033,62518,20.81754,300314
8452,pangbingqiang1,1,0.00033,62519,20.81788,300314
8453,PangQingcheng,1,0.00033,62520,20.81821,300314
8454,pankajagarwal,1,0.00033,62521,20.81854,300314
8455,panscake,1,0.00033,62522,20.81888,300314
8456,Pante,1,0.00033,62523,20.81921,300314
8457,paologallinaharbur,1,0.00033,62524,20.81954,300314
8458,papa-cool,1,0.00033,62525,20.81988,300314
8459,ParamRedekar,1,0.00033,62526,20.82021,300314
8460,parmus,1,0.00033,62527,20.82054,300314
8461,ParthaGoswami,1,0.00033,62528,20.82087,300314
8462,paschdan,1,0.00033,62529,20.82121,300314
8463,pashafirdous1,1,0.00033,62530,20.82154,300314
8464,patatepartie,1,0.00033,62531,20.82187,300314
8465,pathbox,1,0.00033,62532,20.82221,300314
8466,pathob,1,0.00033,62533,20.82254,300314
8467,patjones,1,0.00033,62534,20.82287,300314
8468,patreka,1,0.00033,62535,20.82321,300314
8469,patricksu,1,0.00033,62536,20.82354,300314
8470,Patrik-Netent,1,0.00033,62537,20.82387,300314
8471,patrikszepesi,1,0.00033,62538,20.82420,300314
8472,pattyhuerta,1,0.00033,62539,20.82454,300314
8473,paulinster,1,0.00033,62540,20.82487,300314
8474,paulmcconico,1,0.00033,62541,20.82520,300314
8475,pauloczava,1,0.00033,62542,20.82554,300314
8476,PaulsBecks,1,0.00033,62543,20.82587,300314
8477,paulvvuong,1,0.00033,62544,20.82620,300314
8478,paulwollgast,1,0.00033,62545,20.82653,300314
8479,PavloGl,1,0.00033,62546,20.82687,300314
8480,pawankkamboj,1,0.00033,62547,20.82720,300314
8481,payam54,1,0.00033,62548,20.82753,300314
8482,pbh101,1,0.00033,62549,20.82787,300314
8483,pc-alves,1,0.00033,62550,20.82820,300314
8484,pciazynski,1,0.00033,62551,20.82853,300314
8485,pcmoritz,1,0.00033,62552,20.82887,300314
8486,pdebuitlear,1,0.00033,62553,20.82920,300314
8487,pdecks,1,0.00033,62554,20.82953,300314
8488,pdefreitas,1,0.00033,62555,20.82986,300314
8489,pdgistio,1,0.00033,62556,20.83020,300314
8490,pealtrufo,1,0.00033,62557,20.83053,300314
8491,pedrobaeza,1,0.00033,62558,20.83086,300314
8492,PedroCapdevila,1,0.00033,62559,20.83120,300314
8493,peidaqi,1,0.00033,62560,20.83153,300314
8494,Peksa,1,0.00033,62561,20.83186,300314
8495,pellegrino,1,0.00033,62562,20.83220,300314
8496,pencilso,1,0.00033,62563,20.83253,300314
8497,pengweiqhca,1,0.00033,62564,20.83286,300314
8498,pepesi,1,0.00033,62565,20.83319,300314
8499,PerArneng,1,0.00033,62566,20.83353,300314
8500,pereiren,1,0.00033,62567,20.83386,300314
8501,perf2711,1,0.00033,62568,20.83419,300314
8502,pervadepyy,1,0.00033,62569,20.83453,300314
8503,petar-dambovaliev,1,0.00033,62570,20.83486,300314
8504,PeteMac88,1,0.00033,62571,20.83519,300314
8505,PeterAdams-A,1,0.00033,62572,20.83553,300314
8506,peter-crist,1,0.00033,62573,20.83586,300314
8507,peterfraedrich,1,0.00033,62574,20.83619,300314
8508,peter-miroshnikov,1,0.00033,62575,20.83652,300314
8509,peterparsons-chef,1,0.00033,62576,20.83686,300314
8510,petersutter,1,0.00033,62577,20.83719,300314
8511,petrepopescu21,1,0.00033,62578,20.83752,300314
8512,Pezhvak,1,0.00033,62579,20.83786,300314
8513,Pflegusch,1,0.00033,62580,20.83819,300314
8514,pgeler,1,0.00033,62581,20.83852,300314
8515,pghildiyal,1,0.00033,62582,20.83886,300314
8516,pgs-progress,1,0.00033,62583,20.83919,300314
8517,pguedes,1,0.00033,62584,20.83952,300314
8518,Phazz,1,0.00033,62585,20.83985,300314
8519,phew-ww,1,0.00033,62586,20.84019,300314
8520,phil123456,1,0.00033,62587,20.84052,300314
8521,phillipgreenii,1,0.00033,62588,20.84085,300314
8522,philroche,1,0.00033,62589,20.84119,300314
8523,Phips0812,1,0.00033,62590,20.84152,300314
8524,Phlak106,1,0.00033,62591,20.84185,300314
8525,PIAOTJ,1,0.00033,62592,20.84219,300314
8526,piavgh,1,0.00033,62593,20.84252,300314
8527,picatz,1,0.00033,62594,20.84285,300314
8528,pidydx,1,0.00033,62595,20.84318,300314
8529,pie-r,1,0.00033,62596,20.84352,300314
8530,pietervincken,1,0.00033,62597,20.84385,300314
8531,pikachu,1,0.00033,62598,20.84418,300314
8532,Pikaxtron,1,0.00033,62599,20.84452,300314
8533,pikrzysztof,1,0.00033,62600,20.84485,300314
8534,pingcrosby,1,0.00033,62601,20.84518,300314
8535,pingstar,1,0.00033,62602,20.84552,300314
8536,pioziol123,1,0.00033,62603,20.84585,300314
8537,pistachio2011,1,0.00033,62604,20.84618,300314
8538,pisto,1,0.00033,62605,20.84651,300314
8539,pitwegner,1,0.00033,62606,20.84685,300314
8540,pixiono,1,0.00033,62607,20.84718,300314
8541,PixnBits,1,0.00033,62608,20.84751,300314
8542,pjaak,1,0.00033,62609,20.84785,300314
8543,pkddacoliat,1,0.00033,62610,20.84818,300314
8544,placydo,1,0.00033,62611,20.84851,300314
8545,plsmaop,1,0.00033,62612,20.84884,300314
8546,pmartin-lvmh,1,0.00033,62613,20.84918,300314
8547,pmccau,1,0.00033,62614,20.84951,300314
8548,pmorelli92,1,0.00033,62615,20.84984,300314
8549,pnmice,1,0.00033,62616,20.85018,300314
8550,pnorth1,1,0.00033,62617,20.85051,300314
8551,pnutmath,1,0.00033,62618,20.85084,300314
8552,poblin-orange,1,0.00033,62619,20.85118,300314
8553,POD666,1,0.00033,62620,20.85151,300314
8554,pogao,1,0.00033,62621,20.85184,300314
8555,pokutuna,1,0.00033,62622,20.85217,300314
8556,Polygens,1,0.00033,62623,20.85251,300314
8557,ponceps,1,0.00033,62624,20.85284,300314
8558,pontovinte,1,0.00033,62625,20.85317,300314
8559,pontusmelke,1,0.00033,62626,20.85351,300314
8560,poorX,1,0.00033,62627,20.85384,300314
8561,poozza,1,0.00033,62628,20.85417,300314
8562,porterfc,1,0.00033,62629,20.85451,300314
8563,posilva,1,0.00033,62630,20.85484,300314
8564,potester,1,0.00033,62631,20.85517,300314
8565,Poundex,1,0.00033,62632,20.85550,300314
8566,povesteam,1,0.00033,62633,20.85584,300314
8567,powertoaster,1,0.00033,62634,20.85617,300314
8568,ppeereb1,1,0.00033,62635,20.85650,300314
8569,ppirus,1,0.00033,62636,20.85684,300314
8570,pr3l14t0r,1,0.00033,62637,20.85717,300314
8571,prabha1331,1,0.00033,62638,20.85750,300314
8572,prabhakhar,1,0.00033,62639,20.85784,300314
8573,PradeepKumar-15,1,0.00033,62640,20.85817,300314
8574,prakash-arjun,1,0.00033,62641,20.85850,300314
8575,prakhar101,1,0.00033,62642,20.85883,300314
8576,Prakhar-FF13,1,0.00033,62643,20.85917,300314
8577,pranav-shah294,1,0.00033,62644,20.85950,300314
8578,PranayVJain,1,0.00033,62645,20.85983,300314
8579,PranshuSrivastava,1,0.00033,62646,20.86017,300314
8580,prasadborole1,1,0.00033,62647,20.86050,300314
8581,Prashanth684,1,0.00033,62648,20.86083,300314
8582,prashanthb-ai,1,0.00033,62649,20.86117,300314
8583,pratik322,1,0.00033,62650,20.86150,300314
8584,PrayagS,1,0.00033,62651,20.86183,300314
8585,predator-coder,1,0.00033,62652,20.86216,300314
8586,previousdeveloper,1,0.00033,62653,20.86250,300314
8587,pribalaji58,1,0.00033,62654,20.86283,300314
8588,Priyabrata-dev,1,0.00033,62655,20.86316,300314
8589,Priyaraj17,1,0.00033,62656,20.86350,300314
8590,pr-mu-deploy,1,0.00033,62657,20.86383,300314
8591,profporridge,1,0.00033,62658,20.86416,300314
8592,p-rog,1,0.00033,62659,20.86450,300314
8593,proggga,1,0.00033,62660,20.86483,300314
8594,protosam,1,0.00033,62661,20.86516,300314
8595,Pryz,1,0.00033,62662,20.86549,300314
8596,psalkowski,1,0.00033,62663,20.86583,300314
8597,PSanetra,1,0.00033,62664,20.86616,300314
8598,pscheid92,1,0.00033,62665,20.86649,300314
8599,pschulten,1,0.00033,62666,20.86683,300314
8600,psschwei,1,0.00033,62667,20.86716,300314
8601,psundareshan,1,0.00033,62668,20.86749,300314
8602,psvmcc,1,0.00033,62669,20.86783,300314
8603,psyxoz,1,0.00033,62670,20.86816,300314
8604,Pterosaur,1,0.00033,62671,20.86849,300314
8605,ptzool,1,0.00033,62672,20.86882,300314
8606,puddinman,1,0.00033,62673,20.86916,300314
8607,pulberg,1,0.00033,62674,20.86949,300314
8608,PulseBright,1,0.00033,62675,20.86982,300314
8609,punedhir,1,0.00033,62676,20.87016,300314
8610,puneeth8994,1,0.00033,62677,20.87049,300314
8611,pvorontsovd,1,0.00033,62678,20.87082,300314
8612,pwhissell,1,0.00033,62679,20.87115,300314
8613,pysiekytel,1,0.00033,62680,20.87149,300314
8614,Qdigital,1,0.00033,62681,20.87182,300314
8615,qdj0226,1,0.00033,62682,20.87215,300314
8616,qingshanyinyin,1,0.00033,62683,20.87249,300314
8617,qingyunha,1,0.00033,62684,20.87282,300314
8618,qinyunfei,1,0.00033,62685,20.87315,300314
8619,qisikai,1,0.00033,62686,20.87349,300314
8620,qizichao-dm,1,0.00033,62687,20.87382,300314
8621,qkflies,1,0.00033,62688,20.87415,300314
8622,qldosdme0,1,0.00033,62689,20.87448,300314
8623,q-o-ap,1,0.00033,62690,20.87482,300314
8624,qpakzk,1,0.00033,62691,20.87515,300314
8625,quangthe,1,0.00033,62692,20.87548,300314
8626,quentinplessis,1,0.00033,62693,20.87582,300314
8627,quickwind,1,0.00033,62694,20.87615,300314
8628,qzmfranklin,1,0.00033,62695,20.87648,300314
8629,r00ta,1,0.00033,62696,20.87682,300314
8630,r0b6,1,0.00033,62697,20.87715,300314
8631,r10r,1,0.00033,62698,20.87748,300314
8632,r8474,1,0.00033,62699,20.87781,300314
8633,ra312,1,0.00033,62700,20.87815,300314
8634,radekba,1,0.00033,62701,20.87848,300314
8635,radekkut,1,0.00033,62702,20.87881,300314
8636,Radhika299,1,0.00033,62703,20.87915,300314
8637,radityasurya,1,0.00033,62704,20.87948,300314
8638,rafaellima,1,0.00033,62705,20.87981,300314
8639,rafalkasa,1,0.00033,62706,20.88015,300314
8640,rafatio,1,0.00033,62707,20.88048,300314
8641,rafilkmp3,1,0.00033,62708,20.88081,300314
8642,RafPe,1,0.00033,62709,20.88114,300314
8643,rahul-1020,1,0.00033,62710,20.88148,300314
8644,rahul7rajdn,1,0.00033,62711,20.88181,300314
8645,rahulkohli23,1,0.00033,62712,20.88214,300314
8646,raids,1,0.00033,62713,20.88248,300314
8647,RainFlying,1,0.00033,62714,20.88281,300314
8648,rajasaur,1,0.00033,62715,20.88314,300314
8649,rajesh444aws,1,0.00033,62716,20.88348,300314
8650,rajha-korithrien,1,0.00033,62717,20.88381,300314
8651,rajiamarnath,1,0.00033,62718,20.88414,300314
8652,rajibmitra,1,0.00033,62719,20.88447,300314
8653,rajivml,1,0.00033,62720,20.88481,300314
8654,rajiv-webill,1,0.00033,62721,20.88514,300314
8655,rajpratyush,1,0.00033,62722,20.88547,300314
8656,rajsameer,1,0.00033,62723,20.88581,300314
8657,raj-saxena,1,0.00033,62724,20.88614,300314
8658,rajveermalviya,1,0.00033,62725,20.88647,300314
8659,ralight,1,0.00033,62726,20.88681,300314
8660,ralongit,1,0.00033,62727,20.88714,300314
8661,ram2031,1,0.00033,62728,20.88747,300314
8662,Raman-Kumar,1,0.00033,62729,20.88780,300314
8663,ramay1,1,0.00033,62730,20.88814,300314
8664,RamazanKara,1,0.00033,62731,20.88847,300314
8665,rambo406,1,0.00033,62732,20.88880,300314
8666,Rameshgangaa,1,0.00033,62733,20.88914,300314
8667,RameshKandukuriB,1,0.00033,62734,20.88947,300314
8668,ramijebara,1,0.00033,62735,20.88980,300314
8669,raminorujov,1,0.00033,62736,20.89013,300314
8670,ramirogarciaf,1,0.00033,62737,20.89047,300314
8671,ramkarthik-sys,1,0.00033,62738,20.89080,300314
8672,ramrodo,1,0.00033,62739,20.89113,300314
8673,ramthi,1,0.00033,62740,20.89147,300314
8674,rancherissue2,1,0.00033,62741,20.89180,300314
8675,Rancheroo,1,0.00033,62742,20.89213,300314
8676,randallt,1,0.00033,62743,20.89247,300314
8677,ranjanprj,1,0.00033,62744,20.89280,300314
8678,ranrubin,1,0.00033,62745,20.89313,300314
8679,ranulf10,1,0.00033,62746,20.89346,300314
8680,rao2100,1,0.00033,62747,20.89380,300314
8681,raphaelquati,1,0.00033,62748,20.89413,300314
8682,rapkalya,1,0.00033,62749,20.89446,300314
8683,raptium,1,0.00033,62750,20.89480,300314
8684,rassidm,1,0.00033,62751,20.89513,300314
8685,RationalityFrontline,1,0.00033,62752,20.89546,300314
8686,raul1991,1,0.00033,62753,20.89580,300314
8687,ravann,1,0.00033,62754,20.89613,300314
8688,ravikumarkp7,1,0.00033,62755,20.89646,300314
8689,RavirahulPadmanabhan,1,0.00033,62756,20.89679,300314
8690,raviranjanelastisys,1,0.00033,62757,20.89713,300314
8691,rayman-g,1,0.00033,62758,20.89746,300314
8692,raythorn,1,0.00033,62759,20.89779,300314
8693,razigarbie,1,0.00033,62760,20.89813,300314
8694,rbk111088,1,0.00033,62761,20.89846,300314
8695,rbq,1,0.00033,62762,20.89879,300314
8696,rbranson,1,0.00033,62763,20.89913,300314
8697,rbuisson,1,0.00033,62764,20.89946,300314
8698,r-catania,1,0.00033,62765,20.89979,300314
8699,rchrd,1,0.00033,62766,20.90012,300314
8700,rckgomz,1,0.00033,62767,20.90046,300314
8701,rda3mon,1,0.00033,62768,20.90079,300314
8702,rdcox,1,0.00033,62769,20.90112,300314
8703,rdp,1,0.00033,62770,20.90146,300314
8704,rdxbarakn,1,0.00033,62771,20.90179,300314
8705,readerx,1,0.00033,62772,20.90212,300314
8706,RealCLanger,1,0.00033,62773,20.90246,300314
8707,Reamer,1,0.00033,62774,20.90279,300314
8708,redplanet00,1,0.00033,62775,20.90312,300314
8709,redvg,1,0.00033,62776,20.90345,300314
8710,reejinbouk,1,0.00033,62777,20.90379,300314
8711,regel,1,0.00033,62778,20.90412,300314
8712,reggie-k,1,0.00033,62779,20.90445,300314
8713,regnaio,1,0.00033,62780,20.90479,300314
8714,Relers,1,0.00033,62781,20.90512,300314
8715,RemiGaudin,1,0.00033,62782,20.90545,300314
8716,remiminnebo,1,0.00033,62783,20.90579,300314
8717,renchap,1,0.00033,62784,20.90612,300314
8718,renejahn,1,0.00033,62785,20.90645,300314
8719,RenePinnow,1,0.00033,62786,20.90678,300314
8720,renhuanyu,1,0.00033,62787,20.90712,300314
8721,renier,1,0.00033,62788,20.90745,300314
8722,renyuntao,1,0.00033,62789,20.90778,300314
8723,repl-mike-roest,1,0.00033,62790,20.90812,300314
8724,revolunet,1,0.00033,62791,20.90845,300314
8725,rewiko,1,0.00033,62792,20.90878,300314
8726,rewt,1,0.00033,62793,20.90912,300314
8727,rex,1,0.00033,62794,20.90945,300314
8728,rexagod,1,0.00033,62795,20.90978,300314
8729,rexledesma,1,0.00033,62796,20.91011,300314
8730,reynn,1,0.00033,62797,20.91045,300314
8731,rfezz,1,0.00033,62798,20.91078,300314
8732,rgangoni,1,0.00033,62799,20.91111,300314
8733,rgarcia,1,0.00033,62800,20.91145,300314
8734,rgl,1,0.00033,62801,20.91178,300314
8735,rgreig,1,0.00033,62802,20.91211,300314
8736,rhclaudio,1,0.00033,62803,20.91244,300314
8737,rhino5oh,1,0.00033,62804,20.91278,300314
8738,rhjanders,1,0.00033,62805,20.91311,300314
8739,rhoboat,1,0.00033,62806,20.91344,300314
8740,rhtyd,1,0.00033,62807,20.91378,300314
8741,rhuitl,1,0.00033,62808,20.91411,300314
8742,rhyek,1,0.00033,62809,20.91444,300314
8743,ricgatti,1,0.00033,62810,20.91478,300314
8744,richardmcsong,1,0.00033,62811,20.91511,300314
8745,RichardoC,1,0.00033,62812,20.91544,300314
8746,richgerrard,1,0.00033,62813,20.91577,300314
8747,Richman5138,1,0.00033,62814,20.91611,300314
8748,ricky26,1,0.00033,62815,20.91644,300314
8749,RiichardCC,1,0.00033,62816,20.91677,300314
8750,Rishantkr,1,0.00033,62817,20.91711,300314
8751,rishi1111,1,0.00033,62818,20.91744,300314
8752,riskgod,1,0.00033,62819,20.91777,300314
8753,ritheshgm,1,0.00033,62820,20.91811,300314
8754,rivernews,1,0.00033,62821,20.91844,300314
8755,RiyaTyagi,1,0.00033,62822,20.91877,300314
8756,rjdp,1,0.00033,62823,20.91910,300314
8757,rjeka,1,0.00033,62824,20.91944,300314
8758,r-joyce,1,0.00033,62825,20.91977,300314
8759,rk185151,1,0.00033,62826,20.92010,300314
8760,rkayman,1,0.00033,62827,20.92044,300314
8761,rkilingr,1,0.00033,62828,20.92077,300314
8762,rkleinman-hpe,1,0.00033,62829,20.92110,300314
8763,rlisewski,1,0.00033,62830,20.92144,300314
8764,rLitto,1,0.00033,62831,20.92177,300314
8765,rlljorge,1,0.00033,62832,20.92210,300314
8766,rlogiacco,1,0.00033,62833,20.92243,300314
8767,rmakulov,1,0.00033,62834,20.92277,300314
8768,rmon-vfer,1,0.00033,62835,20.92310,300314
8769,RmStorm,1,0.00033,62836,20.92343,300314
8770,rneto12,1,0.00033,62837,20.92377,300314
8771,rnwolfe,1,0.00033,62838,20.92410,300314
8772,Roarain,1,0.00033,62839,20.92443,300314
8773,roastedmonk,1,0.00033,62840,20.92477,300314
8774,Robbie558,1,0.00033,62841,20.92510,300314
8775,robd003,1,0.00033,62842,20.92543,300314
8776,robdewit,1,0.00033,62843,20.92576,300314
8777,Robert-Christensen-visa,1,0.00033,62844,20.92610,300314
8778,RobertDiPaolo,1,0.00033,62845,20.92643,300314
8779,robertjahn,1,0.00033,62846,20.92676,300314
8780,robertkaelin,1,0.00033,62847,20.92710,300314
8781,robertvanhoesel,1,0.00033,62848,20.92743,300314
8782,robertwt7,1,0.00033,62849,20.92776,300314
8783,RobinYang11,1,0.00033,62850,20.92810,300314
8784,roblappcoupa,1,0.00033,62851,20.92843,300314
8785,robododge,1,0.00033,62852,20.92876,300314
8786,robvanmaris,1,0.00033,62853,20.92909,300314
8787,robwithhair,1,0.00033,62854,20.92943,300314
8788,roccqqck,1,0.00033,62855,20.92976,300314
8789,rocklau,1,0.00033,62856,20.93009,300314
8790,rockyzhengwu,1,0.00033,62857,20.93043,300314
8791,rodrigosaito,1,0.00033,62858,20.93076,300314
8792,roee88,1,0.00033,62859,20.93109,300314
8793,roelvdberg,1,0.00033,62860,20.93143,300314
8794,Rofor51,1,0.00033,62861,20.93176,300314
8795,rohilsurana,1,0.00033,62862,20.93209,300314
8796,rohitju1,1,0.00033,62863,20.93242,300314
8797,roitenen1981,1,0.00033,62864,20.93276,300314
8798,rokcarl,1,0.00033,62865,20.93309,300314
8799,roli25,1,0.00033,62866,20.93342,300314
8800,RomanKisilenko,1,0.00033,62867,20.93376,300314
8801,rommelandrea,1,0.00033,62868,20.93409,300314
8802,romuald,1,0.00033,62869,20.93442,300314
8803,romulocollopy,1,0.00033,62870,20.93475,300314
8804,ronaknnathani,1,0.00033,62871,20.93509,300314
8805,ronaldmiranda,1,0.00033,62872,20.93542,300314
8806,rooflz,1,0.00033,62873,20.93575,300314
8807,rosaiahch,1,0.00033,62874,20.93609,300314
8808,RosenKaramanov,1,0.00033,62875,20.93642,300314
8809,rosslutsch,1,0.00033,62876,20.93675,300314
8810,rostams-lyft,1,0.00033,62877,20.93709,300314
8811,rothn,1,0.00033,62878,20.93742,300314
8812,RouR,1,0.00033,62879,20.93775,300314
8813,roverliang,1,0.00033,62880,20.93808,300314
8814,rpjayasekara,1,0.00033,62881,20.93842,300314
8815,rraj-gautam,1,0.00033,62882,20.93875,300314
8816,r-ricardo,1,0.00033,62883,20.93908,300314
8817,RSE132,1,0.00033,62884,20.93942,300314
8818,rslowe,1,0.00033,62885,20.93975,300314
8819,rstefan1,1,0.00033,62886,20.94008,300314
8820,rstober,1,0.00033,62887,20.94042,300314
8821,rstub,1,0.00033,62888,20.94075,300314
8822,RtlduinoMan,1,0.00033,62889,20.94108,300314
8823,rtreffer-sc,1,0.00033,62890,20.94141,300314
8824,rubberduck203,1,0.00033,62891,20.94175,300314
8825,rubit0,1,0.00033,62892,20.94208,300314
8826,rucheton,1,0.00033,62893,20.94241,300314
8827,ruckc,1,0.00033,62894,20.94275,300314
8828,runseason,1,0.00033,62895,20.94308,300314
8829,RunziiMo,1,0.00033,62896,20.94341,300314
8830,rurounijones,1,0.00033,62897,20.94375,300314
8831,rursprung,1,0.00033,62898,20.94408,300314
8832,rverdugo01,1,0.00033,62899,20.94441,300314
8833,rvrangel,1,0.00033,62900,20.94474,300314
8834,rwaweber,1,0.00033,62901,20.94508,300314
8835,rwin-novo,1,0.00033,62902,20.94541,300314
8836,rwxrob,1,0.00033,62903,20.94574,300314
8837,rxbn,1,0.00033,62904,20.94608,300314
8838,ryan-dyer-sp,1,0.00033,62905,20.94641,300314
8839,ryanemerson,1,0.00033,62906,20.94674,300314
8840,ryannix123,1,0.00033,62907,20.94708,300314
8841,ryanprobus,1,0.00033,62908,20.94741,300314
8842,RyanSquared,1,0.00033,62909,20.94774,300314
8843,Rylab,1,0.00033,62910,20.94807,300314
8844,ryneal,1,0.00033,62911,20.94841,300314
8845,RyuSA,1,0.00033,62912,20.94874,300314
8846,s3kkt,1,0.00033,62913,20.94907,300314
8847,S3ky,1,0.00033,62914,20.94941,300314
8848,saadzimat430,1,0.00033,62915,20.94974,300314
8849,SAAMalusare,1,0.00033,62916,20.95007,300314
8850,SabarishMN,1,0.00033,62917,20.95041,300314
8851,SAbdulRahuman,1,0.00033,62918,20.95074,300314
8852,sachinms27,1,0.00033,62919,20.95107,300314
8853,sadovnikov,1,0.00033,62920,20.95140,300314
8854,sagar027,1,0.00033,62921,20.95174,300314
8855,sagarbirla,1,0.00033,62922,20.95207,300314
8856,sagarkal,1,0.00033,62923,20.95240,300314
8857,sagarpreet-chadha,1,0.00033,62924,20.95274,300314
8858,sagital,1,0.00033,62925,20.95307,300314
8859,saharme,1,0.00033,62926,20.95340,300314
8860,saharshjain,1,0.00033,62927,20.95374,300314
8861,SahilChaudhary25,1,0.00033,62928,20.95407,300314
8862,Sahilgupta942,1,0.00033,62929,20.95440,300314
8863,saif-romdhane,1,0.00033,62930,20.95473,300314
8864,Saksow,1,0.00033,62931,20.95507,300314
8865,salamander-mh,1,0.00033,62932,20.95540,300314
8866,Salicorne,1,0.00033,62933,20.95573,300314
8867,sallylxl,1,0.00033,62934,20.95607,300314
8868,samath117,1,0.00033,62935,20.95640,300314
8869,SamFisher940425,1,0.00033,62936,20.95673,300314
8870,samirspatel,1,0.00033,62937,20.95706,300314
8871,Sam-Lin-MillersLab,1,0.00033,62938,20.95740,300314
8872,sammym1982,1,0.00033,62939,20.95773,300314
8873,sampaiodiego,1,0.00033,62940,20.95806,300314
8874,sampeinado,1,0.00033,62941,20.95840,300314
8875,sam-robson,1,0.00033,62942,20.95873,300314
8876,samthehai,1,0.00033,62943,20.95906,300314
8877,samuelchen,1,0.00033,62944,20.95940,300314
8878,SamuelDudley,1,0.00033,62945,20.95973,300314
8879,samwhite,1,0.00033,62946,20.96006,300314
8880,samwiskow,1,0.00033,62947,20.96039,300314
8881,sanj982052,1,0.00033,62948,20.96073,300314
8882,sanjarora,1,0.00033,62949,20.96106,300314
8883,sanjeevpandey19,1,0.00033,62950,20.96139,300314
8884,sanjeevvpshastry,1,0.00033,62951,20.96173,300314
8885,Sanjit-Prasad,1,0.00033,62952,20.96206,300314
8886,SanthoshConatix,1,0.00033,62953,20.96239,300314
8887,santhoshs123,1,0.00033,62954,20.96273,300314
8888,sAnti09,1,0.00033,62955,20.96306,300314
8889,santinoncs,1,0.00033,62956,20.96339,300314
8890,santoojoshi,1,0.00033,62957,20.96372,300314
8891,SantoshNGitHub,1,0.00033,62958,20.96406,300314
8892,sanya2022,1,0.00033,62959,20.96439,300314
8893,saputkin,1,0.00033,62960,20.96472,300314
8894,saramach,1,0.00033,62961,20.96506,300314
8895,sarathm54,1,0.00033,62962,20.96539,300314
8896,sarbh20,1,0.00033,62963,20.96572,300314
8897,sarthakroy2002,1,0.00033,62964,20.96606,300314
8898,SarthakSahu,1,0.00033,62965,20.96639,300314
8899,saruman9,1,0.00033,62966,20.96672,300314
8900,sashaaKr,1,0.00033,62967,20.96705,300314
8901,sashasimkin,1,0.00033,62968,20.96739,300314
8902,sasheeny,1,0.00033,62969,20.96772,300314
8903,sasukeuchiha-clan,1,0.00033,62970,20.96805,300314
8904,sathishavm,1,0.00033,62971,20.96839,300314
8905,sathish-kumar-narayanan,1,0.00033,62972,20.96872,300314
8906,sathwikreddygv,1,0.00033,62973,20.96905,300314
8907,satishs97,1,0.00033,62974,20.96939,300314
8908,Satyasreegoli,1,0.00033,62975,20.96972,300314
8909,saurap,1,0.00033,62976,20.97005,300314
8910,saviovettoor,1,0.00033,62977,20.97038,300314
8911,sbajaj-vmw,1,0.00033,62978,20.97072,300314
8912,sbandadd,1,0.00033,62979,20.97105,300314
8913,sbeginCoveo,1,0.00033,62980,20.97138,300314
8914,sbirl,1,0.00033,62981,20.97172,300314
8915,S-Bohn,1,0.00033,62982,20.97205,300314
8916,sbrnunes,1,0.00033,62983,20.97238,300314
8917,scalen,1,0.00033,62984,20.97272,300314
8918,scarbeau,1,0.00033,62985,20.97305,300314
8919,scarby,1,0.00033,62986,20.97338,300314
8920,scastria,1,0.00033,62987,20.97371,300314
8921,sc-chad,1,0.00033,62988,20.97405,300314
8922,sceptreone,1,0.00033,62989,20.97438,300314
8923,schans,1,0.00033,62990,20.97471,300314
8924,schmurfy,1,0.00033,62991,20.97505,300314
8925,Schneider-Electric-Carros,1,0.00033,62992,20.97538,300314
8926,SchroterQuentin,1,0.00033,62993,20.97571,300314
8927,Schuttrim,1,0.00033,62994,20.97605,300314
8928,sciyoshi,1,0.00033,62995,20.97638,300314
8929,SCKelemen,1,0.00033,62996,20.97671,300314
8930,sckn,1,0.00033,62997,20.97704,300314
8931,sconover,1,0.00033,62998,20.97738,300314
8932,Scoppio,1,0.00033,62999,20.97771,300314
8933,scoren-gl,1,0.00033,63000,20.97804,300314
8934,scorputty,1,0.00033,63001,20.97838,300314
8935,screamyao,1,0.00033,63002,20.97871,300314
8936,Scrier,1,0.00033,63003,20.97904,300314
8937,scsldb,1,0.00033,63004,20.97937,300314
8938,scuzhanglei,1,0.00033,63005,20.97971,300314
8939,sdanzan,1,0.00033,63006,20.98004,300314
8940,sdarlington,1,0.00033,63007,20.98037,300314
8941,sdesbure,1,0.00033,63008,20.98071,300314
8942,sdgmf,1,0.00033,63009,20.98104,300314
8943,sdhoward,1,0.00033,63010,20.98137,300314
8944,sealcome,1,0.00033,63011,20.98171,300314
8945,seamaner,1,0.00033,63012,20.98204,300314
8946,seangallavan,1,0.00033,63013,20.98237,300314
8947,seankhliao,1,0.00033,63014,20.98270,300314
8948,sean-mcgimpsey,1,0.00033,63015,20.98304,300314
8949,seanschade,1,0.00033,63016,20.98337,300314
8950,seantheyahn,1,0.00033,63017,20.98370,300314
8951,seanwalker909,1,0.00033,63018,20.98404,300314
8952,seaurching,1,0.00033,63019,20.98437,300314
8953,Sebi2020,1,0.00033,63020,20.98470,300314
8954,Seb-Solon,1,0.00033,63021,20.98504,300314
8955,sech9446,1,0.00033,63022,20.98537,300314
8956,secustor,1,0.00033,63023,20.98570,300314
8957,seebs,1,0.00033,63024,20.98603,300314
8958,seefor,1,0.00033,63025,20.98637,300314
8959,sefaphlvn,1,0.00033,63026,20.98670,300314
8960,seishinsha,1,0.00033,63027,20.98703,300314
8961,seksham,1,0.00033,63028,20.98737,300314
8962,Seljuke,1,0.00033,63029,20.98770,300314
8963,sendev1,1,0.00033,63030,20.98803,300314
8964,senorsmile,1,0.00033,63031,20.98837,300314
8965,seonggwonyoon,1,0.00033,63032,20.98870,300314
8966,sepich,1,0.00033,63033,20.98903,300314
8967,sequoiar,1,0.00033,63034,20.98936,300314
8968,sereinity,1,0.00033,63035,20.98970,300314
8969,sergenyalcin,1,0.00033,63036,20.99003,300314
8970,sergeye-boltinc,1,0.00033,63037,20.99036,300314
8971,sergiomacedo,1,0.00033,63038,20.99070,300314
8972,sethmiles,1,0.00033,63039,20.99103,300314
8973,seungyongshim,1,0.00033,63040,20.99136,300314
8974,sevagh,1,0.00033,63041,20.99170,300314
8975,sevberg,1,0.00033,63042,20.99203,300314
8976,sgarg04,1,0.00033,63043,20.99236,300314
8977,sgblv,1,0.00033,63044,20.99269,300314
8978,sgkoutscloudreach,1,0.00033,63045,20.99303,300314
8979,sgn,1,0.00033,63046,20.99336,300314
8980,sgpinkus,1,0.00033,63047,20.99369,300314
8981,sguyennet,1,0.00033,63048,20.99403,300314
8982,sh0umik,1,0.00033,63049,20.99436,300314
8983,shadowlan,1,0.00033,63050,20.99469,300314
8984,Shahab1296,1,0.00033,63051,20.99503,300314
8985,shahabio,1,0.00033,63052,20.99536,300314
8986,shahidv3,1,0.00033,63053,20.99569,300314
8987,ShahNewazKhan,1,0.00033,63054,20.99602,300314
8988,shairozan,1,0.00033,63055,20.99636,300314
8989,shakti-mishra,1,0.00033,63056,20.99669,300314
8990,ShalbafZadeh,1,0.00033,63057,20.99702,300314
8991,shalver,1,0.00033,63058,20.99736,300314
8992,shan0809,1,0.00033,63059,20.99769,300314
8993,shan100github,1,0.00033,63060,20.99802,300314
8994,shanemcd,1,0.00033,63061,20.99836,300314
8995,shangsony,1,0.00033,63062,20.99869,300314
8996,shangwu-google,1,0.00033,63063,20.99902,300314
8997,sha-rath,1,0.00033,63064,20.99935,300314
8998,sharoncr1,1,0.00033,63065,20.99969,300314
8999,shartte,1,0.00033,63066,21.00002,300314
9000,Shashankft9,1,0.00033,63067,21.00035,300314
9001,shashank-k,1,0.00033,63068,21.00069,300314
9002,shashankkmurthy,1,0.00033,63069,21.00102,300314
9003,shatoboar,1,0.00033,63070,21.00135,300314
9004,shawngmc,1,0.00033,63071,21.00168,300314
9005,shaybbigid,1,0.00033,63072,21.00202,300314
9006,shcherbak,1,0.00033,63073,21.00235,300314
9007,sheetalsingala,1,0.00033,63074,21.00268,300314
9008,sheinbergon,1,0.00033,63075,21.00302,300314
9009,shelltea,1,0.00033,63076,21.00335,300314
9010,shenshouer,1,0.00033,63077,21.00368,300314
9011,sherbang,1,0.00033,63078,21.00402,300314
9012,Shesoff,1,0.00033,63079,21.00435,300314
9013,shiba24,1,0.00033,63080,21.00468,300314
9014,shifeichen,1,0.00033,63081,21.00501,300314
9015,shirolimit,1,0.00033,63082,21.00535,300314
9016,shishirkh,1,0.00033,63083,21.00568,300314
9017,shivakumar12,1,0.00033,63084,21.00601,300314
9018,shivamsood,1,0.00033,63085,21.00635,300314
9019,shivubhatt,1,0.00033,63086,21.00668,300314
9020,shixinghong,1,0.00033,63087,21.00701,300314
9021,shiyiyue1102,1,0.00033,63088,21.00735,300314
9022,shlee322,1,0.00033,63089,21.00768,300314
9023,shnhrrsn,1,0.00033,63090,21.00801,300314
9024,sho-abe,1,0.00033,63091,21.00834,300314
9025,shpml,1,0.00033,63092,21.00868,300314
9026,shreeraj2698,1,0.00033,63093,21.00901,300314
9027,shuaisai,1,0.00033,63094,21.00934,300314
9028,shuangyangqian,1,0.00033,63095,21.00968,300314
9029,shuxnhs,1,0.00033,63096,21.01001,300314
9030,shuzijun,1,0.00033,63097,21.01034,300314
9031,ShuzZzle,1,0.00033,63098,21.01068,300314
9032,Shyrou,1,0.00033,63099,21.01101,300314
9033,siavashsoleymani,1,0.00033,63100,21.01134,300314
9034,sichapman,1,0.00033,63101,21.01167,300314
9035,sidh,1,0.00033,63102,21.01201,300314
9036,sidpremkumar,1,0.00033,63103,21.01234,300314
9037,sifotes,1,0.00033,63104,21.01267,300314
9038,sigxcpu76,1,0.00033,63105,21.01301,300314
9039,Sil3ntStorm,1,0.00033,63106,21.01334,300314
9040,silashansen,1,0.00033,63107,21.01367,300314
9041,silhouette,1,0.00033,63108,21.01401,300314
9042,sillent,1,0.00033,63109,21.01434,300314
9043,Silverhumor,1,0.00033,63110,21.01467,300314
9044,Silver-Knight,1,0.00033,63111,21.01500,300314
9045,SilverTux,1,0.00033,63112,21.01534,300314
9046,silviu-paunescu,1,0.00033,63113,21.01567,300314
9047,simax,1,0.00033,63114,21.01600,300314
9048,simcard0000,1,0.00033,63115,21.01634,300314
9049,SimeonGerginov,1,0.00033,63116,21.01667,300314
9050,SimonDreher,1,0.00033,63117,21.01700,300314
9051,SimonePomata,1,0.00033,63118,21.01734,300314
9052,simonfrey,1,0.00033,63119,21.01767,300314
9053,simonhou,1,0.00033,63120,21.01800,300314
9054,simonklb,1,0.00033,63121,21.01833,300314
9055,SimonOlenik,1,0.00033,63122,21.01867,300314
9056,simonseyock,1,0.00033,63123,21.01900,300314
9057,simonweil,1,0.00033,63124,21.01933,300314
9058,sindreij,1,0.00033,63125,21.01967,300314
9059,singla-shivam,1,0.00033,63126,21.02000,300314
9060,sinoohe,1,0.00033,63127,21.02033,300314
9061,sinoon,1,0.00033,63128,21.02067,300314
9062,sinsoku,1,0.00033,63129,21.02100,300314
9063,siriuslan,1,0.00033,63130,21.02133,300314
9064,sirkrypt0,1,0.00033,63131,21.02166,300314
9065,SirNiggo,1,0.00033,63132,21.02200,300314
9066,sit-md,1,0.00033,63133,21.02233,300314
9067,SivaKesava1,1,0.00033,63134,21.02266,300314
9068,Siva-pixel669,1,0.00033,63135,21.02300,300314
9069,sivareddyforu,1,0.00033,63136,21.02333,300314
9070,siyueshiqi,1,0.00033,63137,21.02366,300314
9071,sj26,1,0.00033,63138,21.02399,300314
9072,sjfke,1,0.00033,63139,21.02433,300314
9073,Skarlso,1,0.00033,63140,21.02466,300314
9074,skhalash,1,0.00033,63141,21.02499,300314
9075,skibbipl,1,0.00033,63142,21.02533,300314
9076,skk2142,1,0.00033,63143,21.02566,300314
9077,sknaumov,1,0.00033,63144,21.02599,300314
9078,skogta,1,0.00033,63145,21.02633,300314
9079,skrishna-unix,1,0.00033,63146,21.02666,300314
9080,Skulblaka,1,0.00033,63147,21.02699,300314
9081,skuruppu,1,0.00033,63148,21.02732,300314
9082,sky91,1,0.00033,63149,21.02766,300314
9083,skydroplet,1,0.00033,63150,21.02799,300314
9084,slacksach,1,0.00033,63151,21.02832,300314
9085,slametkoala,1,0.00033,63152,21.02866,300314
9086,slashmo,1,0.00033,63153,21.02899,300314
9087,slayer,1,0.00033,63154,21.02932,300314
9088,sleepreading,1,0.00033,63155,21.02966,300314
9089,sleeyax,1,0.00033,63156,21.02999,300314
9090,slehlib,1,0.00033,63157,21.03032,300314
9091,sliabat,1,0.00033,63158,21.03065,300314
9092,Slideee,1,0.00033,63159,21.03099,300314
9093,slmjy,1,0.00033,63160,21.03132,300314
9094,slobodangacesa,1,0.00033,63161,21.03165,300314
9095,sloev,1,0.00033,63162,21.03199,300314
9096,slovdahl,1,0.00033,63163,21.03232,300314
9097,SM616,1,0.00033,63164,21.03265,300314
9098,smallc2009,1,0.00033,63165,21.03299,300314
9099,smandava,1,0.00033,63166,21.03332,300314
9100,smartin015,1,0.00033,63167,21.03365,300314
9101,SmileCaoJ,1,0.00033,63168,21.03398,300314
9102,smiletrl,1,0.00033,63169,21.03432,300314
9103,smithdebug,1,0.00033,63170,21.03465,300314
9104,smitthakkar96,1,0.00033,63171,21.03498,300314
9105,smlx,1,0.00033,63172,21.03532,300314
9106,smndtrl,1,0.00033,63173,21.03565,300314
9107,smp1204,1,0.00033,63174,21.03598,300314
9108,smsilva,1,0.00033,63175,21.03632,300314
9109,Smurf-IV,1,0.00033,63176,21.03665,300314
9110,smyrman,1,0.00033,63177,21.03698,300314
9111,SnailDove,1,0.00033,63178,21.03731,300314
9112,snappyJack,1,0.00033,63179,21.03765,300314
9113,snez,1,0.00033,63180,21.03798,300314
9114,snoopotic,1,0.00033,63181,21.03831,300314
9115,socketbox,1,0.00033,63182,21.03865,300314
9116,sodul,1,0.00033,63183,21.03898,300314
9117,soerenmartius,1,0.00033,63184,21.03931,300314
9118,sofat1989,1,0.00033,63185,21.03965,300314
9119,SofianeLamrous,1,0.00033,63186,21.03998,300314
9120,sohan,1,0.00033,63187,21.04031,300314
9121,SolarLiner,1,0.00033,63188,21.04064,300314
9122,SolidifiedRay,1,0.00033,63189,21.04098,300314
9123,somehibs,1,0.00033,63190,21.04131,300314
9124,SomeshJoshi19,1,0.00033,63191,21.04164,300314
9125,someshnnv,1,0.00033,63192,21.04198,300314
9126,SomKen,1,0.00033,63193,21.04231,300314
9127,somnath-kadavergu,1,0.00033,63194,21.04264,300314
9128,somnuscq,1,0.00033,63195,21.04298,300314
9129,sonalimote,1,0.00033,63196,21.04331,300314
9130,songshusen1978,1,0.00033,63197,21.04364,300314
9131,SophiaNamesLiu,1,0.00033,63198,21.04397,300314
9132,sophieyfang,1,0.00033,63199,21.04431,300314
9133,soudaburger,1,0.00033,63200,21.04464,300314
9134,souleb,1,0.00033,63201,21.04497,300314
9135,soumitrak,1,0.00033,63202,21.04531,300314
9136,SoundaryaA3098,1,0.00033,63203,21.04564,300314
9137,soyoo,1,0.00033,63204,21.04597,300314
9138,spaced,1,0.00033,63205,21.04630,300314
9139,spacether,1,0.00033,63206,21.04664,300314
9140,spaletta,1,0.00033,63207,21.04697,300314
9141,SparkScratch-P,1,0.00033,63208,21.04730,300314
9142,sparky005,1,0.00033,63209,21.04764,300314
9143,SpComb,1,0.00033,63210,21.04797,300314
9144,spicysomtam,1,0.00033,63211,21.04830,300314
9145,spjmurray,1,0.00033,63212,21.04864,300314
9146,Splitside,1,0.00033,63213,21.04897,300314
9147,spol-vt,1,0.00033,63214,21.04930,300314
9148,SpootDev,1,0.00033,63215,21.04963,300314
9149,sprenge,1,0.00033,63216,21.04997,300314
9150,spyyang,1,0.00033,63217,21.05030,300314
9151,squ94wk,1,0.00033,63218,21.05063,300314
9152,squigley,1,0.00033,63219,21.05097,300314
9153,sr-gi,1,0.00033,63220,21.05130,300314
9154,srhb,1,0.00033,63221,21.05163,300314
9155,srikanthcs,1,0.00033,63222,21.05197,300314
9156,srinirei,1,0.00033,63223,21.05230,300314
9157,srinivasanrk,1,0.00033,63224,21.05263,300314
9158,Sriram21,1,0.00033,63225,21.05296,300314
9159,SRodi,1,0.00033,63226,21.05330,300314
9160,srunze,1,0.00033,63227,21.05363,300314
9161,SrushtiPasari-GEP,1,0.00033,63228,21.05396,300314
9162,ssa3512,1,0.00033,63229,21.05430,300314
9163,ssandanshi,1,0.00033,63230,21.05463,300314
9164,sseetharaman6,1,0.00033,63231,21.05496,300314
9165,ssharma2089,1,0.00033,63232,21.05530,300314
9166,ssinger,1,0.00033,63233,21.05563,300314
9167,ssovberkt,1,0.00033,63234,21.05596,300314
9168,ssurovich,1,0.00033,63235,21.05629,300314
9169,ssvinarev,1,0.00033,63236,21.05663,300314
9170,stanDXCisdaman,1,0.00033,63237,21.05696,300314
9171,stannum-l,1,0.00033,63238,21.05729,300314
9172,stanxing,1,0.00033,63239,21.05763,300314
9173,startstorm,1,0.00033,63240,21.05796,300314
9174,StasPerekrestov,1,0.00033,63241,21.05829,300314
9175,stawii,1,0.00033,63242,21.05863,300314
9176,ST-DDT,1,0.00033,63243,21.05896,300314
9177,stefanfritsch,1,0.00033,63244,21.05929,300314
9178,stefankraus-wf,1,0.00033,63245,21.05962,300314
9179,stefanmcshane,1,0.00033,63246,21.05996,300314
9180,stefanomart,1,0.00033,63247,21.06029,300314
9181,Steffan-Ennis,1,0.00033,63248,21.06062,300314
9182,steinarvk-kolonial,1,0.00033,63249,21.06096,300314
9183,steinheber,1,0.00033,63250,21.06129,300314
9184,steliosAnastasakis,1,0.00033,63251,21.06162,300314
9185,stemis,1,0.00033,63252,21.06196,300314
9186,stephan-hartmann,1,0.00033,63253,21.06229,300314
9187,stephankoelle,1,0.00033,63254,21.06262,300314
9188,stephanmiehe,1,0.00033,63255,21.06295,300314
9189,stevelipinski,1,0.00033,63256,21.06329,300314
9190,stevenkitter,1,0.00033,63257,21.06362,300314
9191,StevenLiekens,1,0.00033,63258,21.06395,300314
9192,stewrad,1,0.00033,63259,21.06429,300314
9193,stfp,1,0.00033,63260,21.06462,300314
9194,stgoogle,1,0.00033,63261,21.06495,300314
9195,stiks,1,0.00033,63262,21.06529,300314
9196,stingshen,1,0.00033,63263,21.06562,300314
9197,stirno,1,0.00033,63264,21.06595,300314
9198,stoehdoi,1,0.00033,63265,21.06628,300314
9199,stoffus,1,0.00033,63266,21.06662,300314
9200,Stone624,1,0.00033,63267,21.06695,300314
9201,storm1kk,1,0.00033,63268,21.06728,300314
9202,stormobile,1,0.00033,63269,21.06762,300314
9203,strangeman,1,0.00033,63270,21.06795,300314
9204,strekm,1,0.00033,63271,21.06828,300314
9205,StrikerExtreem,1,0.00033,63272,21.06861,300314
9206,stritti,1,0.00033,63273,21.06895,300314
9207,STRML,1,0.00033,63274,21.06928,300314
9208,strowk,1,0.00033,63275,21.06961,300314
9209,stuart-c-moore,1,0.00033,63276,21.06995,300314
9210,stubclan,1,0.00033,63277,21.07028,300314
9211,stud0r,1,0.00033,63278,21.07061,300314
9212,studypyth,1,0.00033,63279,21.07095,300314
9213,stupidlamo,1,0.00033,63280,21.07128,300314
9214,sturfee-petrl,1,0.00033,63281,21.07161,300314
9215,stylius,1,0.00033,63282,21.07194,300314
9216,subhajit-halder,1,0.00033,63283,21.07228,300314
9217,subhankarc,1,0.00033,63284,21.07261,300314
9218,suckerfish,1,0.00033,63285,21.07294,300314
9219,suhanime,1,0.00033,63286,21.07328,300314
9220,suhasgaddam-trueaccord,1,0.00033,63287,21.07361,300314
9221,sujeshkumar,1,0.00033,63288,21.07394,300314
9222,suket22,1,0.00033,63289,21.07428,300314
9223,sumitaneja,1,0.00033,63290,21.07461,300314
9224,summerisc,1,0.00033,63291,21.07494,300314
9225,Sumukha15,1,0.00033,63292,21.07527,300314
9226,Sunbreak,1,0.00033,63293,21.07561,300314
9227,sundag,1,0.00033,63294,21.07594,300314
9228,SundayCloud,1,0.00033,63295,21.07627,300314
9229,sunyuan300,1,0.00033,63296,21.07661,300314
9230,sunzen,1,0.00033,63297,21.07694,300314
9231,SuperCosmicBeing,1,0.00033,63298,21.07727,300314
9232,Superskyyy,1,0.00033,63299,21.07761,300314
9233,suraciii,1,0.00033,63300,21.07794,300314
9234,surajrajan-maf,1,0.00033,63301,21.07827,300314
9235,surenraju,1,0.00033,63302,21.07860,300314
9236,surjikal,1,0.00033,63303,21.07894,300314
9237,surmabck,1,0.00033,63304,21.07927,300314
9238,sushiMix,1,0.00033,63305,21.07960,300314
9239,sushmit1,1,0.00033,63306,21.07994,300314
9240,susmitaganguli,1,0.00033,63307,21.08027,300314
9241,susmitameher,1,0.00033,63308,21.08060,300314
9242,susnux,1,0.00033,63309,21.08094,300314
9243,Sutty100,1,0.00033,63310,21.08127,300314
9244,suyog-fp,1,0.00033,63311,21.08160,300314
9245,sviatoslav-somov,1,0.00033,63312,21.08193,300314
9246,svityashchuk,1,0.00033,63313,21.08227,300314
9247,svogt,1,0.00033,63314,21.08260,300314
9248,SwagBucks123,1,0.00033,63315,21.08293,300314
9249,swapnilmsurve,1,0.00033,63316,21.08327,300314
9250,swaroop1012,1,0.00033,63317,21.08360,300314
9251,Swetad90,1,0.00033,63318,21.08393,300314
9252,swimablefish,1,0.00033,63319,21.08427,300314
9253,sw-ms-pradipbaria,1,0.00033,63320,21.08460,300314
9254,swoga,1,0.00033,63321,21.08493,300314
9255,sxmartin,1,0.00033,63322,21.08526,300314
9256,syy6,1,0.00033,63323,21.08560,300314
9257,szEvEz,1,0.00033,63324,21.08593,300314
9258,szlend,1,0.00033,63325,21.08626,300314
9259,szmytson,1,0.00033,63326,21.08660,300314
9260,szwss,1,0.00033,63327,21.08693,300314
9261,szymon-grzemski,1,0.00033,63328,21.08726,300314
9262,szymonpk,1,0.00033,63329,21.08759,300314
9263,t089,1,0.00033,63330,21.08793,300314
9264,tadamhicks,1,0.00033,63331,21.08826,300314
9265,Tafsiralam,1,0.00033,63332,21.08859,300314
9266,Taher-Ghaleb,1,0.00033,63333,21.08893,300314
9267,TairDal,1,0.00033,63334,21.08926,300314
9268,takamario,1,0.00033,63335,21.08959,300314
9269,TakuKaneda,1,0.00033,63336,21.08993,300314
9270,talcoh2x,1,0.00033,63337,21.09026,300314
9271,Talkmapops,1,0.00033,63338,21.09059,300314
9272,Taloth,1,0.00033,63339,21.09092,300314
9273,Tammyxia,1,0.00033,63340,21.09126,300314
9274,tampler,1,0.00033,63341,21.09159,300314
9275,Tanbouz,1,0.00033,63342,21.09192,300314
9276,Tang8330,1,0.00033,63343,21.09226,300314
9277,tangenta,1,0.00033,63344,21.09259,300314
9278,tangtang666,1,0.00033,63345,21.09292,300314
9279,tanis2000,1,0.00033,63346,21.09326,300314
9280,tanmay7270,1,0.00033,63347,21.09359,300314
9281,tanyabouman,1,0.00033,63348,21.09392,300314
9282,TaoPanfeng,1,0.00033,63349,21.09425,300314
9283,taorui666,1,0.00033,63350,21.09459,300314
9284,TaoYang526,1,0.00033,63351,21.09492,300314
9285,taoyuanyuan,1,0.00033,63352,21.09525,300314
9286,Tarkleigh,1,0.00033,63353,21.09559,300314
9287,tartakynov,1,0.00033,63354,21.09592,300314
9288,tarvitz,1,0.00033,63355,21.09625,300314
9289,tatemz,1,0.00033,63356,21.09659,300314
9290,tatsonlambda,1,0.00033,63357,21.09692,300314
9291,tattasunder,1,0.00033,63358,21.09725,300314
9292,taupiknr26,1,0.00033,63359,21.09758,300314
9293,TaylorKanper,1,0.00033,63360,21.09792,300314
9294,tbasim,1,0.00033,63361,21.09825,300314
9295,tbernacchi,1,0.00033,63362,21.09858,300314
9296,TCarbon001,1,0.00033,63363,21.09892,300314
9297,tclh123,1,0.00033,63364,21.09925,300314
9298,tculp,1,0.00033,63365,21.09958,300314
9299,tdonovic,1,0.00033,63366,21.09992,300314
9300,tduverge,1,0.00033,63367,21.10025,300314
9301,teaglebuilt,1,0.00033,63368,21.10058,300314
9302,techgadgetsera,1,0.00033,63369,21.10091,300314
9303,techgeek03,1,0.00033,63370,21.10125,300314
9304,techgnosis,1,0.00033,63371,21.10158,300314
9305,TechnicalMercenary,1,0.00033,63372,21.10191,300314
9306,technotaff-nbs,1,0.00033,63373,21.10225,300314
9307,techslaves,1,0.00033,63374,21.10258,300314
9308,teebszet,1,0.00033,63375,21.10291,300314
9309,tegk,1,0.00033,63376,21.10325,300314
9310,tejaschumbalkar,1,0.00033,63377,21.10358,300314
9311,TejaswiKarasani,1,0.00033,63378,21.10391,300314
9312,tejunior,1,0.00033,63379,21.10424,300314
9313,tempbottle,1,0.00033,63380,21.10458,300314
9314,tempestrock,1,0.00033,63381,21.10491,300314
9315,teq0,1,0.00033,63382,21.10524,300314
9316,terghalin,1,0.00033,63383,21.10558,300314
9317,terryburton,1,0.00033,63384,21.10591,300314
9318,testillano,1,0.00033,63385,21.10624,300314
9319,Tetragramato,1,0.00033,63386,21.10658,300314
9320,tfedyanin,1,0.00033,63387,21.10691,300314
9321,tfournier,1,0.00033,63388,21.10724,300314
9322,tfussell,1,0.00033,63389,21.10757,300314
9323,tgdfool2,1,0.00033,63390,21.10791,300314
9324,tgrushka,1,0.00033,63391,21.10824,300314
9325,Tha-Fox,1,0.00033,63392,21.10857,300314
9326,Thakurvaibhav,1,0.00033,63393,21.10891,300314
9327,thanaphat1991,1,0.00033,63394,21.10924,300314
9328,thangchung,1,0.00033,63395,21.10957,300314
9329,Tharunrm,1,0.00033,63396,21.10990,300314
9330,that1boy,1,0.00033,63397,21.11024,300314
9331,thatch,1,0.00033,63398,21.11057,300314
9332,thealpinist,1,0.00033,63399,21.11090,300314
9333,TheBeatles1994,1,0.00033,63400,21.11124,300314
9334,TheCamNelson,1,0.00033,63401,21.11157,300314
9335,TheCloverly,1,0.00033,63402,21.11190,300314
9336,TheCodingLab,1,0.00033,63403,21.11224,300314
9337,thecoolwinter,1,0.00033,63404,21.11257,300314
9338,thegasmann,1,0.00033,63405,21.11290,300314
9339,thejosephstevens,1,0.00033,63406,21.11323,300314
9340,thekiller880,1,0.00033,63407,21.11357,300314
9341,TheLunaticScripter,1,0.00033,63408,21.11390,300314
9342,thepankajtech,1,0.00033,63409,21.11423,300314
9343,therealaditigupta,1,0.00033,63410,21.11457,300314
9344,TheRealBro,1,0.00033,63411,21.11490,300314
9345,therealqxing,1,0.00033,63412,21.11523,300314
9346,theunisbotha,1,0.00033,63413,21.11557,300314
9347,thiagojsb,1,0.00033,63414,21.11590,300314
9348,thiagosantosleite,1,0.00033,63415,21.11623,300314
9349,Thibault-Brocheton,1,0.00033,63416,21.11656,300314
9350,Thitve,1,0.00033,63417,21.11690,300314
9351,thodquach,1,0.00033,63418,21.11723,300314
9352,ThomasADavis,1,0.00033,63419,21.11756,300314
9353,ThomasBoutelier,1,0.00033,63420,21.11790,300314
9354,thomasdziedzic-census,1,0.00033,63421,21.11823,300314
9355,thomashoefkens-vw,1,0.00033,63422,21.11856,300314
9356,thomas-lui,1,0.00033,63423,21.11890,300314
9357,ThomasWunderlich,1,0.00033,63424,21.11923,300314
9358,thotypous,1,0.00033,63425,21.11956,300314
9359,threen134,1,0.00033,63426,21.11989,300314
9360,thuongnn,1,0.00033,63427,21.12023,300314
9361,thuynt99,1,0.00033,63428,21.12056,300314
9362,thuzhf,1,0.00033,63429,21.12089,300314
9363,TiagoJMartins,1,0.00033,63430,21.12123,300314
9364,tianlang8158,1,0.00033,63431,21.12156,300314
9365,Ticiano-mw,1,0.00033,63432,21.12189,300314
9366,TicktW,1,0.00033,63433,21.12223,300314
9367,Tiemma,1,0.00033,63434,21.12256,300314
9368,tiendungitd,1,0.00033,63435,21.12289,300314
9369,tienthanh2509,1,0.00033,63436,21.12322,300314
9370,tiero,1,0.00033,63437,21.12356,300314
9371,ties,1,0.00033,63438,21.12389,300314
9372,ties-s,1,0.00033,63439,21.12422,300314
9373,timd73,1,0.00033,63440,21.12456,300314
9374,timgates42,1,0.00033,63441,21.12489,300314
9375,timirnich,1,0.00033,63442,21.12522,300314
9376,timjohn2,1,0.00033,63443,21.12556,300314
9377,timkra,1,0.00033,63444,21.12589,300314
9378,timolehto,1,0.00033,63445,21.12622,300314
9379,Timoses,1,0.00033,63446,21.12655,300314
9380,timrcoulson,1,0.00033,63447,21.12689,300314
9381,timspeetjens,1,0.00033,63448,21.12722,300314
9382,timtorChen,1,0.00033,63449,21.12755,300314
9383,timxi,1,0.00033,63450,21.12789,300314
9384,TinaTong-coder,1,0.00033,63451,21.12822,300314
9385,tinerehbein,1,0.00033,63452,21.12855,300314
9386,tjay,1,0.00033,63453,21.12889,300314
9387,tjegan,1,0.00033,63454,21.12922,300314
9388,tjhop,1,0.00033,63455,21.12955,300314
9389,tkgeng,1,0.00033,63456,21.12988,300314
9390,tl-eddie-hoffman,1,0.00033,63457,21.13022,300314
9391,tlianza,1,0.00033,63458,21.13055,300314
9392,tmodelsk,1,0.00033,63459,21.13088,300314
9393,tmthrgd,1,0.00033,63460,21.13122,300314
9394,tn185070,1,0.00033,63461,21.13155,300314
9395,tob123,1,0.00033,63462,21.13188,300314
9396,tobias-trabelsi-sonarsource,1,0.00033,63463,21.13221,300314
9397,tobias-zeptio,1,0.00033,63464,21.13255,300314
9398,TobiMichael96,1,0.00033,63465,21.13288,300314
9399,toby1799,1,0.00033,63466,21.13321,300314
9400,tobygale,1,0.00033,63467,21.13355,300314
9401,todd-davenport,1,0.00033,63468,21.13388,300314
9402,toddmgreer,1,0.00033,63469,21.13421,300314
9403,tohjustin,1,0.00033,63470,21.13455,300314
9404,tokt,1,0.00033,63471,21.13488,300314
9405,tolik93,1,0.00033,63472,21.13521,300314
9406,Tom284,1,0.00033,63473,21.13554,300314
9407,Tom910,1,0.00033,63474,21.13588,300314
9408,tomassatka,1,0.00033,63475,21.13621,300314
9409,tomellis,1,0.00033,63476,21.13654,300314
9410,Tomer23,1,0.00033,63477,21.13688,300314
9411,tomfeigin,1,0.00033,63478,21.13721,300314
9412,tomgoren,1,0.00033,63479,21.13754,300314
9413,tomhzt,1,0.00033,63480,21.13788,300314
9414,tomkcpr,1,0.00033,63481,21.13821,300314
9415,tomrgh,1,0.00033,63482,21.13854,300314
9416,tonihintikka,1,0.00033,63483,21.13887,300314
9417,TonyBian,1,0.00033,63484,21.13921,300314
9418,tonyskapunk,1,0.00033,63485,21.13954,300314
9419,TopeltR,1,0.00033,63486,21.13987,300314
9420,Topher-the-Geek,1,0.00033,63487,21.14021,300314
9421,toraora,1,0.00033,63488,21.14054,300314
9422,torrescd,1,0.00033,63489,21.14087,300314
9423,tothbalintjanos,1,0.00033,63490,21.14121,300314
9424,totycro,1,0.00033,63491,21.14154,300314
9425,tr1ck3r,1,0.00033,63492,21.14187,300314
9426,traceygithub,1,0.00033,63493,21.14220,300314
9427,trailstrider,1,0.00033,63494,21.14254,300314
9428,trajano,1,0.00033,63495,21.14287,300314
9429,transacid,1,0.00033,63496,21.14320,300314
9430,trejjam,1,0.00033,63497,21.14354,300314
9431,TrentScholl,1,0.00033,63498,21.14387,300314
9432,tr-srij,1,0.00033,63499,21.14420,300314
9433,trstn70,1,0.00033,63500,21.14454,300314
9434,true64gurus,1,0.00033,63501,21.14487,300314
9435,TrushneshGawande,1,0.00033,63502,21.14520,300314
9436,trustin,1,0.00033,63503,21.14553,300314
9437,Truth1984,1,0.00033,63504,21.14587,300314
9438,tschale,1,0.00033,63505,21.14620,300314
9439,tschmidt64-SC,1,0.00033,63506,21.14653,300314
9440,tscpp,1,0.00033,63507,21.14687,300314
9441,tsg-l,1,0.00033,63508,21.14720,300314
9442,ts-mini,1,0.00033,63509,21.14753,300314
9443,tsoy,1,0.00033,63510,21.14787,300314
9444,tsub,1,0.00033,63511,21.14820,300314
9445,tsunny,1,0.00033,63512,21.14853,300314
9446,tulanian,1,0.00033,63513,21.14886,300314
9447,TuNGO-86,1,0.00033,63514,21.14920,300314
9448,tuommaki,1,0.00033,63515,21.14953,300314
9449,turanmehmet,1,0.00033,63516,21.14986,300314
9450,turbanoff,1,0.00033,63517,21.15020,300314
9451,tusharbhasme,1,0.00033,63518,21.15053,300314
9452,tustyianovych,1,0.00033,63519,21.15086,300314
9453,tuttle,1,0.00033,63520,21.15120,300314
9454,tuvovan,1,0.00033,63521,21.15153,300314
9455,twilight327426371,1,0.00033,63522,21.15186,300314
9456,twosigmajab,1,0.00033,63523,21.15219,300314
9457,tylerbrazier,1,0.00033,63524,21.15253,300314
9458,tylermmorton,1,0.00033,63525,21.15286,300314
9459,Tyraelone,1,0.00033,63526,21.15319,300314
9460,TZdybel,1,0.00033,63527,21.15353,300314
9461,tzubcic-tolar,1,0.00033,63528,21.15386,300314
9462,u2bo,1,0.00033,63529,21.15419,300314
9463,u6006,1,0.00033,63530,21.15452,300314
9464,u8sand,1,0.00033,63531,21.15486,300314
9465,UAnton,1,0.00033,63532,21.15519,300314
9466,u-ashish,1,0.00033,63533,21.15552,300314
9467,udkyo,1,0.00033,63534,21.15586,300314
9468,udoratin,1,0.00033,63535,21.15619,300314
9469,ulrikjohansson,1,0.00033,63536,21.15652,300314
9470,umairmkhan,1,0.00033,63537,21.15686,300314
9471,umann,1,0.00033,63538,21.15719,300314
9472,umegbewe,1,0.00033,63539,21.15752,300314
9473,umeshch1,1,0.00033,63540,21.15785,300314
9474,umka1332,1,0.00033,63541,21.15819,300314
9475,unbreakabl3,1,0.00033,63542,21.15852,300314
9476,unbyte,1,0.00033,63543,21.15885,300314
9477,uncaughtgregory,1,0.00033,63544,21.15919,300314
9478,Unichron,1,0.00033,63545,21.15952,300314
9479,uniqueck,1,0.00033,63546,21.15985,300314
9480,unitof,1,0.00033,63547,21.16019,300314
9481,univ0298,1,0.00033,63548,21.16052,300314
9482,unixmind,1,0.00033,63549,21.16085,300314
9483,unleashed,1,0.00033,63550,21.16118,300314
9484,unmarshall,1,0.00033,63551,21.16152,300314
9485,UnrealCraig,1,0.00033,63552,21.16185,300314
9486,urpyLLIKa,1,0.00033,63553,21.16218,300314
9487,ushell,1,0.00033,63554,21.16252,300314
9488,usimd,1,0.00033,63555,21.16285,300314
9489,uturunku1,1,0.00033,63556,21.16318,300314
9490,uweschaefer,1,0.00033,63557,21.16352,300314
9491,V3K3R,1,0.00033,63558,21.16385,300314
9492,v3n,1,0.00033,63559,21.16418,300314
9493,Vaccano,1,0.00033,63560,21.16451,300314
9494,VackarAfzal,1,0.00033,63561,21.16485,300314
9495,Vadim-Zenin,1,0.00033,63562,21.16518,300314
9496,vadivkanag,1,0.00033,63563,21.16551,300314
9497,vaibhavmagon,1,0.00033,63564,21.16585,300314
9498,vakarthik,1,0.00033,63565,21.16618,300314
9499,Vake93,1,0.00033,63566,21.16651,300314
9500,valdis932,1,0.00033,63567,21.16685,300314
9501,valeriaverboloz,1,0.00033,63568,21.16718,300314
9502,vals-productions,1,0.00033,63569,21.16751,300314
9503,vandreykiv,1,0.00033,63570,21.16784,300314
9504,vanneback,1,0.00033,63571,21.16818,300314
9505,varas,1,0.00033,63572,21.16851,300314
9506,varghesejose2020,1,0.00033,63573,21.16884,300314
9507,VariableDeclared,1,0.00033,63574,21.16918,300314
9508,varkey,1,0.00033,63575,21.16951,300314
9509,varshithreddy21,1,0.00033,63576,21.16984,300314
9510,varun06,1,0.00033,63577,21.17018,300314
9511,varunchandak,1,0.00033,63578,21.17051,300314
9512,varuzam,1,0.00033,63579,21.17084,300314
9513,vasanthaganeshk,1,0.00033,63580,21.17117,300314
9514,VaskoBozhurski,1,0.00033,63581,21.17151,300314
9515,vaustral,1,0.00033,63582,21.17184,300314
9516,vbeersma,1,0.00033,63583,21.17217,300314
9517,vbfox,1,0.00033,63584,21.17251,300314
9518,vbhakta8,1,0.00033,63585,21.17284,300314
9519,vcarluer,1,0.00033,63586,21.17317,300314
9520,vchirikov,1,0.00033,63587,21.17351,300314
9521,velkovb,1,0.00033,63588,21.17384,300314
9522,Venkat2694,1,0.00033,63589,21.17417,300314
9523,venkatbokka,1,0.00033,63590,21.17450,300314
9524,venkatramanareddy,1,0.00033,63591,21.17484,300314
9525,vennekilde,1,0.00033,63592,21.17517,300314
9526,Veraticus,1,0.00033,63593,21.17550,300314
9527,vermaa31,1,0.00033,63594,21.17584,300314
9528,verysonglaa,1,0.00033,63595,21.17617,300314
9529,Vetm,1,0.00033,63596,21.17650,300314
9530,veyselsahin,1,0.00033,63597,21.17683,300314
9531,VF-mbrauer,1,0.00033,63598,21.17717,300314
9532,vfoehn,1,0.00033,63599,21.17750,300314
9533,VGerris,1,0.00033,63600,21.17783,300314
9534,vguaglione,1,0.00033,63601,21.17817,300314
9535,vharitonsky,1,0.00033,63602,21.17850,300314
9536,vhladiienko,1,0.00033,63603,21.17883,300314
9537,Viachaslau-Zinkevich,1,0.00033,63604,21.17917,300314
9538,vibhas77,1,0.00033,63605,21.17950,300314
9539,viccuad,1,0.00033,63606,21.17983,300314
9540,viceice,1,0.00033,63607,21.18016,300314
9541,vickyvikas7988,1,0.00033,63608,21.18050,300314
9542,vidyaap,1,0.00033,63609,21.18083,300314
9543,vifar,1,0.00033,63610,21.18116,300314
9544,vignir88,1,0.00033,63611,21.18150,300314
9545,vijaymateti,1,0.00033,63612,21.18183,300314
9546,Vijay-Nirmal,1,0.00033,63613,21.18216,300314
9547,vijayrajah,1,0.00033,63614,21.18250,300314
9548,vijayvishnu,1,0.00033,63615,21.18283,300314
9549,vikas-chourasia,1,0.00033,63616,21.18316,300314
9550,vikasgoswami5035,1,0.00033,63617,21.18349,300314
9551,vikas-prabhakar,1,0.00033,63618,21.18383,300314
9552,vikramparth,1,0.00033,63619,21.18416,300314
9553,vincent-doudou,1,0.00033,63620,21.18449,300314
9554,vincentmrg,1,0.00033,63621,21.18483,300314
9555,VincenzoDo,1,0.00033,63622,21.18516,300314
9556,vinx-2105,1,0.00033,63623,21.18549,300314
9557,violuke,1,0.00033,63624,21.18583,300314
9558,VirajSalaka,1,0.00033,63625,21.18616,300314
9559,vishaljoshi,1,0.00033,63626,21.18649,300314
9560,vishal-wiai,1,0.00033,63627,21.18682,300314
9561,visit1985,1,0.00033,63628,21.18716,300314
9562,Vivek205,1,0.00033,63629,21.18749,300314
9563,vivekab,1,0.00033,63630,21.18782,300314
9564,VivekNidhi,1,0.00033,63631,21.18816,300314
9565,vivgoyal,1,0.00033,63632,21.18849,300314
9566,vjk1kor,1,0.00033,63633,21.18882,300314
9567,vladimir-avinkin,1,0.00033,63634,21.18916,300314
9568,VladimirKhvostov,1,0.00033,63635,21.18949,300314
9569,voarsh2,1,0.00033,63636,21.18982,300314
9570,vodwood,1,0.00033,63637,21.19015,300314
9571,VoidShaper,1,0.00033,63638,21.19049,300314
9572,voigt,1,0.00033,63639,21.19082,300314
9573,voiser,1,0.00033,63640,21.19115,300314
9574,volleynator,1,0.00033,63641,21.19149,300314
9575,vonbrand,1,0.00033,63642,21.19182,300314
9576,vpnachev,1,0.00033,63643,21.19215,300314
9577,vrmiguel,1,0.00033,63644,21.19249,300314
9578,v-sag,1,0.00033,63645,21.19282,300314
9579,vsevel,1,0.00033,63646,21.19315,300314
9580,vsharathis,1,0.00033,63647,21.19348,300314
9581,vsile,1,0.00033,63648,21.19382,300314
9582,vstrimaitis,1,0.00033,63649,21.19415,300314
9583,vthinhbd3,1,0.00033,63650,21.19448,300314
9584,vvijayv,1,0.00033,63651,21.19482,300314
9585,vvvggg,1,0.00033,63652,21.19515,300314
9586,vybber,1,0.00033,63653,21.19548,300314
9587,vyrwu,1,0.00033,63654,21.19582,300314
9588,w3blogfr,1,0.00033,63655,21.19615,300314
9589,waciumawanjohi,1,0.00033,63656,21.19648,300314
9590,wahyd4,1,0.00033,63657,21.19681,300314
9591,waldo323,1,0.00033,63658,21.19715,300314
9592,walec51,1,0.00033,63659,21.19748,300314
9593,waltermaldonado,1,0.00033,63660,21.19781,300314
9594,waltlps,1,0.00033,63661,21.19815,300314
9595,wangkuan,1,0.00033,63662,21.19848,300314
9596,wangtenfee,1,0.00033,63663,21.19881,300314
9597,wangxiyuan,1,0.00033,63664,21.19914,300314
9598,wanzr,1,0.00033,63665,21.19948,300314
9599,warisp,1,0.00033,63666,21.19981,300314
9600,WassimBenzarti,1,0.00033,63667,21.20014,300314
9601,Wastack,1,0.00033,63668,21.20048,300314
9602,waynr,1,0.00033,63669,21.20081,300314
9603,wcollin,1,0.00033,63670,21.20114,300314
9604,wcushen,1,0.00033,63671,21.20148,300314
9605,webcane,1,0.00033,63672,21.20181,300314
9606,webmobiletraining,1,0.00033,63673,21.20214,300314
9607,websi96,1,0.00033,63674,21.20247,300314
9608,WEEEgao,1,0.00033,63675,21.20281,300314
9609,weignerg,1,0.00033,63676,21.20314,300314
9610,weinformatics,1,0.00033,63677,21.20347,300314
9611,weixiao619,1,0.00033,63678,21.20381,300314
9612,weizenberg,1,0.00033,63679,21.20414,300314
9613,WellsCui,1,0.00033,63680,21.20447,300314
9614,wenhuwang,1,0.00033,63681,21.20481,300314
9615,wenjunma004,1,0.00033,63682,21.20514,300314
9616,WesDowney,1,0.00033,63683,21.20547,300314
9617,weskerfoot,1,0.00033,63684,21.20580,300314
9618,wfu8,1,0.00033,63685,21.20614,300314
9619,wgqkirk,1,0.00033,63686,21.20647,300314
9620,Wh1t3Fox,1,0.00033,63687,21.20680,300314
9621,whacked,1,0.00033,63688,21.20714,300314
9622,whihathac,1,0.00033,63689,21.20747,300314
9623,whyh,1,0.00033,63690,21.20780,300314
9624,wi1dcard,1,0.00033,63691,21.20814,300314
9625,wickachan,1,0.00033,63692,21.20847,300314
9626,wiebeck,1,0.00033,63693,21.20880,300314
9627,wietse-gmail,1,0.00033,63694,21.20913,300314
9628,wildwind391,1,0.00033,63695,21.20947,300314
9629,William-Newshutz,1,0.00033,63696,21.20980,300314
9630,willieowens,1,0.00033,63697,21.21013,300314
9631,WillyRL,1,0.00033,63698,21.21047,300314
9632,willysamz,1,0.00033,63699,21.21080,300314
9633,willzhujian,1,0.00033,63700,21.21113,300314
9634,wilsonge,1,0.00033,63701,21.21147,300314
9635,win5do,1,0.00033,63702,21.21180,300314
9636,windnod,1,0.00033,63703,21.21213,300314
9637,Windrow,1,0.00033,63704,21.21246,300314
9638,WinJayX,1,0.00033,63705,21.21280,300314
9639,winnetcn,1,0.00033,63706,21.21313,300314
9640,wiruzman,1,0.00033,63707,21.21346,300314
9641,WisdomWolf,1,0.00033,63708,21.21380,300314
9642,wisecodecraft,1,0.00033,63709,21.21413,300314
9643,wizardels,1,0.00033,63710,21.21446,300314
9644,wjrogers,1,0.00033,63711,21.21480,300314
9645,wkgcass,1,0.00033,63712,21.21513,300314
9646,Wkkkkk,1,0.00033,63713,21.21546,300314
9647,wls1036,1,0.00033,63714,21.21579,300314
9648,wmealing,1,0.00033,63715,21.21613,300314
9649,wmiller112,1,0.00033,63716,21.21646,300314
9650,wnagele,1,0.00033,63717,21.21679,300314
9651,wojtekmach,1,0.00033,63718,21.21713,300314
9652,wolfleave,1,0.00033,63719,21.21746,300314
9653,woloss,1,0.00033,63720,21.21779,300314
9654,wookietreiber,1,0.00033,63721,21.21813,300314
9655,woter1832,1,0.00033,63722,21.21846,300314
9656,WouldYouKindly,1,0.00033,63723,21.21879,300314
9657,wpmoore,1,0.00033,63724,21.21912,300314
9658,wprogLK,1,0.00033,63725,21.21946,300314
9659,wrogrammer,1,0.00033,63726,21.21979,300314
9660,wuboui,1,0.00033,63727,21.22012,300314
9661,wucao,1,0.00033,63728,21.22046,300314
9662,wuluoyong,1,0.00033,63729,21.22079,300314
9663,wurong1420,1,0.00033,63730,21.22112,300314
9664,wutongjie23hao,1,0.00033,63731,21.22145,300314
9665,wuxin66,1,0.00033,63732,21.22179,300314
9666,wuxingzhong,1,0.00033,63733,21.22212,300314
9667,wy97,1,0.00033,63734,21.22245,300314
9668,wyaron,1,0.00033,63735,21.22279,300314
9669,WybeKoper,1,0.00033,63736,21.22312,300314
9670,Wyverald,1,0.00033,63737,21.22345,300314
9671,wyznio,1,0.00033,63738,21.22379,300314
9672,Xaeroxe,1,0.00033,63739,21.22412,300314
9673,Xalior,1,0.00033,63740,21.22445,300314
9674,Xan2063,1,0.00033,63741,21.22478,300314
9675,XanderAtBackboneSystems,1,0.00033,63742,21.22512,300314
9676,xenji,1,0.00033,63743,21.22545,300314
9677,Xeno365,1,0.00033,63744,21.22578,300314
9678,xeraa,1,0.00033,63745,21.22612,300314
9679,xevilmaxx,1,0.00033,63746,21.22645,300314
9680,xheke,1,0.00033,63747,21.22678,300314
9681,xiangzho72,1,0.00033,63748,21.22712,300314
9682,xiaofan-linux,1,0.00033,63749,21.22745,300314
9683,xiaogangwazi,1,0.00033,63750,21.22778,300314
9684,xiaohui,1,0.00033,63751,21.22811,300314
9685,xiaoxiaojx,1,0.00033,63752,21.22845,300314
9686,xibei316,1,0.00033,63753,21.22878,300314
9687,xike41,1,0.00033,63754,21.22911,300314
9688,XinCai,1,0.00033,63755,21.22945,300314
9689,xinhuang-1,1,0.00033,63756,21.22978,300314
9690,xinnad,1,0.00033,63757,21.23011,300314
9691,xjas,1,0.00033,63758,21.23045,300314
9692,x-lambda,1,0.00033,63759,21.23078,300314
9693,xlanor,1,0.00033,63760,21.23111,300314
9694,xliu-indeed,1,0.00033,63761,21.23144,300314
9695,xoleja01,1,0.00033,63762,21.23178,300314
9696,xonvanetta,1,0.00033,63763,21.23211,300314
9697,xpahos,1,0.00033,63764,21.23244,300314
9698,xSehrMotiviert,1,0.00033,63765,21.23278,300314
9699,xserrat,1,0.00033,63766,21.23311,300314
9700,xsonghppy,1,0.00033,63767,21.23344,300314
9701,xtalkme,1,0.00033,63768,21.23378,300314
9702,xudesheng,1,0.00033,63769,21.23411,300314
9703,XueCangQiuYe,1,0.00033,63770,21.23444,300314
9704,xufei56789,1,0.00033,63771,21.23477,300314
9705,xunliu,1,0.00033,63772,21.23511,300314
9706,x-yuri,1,0.00033,63773,21.23544,300314
9707,y2kdread,1,0.00033,63774,21.23577,300314
9708,y6vmeq,1,0.00033,63775,21.23611,300314
9709,Yakir6,1,0.00033,63776,21.23644,300314
9710,yamlCase,1,0.00033,63777,21.23677,300314
9711,yanchaozhong,1,0.00033,63778,21.23711,300314
9712,yangl,1,0.00033,63779,21.23744,300314
9713,yangsoon,1,0.00033,63780,21.23777,300314
9714,yangvipguang,1,0.00033,63781,21.23810,300314
9715,yangyang198599,1,0.00033,63782,21.23844,300314
9716,yangyuan6,1,0.00033,63783,21.23877,300314
9717,yang-zhang-edge,1,0.00033,63784,21.23910,300314
9718,yanovich,1,0.00033,63785,21.23944,300314
9719,yao0507,1,0.00033,63786,21.23977,300314
9720,yaoliu,1,0.00033,63787,21.24010,300314
9721,yaronp68,1,0.00033,63788,21.24044,300314
9722,Yasaswini2105,1,0.00033,63789,21.24077,300314
9723,yasharne,1,0.00033,63790,21.24110,300314
9724,yashikabadaya,1,0.00033,63791,21.24143,300314
9725,YasuhiroABE,1,0.00033,63792,21.24177,300314
9726,ybykov-a9s,1,0.00033,63793,21.24210,300314
9727,ycerafto,1,0.00033,63794,21.24243,300314
9728,yconio,1,0.00033,63795,21.24277,300314
9729,yeDor,1,0.00033,63796,21.24310,300314
9730,yee379,1,0.00033,63797,21.24343,300314
9731,yegle,1,0.00033,63798,21.24376,300314
9732,yeongjukang,1,0.00033,63799,21.24410,300314
9733,Yetsenn,1,0.00033,63800,21.24443,300314
9734,Yevhen-Mordak,1,0.00033,63801,21.24476,300314
9735,yfoelling,1,0.00033,63802,21.24510,300314
9736,yganchev,1,0.00033,63803,21.24543,300314
9737,ygolovlev,1,0.00033,63804,21.24576,300314
9738,yichuan66,1,0.00033,63805,21.24610,300314
9739,yin1999,1,0.00033,63806,21.24643,300314
9740,yinchuan9527,1,0.00033,63807,21.24676,300314
9741,yinzara,1,0.00033,63808,21.24709,300314
9742,yioda,1,0.00033,63809,21.24743,300314
9743,YitzyD,1,0.00033,63810,21.24776,300314
9744,yi-yang-github,1,0.00033,63811,21.24809,300314
9745,yjdlau,1,0.00033,63812,21.24843,300314
9746,YjLeo,1,0.00033,63813,21.24876,300314
9747,ykfq,1,0.00033,63814,21.24909,300314
9748,yleiymei,1,0.00033,63815,21.24943,300314
9749,yoanncouillec,1,0.00033,63816,21.24976,300314
9750,yoavkkaltura,1,0.00033,63817,21.25009,300314
9751,yogyang,1,0.00033,63818,21.25042,300314
9752,yohan-th,1,0.00033,63819,21.25076,300314
9753,yolking,1,0.00033,63820,21.25109,300314
9754,yolkov,1,0.00033,63821,21.25142,300314
9755,YonathanGuez,1,0.00033,63822,21.25176,300314
9756,yongxiu,1,0.00033,63823,21.25209,300314
9757,yongzhang,1,0.00033,63824,21.25242,300314
9758,Yorkerrr,1,0.00033,63825,21.25276,300314
9759,yosshi825,1,0.00033,63826,21.25309,300314
9760,younaman,1,0.00033,63827,21.25342,300314
9761,younes-io,1,0.00033,63828,21.25375,300314
9762,y-peter,1,0.00033,63829,21.25409,300314
9763,ystoneman,1,0.00033,63830,21.25442,300314
9764,ysyyork,1,0.00033,63831,21.25475,300314
9765,yuchizh,1,0.00033,63832,21.25509,300314
9766,yudar1024,1,0.00033,63833,21.25542,300314
9767,yufan022,1,0.00033,63834,21.25575,300314
9768,yuha0,1,0.00033,63835,21.25609,300314
9769,Yukesh4791,1,0.00033,63836,21.25642,300314
9770,Yukimir,1,0.00033,63837,21.25675,300314
9771,yukselao,1,0.00033,63838,21.25708,300314
9772,yuriolisa,1,0.00033,63839,21.25742,300314
9773,yuriyfilonovooh,1,0.00033,63840,21.25775,300314
9774,YuryHrytsuk,1,0.00033,63841,21.25808,300314
9775,yusong-shen,1,0.00033,63842,21.25842,300314
9776,yutachaos,1,0.00033,63843,21.25875,300314
9777,YuviGold,1,0.00033,63844,21.25908,300314
9778,yvanadamov,1,0.00033,63845,21.25942,300314
9779,ywauthy,1,0.00033,63846,21.25975,300314
9780,yxyx520,1,0.00033,63847,21.26008,300314
9781,yzz-ihep,1,0.00033,63848,21.26041,300314
9782,zack-johnson5455,1,0.00033,63849,21.26075,300314
9783,zaf187,1,0.00033,63850,21.26108,300314
9784,zahid0,1,0.00033,63851,21.26141,300314
9785,Zajda208,1,0.00033,63852,21.26175,300314
9786,zane-deg,1,0.00033,63853,21.26208,300314
9787,zanise,1,0.00033,63854,21.26241,300314
9788,zanven42,1,0.00033,63855,21.26274,300314
9789,zarelit,1,0.00033,63856,21.26308,300314
9790,zatricky,1,0.00033,63857,21.26341,300314
9791,zaverden,1,0.00033,63858,21.26374,300314
9792,zbentley,1,0.00033,63859,21.26408,300314
9793,zc310,1,0.00033,63860,21.26441,300314
9794,zcong1993,1,0.00033,63861,21.26474,300314
9795,zeev512,1,0.00033,63862,21.26508,300314
9796,zeeZ,1,0.00033,63863,21.26541,300314
9797,zejar,1,0.00033,63864,21.26574,300314
9798,zekth,1,0.00033,63865,21.26607,300314
9799,zenbones,1,0.00033,63866,21.26641,300314
9800,zephyrxvxx7,1,0.00033,63867,21.26674,300314
9801,zerodefect,1,0.00033,63868,21.26707,300314
9802,zerog2k,1,0.00033,63869,21.26741,300314
9803,Zeroji,1,0.00033,63870,21.26774,300314
9804,ZF-fredericvanlinthoudt,1,0.00033,63871,21.26807,300314
9805,zgaduj,1,0.00033,63872,21.26841,300314
9806,Zh1Cheung,1,0.00033,63873,21.26874,300314
9807,zhangggg,1,0.00033,63874,21.26907,300314
9808,ZhangLei-cn,1,0.00033,63875,21.26940,300314
9809,zhangmengid,1,0.00033,63876,21.26974,300314
9810,zhang-xuebin,1,0.00033,63877,21.27007,300314
9811,zhangyoufu,1,0.00033,63878,21.27040,300314
9812,ZhangZhi-ZG,1,0.00033,63879,21.27074,300314
9813,zhanshen8D,1,0.00033,63880,21.27107,300314
9814,zhaoxq,1,0.00033,63881,21.27140,300314
9815,ZhaoYis,1,0.00033,63882,21.27174,300314
9816,zhe-wish,1,0.00033,63883,21.27207,300314
9817,zhousam,1,0.00033,63884,21.27240,300314
9818,zhuxs264710,1,0.00033,63885,21.27273,300314
9819,zimmski,1,0.00033,63886,21.27307,300314
9820,ZingLix,1,0.00033,63887,21.27340,300314
9821,zippyopstraining,1,0.00033,63888,21.27373,300314
9822,zipzit,1,0.00033,63889,21.27407,300314
9823,ziXet,1,0.00033,63890,21.27440,300314
9824,ziyiluo,1,0.00033,63891,21.27473,300314
9825,zjma,1,0.00033,63892,21.27507,300314
9826,zkkxu,1,0.00033,63893,21.27540,300314
9827,zkoopmans,1,0.00033,63894,21.27573,300314
9828,zky001,1,0.00033,63895,21.27606,300314
9829,zmx,1,0.00033,63896,21.27640,300314
9830,zoglesby,1,0.00033,63897,21.27673,300314
9831,Zophar78,1,0.00033,63898,21.27706,300314
9832,zsmhub,1,0.00033,63899,21.27740,300314
9833,ztripez,1,0.00033,63900,21.27773,300314
9834,Zubnix,1,0.00033,63901,21.27806,300314
9835,zuizuihao,1,0.00033,63902,21.27840,300314
9836,zvazquez,1,0.00033,63903,21.27873,300314
9837,zware,1,0.00033,63904,21.27906,300314
9838,zwpaper,1,0.00033,63905,21.27939,300314
9839,zxh19920616,1,0.00033,63906,21.27973,300314
9840,zxli,1,0.00033,63907,21.28006,300314
9841,zxpower,1,0.00033,63908,21.28039,300314
9842,zyguan,1,0.00033,63909,21.28073,300314
9843,Zyh2333,1,0.00033,63910,21.28106,300314
9844,zyyqqq,1,0.00033,63911,21.28139,300314
9845,Zzjw,1,0.00033,63912,21.28173,300314
9846,ZZKdev,1,0.00033,63913,21.28206,300314
