rank_number,actor,contributions,percent,cumulative_sum,cumulative_percent,all_contributions
1,hzhou97,214,0.87002,214,0.87002,24597
2,DanielMorsing,145,0.58950,359,1.45953,24597
3,cheukwing,113,0.45941,472,1.91893,24597
4,james-w,110,0.44721,582,2.36614,24597
5,cpu,57,0.23174,639,2.59788,24597
6,vdesjardins,49,0.19921,688,2.79709,24597
7,srbraun,40,0.16262,728,2.95971,24597
8,splashx,39,0.15856,767,3.11827,24597
9,badie,37,0.15042,804,3.26869,24597
10,bbzg,34,0.13823,838,3.40692,24597
11,Evesy,34,0.13823,872,3.54515,24597
12,kinolaev,30,0.12197,902,3.66711,24597
13,dl00,27,0.10977,929,3.77688,24597
14,dontreboot,27,0.10977,956,3.88665,24597
15,Crystal-Chun,22,0.08944,978,3.97609,24597
16,HeWhoWas,22,0.08944,1000,4.06554,24597
17,leiw324,22,0.08944,1022,4.15498,24597
18,sam-cogan,22,0.08944,1044,4.24442,24597
19,johanfleury,21,0.08538,1065,4.32980,24597
20,juliohm1978,21,0.08538,1086,4.41517,24597
21,maelvls,21,0.08538,1107,4.50055,24597
22,san360,19,0.07725,1126,4.57779,24597
23,ankitsoni17-png,18,0.07318,1144,4.65097,24597
24,davidzhr,18,0.07318,1162,4.72415,24597
25,vniche,18,0.07318,1180,4.79733,24597
26,kyle-winkelman,17,0.06911,1197,4.86645,24597
27,Richard87,17,0.06911,1214,4.93556,24597
28,zeeZ,17,0.06911,1231,5.00468,24597
29,CoaxVex,16,0.06505,1247,5.06972,24597
30,filipweidemann,16,0.06505,1263,5.13477,24597
31,jslay88,16,0.06505,1279,5.19982,24597
32,tlmiller,16,0.06505,1295,5.26487,24597
33,greywolve,15,0.06098,1310,5.32585,24597
34,kingdonb,15,0.06098,1325,5.38684,24597
35,raphink,15,0.06098,1340,5.44782,24597
36,thebigredgeek,15,0.06098,1355,5.50880,24597
37,arnoldbechtoldt,14,0.05692,1369,5.56572,24597
38,gwaines,14,0.05692,1383,5.62264,24597
39,jfrancisco0,14,0.05692,1397,5.67955,24597
40,JGodin-C2C,14,0.05692,1411,5.73647,24597
41,so-jelly,14,0.05692,1425,5.79339,24597
42,gparvin,13,0.05285,1438,5.84624,24597
43,JCzz,13,0.05285,1451,5.89909,24597
44,lrolaz,13,0.05285,1464,5.95195,24597
45,nefischer,13,0.05285,1477,6.00480,24597
46,stuarthu,13,0.05285,1490,6.05765,24597
47,030,12,0.04879,1502,6.10644,24597
48,arykalin,12,0.04879,1514,6.15522,24597
49,grzechukol,12,0.04879,1526,6.20401,24597
50,hemslo,12,0.04879,1538,6.25280,24597
51,Justkant,12,0.04879,1550,6.30158,24597
52,Ps3ud-0nym,12,0.04879,1562,6.35037,24597
53,fuel-wlightning,11,0.04472,1573,6.39509,24597
54,holmesb,11,0.04472,1584,6.43981,24597
55,JulienBreux,11,0.04472,1595,6.48453,24597
56,mltsy,11,0.04472,1606,6.52925,24597
57,tikael1011,11,0.04472,1617,6.57397,24597
58,altreze,10,0.04066,1627,6.61463,24597
59,bgarcial,10,0.04066,1637,6.65528,24597
60,cyrus-mc,10,0.04066,1647,6.69594,24597
61,damienwebdev,10,0.04066,1657,6.73659,24597
62,Diaphteiros,10,0.04066,1667,6.77725,24597
63,jeremy-duckworth,10,0.04066,1677,6.81790,24597
64,micw,10,0.04066,1687,6.85856,24597
65,mikebridge,10,0.04066,1697,6.89922,24597
66,mtpereira,10,0.04066,1707,6.93987,24597
67,oninoshiko,10,0.04066,1717,6.98053,24597
68,r-divakaran,10,0.04066,1727,7.02118,24597
69,simonkey007,10,0.04066,1737,7.06184,24597
70,sinethra,10,0.04066,1747,7.10249,24597
71,sudhindra-hub,10,0.04066,1757,7.14315,24597
72,TheKangaroo,10,0.04066,1767,7.18380,24597
73,timfeirg,10,0.04066,1777,7.22446,24597
74,woodwardmatt,10,0.04066,1787,7.26511,24597
75,chojnack,9,0.03659,1796,7.30170,24597
76,Cyanopus,9,0.03659,1805,7.33829,24597
77,digitalkaoz,9,0.03659,1814,7.37488,24597
78,dleute,9,0.03659,1823,7.41147,24597
79,elcolie,9,0.03659,1832,7.44806,24597
80,galvesribeiro,9,0.03659,1841,7.48465,24597
81,jai,9,0.03659,1850,7.52124,24597
82,johndietz,9,0.03659,1859,7.55783,24597
83,lucendio,9,0.03659,1868,7.59442,24597
84,MatthiasLohr,9,0.03659,1877,7.63101,24597
85,McShauno,9,0.03659,1886,7.66760,24597
86,metrictwo,9,0.03659,1895,7.70419,24597
87,mmckane,9,0.03659,1904,7.74078,24597
88,ndemeshchenko,9,0.03659,1913,7.77737,24597
89,PirateBread,9,0.03659,1922,7.81396,24597
90,primeroz,9,0.03659,1931,7.85055,24597
91,rodrigdav,9,0.03659,1940,7.88714,24597
92,s-newman,9,0.03659,1949,7.92373,24597
93,steigr,9,0.03659,1958,7.96032,24597
94,subesokun,9,0.03659,1967,7.99691,24597
95,supriya-premkumar,9,0.03659,1976,8.03350,24597
96,tettaji,9,0.03659,1985,8.07009,24597
97,WesCossick,9,0.03659,1994,8.10668,24597
98,archonic,8,0.03252,2002,8.13920,24597
99,ckotzbauer,8,0.03252,2010,8.17173,24597
100,devdattakulkarni,8,0.03252,2018,8.20425,24597
101,dr4Ke,8,0.03252,2026,8.23678,24597
102,frankh,8,0.03252,2034,8.26930,24597
103,haines,8,0.03252,2042,8.30183,24597
104,hendrikhalkow,8,0.03252,2050,8.33435,24597
105,HoogWater,8,0.03252,2058,8.36687,24597
106,kotyara85,8,0.03252,2066,8.39940,24597
107,kranthikirang,8,0.03252,2074,8.43192,24597
108,MichaelOrtho,8,0.03252,2082,8.46445,24597
109,michaelosthege,8,0.03252,2090,8.49697,24597
110,mitsumaui,8,0.03252,2098,8.52950,24597
111,mschickervxob,8,0.03252,2106,8.56202,24597
112,muzuro,8,0.03252,2114,8.59454,24597
113,nabsul,8,0.03252,2122,8.62707,24597
114,obriensystems,8,0.03252,2130,8.65959,24597
115,peopzen,8,0.03252,2138,8.69212,24597
116,rakkum,8,0.03252,2146,8.72464,24597
117,rayfoss,8,0.03252,2154,8.75717,24597
118,Romiko,8,0.03252,2162,8.78969,24597
119,sramek5,8,0.03252,2170,8.82221,24597
120,stefan-kolb,8,0.03252,2178,8.85474,24597
121,tlycken,8,0.03252,2186,8.88726,24597
122,vhurtevent,8,0.03252,2194,8.91979,24597
123,wmgroot,8,0.03252,2202,8.95231,24597
124,4ss3g4f,7,0.02846,2209,8.98077,24597
125,andrexus,7,0.02846,2216,9.00923,24597
126,bjg2,7,0.02846,2223,9.03769,24597
127,casiodk,7,0.02846,2230,9.06615,24597
128,domfaber,7,0.02846,2237,9.09461,24597
129,dstdfx,7,0.02846,2244,9.12306,24597
130,fgrehm,7,0.02846,2251,9.15152,24597
131,floyd-may,7,0.02846,2258,9.17998,24597
132,fsniper,7,0.02846,2265,9.20844,24597
133,gargrag,7,0.02846,2272,9.23690,24597
134,gitnik,7,0.02846,2279,9.26536,24597
135,gudipudipradeep,7,0.02846,2286,9.29382,24597
136,hyakuhei,7,0.02846,2293,9.32228,24597
137,InsOpDe,7,0.02846,2300,9.35073,24597
138,jaitaiwan,7,0.02846,2307,9.37919,24597
139,joshuastern,7,0.02846,2314,9.40765,24597
140,kjdelisle,7,0.02846,2321,9.43611,24597
141,ltetrel,7,0.02846,2328,9.46457,24597
142,matevzmihalic,7,0.02846,2335,9.49303,24597
143,mattdodge,7,0.02846,2342,9.52149,24597
144,mhobotpplnet,7,0.02846,2349,9.54995,24597
145,nd2014-public,7,0.02846,2356,9.57840,24597
146,nsteinmetz,7,0.02846,2363,9.60686,24597
147,qiqizjl,7,0.02846,2370,9.63532,24597
148,Rishka,7,0.02846,2377,9.66378,24597
149,rjeczalik,7,0.02846,2384,9.69224,24597
150,RonnyMaas,7,0.02846,2391,9.72070,24597
151,rpahli,7,0.02846,2398,9.74916,24597
152,Serrvosky,7,0.02846,2405,9.77762,24597
153,stevo-knievo,7,0.02846,2412,9.80607,24597
154,thejasbabu,7,0.02846,2419,9.83453,24597
155,Tzrlk,7,0.02846,2426,9.86299,24597
156,unbreakab1e,7,0.02846,2433,9.89145,24597
157,WB3Tech,7,0.02846,2440,9.91991,24597
158,akhamar,6,0.02439,2446,9.94430,24597
159,alanbover,6,0.02439,2452,9.96870,24597
160,AmazingTurtle,6,0.02439,2458,9.99309,24597
161,bertoost,6,0.02439,2464,10.01748,24597
162,call-a3,6,0.02439,2470,10.04188,24597
163,chdorb,6,0.02439,2476,10.06627,24597
164,CyberPoison,6,0.02439,2482,10.09066,24597
165,devops2201,6,0.02439,2488,10.11505,24597
166,dperetti,6,0.02439,2494,10.13945,24597
167,freym,6,0.02439,2500,10.16384,24597
168,gingerwizard,6,0.02439,2506,10.18823,24597
169,graned,6,0.02439,2512,10.21263,24597
170,grrywlsn,6,0.02439,2518,10.23702,24597
171,ivanovUA,6,0.02439,2524,10.26141,24597
172,jpantsjoha,6,0.02439,2530,10.28581,24597
173,kendricktan,6,0.02439,2536,10.31020,24597
174,kojiDev,6,0.02439,2542,10.33459,24597
175,larsha,6,0.02439,2548,10.35899,24597
176,martaver,6,0.02439,2554,10.38338,24597
177,miguel-santiago,6,0.02439,2560,10.40777,24597
178,mikejk8s,6,0.02439,2566,10.43217,24597
179,net47,6,0.02439,2572,10.45656,24597
180,Nuru,6,0.02439,2578,10.48095,24597
181,paulbdavis,6,0.02439,2584,10.50535,24597
182,PaulusTM,6,0.02439,2590,10.52974,24597
183,pbabilas,6,0.02439,2596,10.55413,24597
184,ptzianos,6,0.02439,2602,10.57853,24597
185,pyr0hu,6,0.02439,2608,10.60292,24597
186,raazcrzy,6,0.02439,2614,10.62731,24597
187,Sahasrara,6,0.02439,2620,10.65171,24597
188,sassanh,6,0.02439,2626,10.67610,24597
189,sboussekeyt,6,0.02439,2632,10.70049,24597
190,schybbkoh,6,0.02439,2638,10.72489,24597
191,sfriquet,6,0.02439,2644,10.74928,24597
192,skinlayers,6,0.02439,2650,10.77367,24597
193,softshipper,6,0.02439,2656,10.79806,24597
194,Stijn98s,6,0.02439,2662,10.82246,24597
195,terrabitz,6,0.02439,2668,10.84685,24597
196,the-fine,6,0.02439,2674,10.87124,24597
197,tpo,6,0.02439,2680,10.89564,24597
198,ttyS0,6,0.02439,2686,10.92003,24597
199,turowicz,6,0.02439,2692,10.94442,24597
200,urmet,6,0.02439,2698,10.96882,24597
201,wmedlar,6,0.02439,2704,10.99321,24597
202,wojciechss,6,0.02439,2710,11.01760,24597
203,abessifi,5,0.02033,2715,11.03793,24597
204,abevoelker,5,0.02033,2720,11.05826,24597
205,acartapanis,5,0.02033,2725,11.07859,24597
206,anatoly-kryzhanovsky,5,0.02033,2730,11.09891,24597
207,anderspetersson,5,0.02033,2735,11.11924,24597
208,antonioua,5,0.02033,2740,11.13957,24597
209,arkadyb,5,0.02033,2745,11.15990,24597
210,arnediekmann,5,0.02033,2750,11.18023,24597
211,blhagadorn,5,0.02033,2755,11.20055,24597
212,bwolf,5,0.02033,2760,11.22088,24597
213,C3po23,5,0.02033,2765,11.24121,24597
214,chenmeng111,5,0.02033,2770,11.26154,24597
215,cihangirbesiktas,5,0.02033,2775,11.28186,24597
216,creeram,5,0.02033,2780,11.30219,24597
217,croeck,5,0.02033,2785,11.32252,24597
218,dannybitgo,5,0.02033,2790,11.34285,24597
219,davelosert,5,0.02033,2795,11.36317,24597
220,david-mclean,5,0.02033,2800,11.38350,24597
221,Dig-Doug,5,0.02033,2805,11.40383,24597
222,djmitche,5,0.02033,2810,11.42416,24597
223,donifer,5,0.02033,2815,11.44449,24597
224,dts,5,0.02033,2820,11.46481,24597
225,eduardolundgren,5,0.02033,2825,11.48514,24597
226,eladitzhakian,5,0.02033,2830,11.50547,24597
227,erewok,5,0.02033,2835,11.52580,24597
228,evilezh,5,0.02033,2840,11.54612,24597
229,eyalzek,5,0.02033,2845,11.56645,24597
230,feluxe,5,0.02033,2850,11.58678,24597
231,fliphess,5,0.02033,2855,11.60711,24597
232,Gerrit-K,5,0.02033,2860,11.62743,24597
233,Gl4di4torRr,5,0.02033,2865,11.64776,24597
234,gordonbondon,5,0.02033,2870,11.66809,24597
235,GramozKrasniqi,5,0.02033,2875,11.68842,24597
236,habeebshk,5,0.02033,2880,11.70874,24597
237,happywzy,5,0.02033,2885,11.72907,24597
238,HardBrainer,5,0.02033,2890,11.74940,24597
239,HaveFun83,5,0.02033,2895,11.76973,24597
240,haysclark,5,0.02033,2900,11.79006,24597
241,HenriAW,5,0.02033,2905,11.81038,24597
242,julien-hedoux,5,0.02033,2910,11.83071,24597
243,jurgenweber,5,0.02033,2915,11.85104,24597
244,jwalker343,5,0.02033,2920,11.87137,24597
245,Jyrno42,5,0.02033,2925,11.89169,24597
246,katlimruiz,5,0.02033,2930,11.91202,24597
247,kfirfer,5,0.02033,2935,11.93235,24597
248,KristianWindsor,5,0.02033,2940,11.95268,24597
249,ksemaev,5,0.02033,2945,11.97300,24597
250,l1v3,5,0.02033,2950,11.99333,24597
251,leorockway,5,0.02033,2955,12.01366,24597
252,lolin9,5,0.02033,2960,12.03399,24597
253,lostllama,5,0.02033,2965,12.05432,24597
254,madmod,5,0.02033,2970,12.07464,24597
255,Magicloud,5,0.02033,2975,12.09497,24597
256,mbinette,5,0.02033,2980,12.11530,24597
257,mgazza,5,0.02033,2985,12.13563,24597
258,michidk,5,0.02033,2990,12.15595,24597
259,mjungsbluth,5,0.02033,2995,12.17628,24597
260,nielsbasjes,5,0.02033,3000,12.19661,24597
261,paulrostorp,5,0.02033,3005,12.21694,24597
262,phyrog,5,0.02033,3010,12.23726,24597
263,rachasakr,5,0.02033,3015,12.25759,24597
264,raphaelpereira,5,0.02033,3020,12.27792,24597
265,riccardodl,5,0.02033,3025,12.29825,24597
266,rnkhouse,5,0.02033,3030,12.31858,24597
267,RobbieJVMW,5,0.02033,3035,12.33890,24597
268,Roydon,5,0.02033,3040,12.35923,24597
269,rvennam-lbg,5,0.02033,3045,12.37956,24597
270,saplla,5,0.02033,3050,12.39989,24597
271,sbocinec,5,0.02033,3055,12.42021,24597
272,sch0718,5,0.02033,3060,12.44054,24597
273,shalkam,5,0.02033,3065,12.46087,24597
274,sharmaansh21,5,0.02033,3070,12.48120,24597
275,shaunc,5,0.02033,3075,12.50152,24597
276,siddth09,5,0.02033,3080,12.52185,24597
277,simonfuhrer,5,0.02033,3085,12.54218,24597
278,sleshchenko,5,0.02033,3090,12.56251,24597
279,stefandevo,5,0.02033,3095,12.58284,24597
280,stuartgunter,5,0.02033,3100,12.60316,24597
281,sturfee-petrl,5,0.02033,3105,12.62349,24597
282,tdewitt,5,0.02033,3110,12.64382,24597
283,TheEnbyperor,5,0.02033,3115,12.66415,24597
284,tkatrichenko,5,0.02033,3120,12.68447,24597
285,Tybot204,5,0.02033,3125,12.70480,24597
286,Vinceveve,5,0.02033,3130,12.72513,24597
287,wgoulet,5,0.02033,3135,12.74546,24597
288,wichert,5,0.02033,3140,12.76578,24597
289,wsilva,5,0.02033,3145,12.78611,24597
290,Zetanova,5,0.02033,3150,12.80644,24597
291,zzaareer,5,0.02033,3155,12.82677,24597
292,54853315,4,0.01626,3159,12.84303,24597
293,Aarabika,4,0.01626,3163,12.85929,24597
294,AdimUser,4,0.01626,3167,12.87555,24597
295,ajpauwels,4,0.01626,3171,12.89182,24597
296,alanpearce,4,0.01626,3175,12.90808,24597
297,alljames,4,0.01626,3179,12.92434,24597
298,AmbroiseCouissin,4,0.01626,3183,12.94060,24597
299,AndreKoepke,4,0.01626,3187,12.95686,24597
300,angelosanramon,4,0.01626,3191,12.97313,24597
301,Anujay-Saraf,4,0.01626,3195,12.98939,24597
302,apatil4,4,0.01626,3199,13.00565,24597
303,arrase,4,0.01626,3203,13.02191,24597
304,artjomzab,4,0.01626,3207,13.03818,24597
305,ashpreetbedi,4,0.01626,3211,13.05444,24597
306,astrocket,4,0.01626,3215,13.07070,24597
307,Azylog,4,0.01626,3219,13.08696,24597
308,bahetiamit,4,0.01626,3223,13.10322,24597
309,barclayadam,4,0.01626,3227,13.11949,24597
310,barrymoo,4,0.01626,3231,13.13575,24597
311,benfdking,4,0.01626,3235,13.15201,24597
312,calexandre,4,0.01626,3239,13.16827,24597
313,captncraig,4,0.01626,3243,13.18453,24597
314,cemsbr,4,0.01626,3247,13.20080,24597
315,cfeeling,4,0.01626,3251,13.21706,24597
316,charri,4,0.01626,3255,13.23332,24597
317,chetanku,4,0.01626,3259,13.24958,24597
318,christiancorbin,4,0.01626,3263,13.26585,24597
319,Cian911,4,0.01626,3267,13.28211,24597
320,Cl8vM1nd,4,0.01626,3271,13.29837,24597
321,compumike,4,0.01626,3275,13.31463,24597
322,cpick,4,0.01626,3279,13.33089,24597
323,ctlaux,4,0.01626,3283,13.34716,24597
324,cypressious,4,0.01626,3287,13.36342,24597
325,czunker,4,0.01626,3291,13.37968,24597
326,darkedges,4,0.01626,3295,13.39594,24597
327,DawPawel,4,0.01626,3299,13.41220,24597
328,demiters,4,0.01626,3303,13.42847,24597
329,dingsongjie,4,0.01626,3307,13.44473,24597
330,Dvelezs94,4,0.01626,3311,13.46099,24597
331,EIrwin,4,0.01626,3315,13.47725,24597
332,elemakil,4,0.01626,3319,13.49352,24597
333,empikls,4,0.01626,3323,13.50978,24597
334,enhendrickson,4,0.01626,3327,13.52604,24597
335,evanrich,4,0.01626,3331,13.54230,24597
336,fabinou,4,0.01626,3335,13.55856,24597
337,farahabdi,4,0.01626,3339,13.57483,24597
338,fstn,4,0.01626,3343,13.59109,24597
339,GeckoSplinter,4,0.01626,3347,13.60735,24597
340,ghorsey,4,0.01626,3351,13.62361,24597
341,gintautassulskus,4,0.01626,3355,13.63987,24597
342,git4suvendu,4,0.01626,3359,13.65614,24597
343,gordcorp,4,0.01626,3363,13.67240,24597
344,greenrd,4,0.01626,3367,13.68866,24597
345,grindsa,4,0.01626,3371,13.70492,24597
346,guilhermeblanco,4,0.01626,3375,13.72119,24597
347,gustav-mattsson,4,0.01626,3379,13.73745,24597
348,hytromo,4,0.01626,3383,13.75371,24597
349,iamonkara,4,0.01626,3387,13.76997,24597
350,igoratencompass,4,0.01626,3391,13.78623,24597
351,infa-mhadiman,4,0.01626,3395,13.80250,24597
352,isantospardo,4,0.01626,3399,13.81876,24597
353,ivalexa,4,0.01626,3403,13.83502,24597
354,JasonWhall,4,0.01626,3407,13.85128,24597
355,javachen,4,0.01626,3411,13.86754,24597
356,jawabuu,4,0.01626,3415,13.88381,24597
357,jdelafon,4,0.01626,3419,13.90007,24597
358,jeroenjacobs1205,4,0.01626,3423,13.91633,24597
359,jeroenjacobs79,4,0.01626,3427,13.93259,24597
360,jjacob27,4,0.01626,3431,13.94886,24597
361,JJJAMM,4,0.01626,3435,13.96512,24597
362,jmgilman,4,0.01626,3439,13.98138,24597
363,jnu,4,0.01626,3443,13.99764,24597
364,johannwagner,4,0.01626,3447,14.01390,24597
365,jonas27,4,0.01626,3451,14.03017,24597
366,jpds,4,0.01626,3455,14.04643,24597
367,jstephenson,4,0.01626,3459,14.06269,24597
368,jvanbruegge,4,0.01626,3463,14.07895,24597
369,kchodnicki,4,0.01626,3467,14.09521,24597
370,kevinscholz,4,0.01626,3471,14.11148,24597
371,khernyo,4,0.01626,3475,14.12774,24597
372,kopaygorodsky,4,0.01626,3479,14.14400,24597
373,krenaut1,4,0.01626,3483,14.16026,24597
374,kushwahashiv,4,0.01626,3487,14.17653,24597
375,liorhasson,4,0.01626,3491,14.19279,24597
376,lodejard,4,0.01626,3495,14.20905,24597
377,Lucaber,4,0.01626,3499,14.22531,24597
378,Ludea,4,0.01626,3503,14.24157,24597
379,Luttik,4,0.01626,3507,14.25784,24597
380,maaroen,4,0.01626,3511,14.27410,24597
381,makkarpov,4,0.01626,3515,14.29036,24597
382,maraino,4,0.01626,3519,14.30662,24597
383,marc-barry,4,0.01626,3523,14.32288,24597
384,marcelloromani,4,0.01626,3527,14.33915,24597
385,masih,4,0.01626,3531,14.35541,24597
386,matthewerwin,4,0.01626,3535,14.37167,24597
387,mgoltzsche,4,0.01626,3539,14.38793,24597
388,mikkelfj,4,0.01626,3543,14.40420,24597
389,monomosc,4,0.01626,3547,14.42046,24597
390,Mr-Reca,4,0.01626,3551,14.43672,24597
391,mrsegen,4,0.01626,3555,14.45298,24597
392,mt3593,4,0.01626,3559,14.46924,24597
393,nagarjunac,4,0.01626,3563,14.48551,24597
394,nappy,4,0.01626,3567,14.50177,24597
395,nbendafi-yseop,4,0.01626,3571,14.51803,24597
396,Ndidi,4,0.01626,3575,14.53429,24597
397,nikhilbalekundargi,4,0.01626,3579,14.55055,24597
398,novakg,4,0.01626,3583,14.56682,24597
399,Nowaker,4,0.01626,3587,14.58308,24597
400,olivierboudet,4,0.01626,3591,14.59934,24597
401,osthus-af,4,0.01626,3595,14.61560,24597
402,PatrickGeyer,4,0.01626,3599,14.63187,24597
403,peterfication,4,0.01626,3603,14.64813,24597
404,Philio,4,0.01626,3607,14.66439,24597
405,pwplusnick,4,0.01626,3611,14.68065,24597
406,r0bj,4,0.01626,3615,14.69691,24597
407,RaduRaducuIlie,4,0.01626,3619,14.71318,24597
408,RazaGR,4,0.01626,3623,14.72944,24597
409,rbq,4,0.01626,3627,14.74570,24597
410,rdxmb,4,0.01626,3631,14.76196,24597
411,rfevang,4,0.01626,3635,14.77822,24597
412,richardfickling,4,0.01626,3639,14.79449,24597
413,rjemanuele,4,0.01626,3643,14.81075,24597
414,rklubenspies,4,0.01626,3647,14.82701,24597
415,rtgibbons,4,0.01626,3651,14.84327,24597
416,s4rd1nh4,4,0.01626,3655,14.85954,24597
417,saltenhub,4,0.01626,3659,14.87580,24597
418,samanamp,4,0.01626,3663,14.89206,24597
419,scones,4,0.01626,3667,14.90832,24597
420,sebbrandt87,4,0.01626,3671,14.92458,24597
421,sgodiyal,4,0.01626,3675,14.94085,24597
422,skaarup1986,4,0.01626,3679,14.95711,24597
423,smueller18,4,0.01626,3683,14.97337,24597
424,snstanton,4,0.01626,3687,14.98963,24597
425,spekr,4,0.01626,3691,15.00590,24597
426,sph1982,4,0.01626,3695,15.02216,24597
427,StephanX,4,0.01626,3699,15.03842,24597
428,stephen-dexda,4,0.01626,3703,15.05468,24597
429,sylvainfilteau,4,0.01626,3707,15.07094,24597
430,tamphuc0503,4,0.01626,3711,15.08721,24597
431,tgruenert,4,0.01626,3715,15.10347,24597
432,thehedgefrog,4,0.01626,3719,15.11973,24597
433,tiagojsag,4,0.01626,3723,15.13599,24597
434,timblakely,4,0.01626,3727,15.15225,24597
435,tmontalbano,4,0.01626,3731,15.16852,24597
436,tomko80,4,0.01626,3735,15.18478,24597
437,tommy-dk,4,0.01626,3739,15.20104,24597
438,Trenthani,4,0.01626,3743,15.21730,24597
439,tschirmer,4,0.01626,3747,15.23357,24597
440,Tyil,4,0.01626,3751,15.24983,24597
441,vidarw,4,0.01626,3755,15.26609,24597
442,vindvaki,4,0.01626,3759,15.28235,24597
443,vkukk,4,0.01626,3763,15.29861,24597
444,whitecolor,4,0.01626,3767,15.31488,24597
445,wmellouli,4,0.01626,3771,15.33114,24597
446,wolfebrian2120,4,0.01626,3775,15.34740,24597
447,xh3b4sd,4,0.01626,3779,15.36366,24597
448,Zenuka,4,0.01626,3783,15.37992,24597
449,zes-richard,4,0.01626,3787,15.39619,24597
450,zhaoyao91,4,0.01626,3791,15.41245,24597
451,zosocanuck,4,0.01626,3795,15.42871,24597
452,akoudal,3,0.01220,3798,15.44091,24597
453,alexivkin,3,0.01220,3801,15.45310,24597
454,alexsorkin,3,0.01220,3804,15.46530,24597
455,allandegnan,3,0.01220,3807,15.47750,24597
456,allantatter,3,0.01220,3810,15.48969,24597
457,altinukshini,3,0.01220,3813,15.50189,24597
458,amgads,3,0.01220,3816,15.51409,24597
459,AMoghrabi,3,0.01220,3819,15.52628,24597
460,amontalban,3,0.01220,3822,15.53848,24597
461,AndrewDryga,3,0.01220,3825,15.55068,24597
462,annymsMthd,3,0.01220,3828,15.56287,24597
463,Anonymouslemming,3,0.01220,3831,15.57507,24597
464,aredridel,3,0.01220,3834,15.58727,24597
465,ArgTang,3,0.01220,3837,15.59946,24597
466,Arnold1,3,0.01220,3840,15.61166,24597
467,arvtiwar,3,0.01220,3843,15.62386,24597
468,atb00ker,3,0.01220,3846,15.63605,24597
469,atmosx,3,0.01220,3849,15.64825,24597
470,aude,3,0.01220,3852,15.66045,24597
471,austinmcconnell,3,0.01220,3855,15.67264,24597
472,ayushlodhi11,3,0.01220,3858,15.68484,24597
473,bangau1,3,0.01220,3861,15.69704,24597
474,barryzhounb,3,0.01220,3864,15.70923,24597
475,barth12,3,0.01220,3867,15.72143,24597
476,bbearce,3,0.01220,3870,15.73363,24597
477,belovebist,3,0.01220,3873,15.74582,24597
478,bemanuel,3,0.01220,3876,15.75802,24597
479,Bengrunt,3,0.01220,3879,15.77022,24597
480,benjii,3,0.01220,3882,15.78241,24597
481,bergkvist,3,0.01220,3885,15.79461,24597
482,Ble4Ch,3,0.01220,3888,15.80681,24597
483,blz-ea,3,0.01220,3891,15.81900,24597
484,BnMcG,3,0.01220,3894,15.83120,24597
485,bogdanalov-sw,3,0.01220,3897,15.84340,24597
486,borisermakof,3,0.01220,3900,15.85559,24597
487,Bowser1704,3,0.01220,3903,15.86779,24597
488,bradjones1,3,0.01220,3906,15.87999,24597
489,b-rajesh,3,0.01220,3909,15.89218,24597
490,bramvdklinkenberg,3,0.01220,3912,15.90438,24597
491,brbarnett,3,0.01220,3915,15.91658,24597
492,brokenmass,3,0.01220,3918,15.92877,24597
493,bruce2409,3,0.01220,3921,15.94097,24597
494,brunobolandini,3,0.01220,3924,15.95317,24597
495,budanm,3,0.01220,3927,15.96536,24597
496,cabiad,3,0.01220,3930,15.97756,24597
497,capitannaranja,3,0.01220,3933,15.98975,24597
498,cbiphuk,3,0.01220,3936,16.00195,24597
499,chinazj,3,0.01220,3939,16.01415,24597
500,chrisabird,3,0.01220,3942,16.02634,24597
501,clstb,3,0.01220,3945,16.03854,24597
502,code-chris,3,0.01220,3948,16.05074,24597
503,codedumper,3,0.01220,3951,16.06293,24597
504,CorentinAulagnier,3,0.01220,3954,16.07513,24597
505,cristiano-pires,3,0.01220,3957,16.08733,24597
506,csandanov,3,0.01220,3960,16.09952,24597
507,cyberaleks,3,0.01220,3963,16.11172,24597
508,Darwinyo,3,0.01220,3966,16.12392,24597
509,davegrix,3,0.01220,3969,16.13611,24597
510,davidcorbin,3,0.01220,3972,16.14831,24597
511,divo1,3,0.01220,3975,16.16051,24597
512,dpankros,3,0.01220,3978,16.17270,24597
513,durmisi,3,0.01220,3981,16.18490,24597
514,dverbeek84,3,0.01220,3984,16.19710,24597
515,eckseleven,3,0.01220,3987,16.20929,24597
516,ecktom,3,0.01220,3990,16.22149,24597
517,eks5115,3,0.01220,3993,16.23369,24597
518,enenum,3,0.01220,3996,16.24588,24597
519,entersb,3,0.01220,3999,16.25808,24597
520,erick-thompson,3,0.01220,4002,16.27028,24597
521,EverOctivian,3,0.01220,4005,16.28247,24597
522,exapsy,3,0.01220,4008,16.29467,24597
523,ezk84,3,0.01220,4011,16.30687,24597
524,fenngineering,3,0.01220,4014,16.31906,24597
525,f-f,3,0.01220,4017,16.33126,24597
526,fibbers,3,0.01220,4020,16.34346,24597
527,foux,3,0.01220,4023,16.35565,24597
528,gaddamas,3,0.01220,4026,16.36785,24597
529,gaidap,3,0.01220,4029,16.38005,24597
530,gaieges,3,0.01220,4032,16.39224,24597
531,galamiram,3,0.01220,4035,16.40444,24597
532,geNAZt,3,0.01220,4038,16.41664,24597
533,gentisaliu,3,0.01220,4041,16.42883,24597
534,giannello,3,0.01220,4044,16.44103,24597
535,gioggi,3,0.01220,4047,16.45323,24597
536,Glorf,3,0.01220,4050,16.46542,24597
537,gophobic,3,0.01220,4053,16.47762,24597
538,GuillaumeSmaha,3,0.01220,4056,16.48982,24597
539,gustavovalverde,3,0.01220,4059,16.50201,24597
540,guxlightyear,3,0.01220,4062,16.51421,24597
541,h00pz,3,0.01220,4065,16.52641,24597
542,HarmtH,3,0.01220,4068,16.53860,24597
543,haskell42,3,0.01220,4071,16.55080,24597
544,haven2dotnet,3,0.01220,4074,16.56300,24597
545,henri9813,3,0.01220,4077,16.57519,24597
546,heprotecbuthealsoattac,3,0.01220,4080,16.58739,24597
547,hpohl,3,0.01220,4083,16.59959,24597
548,huang-jy,3,0.01220,4086,16.61178,24597
549,hubstairs-admin,3,0.01220,4089,16.62398,24597
550,huyph,3,0.01220,4092,16.63618,24597
551,i008817,3,0.01220,4095,16.64837,24597
552,ianstanton,3,0.01220,4098,16.66057,24597
553,ichtar,3,0.01220,4101,16.67276,24597
554,ifilatov,3,0.01220,4104,16.68496,24597
555,iMacX,3,0.01220,4107,16.69716,24597
556,inos123,3,0.01220,4110,16.70935,24597
557,JayatiGoyal,3,0.01220,4113,16.72155,24597
558,jbouzekri,3,0.01220,4116,16.73375,24597
559,jeffgriffith,3,0.01220,4119,16.74594,24597
560,jenting,3,0.01220,4122,16.75814,24597
561,johan-smits,3,0.01220,4125,16.77034,24597
562,jsnick,3,0.01220,4128,16.78253,24597
563,julb,3,0.01220,4131,16.79473,24597
564,kariae,3,0.01220,4134,16.80693,24597
565,katiekeel,3,0.01220,4137,16.81912,24597
566,kaypeter87,3,0.01220,4140,16.83132,24597
567,kfyharukz,3,0.01220,4143,16.84352,24597
568,kirkre,3,0.01220,4146,16.85571,24597
569,klauskobald,3,0.01220,4149,16.86791,24597
570,kurtostfeld,3,0.01220,4152,16.88011,24597
571,lakeshadow0,3,0.01220,4155,16.89230,24597
572,laopojiaotutu,3,0.01220,4158,16.90450,24597
573,laurieodgers,3,0.01220,4161,16.91670,24597
574,ldealmei,3,0.01220,4164,16.92889,24597
575,leak4mk0,3,0.01220,4167,16.94109,24597
576,LekeFasola,3,0.01220,4170,16.95329,24597
577,lenhattan86,3,0.01220,4173,16.96548,24597
578,lenkeybalis,3,0.01220,4176,16.97768,24597
579,levasseur-sp,3,0.01220,4179,16.98988,24597
580,leyshon,3,0.01220,4182,17.00207,24597
581,Lirt,3,0.01220,4185,17.01427,24597
582,liulangwa,3,0.01220,4188,17.02647,24597
583,locky-me,3,0.01220,4191,17.03866,24597
584,logicbomb421,3,0.01220,4194,17.05086,24597
585,loomsen,3,0.01220,4197,17.06306,24597
586,lopezator,3,0.01220,4200,17.07525,24597
587,ltatakis-vocovo,3,0.01220,4203,17.08745,24597
588,luceos,3,0.01220,4206,17.09965,24597
589,lukshap,3,0.01220,4209,17.11184,24597
590,lulin1994,3,0.01220,4212,17.12404,24597
591,m0rg0th,3,0.01220,4215,17.13624,24597
592,m3adow,3,0.01220,4218,17.14843,24597
593,madmesi,3,0.01220,4221,17.16063,24597
594,madsonic,3,0.01220,4224,17.17283,24597
595,manmat,3,0.01220,4227,17.18502,24597
596,MartinodF,3,0.01220,4230,17.19722,24597
597,marty90,3,0.01220,4233,17.20942,24597
598,MatthiasHertel,3,0.01220,4236,17.22161,24597
599,mattshin,3,0.01220,4239,17.23381,24597
600,Mattsky,3,0.01220,4242,17.24601,24597
601,Mazon,3,0.01220,4245,17.25820,24597
602,mbaragiola,3,0.01220,4248,17.27040,24597
603,mccrackend,3,0.01220,4251,17.28260,24597
604,mdroogendijk,3,0.01220,4254,17.29479,24597
605,menardorama,3,0.01220,4257,17.30699,24597
606,michaelgregson,3,0.01220,4260,17.31919,24597
607,michaelhaessig,3,0.01220,4263,17.33138,24597
608,michelefa1988,3,0.01220,4266,17.34358,24597
609,minho-comcom-ai,3,0.01220,4269,17.35578,24597
610,mkozjak,3,0.01220,4272,17.36797,24597
611,mohanrao,3,0.01220,4275,17.38017,24597
612,molon,3,0.01220,4278,17.39236,24597
613,momon,3,0.01220,4281,17.40456,24597
614,Morallying,3,0.01220,4284,17.41676,24597
615,Morishiri,3,0.01220,4287,17.42895,24597
616,murbano83,3,0.01220,4290,17.44115,24597
617,myco,3,0.01220,4293,17.45335,24597
618,ncgee,3,0.01220,4296,17.46554,24597
619,nekar93,3,0.01220,4299,17.47774,24597
620,neverping,3,0.01220,4302,17.48994,24597
621,nik-sviridenko,3,0.01220,4305,17.50213,24597
622,nirik,3,0.01220,4308,17.51433,24597
623,nreisbeck,3,0.01220,4311,17.52653,24597
624,ntx-ben,3,0.01220,4314,17.53872,24597
625,Nymria,3,0.01220,4317,17.55092,24597
626,oliverholliday,3,0.01220,4320,17.56312,24597
627,olivierchatry,3,0.01220,4323,17.57531,24597
628,olivier-mauras,3,0.01220,4326,17.58751,24597
629,OndroNR,3,0.01220,4329,17.59971,24597
630,opaolini,3,0.01220,4332,17.61190,24597
631,Oxalide-Team-2,3,0.01220,4335,17.62410,24597
632,oze4,3,0.01220,4338,17.63630,24597
633,paddatrapper,3,0.01220,4341,17.64849,24597
634,paulwoelfelcpl,3,0.01220,4344,17.66069,24597
635,pehlert,3,0.01220,4347,17.67289,24597
636,petermikitsh,3,0.01220,4350,17.68508,24597
637,Piusdan,3,0.01220,4353,17.69728,24597
638,pkdetlefsen,3,0.01220,4356,17.70948,24597
639,pluqueTheLuxe,3,0.01220,4359,17.72167,24597
640,povils,3,0.01220,4362,17.73387,24597
641,programatt,3,0.01220,4365,17.74607,24597
642,psavva,3,0.01220,4368,17.75826,24597
643,PurpleBooth,3,0.01220,4371,17.77046,24597
644,qfny88,3,0.01220,4374,17.78266,24597
645,r0bnet,3,0.01220,4377,17.79485,24597
646,rajinator,3,0.01220,4380,17.80705,24597
647,RammusXu,3,0.01220,4383,17.81925,24597
648,ravenpride,3,0.01220,4386,17.83144,24597
649,remizyaka,3,0.01220,4389,17.84364,24597
650,renaudguerin,3,0.01220,4392,17.85584,24597
651,rfleschenberg,3,0.01220,4395,17.86803,24597
652,rittneje,3,0.01220,4398,17.88023,24597
653,rlaakkol,3,0.01220,4401,17.89243,24597
654,rlevchenko,3,0.01220,4404,17.90462,24597
655,rnsv,3,0.01220,4407,17.91682,24597
656,RobTheArchitect,3,0.01220,4410,17.92902,24597
657,ronneke1996,3,0.01220,4413,17.94121,24597
658,rosskevin,3,0.01220,4416,17.95341,24597
659,royolsen,3,0.01220,4419,17.96561,24597
660,roy-work,3,0.01220,4422,17.97780,24597
661,rudolphjacksonm,3,0.01220,4425,17.99000,24597
662,sambhav-gore,3,0.01220,4428,18.00220,24597
663,sambhavsaggi,3,0.01220,4431,18.01439,24597
664,samrobillard,3,0.01220,4434,18.02659,24597
665,sangnguyen7,3,0.01220,4437,18.03879,24597
666,saraedum,3,0.01220,4440,18.05098,24597
667,SathishManokar,3,0.01220,4443,18.06318,24597
668,SeriousM,3,0.01220,4446,18.07538,24597
669,seunroava,3,0.01220,4449,18.08757,24597
670,simon-k8s,3,0.01220,4452,18.09977,24597
671,simonwahlgren,3,0.01220,4455,18.11196,24597
672,skuro,3,0.01220,4458,18.12416,24597
673,skygeo,3,0.01220,4461,18.13636,24597
674,sseneca,3,0.01220,4464,18.14855,24597
675,steadysupply,3,0.01220,4467,18.16075,24597
676,stobias123,3,0.01220,4470,18.17295,24597
677,str1k3r,3,0.01220,4473,18.18514,24597
678,styoe,3,0.01220,4476,18.19734,24597
679,suda,3,0.01220,4479,18.20954,24597
680,Sudharma,3,0.01220,4482,18.22173,24597
681,swagat16,3,0.01220,4485,18.23393,24597
682,sww314,3,0.01220,4488,18.24613,24597
683,sysradium,3,0.01220,4491,18.25832,24597
684,taikoThe,3,0.01220,4494,18.27052,24597
685,tareksalem,3,0.01220,4497,18.28272,24597
686,tcassaert,3,0.01220,4500,18.29491,24597
687,tijsg,3,0.01220,4503,18.30711,24597
688,Timbus,3,0.01220,4506,18.31931,24597
689,timuckun,3,0.01220,4509,18.33150,24597
690,tjakobsson,3,0.01220,4512,18.34370,24597
691,tjesser-ucdavis-edu,3,0.01220,4515,18.35590,24597
692,tjma2001,3,0.01220,4518,18.36809,24597
693,Toasterson,3,0.01220,4521,18.38029,24597
694,tobiajo,3,0.01220,4524,18.39249,24597
695,tomtom94,3,0.01220,4527,18.40468,24597
696,tonit,3,0.01220,4530,18.41688,24597
697,trenslow,3,0.01220,4533,18.42908,24597
698,ttinkr,3,0.01220,4536,18.44127,24597
699,TylerIlunga,3,0.01220,4539,18.45347,24597
700,ultimatesecpro,3,0.01220,4542,18.46567,24597
701,vainkop,3,0.01220,4545,18.47786,24597
702,vairakkumar-vairaperumal,3,0.01220,4548,18.49006,24597
703,vfiset,3,0.01220,4551,18.50226,24597
704,VihanAgarwal97,3,0.01220,4554,18.51445,24597
705,viralpoetry,3,0.01220,4557,18.52665,24597
706,vitalidn,3,0.01220,4560,18.53885,24597
707,vitorfhc,3,0.01220,4563,18.55104,24597
708,vnorguet,3,0.01220,4566,18.56324,24597
709,Vonor,3,0.01220,4569,18.57544,24597
710,vosuyak,3,0.01220,4572,18.58763,24597
711,vyau987,3,0.01220,4575,18.59983,24597
712,willingham,3,0.01220,4578,18.61203,24597
713,Woland2k,3,0.01220,4581,18.62422,24597
714,wstewartii,3,0.01220,4584,18.63642,24597
715,xaralis,3,0.01220,4587,18.64862,24597
716,xenu256,3,0.01220,4590,18.66081,24597
717,yaminisridaran,3,0.01220,4593,18.67301,24597
718,yashaswee,3,0.01220,4596,18.68521,24597
719,yehudamakarov,3,0.01220,4599,18.69740,24597
720,ymatsiuk,3,0.01220,4602,18.70960,24597
721,yosbeleg89,3,0.01220,4605,18.72180,24597
722,zachomedia,3,0.01220,4608,18.73399,24597
723,zeeraw,3,0.01220,4611,18.74619,24597
724,2point0,2,0.00813,4613,18.75432,24597
725,4ydx,2,0.00813,4615,18.76245,24597
726,aam-wtag,2,0.00813,4617,18.77058,24597
727,adamgajzlerowicz,2,0.00813,4619,18.77871,24597
728,AdlerFleurant,2,0.00813,4621,18.78684,24597
729,aeimer,2,0.00813,4623,18.79497,24597
730,AeroNotix,2,0.00813,4625,18.80311,24597
731,agusti-t,2,0.00813,4627,18.81124,24597
732,ailox,2,0.00813,4629,18.81937,24597
733,ainiml,2,0.00813,4631,18.82750,24597
734,AislingFae,2,0.00813,4633,18.83563,24597
735,ajchiarello,2,0.00813,4635,18.84376,24597
736,ajfriesen,2,0.00813,4637,18.85189,24597
737,akaveti-cs,2,0.00813,4639,18.86002,24597
738,akrantz01,2,0.00813,4641,18.86815,24597
739,AlaaMansourTW,2,0.00813,4643,18.87629,24597
740,alecunsolo,2,0.00813,4645,18.88442,24597
741,alemonmk,2,0.00813,4647,18.89255,24597
742,alepaez,2,0.00813,4649,18.90068,24597
743,alexandrem,2,0.00813,4651,18.90881,24597
744,AlexGilleran,2,0.00813,4653,18.91694,24597
745,alhafoudh,2,0.00813,4655,18.92507,24597
746,alkiko,2,0.00813,4657,18.93320,24597
747,aloopkin,2,0.00813,4659,18.94133,24597
748,altoning,2,0.00813,4661,18.94947,24597
749,alxbse,2,0.00813,4663,18.95760,24597
750,amandadebler,2,0.00813,4665,18.96573,24597
751,andrei-dascalu,2,0.00813,4667,18.97386,24597
752,anebi,2,0.00813,4669,18.98199,24597
753,angrybug,2,0.00813,4671,18.99012,24597
754,anouarchattouna,2,0.00813,4673,18.99825,24597
755,antegulin,2,0.00813,4675,19.00638,24597
756,antjkennedy,2,0.00813,4677,19.01451,24597
757,apetheriotis,2,0.00813,4679,19.02265,24597
758,apognu,2,0.00813,4681,19.03078,24597
759,aranair,2,0.00813,4683,19.03891,24597
760,aristosvo,2,0.00813,4685,19.04704,24597
761,arnisoph,2,0.00813,4687,19.05517,24597
762,ashitikov,2,0.00813,4689,19.06330,24597
763,asplogic,2,0.00813,4691,19.07143,24597
764,async-dna,2,0.00813,4693,19.07956,24597
765,AthulDilip,2,0.00813,4695,19.08769,24597
766,austinpray,2,0.00813,4697,19.09582,24597
767,awsum,2,0.00813,4699,19.10396,24597
768,babvin,2,0.00813,4701,19.11209,24597
769,baldeynz,2,0.00813,4703,19.12022,24597
770,ball-hayden,2,0.00813,4705,19.12835,24597
771,bauerd,2,0.00813,4707,19.13648,24597
772,bengentil,2,0.00813,4709,19.14461,24597
773,benjick,2,0.00813,4711,19.15274,24597
774,Berndinox,2,0.00813,4713,19.16087,24597
775,bharatak,2,0.00813,4715,19.16900,24597
776,bibi520,2,0.00813,4717,19.17714,24597
777,bigdrum,2,0.00813,4719,19.18527,24597
778,bilalmalik777,2,0.00813,4721,19.19340,24597
779,blacs30,2,0.00813,4723,19.20153,24597
780,bodanc,2,0.00813,4725,19.20966,24597
781,boris-savic,2,0.00813,4727,19.21779,24597
782,bots-business,2,0.00813,4729,19.22592,24597
783,bradleybluebean,2,0.00813,4731,19.23405,24597
784,BrendanThompson,2,0.00813,4733,19.24218,24597
785,brondum,2,0.00813,4735,19.25032,24597
786,brownleej,2,0.00813,4737,19.25845,24597
787,brucewu16899,2,0.00813,4739,19.26658,24597
788,bspaans,2,0.00813,4741,19.27471,24597
789,bukowa,2,0.00813,4743,19.28284,24597
790,bwolfehcm,2,0.00813,4745,19.29097,24597
791,camsjams,2,0.00813,4747,19.29910,24597
792,carrchang,2,0.00813,4749,19.30723,24597
793,cbeneke,2,0.00813,4751,19.31536,24597
794,ceefour,2,0.00813,4753,19.32349,24597
795,cepefernando,2,0.00813,4755,19.33163,24597
796,chauffer,2,0.00813,4757,19.33976,24597
797,CheesyFeet,2,0.00813,4759,19.34789,24597
798,chenmin1992,2,0.00813,4761,19.35602,24597
799,chriskolenko,2,0.00813,4763,19.36415,24597
800,ChSch3000,2,0.00813,4765,19.37228,24597
801,ciokan,2,0.00813,4767,19.38041,24597
802,clook,2,0.00813,4769,19.38854,24597
803,cmrust,2,0.00813,4771,19.39667,24597
804,cochiseruhulessin,2,0.00813,4773,19.40481,24597
805,codejamninja,2,0.00813,4775,19.41294,24597
806,coreycollins,2,0.00813,4777,19.42107,24597
807,dabeck,2,0.00813,4779,19.42920,24597
808,dadrian,2,0.00813,4781,19.43733,24597
809,danfoster,2,0.00813,4783,19.44546,24597
810,danielbjornadal,2,0.00813,4785,19.45359,24597
811,danielrudn,2,0.00813,4787,19.46172,24597
812,daryllstrauss,2,0.00813,4789,19.46985,24597
813,davenewza,2,0.00813,4791,19.47799,24597
814,dbourcet,2,0.00813,4793,19.48612,24597
815,ddrechse,2,0.00813,4795,19.49425,24597
816,deathcat05,2,0.00813,4797,19.50238,24597
817,defcronyke,2,0.00813,4799,19.51051,24597
818,deiga,2,0.00813,4801,19.51864,24597
819,devopstales,2,0.00813,4803,19.52677,24597
820,devorbitus,2,0.00813,4805,19.53490,24597
821,dhawton,2,0.00813,4807,19.54303,24597
822,dlamotte,2,0.00813,4809,19.55116,24597
823,dmolik,2,0.00813,4811,19.55930,24597
824,donchev7,2,0.00813,4813,19.56743,24597
825,donspaulding,2,0.00813,4815,19.57556,24597
826,dpeckett,2,0.00813,4817,19.58369,24597
827,Dr4s1l,2,0.00813,4819,19.59182,24597
828,dsbrng25b,2,0.00813,4821,19.59995,24597
829,dunjut,2,0.00813,4823,19.60808,24597
830,dustinblackman,2,0.00813,4825,19.61621,24597
831,Dynogic,2,0.00813,4827,19.62434,24597
832,eddieparker,2,0.00813,4829,19.63248,24597
833,ekozan,2,0.00813,4831,19.64061,24597
834,eranchetz,2,0.00813,4833,19.64874,24597
835,erSitzt,2,0.00813,4835,19.65687,24597
836,esantoro,2,0.00813,4837,19.66500,24597
837,eseliger,2,0.00813,4839,19.67313,24597
838,eugenegoncharuk,2,0.00813,4841,19.68126,24597
839,eugenestarchenko,2,0.00813,4843,19.68939,24597
840,eupestov,2,0.00813,4845,19.69752,24597
841,evgkrsk,2,0.00813,4847,19.70566,24597
842,fabianhjr,2,0.00813,4849,19.71379,24597
843,fabio-510,2,0.00813,4851,19.72192,24597
844,FabioSchmidberger,2,0.00813,4853,19.73005,24597
845,falconc,2,0.00813,4855,19.73818,24597
846,Feder1co5oave,2,0.00813,4857,19.74631,24597
847,fgeorgatos,2,0.00813,4859,19.75444,24597
848,filoe,2,0.00813,4861,19.76257,24597
849,fmd,2,0.00813,4863,19.77070,24597
850,Fresa,2,0.00813,4865,19.77883,24597
851,fristedt,2,0.00813,4867,19.78697,24597
852,galingit,2,0.00813,4869,19.79510,24597
853,geekette86,2,0.00813,4871,19.80323,24597
854,GeoffWilliams,2,0.00813,4873,19.81136,24597
855,Georege,2,0.00813,4875,19.81949,24597
856,germetist,2,0.00813,4877,19.82762,24597
857,goblain,2,0.00813,4879,19.83575,24597
858,goblue212,2,0.00813,4881,19.84388,24597
859,goloxxly,2,0.00813,4883,19.85201,24597
860,goodidea-kp,2,0.00813,4885,19.86015,24597
861,gryphius,2,0.00813,4887,19.86828,24597
862,GTB3NW,2,0.00813,4889,19.87641,24597
863,guanzo,2,0.00813,4891,19.88454,24597
864,guneemwelloeux,2,0.00813,4893,19.89267,24597
865,gwenall,2,0.00813,4895,19.90080,24597
866,halcyon,2,0.00813,4897,19.90893,24597
867,hampos,2,0.00813,4899,19.91706,24597
868,harshmaur,2,0.00813,4901,19.92519,24597
869,hedeesa,2,0.00813,4903,19.93333,24597
870,heptathlon,2,0.00813,4905,19.94146,24597
871,hexa2k9,2,0.00813,4907,19.94959,24597
872,hguerrero,2,0.00813,4909,19.95772,24597
873,hlubek,2,0.00813,4911,19.96585,24597
874,hmeerlo,2,0.00813,4913,19.97398,24597
875,holdenkilbride,2,0.00813,4915,19.98211,24597
876,honi,2,0.00813,4917,19.99024,24597
877,htimur,2,0.00813,4919,19.99837,24597
878,iceydee,2,0.00813,4921,20.00650,24597
879,icsy7867,2,0.00813,4923,20.01464,24597
880,ifnazar,2,0.00813,4925,20.02277,24597
881,infa-bsurber,2,0.00813,4927,20.03090,24597
882,infa-ddeore,2,0.00813,4929,20.03903,24597
883,innovia,2,0.00813,4931,20.04716,24597
884,intellix,2,0.00813,4933,20.05529,24597
885,Isakgicu,2,0.00813,4935,20.06342,24597
886,itpcc,2,0.00813,4937,20.07155,24597
887,Jagdeep1,2,0.00813,4939,20.07968,24597
888,jakubigla,2,0.00813,4941,20.08782,24597
889,jakubknejzlik,2,0.00813,4943,20.09595,24597
890,jallaix,2,0.00813,4945,20.10408,24597
891,jamesthegiantpeach,2,0.00813,4947,20.11221,24597
892,JanisOrlovs,2,0.00813,4949,20.12034,24597
893,JannikSt,2,0.00813,4951,20.12847,24597
894,jar3b,2,0.00813,4953,20.13660,24597
895,jasonchester,2,0.00813,4955,20.14473,24597
896,jasonjho,2,0.00813,4957,20.15286,24597
897,jaykaypea,2,0.00813,4959,20.16100,24597
898,jbartus,2,0.00813,4961,20.16913,24597
899,jcbcn,2,0.00813,4963,20.17726,24597
900,jclaessens97,2,0.00813,4965,20.18539,24597
901,jeffijoe,2,0.00813,4967,20.19352,24597
902,jesseborden,2,0.00813,4969,20.20165,24597
903,jetersen,2,0.00813,4971,20.20978,24597
904,jkoyle,2,0.00813,4973,20.21791,24597
905,jnschaeffer,2,0.00813,4975,20.22604,24597
906,joaoh821C,2,0.00813,4977,20.23417,24597
907,johnl,2,0.00813,4979,20.24231,24597
908,jonbcampos-alto,2,0.00813,4981,20.25044,24597
909,jpiepkow,2,0.00813,4983,20.25857,24597
910,jrosinsk,2,0.00813,4985,20.26670,24597
911,jschniper,2,0.00813,4987,20.27483,24597
912,juanjoDiaz,2,0.00813,4989,20.28296,24597
913,julien-piccaluga,2,0.00813,4991,20.29109,24597
914,jvthanh,2,0.00813,4993,20.29922,24597
915,KetulParikh,2,0.00813,4995,20.30735,24597
916,kevinniu666,2,0.00813,4997,20.31549,24597
917,kfoozminus,2,0.00813,4999,20.32362,24597
918,khwerhahn,2,0.00813,5001,20.33175,24597
919,kieronlanning,2,0.00813,5003,20.33988,24597
920,KillerByte,2,0.00813,5005,20.34801,24597
921,Kirill-Garbar,2,0.00813,5007,20.35614,24597
922,kkurzhal,2,0.00813,5009,20.36427,24597
923,Knowledge91,2,0.00813,5011,20.37240,24597
924,koldoon,2,0.00813,5013,20.38053,24597
925,kolyan007,2,0.00813,5015,20.38867,24597
926,korjanvos,2,0.00813,5017,20.39680,24597
927,korovaisdead,2,0.00813,5019,20.40493,24597
928,kostyrev,2,0.00813,5021,20.41306,24597
929,Koteko,2,0.00813,5023,20.42119,24597
930,koustubhg,2,0.00813,5025,20.42932,24597
931,krisztian-trl,2,0.00813,5027,20.43745,24597
932,kvolkovich-sc,2,0.00813,5029,20.44558,24597
933,l4z41,2,0.00813,5031,20.45371,24597
934,laimison,2,0.00813,5033,20.46184,24597
935,leberknecht,2,0.00813,5035,20.46998,24597
936,lekspyl,2,0.00813,5037,20.47811,24597
937,lenny87,2,0.00813,5039,20.48624,24597
938,leojonathanoh,2,0.00813,5041,20.49437,24597
939,LuckySB,2,0.00813,5043,20.50250,24597
940,ludovicMercier,2,0.00813,5045,20.51063,24597
941,luishdez,2,0.00813,5047,20.51876,24597
942,lyndon160,2,0.00813,5049,20.52689,24597
943,m22r,2,0.00813,5051,20.53502,24597
944,Maciej-Zelechowski,2,0.00813,5053,20.54316,24597
945,maddylliieeee,2,0.00813,5055,20.55129,24597
946,madjam002,2,0.00813,5057,20.55942,24597
947,MadVikingGod,2,0.00813,5059,20.56755,24597
948,MahdiZareie,2,0.00813,5061,20.57568,24597
949,makeacode,2,0.00813,5063,20.58381,24597
950,mam8270,2,0.00813,5065,20.59194,24597
951,mansona,2,0.00813,5067,20.60007,24597
952,marcoamorales,2,0.00813,5069,20.60820,24597
953,markns,2,0.00813,5071,20.61634,24597
954,MarkusMikkolainen,2,0.00813,5073,20.62447,24597
955,martell,2,0.00813,5075,20.63260,24597
956,martinbaillie,2,0.00813,5077,20.64073,24597
957,Martin-Idel-SI,2,0.00813,5079,20.64886,24597
958,masa213f,2,0.00813,5081,20.65699,24597
959,mat285,2,0.00813,5083,20.66512,24597
960,matthiasbaldi,2,0.00813,5085,20.67325,24597
961,mav96,2,0.00813,5087,20.68138,24597
962,maxwedwards,2,0.00813,5089,20.68951,24597
963,maxweis,2,0.00813,5091,20.69765,24597
964,mblhaunted,2,0.00813,5093,20.70578,24597
965,MerNat,2,0.00813,5095,20.71391,24597
966,metallhopf,2,0.00813,5097,20.72204,24597
967,mgcrea,2,0.00813,5099,20.73017,24597
968,mhyousefi,2,0.00813,5101,20.73830,24597
969,MiaoZhou,2,0.00813,5103,20.74643,24597
970,michaelsteven,2,0.00813,5105,20.75456,24597
971,michalmikolajczyk,2,0.00813,5107,20.76269,24597
972,migueloller,2,0.00813,5109,20.77083,24597
973,MikeDaniel18,2,0.00813,5111,20.77896,24597
974,mikepuglisi,2,0.00813,5113,20.78709,24597
975,mikereiche,2,0.00813,5115,20.79522,24597
976,MilanDasek,2,0.00813,5117,20.80335,24597
977,milenyordanov,2,0.00813,5119,20.81148,24597
978,minafarouk,2,0.00813,5121,20.81961,24597
979,mindrunner,2,0.00813,5123,20.82774,24597
980,misteruly,2,0.00813,5125,20.83587,24597
981,mitom,2,0.00813,5127,20.84401,24597
982,MohiK98,2,0.00813,5129,20.85214,24597
983,mornindew,2,0.00813,5131,20.86027,24597
984,MrDienns,2,0.00813,5133,20.86840,24597
985,msalles-winn,2,0.00813,5135,20.87653,24597
986,mschweiker,2,0.00813,5137,20.88466,24597
987,munjal-patel,2,0.00813,5139,20.89279,24597
988,myrage2000,2,0.00813,5141,20.90092,24597
989,myshkin5,2,0.00813,5143,20.90905,24597
990,nabilbendafi,2,0.00813,5145,20.91719,24597
991,navneet1075,2,0.00813,5147,20.92532,24597
992,naymore,2,0.00813,5149,20.93345,24597
993,ncri,2,0.00813,5151,20.94158,24597
994,ndjido,2,0.00813,5153,20.94971,24597
995,nielsslot,2,0.00813,5155,20.95784,24597
996,Nikhilmadduri,2,0.00813,5157,20.96597,24597
997,ninja-,2,0.00813,5159,20.97410,24597
998,NiPfi,2,0.00813,5161,20.98223,24597
999,nirgn975,2,0.00813,5163,20.99036,24597
1000,norwoodj,2,0.00813,5165,20.99850,24597
1001,nphmuller,2,0.00813,5167,21.00663,24597
1002,nxf5025,2,0.00813,5169,21.01476,24597
1003,ofer-tvil,2,0.00813,5171,21.02289,24597
1004,Ogala,2,0.00813,5173,21.03102,24597
1005,ohardy,2,0.00813,5175,21.03915,24597
1006,oliverbaehler,2,0.00813,5177,21.04728,24597
1007,omegazeng,2,0.00813,5179,21.05541,24597
1008,opensourceonly,2,0.00813,5181,21.06354,24597
1009,oussamaelhajoui,2,0.00813,5183,21.07168,24597
1010,PabloDeCortes,2,0.00813,5185,21.07981,24597
1011,PascalKu,2,0.00813,5187,21.08794,24597
1012,patrickdent,2,0.00813,5189,21.09607,24597
1013,paulopontesm,2,0.00813,5191,21.10420,24597
1014,paulwilljones,2,0.00813,5193,21.11233,24597
1015,pavelzamyatin,2,0.00813,5195,21.12046,24597
1016,pbnsilva,2,0.00813,5197,21.12859,24597
1017,peppe77,2,0.00813,5199,21.13672,24597
1018,perezjasonr,2,0.00813,5201,21.14486,24597
1019,PG2000,2,0.00813,5203,21.15299,24597
1020,pimpolderman,2,0.00813,5205,21.16112,24597
1021,polinchw,2,0.00813,5207,21.16925,24597
1022,priyankak1212,2,0.00813,5209,21.17738,24597
1023,pvdvreede,2,0.00813,5211,21.18551,24597
1024,radarnex,2,0.00813,5213,21.19364,24597
1025,raedur,2,0.00813,5215,21.20177,24597
1026,RafaelAybar,2,0.00813,5217,21.20990,24597
1027,Raghubalam,2,0.00813,5219,21.21803,24597
1028,ragurakesh,2,0.00813,5221,21.22617,24597
1029,Rambatino,2,0.00813,5223,21.23430,24597
1030,RbertKo,2,0.00813,5225,21.24243,24597
1031,rclsilver,2,0.00813,5227,21.25056,24597
1032,remcohaszing,2,0.00813,5229,21.25869,24597
1033,remikj,2,0.00813,5231,21.26682,24597
1034,Rested,2,0.00813,5233,21.27495,24597
1035,ricardopt,2,0.00813,5235,21.28308,24597
1036,rihardssceredins,2,0.00813,5237,21.29121,24597
1037,rndmh3ro,2,0.00813,5239,21.29935,24597
1038,robearlam,2,0.00813,5241,21.30748,24597
1039,robertgates55,2,0.00813,5243,21.31561,24597
1040,RobinJ1995,2,0.00813,5245,21.32374,24597
1041,RobinOvergaard,2,0.00813,5247,21.33187,24597
1042,rodrigo-findhotel,2,0.00813,5249,21.34000,24597
1043,roonie007,2,0.00813,5251,21.34813,24597
1044,rootsh,2,0.00813,5253,21.35626,24597
1045,roshan-mr,2,0.00813,5255,21.36439,24597
1046,rosskusler,2,0.00813,5257,21.37253,24597
1047,rot26,2,0.00813,5259,21.38066,24597
1048,rspier,2,0.00813,5261,21.38879,24597
1049,rubanooo,2,0.00813,5263,21.39692,24597
1050,ryan-harper-dentsu,2,0.00813,5265,21.40505,24597
1051,saalaa,2,0.00813,5267,21.41318,24597
1052,sadym,2,0.00813,5269,21.42131,24597
1053,SamuelTechwolf,2,0.00813,5271,21.42944,24597
1054,sayhell,2,0.00813,5273,21.43757,24597
1055,sc0ttwad3,2,0.00813,5275,21.44570,24597
1056,SCLogo,2,0.00813,5277,21.45384,24597
1057,scottjg,2,0.00813,5279,21.46197,24597
1058,sdesbure,2,0.00813,5281,21.47010,24597
1059,sdlarsen,2,0.00813,5283,21.47823,24597
1060,sebastian-myrepublic,2,0.00813,5285,21.48636,24597
1061,seleznev,2,0.00813,5287,21.49449,24597
1062,ser60v,2,0.00813,5289,21.50262,24597
1063,sergeyshaykhullin,2,0.00813,5291,21.51075,24597
1064,sgraza,2,0.00813,5293,21.51888,24597
1065,sha224,2,0.00813,5295,21.52702,24597
1066,shankardevy,2,0.00813,5297,21.53515,24597
1067,shankgan,2,0.00813,5299,21.54328,24597
1068,sharkymcdongles,2,0.00813,5301,21.55141,24597
1069,shenek,2,0.00813,5303,21.55954,24597
1070,sibradzic,2,0.00813,5305,21.56767,24597
1071,sillva,2,0.00813,5307,21.57580,24597
1072,silviogutierrez,2,0.00813,5309,21.58393,24597
1073,Simon0Liu,2,0.00813,5311,21.59206,24597
1074,simpers,2,0.00813,5313,21.60020,24597
1075,sindrepm,2,0.00813,5315,21.60833,24597
1076,sjbarrio,2,0.00813,5317,21.61646,24597
1077,slynickel,2,0.00813,5319,21.62459,24597
1078,smaslennikov,2,0.00813,5321,21.63272,24597
1079,softlion,2,0.00813,5323,21.64085,24597
1080,sonalijha1711,2,0.00813,5325,21.64898,24597
1081,spacejam101,2,0.00813,5327,21.65711,24597
1082,splattner,2,0.00813,5329,21.66524,24597
1083,spor7y,2,0.00813,5331,21.67337,24597
1084,sporkmonger,2,0.00813,5333,21.68151,24597
1085,Sprinkle,2,0.00813,5335,21.68964,24597
1086,staticdev,2,0.00813,5337,21.69777,24597
1087,stefanvladvoinea,2,0.00813,5339,21.70590,24597
1088,stek29,2,0.00813,5341,21.71403,24597
1089,stevelacy,2,0.00813,5343,21.72216,24597
1090,stopsopa,2,0.00813,5345,21.73029,24597
1091,strigona-worksight,2,0.00813,5347,21.73842,24597
1092,sub6as,2,0.00813,5349,21.74655,24597
1093,suragi-cisco,2,0.00813,5351,21.75469,24597
1094,sushi86,2,0.00813,5353,21.76282,24597
1095,svarughese91,2,0.00813,5355,21.77095,24597
1096,swati-nair,2,0.00813,5357,21.77908,24597
1097,synoptase,2,0.00813,5359,21.78721,24597
1098,synth3tk,2,0.00813,5361,21.79534,24597
1099,tareksamni,2,0.00813,5363,21.80347,24597
1100,TecHunter,2,0.00813,5365,21.81160,24597
1101,TehTotalPwnage,2,0.00813,5367,21.81973,24597
1102,tekspacedemo,2,0.00813,5369,21.82787,24597
1103,tellisnz-shift,2,0.00813,5371,21.83600,24597
1104,terunoly,2,0.00813,5373,21.84413,24597
1105,TESTPERSONAL,2,0.00813,5375,21.85226,24597
1106,tgautier,2,0.00813,5377,21.86039,24597
1107,th31nitiate,2,0.00813,5379,21.86852,24597
1108,ThatWasBrilliant,2,0.00813,5381,21.87665,24597
1109,thavlik,2,0.00813,5383,21.88478,24597
1110,the-mateo,2,0.00813,5385,21.89291,24597
1111,therealkevinard,2,0.00813,5387,21.90104,24597
1112,thismatters,2,0.00813,5389,21.90918,24597
1113,Thomas-In,2,0.00813,5391,21.91731,24597
1114,thomassampson,2,0.00813,5393,21.92544,24597
1115,thrucker,2,0.00813,5395,21.93357,24597
1116,timboven,2,0.00813,5397,21.94170,24597
1117,timothysmith0609,2,0.00813,5399,21.94983,24597
1118,toadjaune,2,0.00813,5401,21.95796,24597
1119,tomerleib,2,0.00813,5403,21.96609,24597
1120,TonyLuo,2,0.00813,5405,21.97422,24597
1121,tpoindessous,2,0.00813,5407,21.98236,24597
1122,TripleEmcoder,2,0.00813,5409,21.99049,24597
1123,ttarczynski,2,0.00813,5411,21.99862,24597
1124,tttlkkkl,2,0.00813,5413,22.00675,24597
1125,turbolent,2,0.00813,5415,22.01488,24597
1126,tweakmy,2,0.00813,5417,22.02301,24597
1127,tyg03485,2,0.00813,5419,22.03114,24597
1128,unludo,2,0.00813,5421,22.03927,24597
1129,U-TechMichael,2,0.00813,5423,22.04740,24597
1130,vakkur,2,0.00813,5425,22.05554,24597
1131,VarroReve,2,0.00813,5427,22.06367,24597
1132,vasili439,2,0.00813,5429,22.07180,24597
1133,vdbxavier,2,0.00813,5431,22.07993,24597
1134,VGerris,2,0.00813,5433,22.08806,24597
1135,vigensahakyan,2,0.00813,5435,22.09619,24597
1136,viswadeep,2,0.00813,5437,22.10432,24597
1137,voroniys,2,0.00813,5439,22.11245,24597
1138,waelghaith,2,0.00813,5441,22.12058,24597
1139,wapa5pow,2,0.00813,5443,22.12871,24597
1140,widdix123,2,0.00813,5445,22.13685,24597
1141,wiltonfelix,2,0.00813,5447,22.14498,24597
1142,withnale,2,0.00813,5449,22.15311,24597
1143,wouterh,2,0.00813,5451,22.16124,24597
1144,wutz,2,0.00813,5453,22.16937,24597
1145,XanderAtBackboneSystems,2,0.00813,5455,22.17750,24597
1146,ximon18,2,0.00813,5457,22.18563,24597
1147,xmassx,2,0.00813,5459,22.19376,24597
1148,xorjain,2,0.00813,5461,22.20189,24597
1149,yctn,2,0.00813,5463,22.21003,24597
1150,YoshieraHuang,2,0.00813,5465,22.21816,24597
1151,yvanavermaet,2,0.00813,5467,22.22629,24597
1152,zhanglangbravo,2,0.00813,5469,22.23442,24597
1153,zhaochenglan,2,0.00813,5471,22.24255,24597
1154,zored,2,0.00813,5473,22.25068,24597
1155,zwcn,2,0.00813,5475,22.25881,24597
1156,zystem,2,0.00813,5477,22.26694,24597
1157,0521ak47,1,0.00407,5478,22.27101,24597
1158,10ko,1,0.00407,5479,22.27507,24597
1159,34code,1,0.00407,5480,22.27914,24597
1160,9uill4ume,1,0.00407,5481,22.28321,24597
1161,a13x212,1,0.00407,5482,22.28727,24597
1162,aaroncline,1,0.00407,5483,22.29134,24597
1163,aarongable,1,0.00407,5484,22.29540,24597
1164,aaronkjones,1,0.00407,5485,22.29947,24597
1165,aaronrryan,1,0.00407,5486,22.30353,24597
1166,abh,1,0.00407,5487,22.30760,24597
1167,acaraion,1,0.00407,5488,22.31166,24597
1168,acehead,1,0.00407,5489,22.31573,24597
1169,acraw1,1,0.00407,5490,22.31980,24597
1170,adammartin,1,0.00407,5491,22.32386,24597
1171,adam-thg,1,0.00407,5492,22.32793,24597
1172,adamthomason,1,0.00407,5493,22.33199,24597
1173,adauhajre,1,0.00407,5494,22.33606,24597
1174,a-dawg,1,0.00407,5495,22.34012,24597
1175,addisonbair,1,0.00407,5496,22.34419,24597
1176,aded,1,0.00407,5497,22.34825,24597
1177,adinhodovic,1,0.00407,5498,22.35232,24597
1178,adirery,1,0.00407,5499,22.35638,24597
1179,adn77,1,0.00407,5500,22.36045,24597
1180,adnan-kamili,1,0.00407,5501,22.36452,24597
1181,AdrianRibao,1,0.00407,5502,22.36858,24597
1182,ad-si,1,0.00407,5503,22.37265,24597
1183,AechLyons,1,0.00407,5504,22.37671,24597
1184,agarzas,1,0.00407,5505,22.38078,24597
1185,agelwarg,1,0.00407,5506,22.38484,24597
1186,ahilsend,1,0.00407,5507,22.38891,24597
1187,aiman-alsari,1,0.00407,5508,22.39297,24597
1188,aitgelion,1,0.00407,5509,22.39704,24597
1189,ajcamilo,1,0.00407,5510,22.40111,24597
1190,ajcann,1,0.00407,5511,22.40517,24597
1191,ajpinedam,1,0.00407,5512,22.40924,24597
1192,akowasch,1,0.00407,5513,22.41330,24597
1193,aksharp12,1,0.00407,5514,22.41737,24597
1194,akshay27395,1,0.00407,5515,22.42143,24597
1195,aldemira,1,0.00407,5516,22.42550,24597
1196,Aleksion,1,0.00407,5517,22.42956,24597
1197,alex-berger,1,0.00407,5518,22.43363,24597
1198,alexstuckey,1,0.00407,5519,22.43770,24597
1199,AlexWootton,1,0.00407,5520,22.44176,24597
1200,alexzorin,1,0.00407,5521,22.44583,24597
1201,alfonzso,1,0.00407,5522,22.44989,24597
1202,Aliabbask08,1,0.00407,5523,22.45396,24597
1203,alialshamali,1,0.00407,5524,22.45802,24597
1204,alighm,1,0.00407,5525,22.46209,24597
1205,alikarimii,1,0.00407,5526,22.46615,24597
1206,alikhil,1,0.00407,5527,22.47022,24597
1207,AlirezaHaghshenas,1,0.00407,5528,22.47429,24597
1208,allansun,1,0.00407,5529,22.47835,24597
1209,allquantor,1,0.00407,5530,22.48242,24597
1210,alltho,1,0.00407,5531,22.48648,24597
1211,AlverezYari,1,0.00407,5532,22.49055,24597
1212,amasucci,1,0.00407,5533,22.49461,24597
1213,ameet-nandihal,1,0.00407,5534,22.49868,24597
1214,amirkazem1,1,0.00407,5535,22.50274,24597
1215,Amit-Salunke-02,1,0.00407,5536,22.50681,24597
1216,amon-ra,1,0.00407,5537,22.51088,24597
1217,ampedandwired,1,0.00407,5538,22.51494,24597
1218,anarsen,1,0.00407,5539,22.51901,24597
1219,anayochime,1,0.00407,5540,22.52307,24597
1220,andrew-cormick-dockery,1,0.00407,5541,22.52714,24597
1221,andrew-dovu,1,0.00407,5542,22.53120,24597
1222,AndrewFarley,1,0.00407,5543,22.53527,24597
1223,Andrewjeska,1,0.00407,5544,22.53933,24597
1224,andrewkaczynski,1,0.00407,5545,22.54340,24597
1225,angelnu,1,0.00407,5546,22.54747,24597
1226,anschoewe,1,0.00407,5547,22.55153,24597
1227,anthonyhaussman,1,0.00407,5548,22.55560,24597
1228,antimack,1,0.00407,5549,22.55966,24597
1229,antonkatz,1,0.00407,5550,22.56373,24597
1230,antst,1,0.00407,5551,22.56779,24597
1231,anyname2,1,0.00407,5552,22.57186,24597
1232,aparaschiv,1,0.00407,5553,22.57592,24597
1233,aperona-hai,1,0.00407,5554,22.57999,24597
1234,apjoseph,1,0.00407,5555,22.58405,24597
1235,apk27,1,0.00407,5556,22.58812,24597
1236,aplex,1,0.00407,5557,22.59219,24597
1237,APShirley,1,0.00407,5558,22.59625,24597
1238,artooro,1,0.00407,5559,22.60032,24597
1239,artpar,1,0.00407,5560,22.60438,24597
1240,aumanjoa,1,0.00407,5561,22.60845,24597
1241,avestuk,1,0.00407,5562,22.61251,24597
1242,avluis,1,0.00407,5563,22.61658,24597
1243,axeluhl,1,0.00407,5564,22.62064,24597
1244,ayyazzafar,1,0.00407,5565,22.62471,24597
1245,babadofar,1,0.00407,5566,22.62878,24597
1246,baddlan,1,0.00407,5567,22.63284,24597
1247,bansalrajat,1,0.00407,5568,22.63691,24597
1248,BaronKitten,1,0.00407,5569,22.64097,24597
1249,bartlettc22,1,0.00407,5570,22.64504,24597
1250,BartoszZawadzki,1,0.00407,5571,22.64910,24597
1251,Battochon,1,0.00407,5572,22.65317,24597
1252,bazouie,1,0.00407,5573,22.65723,24597
1253,bbenoist,1,0.00407,5574,22.66130,24597
1254,bdelville,1,0.00407,5575,22.66537,24597
1255,beebird,1,0.00407,5576,22.66943,24597
1256,BenCoughlan15,1,0.00407,5577,22.67350,24597
1257,benjefferies,1,0.00407,5578,22.67756,24597
1258,ben-turner,1,0.00407,5579,22.68163,24597
1259,beshkenadze,1,0.00407,5580,22.68569,24597
1260,bhagyas,1,0.00407,5581,22.68976,24597
1261,billabongrob,1,0.00407,5582,22.69382,24597
1262,biswarup1290dass,1,0.00407,5583,22.69789,24597
1263,bjin01,1,0.00407,5584,22.70196,24597
1264,blame19,1,0.00407,5585,22.70602,24597
1265,Blorby,1,0.00407,5586,22.71009,24597
1266,bmalynovytch,1,0.00407,5587,22.71415,24597
1267,bnoubiap1,1,0.00407,5588,22.71822,24597
1268,bobahspb,1,0.00407,5589,22.72228,24597
1269,bodom0015,1,0.00407,5590,22.72635,24597
1270,boesbo,1,0.00407,5591,22.73041,24597
1271,bollmann,1,0.00407,5592,22.73448,24597
1272,bondarewicz,1,0.00407,5593,22.73855,24597
1273,boogie4eva,1,0.00407,5594,22.74261,24597
1274,boopathykpm,1,0.00407,5595,22.74668,24597
1275,boosh,1,0.00407,5596,22.75074,24597
1276,bordenit,1,0.00407,5597,22.75481,24597
1277,boxboatjeremy,1,0.00407,5598,22.75887,24597
1278,boykom,1,0.00407,5599,22.76294,24597
1279,Bram-Zijp,1,0.00407,5600,22.76700,24597
1280,brettcat,1,0.00407,5601,22.77107,24597
1281,brettcurtis,1,0.00407,5602,22.77514,24597
1282,briananstett,1,0.00407,5603,22.77920,24597
1283,brianbaquiran,1,0.00407,5604,22.78327,24597
1284,brimstone,1,0.00407,5605,22.78733,24597
1285,brunnels,1,0.00407,5606,22.79140,24597
1286,brunovlucena,1,0.00407,5607,22.79546,24597
1287,bryancalvobenoit,1,0.00407,5608,22.79953,24597
1288,bryanhorstmann,1,0.00407,5609,22.80359,24597
1289,btwiuse,1,0.00407,5610,22.80766,24597
1290,BuckinghamIO,1,0.00407,5611,22.81173,24597
1291,BumwooPark,1,0.00407,5612,22.81579,24597
1292,busstram,1,0.00407,5613,22.81986,24597
1293,bvbek,1,0.00407,5614,22.82392,24597
1294,C123R,1,0.00407,5615,22.82799,24597
1295,c4m4,1,0.00407,5616,22.83205,24597
1296,cachak,1,0.00407,5617,22.83612,24597
1297,camille-rodriguez,1,0.00407,5618,22.84018,24597
1298,CanKattwinkel,1,0.00407,5619,22.84425,24597
1299,cannibal-kush,1,0.00407,5620,22.84831,24597
1300,CannibalKush,1,0.00407,5621,22.85238,24597
1301,Capitrium,1,0.00407,5622,22.85645,24597
1302,Carl4,1,0.00407,5623,22.86051,24597
1303,carlonoelle,1,0.00407,5624,22.86458,24597
1304,carlskii,1,0.00407,5625,22.86864,24597
1305,carvendy,1,0.00407,5626,22.87271,24597
1306,cdmadrigal,1,0.00407,5627,22.87677,24597
1307,ceenikc,1,0.00407,5628,22.88084,24597
1308,Cellebyte,1,0.00407,5629,22.88490,24597
1309,cerw,1,0.00407,5630,22.88897,24597
1310,chainhead,1,0.00407,5631,22.89304,24597
1311,chapa,1,0.00407,5632,22.89710,24597
1312,charlesakalugwu,1,0.00407,5633,22.90117,24597
1313,Charles-one,1,0.00407,5634,22.90523,24597
1314,chaudyg,1,0.00407,5635,22.90930,24597
1315,chauhanprateek89,1,0.00407,5636,22.91336,24597
1316,chekinah,1,0.00407,5637,22.91743,24597
1317,chengji77,1,0.00407,5638,22.92149,24597
1318,chenweiyj,1,0.00407,5639,22.92556,24597
1319,chenzhenyang,1,0.00407,5640,22.92963,24597
1320,chibbert,1,0.00407,5641,22.93369,24597
1321,chicken231,1,0.00407,5642,22.93776,24597
1322,chiju,1,0.00407,5643,22.94182,24597
1323,ChinmoyPadhi,1,0.00407,5644,22.94589,24597
1324,chinniehendrix,1,0.00407,5645,22.94995,24597
1325,chiquitawow,1,0.00407,5646,22.95402,24597
1326,choovick,1,0.00407,5647,22.95808,24597
1327,chris-altamimi,1,0.00407,5648,22.96215,24597
1328,chrisbulgaria,1,0.00407,5649,22.96622,24597
1329,chrisjsimpson,1,0.00407,5650,22.97028,24597
1330,chrismellard,1,0.00407,5651,22.97435,24597
1331,chrisplo,1,0.00407,5652,22.97841,24597
1332,chrono2002,1,0.00407,5653,22.98248,24597
1333,Ciantic,1,0.00407,5654,22.98654,24597
1334,cippaciong,1,0.00407,5655,22.99061,24597
1335,ckdarby,1,0.00407,5656,22.99467,24597
1336,claudiocleberson,1,0.00407,5657,22.99874,24597
1337,clement-mwendwa,1,0.00407,5658,23.00281,24597
1338,cloudify,1,0.00407,5659,23.00687,24597
1339,cmagorian,1,0.00407,5660,23.01094,24597
1340,cneumaier,1,0.00407,5661,23.01500,24597
1341,cobexer,1,0.00407,5662,23.01907,24597
1342,coinsummer,1,0.00407,5663,23.02313,24597
1343,colinwilson,1,0.00407,5664,23.02720,24597
1344,ColonelBundy,1,0.00407,5665,23.03126,24597
1345,ComeMaes,1,0.00407,5666,23.03533,24597
1346,comppaz,1,0.00407,5667,23.03940,24597
1347,crinjes,1,0.00407,5668,23.04346,24597
1348,cryptcoin-junkey,1,0.00407,5669,23.04753,24597
1349,cten,1,0.00407,5670,23.05159,24597
1350,cttttt,1,0.00407,5671,23.05566,24597
1351,cuchac,1,0.00407,5672,23.05972,24597
1352,cuotos,1,0.00407,5673,23.06379,24597
1353,cyriptix,1,0.00407,5674,23.06785,24597
1354,CzarMich,1,0.00407,5675,23.07192,24597
1355,daemon-thread,1,0.00407,5676,23.07598,24597
1356,dahovey,1,0.00407,5677,23.08005,24597
1357,dalssaso,1,0.00407,5678,23.08412,24597
1358,damack,1,0.00407,5679,23.08818,24597
1359,DanielFaria,1,0.00407,5680,23.09225,24597
1360,daniel-schulz,1,0.00407,5681,23.09631,24597
1361,danielslee,1,0.00407,5682,23.10038,24597
1362,danielstawiarski,1,0.00407,5683,23.10444,24597
1363,danilina-wsib,1,0.00407,5684,23.10851,24597
1364,danmassie,1,0.00407,5685,23.11257,24597
1365,dano0b,1,0.00407,5686,23.11664,24597
1366,danpe,1,0.00407,5687,23.12071,24597
1367,Danpiel,1,0.00407,5688,23.12477,24597
1368,danudeep90,1,0.00407,5689,23.12884,24597
1369,Dariusch,1,0.00407,5690,23.13290,24597
1370,darkn3rd,1,0.00407,5691,23.13697,24597
1371,darkyat,1,0.00407,5692,23.14103,24597
1372,darrylweaver,1,0.00407,5693,23.14510,24597
1373,darthcorsair,1,0.00407,5694,23.14916,24597
1374,darzanebor,1,0.00407,5695,23.15323,24597
1375,datagen24,1,0.00407,5696,23.15730,24597
1376,davgordo,1,0.00407,5697,23.16136,24597
1377,davidgolub,1,0.00407,5698,23.16543,24597
1378,Daynnnnn,1,0.00407,5699,23.16949,24597
1379,dbhagen,1,0.00407,5700,23.17356,24597
1380,dbpolito,1,0.00407,5701,23.17762,24597
1381,dcardozoo,1,0.00407,5702,23.18169,24597
1382,dchw,1,0.00407,5703,23.18575,24597
1383,dcrdev,1,0.00407,5704,23.18982,24597
1384,DeamonMV,1,0.00407,5705,23.19389,24597
1385,debanjanbasu,1,0.00407,5706,23.19795,24597
1386,degivan,1,0.00407,5707,23.20202,24597
1387,dehypnosis,1,0.00407,5708,23.20608,24597
1388,Depado,1,0.00407,5709,23.21015,24597
1389,deploymentking,1,0.00407,5710,23.21421,24597
1390,derdanu,1,0.00407,5711,23.21828,24597
1391,derekrprice,1,0.00407,5712,23.22234,24597
1392,deshetti,1,0.00407,5713,23.22641,24597
1393,devfans,1,0.00407,5714,23.23048,24597
1394,devnore,1,0.00407,5715,23.23454,24597
1395,DevOpsCaliberstrong,1,0.00407,5716,23.23861,24597
1396,dguettler,1,0.00407,5717,23.24267,24597
1397,dgunjetti,1,0.00407,5718,23.24674,24597
1398,dhiman-git,1,0.00407,5719,23.25080,24597
1399,dhirenshumsher,1,0.00407,5720,23.25487,24597
1400,dhuesmann89,1,0.00407,5721,23.25893,24597
1401,diegodorgam,1,0.00407,5722,23.26300,24597
1402,diegodurante,1,0.00407,5723,23.26707,24597
1403,diego-ojeda-binbash,1,0.00407,5724,23.27113,24597
1404,DiegoPomares,1,0.00407,5725,23.27520,24597
1405,dineshgupta04,1,0.00407,5726,23.27926,24597
1406,dkmbw,1,0.00407,5727,23.28333,24597
1407,dladlk,1,0.00407,5728,23.28739,24597
1408,d-mcd,1,0.00407,5729,23.29146,24597
1409,dng-dev,1,0.00407,5730,23.29552,24597
1410,dnmgns,1,0.00407,5731,23.29959,24597
1411,dogfish182,1,0.00407,5732,23.30365,24597
1412,domagoj03,1,0.00407,5733,23.30772,24597
1413,donutloop,1,0.00407,5734,23.31179,24597
1414,DoryZi,1,0.00407,5735,23.31585,24597
1415,dotw,1,0.00407,5736,23.31992,24597
1416,doubleo46,1,0.00407,5737,23.32398,24597
1417,d-Pixie,1,0.00407,5738,23.32805,24597
1418,drGrove,1,0.00407,5739,23.33211,24597
1419,dr-shim,1,0.00407,5740,23.33618,24597
1420,drweber,1,0.00407,5741,23.34024,24597
1421,Dryymoon,1,0.00407,5742,23.34431,24597
1422,duzy,1,0.00407,5743,23.34838,24597
1423,dvdblk,1,0.00407,5744,23.35244,24597
1424,DWonMtl,1,0.00407,5745,23.35651,24597
1425,Dylan-DutchAndBold,1,0.00407,5746,23.36057,24597
1426,eaba,1,0.00407,5747,23.36464,24597
1427,Earl-wang,1,0.00407,5748,23.36870,24597
1428,easyhash,1,0.00407,5749,23.37277,24597
1429,ebcarty,1,0.00407,5750,23.37683,24597
1430,edalford11,1,0.00407,5751,23.38090,24597
1431,edillmann,1,0.00407,5752,23.38497,24597
1432,edshelton,1,0.00407,5753,23.38903,24597
1433,eduardorn,1,0.00407,5754,23.39310,24597
1434,EgorkZe,1,0.00407,5755,23.39716,24597
1435,ekryski,1,0.00407,5756,23.40123,24597
1436,elbaro,1,0.00407,5757,23.40529,24597
1437,Elettronik,1,0.00407,5758,23.40936,24597
1438,elkh510,1,0.00407,5759,23.41342,24597
1439,elliot-resdiary,1,0.00407,5760,23.41749,24597
1440,elmariofredo,1,0.00407,5761,23.42156,24597
1441,elonzh,1,0.00407,5762,23.42562,24597
1442,elsbrock,1,0.00407,5763,23.42969,24597
1443,else,1,0.00407,5764,23.43375,24597
1444,emichaf,1,0.00407,5765,23.43782,24597
1445,emilyzhang,1,0.00407,5766,23.44188,24597
1446,endocrimes,1,0.00407,5767,23.44595,24597
1447,EntrepreneurAJ,1,0.00407,5768,23.45001,24597
1448,EqbalS,1,0.00407,5769,23.45408,24597
1449,er230059,1,0.00407,5770,23.45815,24597
1450,ericflo,1,0.00407,5771,23.46221,24597
1451,eric-silverman,1,0.00407,5772,23.46628,24597
1452,ernsheong,1,0.00407,5773,23.47034,24597
1453,eroteme,1,0.00407,5774,23.47441,24597
1454,esbencarlsen,1,0.00407,5775,23.47847,24597
1455,esheris,1,0.00407,5776,23.48254,24597
1456,estambakio-sc,1,0.00407,5777,23.48660,24597
1457,estheban,1,0.00407,5778,23.49067,24597
1458,EternalDeiwos,1,0.00407,5779,23.49474,24597
1459,etiennejournet,1,0.00407,5780,23.49880,24597
1460,evan-eb,1,0.00407,5781,23.50287,24597
1461,eviatarkhen,1,0.00407,5782,23.50693,24597
1462,expz,1,0.00407,5783,23.51100,24597
1463,F1nZeR,1,0.00407,5784,23.51506,24597
1464,fabiocarneiro,1,0.00407,5785,23.51913,24597
1465,fabiorauber,1,0.00407,5786,23.52319,24597
1466,FabriceMk,1,0.00407,5787,23.52726,24597
1467,fairlight12,1,0.00407,5788,23.53132,24597
1468,falcoriss,1,0.00407,5789,23.53539,24597
1469,fanfei93,1,0.00407,5790,23.53946,24597
1470,fbuser1,1,0.00407,5791,23.54352,24597
1471,federicopuntoni,1,0.00407,5792,23.54759,24597
1472,feichaohao,1,0.00407,5793,23.55165,24597
1473,feniix,1,0.00407,5794,23.55572,24597
1474,fiberoptic89,1,0.00407,5795,23.55978,24597
1475,fionera,1,0.00407,5796,23.56385,24597
1476,FischlerA,1,0.00407,5797,23.56791,24597
1477,fizzyduck,1,0.00407,5798,23.57198,24597
1478,floriansiepe,1,0.00407,5799,23.57605,24597
1479,fmasion,1,0.00407,5800,23.58011,24597
1480,foosinn,1,0.00407,5801,23.58418,24597
1481,fr34kyn01535,1,0.00407,5802,23.58824,24597
1482,fradeve,1,0.00407,5803,23.59231,24597
1483,frasern,1,0.00407,5804,23.59637,24597
1484,Frederik-Baetens,1,0.00407,5805,23.60044,24597
1485,freedomofkeima,1,0.00407,5806,23.60450,24597
1486,freswa,1,0.00407,5807,23.60857,24597
1487,frosch95,1,0.00407,5808,23.61264,24597
1488,fuine6,1,0.00407,5809,23.61670,24597
1489,furby,1,0.00407,5810,23.62077,24597
1490,g4s8,1,0.00407,5811,23.62483,24597
1491,gabomgp,1,0.00407,5812,23.62890,24597
1492,gabzim,1,0.00407,5813,23.63296,24597
1493,gaelleiadvize,1,0.00407,5814,23.63703,24597
1494,gak10100,1,0.00407,5815,23.64109,24597
1495,garciapd,1,0.00407,5816,23.64516,24597
1496,gargamile,1,0.00407,5817,23.64923,24597
1497,garrettlancaster,1,0.00407,5818,23.65329,24597
1498,gaurav-ackotech,1,0.00407,5819,23.65736,24597
1499,gbonnefille,1,0.00407,5820,23.66142,24597
1500,gcamus59,1,0.00407,5821,23.66549,24597
1501,gd-jroberts,1,0.00407,5822,23.66955,24597
1502,GeniyX,1,0.00407,5823,23.67362,24597
1503,georgekaz,1,0.00407,5824,23.67768,24597
1504,george-oakling,1,0.00407,5825,23.68175,24597
1505,get2arun,1,0.00407,5826,23.68582,24597
1506,ggilley,1,0.00407,5827,23.68988,24597
1507,ggrames,1,0.00407,5828,23.69395,24597
1508,giacomopastore,1,0.00407,5829,23.69801,24597
1509,gitrc,1,0.00407,5830,23.70208,24597
1510,giuscri,1,0.00407,5831,23.70614,24597
1511,GiviMAD,1,0.00407,5832,23.71021,24597
1512,Gjonni,1,0.00407,5833,23.71427,24597
1513,gocreating,1,0.00407,5834,23.71834,24597
1514,gonstr,1,0.00407,5835,23.72241,24597
1515,gopikishanm,1,0.00407,5836,23.72647,24597
1516,gpusker,1,0.00407,5837,23.73054,24597
1517,GrandChaman,1,0.00407,5838,23.73460,24597
1518,gregorylony,1,0.00407,5839,23.73867,24597
1519,Grishas,1,0.00407,5840,23.74273,24597
1520,gubik89,1,0.00407,5841,23.74680,24597
1521,GuillaumeCisco,1,0.00407,5842,23.75086,24597
1522,GustavoAmerico,1,0.00407,5843,23.75493,24597
1523,gvuyk,1,0.00407,5844,23.75899,24597
1524,gzzchh,1,0.00407,5845,23.76306,24597
1525,hacktron95,1,0.00407,5846,23.76713,24597
1526,hadifarnoud,1,0.00407,5847,23.77119,24597
1527,hafizullah,1,0.00407,5848,23.77526,24597
1528,hamishforbes,1,0.00407,5849,23.77932,24597
1529,hanzvanaardt,1,0.00407,5850,23.78339,24597
1530,happycoder86,1,0.00407,5851,23.78745,24597
1531,hasusuf,1,0.00407,5852,23.79152,24597
1532,HazemElAgaty,1,0.00407,5853,23.79558,24597
1533,hedenface,1,0.00407,5854,23.79965,24597
1534,heiqs,1,0.00407,5855,23.80372,24597
1535,helcorin,1,0.00407,5856,23.80778,24597
1536,heldtogether,1,0.00407,5857,23.81185,24597
1537,Hello-Linux,1,0.00407,5858,23.81591,24597
1538,hermanmejang10,1,0.00407,5859,23.81998,24597
1539,Herr-Sepp,1,0.00407,5860,23.82404,24597
1540,hetii,1,0.00407,5861,23.82811,24597
1541,hfuss,1,0.00407,5862,23.83217,24597
1542,hijak,1,0.00407,5863,23.83624,24597
1543,Hild-Franck,1,0.00407,5864,23.84031,24597
1544,hmacias,1,0.00407,5865,23.84437,24597
1545,hoangmnsd,1,0.00407,5866,23.84844,24597
1546,hping2,1,0.00407,5867,23.85250,24597
1547,hvaoc,1,0.00407,5868,23.85657,24597
1548,hyperfocus1337,1,0.00407,5869,23.86063,24597
1549,iancmcmahon,1,0.00407,5870,23.86470,24597
1550,ianks,1,0.00407,5871,23.86876,24597
1551,ibottamike,1,0.00407,5872,23.87283,24597
1552,icode,1,0.00407,5873,23.87690,24597
1553,idarnius,1,0.00407,5874,23.88096,24597
1554,iershovnsk,1,0.00407,5875,23.88503,24597
1555,ij3net,1,0.00407,5876,23.88909,24597
1556,ilia-anastasov,1,0.00407,5877,23.89316,24597
1557,Imccccc,1,0.00407,5878,23.89722,24597
1558,imkane,1,0.00407,5879,23.90129,24597
1559,InamAli144,1,0.00407,5880,23.90535,24597
1560,incogniro,1,0.00407,5881,23.90942,24597
1561,insekticid,1,0.00407,5882,23.91349,24597
1562,instantlinux,1,0.00407,5883,23.91755,24597
1563,intentc,1,0.00407,5884,23.92162,24597
1564,ioben,1,0.00407,5885,23.92568,24597
1565,iosifnicolae2,1,0.00407,5886,23.92975,24597
1566,irizzant,1,0.00407,5887,23.93381,24597
1567,isamuelson,1,0.00407,5888,23.93788,24597
1568,itisevgeny,1,0.00407,5889,23.94194,24597
1569,iusergii,1,0.00407,5890,23.94601,24597
1570,ivanboykoatitv,1,0.00407,5891,23.95008,24597
1571,ivan-gusev,1,0.00407,5892,23.95414,24597
1572,IvanJosipovic,1,0.00407,5893,23.95821,24597
1573,ivan-sirosh,1,0.00407,5894,23.96227,24597
1574,iyacontrol,1,0.00407,5895,23.96634,24597
1575,Izopi4a,1,0.00407,5896,23.97040,24597
1576,jacktar283,1,0.00407,5897,23.97447,24597
1577,Jacob1r,1,0.00407,5898,23.97853,24597
1578,jacobstr,1,0.00407,5899,23.98260,24597
1579,jahutton,1,0.00407,5900,23.98667,24597
1580,jakobhostnik,1,0.00407,5901,23.99073,24597
1581,jakoblindqvist,1,0.00407,5902,23.99480,24597
1582,jakupovic,1,0.00407,5903,23.99886,24597
1583,JamesGuthrie,1,0.00407,5904,24.00293,24597
1584,james-pellow,1,0.00407,5905,24.00699,24597
1585,jamessthompson,1,0.00407,5906,24.01106,24597
1586,JannikZed,1,0.00407,5907,24.01512,24597
1587,JanVoracek,1,0.00407,5908,24.01919,24597
1588,janwout,1,0.00407,5909,24.02325,24597
1589,Jarlotee,1,0.00407,5910,24.02732,24597
1590,jarpsimoes,1,0.00407,5911,24.03139,24597
1591,jasonodonnell,1,0.00407,5912,24.03545,24597
1592,javiertoledos,1,0.00407,5913,24.03952,24597
1593,jbg,1,0.00407,5914,24.04358,24597
1594,jbiel,1,0.00407,5915,24.04765,24597
1595,jbonnett92,1,0.00407,5916,24.05171,24597
1596,jcassee,1,0.00407,5917,24.05578,24597
1597,jc-delvalle,1,0.00407,5918,24.05984,24597
1598,jceresini,1,0.00407,5919,24.06391,24597
1599,jdschmidt,1,0.00407,5920,24.06798,24597
1600,jdstone-ig,1,0.00407,5921,24.07204,24597
1601,jdw2465,1,0.00407,5922,24.07611,24597
1602,jeff-h,1,0.00407,5923,24.08017,24597
1603,jemc,1,0.00407,5924,24.08424,24597
1604,JeroenAppel,1,0.00407,5925,24.08830,24597
1605,jfoechsler,1,0.00407,5926,24.09237,24597
1606,jfpucheu,1,0.00407,5927,24.09643,24597
1607,jgrigg2017,1,0.00407,5928,24.10050,24597
1608,jhnferraris,1,0.00407,5929,24.10457,24597
1609,jhonore,1,0.00407,5930,24.10863,24597
1610,jhselvik,1,0.00407,5931,24.11270,24597
1611,jianglin1008,1,0.00407,5932,24.11676,24597
1612,jimmythedog,1,0.00407,5933,24.12083,24597
1613,jjtroberts,1,0.00407,5934,24.12489,24597
1614,JJWTimmer,1,0.00407,5935,24.12896,24597
1615,jlpedrosa,1,0.00407,5936,24.13302,24597
1616,jmg87,1,0.00407,5937,24.13709,24597
1617,jocarren,1,0.00407,5938,24.14116,24597
1618,jocelynaladin,1,0.00407,5939,24.14522,24597
1619,Joeasaurus,1,0.00407,5940,24.14929,24597
1620,JoelOtter,1,0.00407,5941,24.15335,24597
1621,joerayme,1,0.00407,5942,24.15742,24597
1622,johan-lejdung,1,0.00407,5943,24.16148,24597
1623,JohnAdamsy,1,0.00407,5944,24.16555,24597
1624,JohnGalt1717,1,0.00407,5945,24.16961,24597
1625,johnkoyle,1,0.00407,5946,24.17368,24597
1626,Joker9050,1,0.00407,5947,24.17775,24597
1627,jonathan-graf,1,0.00407,5948,24.18181,24597
1628,jonathanjfshaw,1,0.00407,5949,24.18588,24597
1629,joncak,1,0.00407,5950,24.18994,24597
1630,jonfasking,1,0.00407,5951,24.19401,24597
1631,joostmeijles,1,0.00407,5952,24.19807,24597
1632,jopfeffe,1,0.00407,5953,24.20214,24597
1633,Josbrafe,1,0.00407,5954,24.20620,24597
1634,JoshDaone,1,0.00407,5955,24.21027,24597
1635,joshnewlinatclearobject,1,0.00407,5956,24.21434,24597
1636,jozuenoon,1,0.00407,5957,24.21840,24597
1637,jpfaria,1,0.00407,5958,24.22247,24597
1638,jplfp,1,0.00407,5959,24.22653,24597
1639,jr0d,1,0.00407,5960,24.23060,24597
1640,jrissler,1,0.00407,5961,24.23466,24597
1641,jrudley,1,0.00407,5962,24.23873,24597
1642,jsangco,1,0.00407,5963,24.24279,24597
1643,jSanthosh6,1,0.00407,5964,24.24686,24597
1644,julian7,1,0.00407,5965,24.25092,24597
1645,julienfig,1,0.00407,5966,24.25499,24597
1646,julienvincent,1,0.00407,5967,24.25906,24597
1647,just1689,1,0.00407,5968,24.26312,24597
1648,justinas-b,1,0.00407,5969,24.26719,24597
1649,JustinHead,1,0.00407,5970,24.27125,24597
1650,JustinPlute,1,0.00407,5971,24.27532,24597
1651,juwalter,1,0.00407,5972,24.27938,24597
1652,JVMartin,1,0.00407,5973,24.28345,24597
1653,jwietelmann,1,0.00407,5974,24.28751,24597
1654,kaceo,1,0.00407,5975,24.29158,24597
1655,kaelzhang,1,0.00407,5976,24.29565,24597
1656,kamelbouzizadz,1,0.00407,5977,24.29971,24597
1657,Kamshak,1,0.00407,5978,24.30378,24597
1658,Kansuler,1,0.00407,5979,24.30784,24597
1659,kasisnu,1,0.00407,5980,24.31191,24597
1660,katcheLS,1,0.00407,5981,24.31597,24597
1661,kautkata,1,0.00407,5982,24.32004,24597
1662,k-ayache,1,0.00407,5983,24.32410,24597
1663,kazu,1,0.00407,5984,24.32817,24597
1664,kbirkeland,1,0.00407,5985,24.33224,24597
1665,kbruner,1,0.00407,5986,24.33630,24597
1666,kcatro,1,0.00407,5987,24.34037,24597
1667,kcranston,1,0.00407,5988,24.34443,24597
1668,kdougl,1,0.00407,5989,24.34850,24597
1669,keithlayne,1,0.00407,5990,24.35256,24597
1670,kelvin-yue-scmp,1,0.00407,5991,24.35663,24597
1671,kergeodeta,1,0.00407,5992,24.36069,24597
1672,kesse,1,0.00407,5993,24.36476,24597
1673,kevinchiuwsib,1,0.00407,5994,24.36883,24597
1674,kevinohara80,1,0.00407,5995,24.37289,24597
1675,k-grant,1,0.00407,5996,24.37696,24597
1676,kheraud,1,0.00407,5997,24.38102,24597
1677,khteh,1,0.00407,5998,24.38509,24597
1678,KimGressens,1,0.00407,5999,24.38915,24597
1679,kim-sardine,1,0.00407,6000,24.39322,24597
1680,kina4smile,1,0.00407,6001,24.39728,24597
1681,kinghrothgar,1,0.00407,6002,24.40135,24597
1682,kishankumar05,1,0.00407,6003,24.40542,24597
1683,kiwiidb,1,0.00407,6004,24.40948,24597
1684,kizurazgubai,1,0.00407,6005,24.41355,24597
1685,kjarri,1,0.00407,6006,24.41761,24597
1686,kjedamzik,1,0.00407,6007,24.42168,24597
1687,kkorada,1,0.00407,6008,24.42574,24597
1688,kkwojc,1,0.00407,6009,24.42981,24597
1689,kmai,1,0.00407,6010,24.43387,24597
1690,knaitas,1,0.00407,6011,24.43794,24597
1691,knlambert,1,0.00407,6012,24.44201,24597
1692,kojidev,1,0.00407,6013,24.44607,24597
1693,koliyo,1,0.00407,6014,24.45014,24597
1694,konrad-garus,1,0.00407,6015,24.45420,24597
1695,korkeat,1,0.00407,6016,24.45827,24597
1696,koustubh25,1,0.00407,6017,24.46233,24597
1697,Krishna1408,1,0.00407,6018,24.46640,24597
1698,krishofmans,1,0.00407,6019,24.47046,24597
1699,kriston13,1,0.00407,6020,24.47453,24597
1700,krjackso,1,0.00407,6021,24.47859,24597
1701,krumware,1,0.00407,6022,24.48266,24597
1702,k-spit,1,0.00407,6023,24.48673,24597
1703,ksummersill2,1,0.00407,6024,24.49079,24597
1704,kubaracek,1,0.00407,6025,24.49486,24597
1705,Kugelschieber,1,0.00407,6026,24.49892,24597
1706,kurkowskik,1,0.00407,6027,24.50299,24597
1707,Kusumoto,1,0.00407,6028,24.50705,24597
1708,kwilczek,1,0.00407,6029,24.51112,24597
1709,kz12123,1,0.00407,6030,24.51518,24597
1710,lainra,1,0.00407,6031,24.51925,24597
1711,lakano,1,0.00407,6032,24.52332,24597
1712,lambchr,1,0.00407,6033,24.52738,24597
1713,lbialy,1,0.00407,6034,24.53145,24597
1714,l-e-e-o,1,0.00407,6035,24.53551,24597
1715,Legym,1,0.00407,6036,24.53958,24597
1716,LEI,1,0.00407,6037,24.54364,24597
1717,leonboot,1,0.00407,6038,24.54771,24597
1718,LeoVerto,1,0.00407,6039,24.55177,24597
1719,lewisdiamond,1,0.00407,6040,24.55584,24597
1720,lhzbxx,1,0.00407,6041,24.55991,24597
1721,liejuntao001,1,0.00407,6042,24.56397,24597
1722,lightswitch05,1,0.00407,6043,24.56804,24597
1723,lilvinz,1,0.00407,6044,24.57210,24597
1724,linuxmail,1,0.00407,6045,24.57617,24597
1725,liujianping,1,0.00407,6046,24.58023,24597
1726,liviudm,1,0.00407,6047,24.58430,24597
1727,lkoba,1,0.00407,6048,24.58836,24597
1728,llivingstone,1,0.00407,6049,24.59243,24597
1729,lober-io,1,0.00407,6050,24.59650,24597
1730,loganmzz,1,0.00407,6051,24.60056,24597
1731,looping-18,1,0.00407,6052,24.60463,24597
1732,LouisKottmann,1,0.00407,6053,24.60869,24597
1733,lrosa007,1,0.00407,6054,24.61276,24597
1734,lsde,1,0.00407,6055,24.61682,24597
1735,lucasantarella,1,0.00407,6056,24.62089,24597
1736,lucasces,1,0.00407,6057,24.62495,24597
1737,lucascollino,1,0.00407,6058,24.62902,24597
1738,lucasilverentand,1,0.00407,6059,24.63309,24597
1739,lucax88x,1,0.00407,6060,24.63715,24597
1740,lucduong,1,0.00407,6061,24.64122,24597
1741,lucernae,1,0.00407,6062,24.64528,24597
1742,lucidqdreams,1,0.00407,6063,24.64935,24597
1743,lucpolak,1,0.00407,6064,24.65341,24597
1744,luislhl,1,0.00407,6065,24.65748,24597
1745,lukas-alliado,1,0.00407,6066,24.66154,24597
1746,lukas-zech-software,1,0.00407,6067,24.66561,24597
1747,lukeab,1,0.00407,6068,24.66968,24597
1748,lukeschlather,1,0.00407,6069,24.67374,24597
1749,luwang-vmware,1,0.00407,6070,24.67781,24597
1750,luxflux,1,0.00407,6071,24.68187,24597
1751,macanud0,1,0.00407,6072,24.68594,24597
1752,macevil,1,0.00407,6073,24.69000,24597
1753,macroramesh6,1,0.00407,6074,24.69407,24597
1754,mactr0n,1,0.00407,6075,24.69813,24597
1755,maikelpoot,1,0.00407,6076,24.70220,24597
1756,maishiroma,1,0.00407,6077,24.70626,24597
1757,Majorem,1,0.00407,6078,24.71033,24597
1758,MakG10,1,0.00407,6079,24.71440,24597
1759,makomatic,1,0.00407,6080,24.71846,24597
1760,makuhama,1,0.00407,6081,24.72253,24597
1761,Malikiah,1,0.00407,6082,24.72659,24597
1762,mandelsoft,1,0.00407,6083,24.73066,24597
1763,mandrepont,1,0.00407,6084,24.73472,24597
1764,manhvc,1,0.00407,6085,24.73879,24597
1765,manojit123,1,0.00407,6086,24.74285,24597
1766,marcelfalliere,1,0.00407,6087,24.74692,24597
1767,MarcelMichau,1,0.00407,6088,24.75099,24597
1768,MarcelT-NL,1,0.00407,6089,24.75505,24597
1769,marcoam,1,0.00407,6090,24.75912,24597
1770,marekr,1,0.00407,6091,24.76318,24597
1771,margach,1,0.00407,6092,24.76725,24597
1772,mariusmarais,1,0.00407,6093,24.77131,24597
1773,markhorrocks,1,0.00407,6094,24.77538,24597
1774,markhu,1,0.00407,6095,24.77944,24597
1775,marklee77,1,0.00407,6096,24.78351,24597
1776,marshall007,1,0.00407,6097,24.78758,24597
1777,martin31821,1,0.00407,6098,24.79164,24597
1778,martinkubrak,1,0.00407,6099,24.79571,24597
1779,martinnaughton,1,0.00407,6100,24.79977,24597
1780,marvel-vella,1,0.00407,6101,24.80384,24597
1781,mastrauckas,1,0.00407,6102,24.80790,24597
1782,matfiz,1,0.00407,6103,24.81197,24597
1783,matheus666matheus,1,0.00407,6104,24.81603,24597
1784,mathias-ewald,1,0.00407,6105,24.82010,24597
1785,matthew-muscat,1,0.00407,6106,24.82417,24597
1786,mattiasewers,1,0.00407,6107,24.82823,24597
1787,mavrick,1,0.00407,6108,24.83230,24597
1788,maxdaniel98,1,0.00407,6109,24.83636,24597
1789,Mayuraggarwal1992,1,0.00407,6110,24.84043,24597
1790,mcabrito,1,0.00407,6111,24.84449,24597
1791,mcambal,1,0.00407,6112,24.84856,24597
1792,mcanaves,1,0.00407,6113,24.85262,24597
1793,McSpace,1,0.00407,6114,24.85669,24597
1794,mdaly001,1,0.00407,6115,24.86076,24597
1795,mdxooa,1,0.00407,6116,24.86482,24597
1796,medined,1,0.00407,6117,24.86889,24597
1797,meirhazon2,1,0.00407,6118,24.87295,24597
1798,mercantiandrea,1,0.00407,6119,24.87702,24597
1799,mesouug,1,0.00407,6120,24.88108,24597
1800,Mexxerio,1,0.00407,6121,24.88515,24597
1801,mhamann,1,0.00407,6122,24.88921,24597
1802,michaelburch,1,0.00407,6123,24.89328,24597
1803,MichelFR,1,0.00407,6124,24.89735,24597
1804,Michiel-s,1,0.00407,6125,24.90141,24597
1805,MikeBlomm,1,0.00407,6126,24.90548,24597
1806,mikemaxey,1,0.00407,6127,24.90954,24597
1807,mikhail-yarosh,1,0.00407,6128,24.91361,24597
1808,mikt,1,0.00407,6129,24.91767,24597
1809,milesalex,1,0.00407,6130,24.92174,24597
1810,milkeryildirim,1,0.00407,6131,24.92580,24597
1811,miono,1,0.00407,6132,24.92987,24597
1812,mirage2012,1,0.00407,6133,24.93394,24597
1813,misiektoja,1,0.00407,6134,24.93800,24597
1814,mixollm94,1,0.00407,6135,24.94207,24597
1815,mkxxq,1,0.00407,6136,24.94613,24597
1816,mmorhun,1,0.00407,6137,24.95020,24597
1817,mnkg561,1,0.00407,6138,24.95426,24597
1818,mnordhoff,1,0.00407,6139,24.95833,24597
1819,mo,1,0.00407,6140,24.96239,24597
1820,mohamedalaa33,1,0.00407,6141,24.96646,24597
1821,Mohit049,1,0.00407,6142,24.97052,24597
1822,mokhos,1,0.00407,6143,24.97459,24597
1823,molinch,1,0.00407,6144,24.97866,24597
1824,monaka-hashhub,1,0.00407,6145,24.98272,24597
1825,moomzni,1,0.00407,6146,24.98679,24597
1826,morgoved,1,0.00407,6147,24.99085,24597
1827,moritz31,1,0.00407,6148,24.99492,24597
1828,moss2k13,1,0.00407,6149,24.99898,24597
1829,mous2890,1,0.00407,6150,25.00305,24597
1830,mpetason,1,0.00407,6151,25.00711,24597
1831,mprigge,1,0.00407,6152,25.01118,24597
1832,MrApe,1,0.00407,6153,25.01525,24597
1833,mraqkhan,1,0.00407,6154,25.01931,24597
1834,MrBlaise,1,0.00407,6155,25.02338,24597
1835,mr-smithers-excellent,1,0.00407,6156,25.02744,24597
1836,MSandro,1,0.00407,6157,25.03151,24597
1837,mshorrosh,1,0.00407,6158,25.03557,24597
1838,mslonli,1,0.00407,6159,25.03964,24597
1839,MTCoster,1,0.00407,6160,25.04370,24597
1840,mtneug,1,0.00407,6161,25.04777,24597
1841,muffinrecon,1,0.00407,6162,25.05184,24597
1842,mwthink,1,0.00407,6163,25.05590,24597
1843,nadilas,1,0.00407,6164,25.05997,24597
1844,naineel,1,0.00407,6165,25.06403,24597
1845,nchowinf,1,0.00407,6166,25.06810,24597
1846,necevil,1,0.00407,6167,25.07216,24597
1847,neilmfrench,1,0.00407,6168,25.07623,24597
1848,neszt,1,0.00407,6169,25.08029,24597
1849,ngo275,1,0.00407,6170,25.08436,24597
1850,ngv-egt,1,0.00407,6171,25.08843,24597
1851,nicholas-littlelives,1,0.00407,6172,25.09249,24597
1852,niclarcipretti,1,0.00407,6173,25.09656,24597
1853,nico282,1,0.00407,6174,25.10062,24597
1854,nicolaspascual,1,0.00407,6175,25.10469,24597
1855,nicolls1,1,0.00407,6176,25.10875,24597
1856,nielskrijger,1,0.00407,6177,25.11282,24597
1857,nigh8w0lf,1,0.00407,6178,25.11688,24597
1858,nikhileshva,1,0.00407,6179,25.12095,24597
1859,niteshagrawalgmail,1,0.00407,6180,25.12502,24597
1860,nithinkd-geon,1,0.00407,6181,25.12908,24597
1861,njyeti,1,0.00407,6182,25.13315,24597
1862,nlopez,1,0.00407,6183,25.13721,24597
1863,nmammeri,1,0.00407,6184,25.14128,24597
1864,nolmit,1,0.00407,6185,25.14534,24597
1865,notdsk,1,0.00407,6186,25.14941,24597
1866,npurdy-tyro,1,0.00407,6187,25.15347,24597
1867,nsrvs,1,0.00407,6188,25.15754,24597
1868,nvpnathan,1,0.00407,6189,25.16161,24597
1869,nyjan,1,0.00407,6190,25.16567,24597
1870,oanogin,1,0.00407,6191,25.16974,24597
1871,odysseas,1,0.00407,6192,25.17380,24597
1872,oesah,1,0.00407,6193,25.17787,24597
1873,Oldervoll,1,0.00407,6194,25.18193,24597
1874,oliverkane,1,0.00407,6195,25.18600,24597
1875,ollystephens,1,0.00407,6196,25.19006,24597
1876,onmyflow,1,0.00407,6197,25.19413,24597
1877,oracle3987,1,0.00407,6198,25.19819,24597
1878,orefalo,1,0.00407,6199,25.20226,24597
1879,orian,1,0.00407,6200,25.20633,24597
1880,orphaner,1,0.00407,6201,25.21039,24597
1881,ovidiubuligan,1,0.00407,6202,25.21446,24597
1882,oxyii,1,0.00407,6203,25.21852,24597
1883,oxynux,1,0.00407,6204,25.22259,24597
1884,Oznup,1,0.00407,6205,25.22665,24597
1885,pabens,1,0.00407,6206,25.23072,24597
1886,pabloli84,1,0.00407,6207,25.23478,24597
1887,pacroy,1,0.00407,6208,25.23885,24597
1888,pag-r,1,0.00407,6209,25.24292,24597
1889,Pantelispanka,1,0.00407,6210,25.24698,24597
1890,Patafix,1,0.00407,6211,25.25105,24597
1891,patsadow2,1,0.00407,6212,25.25511,24597
1892,paulternate,1,0.00407,6213,25.25918,24597
1893,pbradly,1,0.00407,6214,25.26324,24597
1894,pdorbaisdkt,1,0.00407,6215,25.26731,24597
1895,pedrorochaorg,1,0.00407,6216,25.27137,24597
1896,PeopleRange,1,0.00407,6217,25.27544,24597
1897,Perfect-Web,1,0.00407,6218,25.27951,24597
1898,perosb,1,0.00407,6219,25.28357,24597
1899,perspectivus1,1,0.00407,6220,25.28764,24597
1900,PeteMac88,1,0.00407,6221,25.29170,24597
1901,petenorth,1,0.00407,6222,25.29577,24597
1902,pgold30,1,0.00407,6223,25.29983,24597
1903,PHameete,1,0.00407,6224,25.30390,24597
1904,philios33,1,0.00407,6225,25.30796,24597
1905,philipp1992,1,0.00407,6226,25.31203,24597
1906,philpearl,1,0.00407,6227,25.31610,24597
1907,philsparrow,1,0.00407,6228,25.32016,24597
1908,phires,1,0.00407,6229,25.32423,24597
1909,pimvanpelt,1,0.00407,6230,25.32829,24597
1910,PiotrJander,1,0.00407,6231,25.33236,24597
1911,pipejiva,1,0.00407,6232,25.33642,24597
1912,pirtoo,1,0.00407,6233,25.34049,24597
1913,pixie79,1,0.00407,6234,25.34455,24597
1914,pjoe,1,0.00407,6235,25.34862,24597
1915,polds,1,0.00407,6236,25.35269,24597
1916,ponderMuse,1,0.00407,6237,25.35675,24597
1917,PowerDos,1,0.00407,6238,25.36082,24597
1918,ppumkin,1,0.00407,6239,25.36488,24597
1919,prabhatnagpal,1,0.00407,6240,25.36895,24597
1920,prakash360,1,0.00407,6241,25.37301,24597
1921,Prasadwani,1,0.00407,6242,25.37708,24597
1922,prashanthr,1,0.00407,6243,25.38114,24597
1923,prashantthakre,1,0.00407,6244,25.38521,24597
1924,prince-code,1,0.00407,6245,25.38928,24597
1925,PSanetra,1,0.00407,6246,25.39334,24597
1926,pstackle,1,0.00407,6247,25.39741,24597
1927,PSTobiasMueller,1,0.00407,6248,25.40147,24597
1928,pthrasher,1,0.00407,6249,25.40554,24597
1929,ptjhuang,1,0.00407,6250,25.40960,24597
1930,pviniciusfm,1,0.00407,6251,25.41367,24597
1931,pvsousalima,1,0.00407,6252,25.41773,24597
1932,pwolthausen,1,0.00407,6253,25.42180,24597
1933,quaythuoc-org,1,0.00407,6254,25.42586,24597
1934,quorak,1,0.00407,6255,25.42993,24597
1935,qwertzxcvb,1,0.00407,6256,25.43400,24597
1936,r1cebank,1,0.00407,6257,25.43806,24597
1937,r734,1,0.00407,6258,25.44213,24597
1938,racenki26,1,0.00407,6259,25.44619,24597
1939,raeballz,1,0.00407,6260,25.45026,24597
1940,raghuvennam,1,0.00407,6261,25.45432,24597
1941,raider444,1,0.00407,6262,25.45839,24597
1942,rainbowjose,1,0.00407,6263,25.46245,24597
1943,rameezk,1,0.00407,6264,25.46652,24597
1944,ramkumarit2007,1,0.00407,6265,25.47059,24597
1945,Ramuimmadi,1,0.00407,6266,25.47465,24597
1946,rarvick,1,0.00407,6267,25.47872,24597
1947,RaudByorn,1,0.00407,6268,25.48278,24597
1948,raymccarthy,1,0.00407,6269,25.48685,24597
1949,resried,1,0.00407,6270,25.49091,24597
1950,resvoe,1,0.00407,6271,25.49498,24597
1951,revant,1,0.00407,6272,25.49904,24597
1952,rfarine,1,0.00407,6273,25.50311,24597
1953,rhysjtevans,1,0.00407,6274,25.50718,24597
1954,richardthombs,1,0.00407,6275,25.51124,24597
1955,RickvdStaaij,1,0.00407,6276,25.51531,24597
1956,rickymulder,1,0.00407,6277,25.51937,24597
1957,Riohyc,1,0.00407,6278,25.52344,24597
1958,riponbanik,1,0.00407,6279,25.52750,24597
1959,rlarivieredevo,1,0.00407,6280,25.53157,24597
1960,rnrsr,1,0.00407,6281,25.53563,24597
1961,robinmanuelthiel,1,0.00407,6282,25.53970,24597
1962,robstradling,1,0.00407,6283,25.54377,24597
1963,rohit-tiwari-scmp,1,0.00407,6284,25.54783,24597
1964,rolandkool,1,0.00407,6285,25.55190,24597
1965,rolfdalhaug,1,0.00407,6286,25.55596,24597
1966,rolish,1,0.00407,6287,25.56003,24597
1967,rombert,1,0.00407,6288,25.56409,24597
1968,ronakthamor,1,0.00407,6289,25.56816,24597
1969,ronnie-webb,1,0.00407,6290,25.57222,24597
1970,Routhinator,1,0.00407,6291,25.57629,24597
1971,rpetteruti,1,0.00407,6292,25.58036,24597
1972,rporres,1,0.00407,6293,25.58442,24597
1973,rra,1,0.00407,6294,25.58849,24597
1974,rrichardson,1,0.00407,6295,25.59255,24597
1975,ruckc,1,0.00407,6296,25.59662,24597
1976,rush2subbu,1,0.00407,6297,25.60068,24597
1977,russell,1,0.00407,6298,25.60475,24597
1978,ryancastle,1,0.00407,6299,25.60881,24597
1979,ryan-dyer-sp,1,0.00407,6300,25.61288,24597
1980,ryangrahamnc,1,0.00407,6301,25.61695,24597
1981,Ryosuke-Sasaki,1,0.00407,6302,25.62101,24597
1982,saadgen,1,0.00407,6303,25.62508,24597
1983,SacDin,1,0.00407,6304,25.62914,24597
1984,Sam123ben,1,0.00407,6305,25.63321,24597
1985,SamyCoenen,1,0.00407,6306,25.63727,24597
1986,sandangel,1,0.00407,6307,25.64134,24597
1987,sankalp-rangare-sap,1,0.00407,6308,25.64540,24597
1988,Sanket110297,1,0.00407,6309,25.64947,24597
1989,santinoncs,1,0.00407,6310,25.65353,24597
1990,sasacocic,1,0.00407,6311,25.65760,24597
1991,sashok2k,1,0.00407,6312,25.66167,24597
1992,sasiedu,1,0.00407,6313,25.66573,24597
1993,savas127,1,0.00407,6314,25.66980,24597
1994,Sayrus,1,0.00407,6315,25.67386,24597
1995,sazzle2611,1,0.00407,6316,25.67793,24597
1996,Schachte,1,0.00407,6317,25.68199,24597
1997,schaerli,1,0.00407,6318,25.68606,24597
1998,schemen,1,0.00407,6319,25.69012,24597
1999,schnidrig,1,0.00407,6320,25.69419,24597
2000,sean-brandt,1,0.00407,6321,25.69826,24597
2001,seandilda,1,0.00407,6322,25.70232,24597
2002,sebastialonso,1,0.00407,6323,25.70639,24597
2003,sebastianblunt,1,0.00407,6324,25.71045,24597
2004,sebiwi,1,0.00407,6325,25.71452,24597
2005,sebonk,1,0.00407,6326,25.71858,24597
2006,seboudry,1,0.00407,6327,25.72265,24597
2007,sedevops,1,0.00407,6328,25.72671,24597
2008,seifane,1,0.00407,6329,25.73078,24597
2009,sejnik,1,0.00407,6330,25.73485,24597
2010,seli,1,0.00407,6331,25.73891,24597
2011,selobosi,1,0.00407,6332,25.74298,24597
2012,senguendk,1,0.00407,6333,25.74704,24597
2013,Seolhun,1,0.00407,6334,25.75111,24597
2014,sepisoad,1,0.00407,6335,25.75517,24597
2015,serafim,1,0.00407,6336,25.75924,24597
2016,sergiomss,1,0.00407,6337,25.76330,24597
2017,Sergo007,1,0.00407,6338,25.76737,24597
2018,serhiiromaniuk,1,0.00407,6339,25.77144,24597
2019,sevteen,1,0.00407,6340,25.77550,24597
2020,shankie-san,1,0.00407,6341,25.77957,24597
2021,shawndodo,1,0.00407,6342,25.78363,24597
2022,Shivang44,1,0.00407,6343,25.78770,24597
2023,shreedhargowda,1,0.00407,6344,25.79176,24597
2024,shubhammicrosoft1,1,0.00407,6345,25.79583,24597
2025,sibelius80,1,0.00407,6346,25.79989,24597
2026,sidapa,1,0.00407,6347,25.80396,24597
2027,siemenskyle,1,0.00407,6348,25.80803,24597
2028,SirNarsh,1,0.00407,6349,25.81209,24597
2029,sitaramkm,1,0.00407,6350,25.81616,24597
2030,Sitong123321,1,0.00407,6351,25.82022,24597
2031,Skaronator,1,0.00407,6352,25.82429,24597
2032,SkeLLLa,1,0.00407,6353,25.82835,24597
2033,skone,1,0.00407,6354,25.83242,24597
2034,slaschinski,1,0.00407,6355,25.83648,24597
2035,slaurencelle,1,0.00407,6356,25.84055,24597
2036,slavoren,1,0.00407,6357,25.84462,24597
2037,Slayug,1,0.00407,6358,25.84868,24597
2038,slenky,1,0.00407,6359,25.85275,24597
2039,smalinskiy,1,0.00407,6360,25.85681,24597
2040,smartbit,1,0.00407,6361,25.86088,24597
2041,smartpcr,1,0.00407,6362,25.86494,24597
2042,smartpierre,1,0.00407,6363,25.86901,24597
2043,smax48,1,0.00407,6364,25.87307,24597
2044,smlehman,1,0.00407,6365,25.87714,24597
2045,smoll,1,0.00407,6366,25.88121,24597
2046,smyrman,1,0.00407,6367,25.88527,24597
2047,Sophian-Mehboub,1,0.00407,6368,25.88934,24597
2048,southbanksoftwaredeveloper,1,0.00407,6369,25.89340,24597
2049,spacecat,1,0.00407,6370,25.89747,24597
2050,spommerening,1,0.00407,6371,25.90153,24597
2051,spyroslalos,1,0.00407,6372,25.90560,24597
2052,sruon,1,0.00407,6373,25.90966,24597
2053,sryabkov,1,0.00407,6374,25.91373,24597
2054,ssadok,1,0.00407,6375,25.91779,24597
2055,ssdowd,1,0.00407,6376,25.92186,24597
2056,Stan0304,1,0.00407,6377,25.92593,24597
2057,Starbix,1,0.00407,6378,25.92999,24597
2058,stepan111,1,0.00407,6379,25.93406,24597
2059,stepbeekio,1,0.00407,6380,25.93812,24597
2060,stevenmunro,1,0.00407,6381,25.94219,24597
2061,stevenvegt,1,0.00407,6382,25.94625,24597
2062,stickycode,1,0.00407,6383,25.95032,24597
2063,stiks,1,0.00407,6384,25.95438,24597
2064,stingerpk,1,0.00407,6385,25.95845,24597
2065,strideynet,1,0.00407,6386,25.96252,24597
2066,strus38,1,0.00407,6387,25.96658,24597
2067,stuffandthings,1,0.00407,6388,25.97065,24597
2068,StyleT,1,0.00407,6389,25.97471,24597
2069,Sudokamikaze,1,0.00407,6390,25.97878,24597
2070,suisrc,1,0.00407,6391,25.98284,24597
2071,sundbry,1,0.00407,6392,25.98691,24597
2072,sundeer,1,0.00407,6393,25.99097,24597
2073,sun-solaris,1,0.00407,6394,25.99504,24597
2074,superbiche,1,0.00407,6395,25.99911,24597
2075,superolo92,1,0.00407,6396,26.00317,24597
2076,suprithwork,1,0.00407,6397,26.00724,24597
2077,svenihoney,1,0.00407,6398,26.01130,24597
2078,sylflo,1,0.00407,6399,26.01537,24597
2079,sylv3r,1,0.00407,6400,26.01943,24597
2080,szymonpk,1,0.00407,6401,26.02350,24597
2081,t3hmrman,1,0.00407,6402,26.02756,24597
2082,tah-mas,1,0.00407,6403,26.03163,24597
2083,talha5389,1,0.00407,6404,26.03570,24597
2084,tankovich,1,0.00407,6405,26.03976,24597
2085,tannerjfco,1,0.00407,6406,26.04383,24597
2086,Tarick,1,0.00407,6407,26.04789,24597
2087,tarikki,1,0.00407,6408,26.05196,24597
2088,Tawmu,1,0.00407,6409,26.05602,24597
2089,tayhalla,1,0.00407,6410,26.06009,24597
2090,tdevopsottawa,1,0.00407,6411,26.06415,24597
2091,tdigangi5,1,0.00407,6412,26.06822,24597
2092,techcto,1,0.00407,6413,26.07229,24597
2093,techmunk,1,0.00407,6414,26.07635,24597
2094,teddyphreak,1,0.00407,6415,26.08042,24597
2095,teelahti,1,0.00407,6416,26.08448,24597
2096,tegamckinney,1,0.00407,6417,26.08855,24597
2097,tewing-riffyn,1,0.00407,6418,26.09261,24597
2098,tg90nor,1,0.00407,6419,26.09668,24597
2099,Thammada,1,0.00407,6420,26.10074,24597
2100,thanatos,1,0.00407,6421,26.10481,24597
2101,theAkito,1,0.00407,6422,26.10888,24597
2102,theallseingeye,1,0.00407,6423,26.11294,24597
2103,thearrow,1,0.00407,6424,26.11701,24597
2104,TheDen,1,0.00407,6425,26.12107,24597
2105,thedumbtechguy,1,0.00407,6426,26.12514,24597
2106,thekalinga,1,0.00407,6427,26.12920,24597
2107,themightychris,1,0.00407,6428,26.13327,24597
2108,theresemchale,1,0.00407,6429,26.13733,24597
2109,thiagogds,1,0.00407,6430,26.14140,24597
2110,thiagonache,1,0.00407,6431,26.14546,24597
2111,thoughtentity,1,0.00407,6432,26.14953,24597
2112,ticinum-aerospace,1,0.00407,6433,26.15360,24597
2113,timroster,1,0.00407,6434,26.15766,24597
2114,timshannon,1,0.00407,6435,26.16173,24597
2115,tinuvthomas,1,0.00407,6436,26.16579,24597
2116,tklebanoff,1,0.00407,6437,26.16986,24597
2117,tmart-ops,1,0.00407,6438,26.17392,24597
2118,tmerten,1,0.00407,6439,26.17799,24597
2119,tobiasbeck,1,0.00407,6440,26.18205,24597
2120,toby-1-kenobi,1,0.00407,6441,26.18612,24597
2121,tofran,1,0.00407,6442,26.19019,24597
2122,tomaustin700,1,0.00407,6443,26.19425,24597
2123,tomdb-BE,1,0.00407,6444,26.19832,24597
2124,Tomesco,1,0.00407,6445,26.20238,24597
2125,tomiamao,1,0.00407,6446,26.20645,24597
2126,tomi-bigpi,1,0.00407,6447,26.21051,24597
2127,tommyknows,1,0.00407,6448,26.21458,24597
2128,tony84727,1,0.00407,6449,26.21864,24597
2129,torpinouche,1,0.00407,6450,26.22271,24597
2130,tr1ck3r,1,0.00407,6451,26.22678,24597
2131,trog-levrai,1,0.00407,6452,26.23084,24597
2132,troywilson,1,0.00407,6453,26.23491,24597
2133,trubit,1,0.00407,6454,26.23897,24597
2134,TrurlMcByte,1,0.00407,6455,26.24304,24597
2135,tryhardest,1,0.00407,6456,26.24710,24597
2136,tsutsu,1,0.00407,6457,26.25117,24597
2137,tuhochi,1,0.00407,6458,26.25523,24597
2138,twendt,1,0.00407,6459,26.25930,24597
2139,twittyc,1,0.00407,6460,26.26337,24597
2140,typekpb,1,0.00407,6461,26.26743,24597
2141,ugurerkan,1,0.00407,6462,26.27150,24597
2142,ulrichSchreiner,1,0.00407,6463,26.27556,24597
2143,umegaya,1,0.00407,6464,26.27963,24597
2144,unfrgivn,1,0.00407,6465,26.28369,24597
2145,unitof,1,0.00407,6466,26.28776,24597
2146,unitto1,1,0.00407,6467,26.29182,24597
2147,urbaniak,1,0.00407,6468,26.29589,24597
2148,UrbanWizardry,1,0.00407,6469,26.29996,24597
2149,urtho,1,0.00407,6470,26.30402,24597
2150,UsernameAlvarez,1,0.00407,6471,26.30809,24597
2151,Utwo,1,0.00407,6472,26.31215,24597
2152,uzxmx,1,0.00407,6473,26.31622,24597
2153,vaishali-prophecy,1,0.00407,6474,26.32028,24597
2154,vanpyrzericj,1,0.00407,6475,26.32435,24597
2155,varac,1,0.00407,6476,26.32841,24597
2156,vdoodala,1,0.00407,6477,26.33248,24597
2157,veereshcc,1,0.00407,6478,26.33655,24597
2158,venkatalolla,1,0.00407,6479,26.34061,24597
2159,venkyvb,1,0.00407,6480,26.34468,24597
2160,victorpalmeida,1,0.00407,6481,26.34874,24597
2161,vijaygos,1,0.00407,6482,26.35281,24597
2162,violenti,1,0.00407,6483,26.35687,24597
2163,Viperoo,1,0.00407,6484,26.36094,24597
2164,vitalikaz,1,0.00407,6485,26.36500,24597
2165,Vlaaaaaaad,1,0.00407,6486,26.36907,24597
2166,vlad0337187,1,0.00407,6487,26.37313,24597
2167,vlad-tuznichenko,1,0.00407,6488,26.37720,24597
2168,vmrm,1,0.00407,6489,26.38127,24597
2169,vodolazov,1,0.00407,6490,26.38533,24597
2170,vparaschiv,1,0.00407,6491,26.38940,24597
2171,vsabella,1,0.00407,6492,26.39346,24597
2172,vslepakov,1,0.00407,6493,26.39753,24597
2173,vukhanhtruong,1,0.00407,6494,26.40159,24597
2174,vvmorilla,1,0.00407,6495,26.40566,24597
2175,w32-blaster,1,0.00407,6496,26.40972,24597
2176,w9jds,1,0.00407,6497,26.41379,24597
2177,waninkoko,1,0.00407,6498,26.41786,24597
2178,wbaumann,1,0.00407,6499,26.42192,24597
2179,wenzlaff,1,0.00407,6500,26.42599,24597
2180,white-hat,1,0.00407,6501,26.43005,24597
2181,whitelion-github,1,0.00407,6502,26.43412,24597
2182,WhitePhoera,1,0.00407,6503,26.43818,24597
2183,whut,1,0.00407,6504,26.44225,24597
2184,wi1dcard,1,0.00407,6505,26.44631,24597
2185,wI2L,1,0.00407,6506,26.45038,24597
2186,wilco,1,0.00407,6507,26.45445,24597
2187,williamchong007,1,0.00407,6508,26.45851,24597
2188,willikay11,1,0.00407,6509,26.46258,24597
2189,willycz,1,0.00407,6510,26.46664,24597
2190,winfieldxu,1,0.00407,6511,26.47071,24597
2191,wjentner,1,0.00407,6512,26.47477,24597
2192,WMP,1,0.00407,6513,26.47884,24597
2193,wondering639,1,0.00407,6514,26.48290,24597
2194,woxxy,1,0.00407,6515,26.48697,24597
2195,wrogrammer,1,0.00407,6516,26.49104,24597
2196,wwyhy,1,0.00407,6517,26.49510,24597
2197,xairos,1,0.00407,6518,26.49917,24597
2198,xanecs,1,0.00407,6519,26.50323,24597
2199,xhalo32,1,0.00407,6520,26.50730,24597
2200,xmfreak,1,0.00407,6521,26.51136,24597
2201,xvonabur,1,0.00407,6522,26.51543,24597
2202,xXTim97Xx,1,0.00407,6523,26.51949,24597
2203,xyxiaobai,1,0.00407,6524,26.52356,24597
2204,Yacine-A,1,0.00407,6525,26.52763,24597
2205,yalctay93,1,0.00407,6526,26.53169,24597
2206,yanjunli76,1,0.00407,6527,26.53576,24597
2207,yassinetimdouine,1,0.00407,6528,26.53982,24597
2208,ycao56,1,0.00407,6529,26.54389,24597
2209,yehaifeng,1,0.00407,6530,26.54795,24597
2210,yevhenchmykhunep,1,0.00407,6531,26.55202,24597
2211,yfxie,1,0.00407,6532,26.55608,24597
2212,yoliander,1,0.00407,6533,26.56015,24597
2213,yonirab,1,0.00407,6534,26.56422,24597
2214,yra-wtag,1,0.00407,6535,26.56828,24597
2215,ysle,1,0.00407,6536,26.57235,24597
2216,yspreen,1,0.00407,6537,26.57641,24597
2217,yujinyan,1,0.00407,6538,26.58048,24597
2218,yves-vogl,1,0.00407,6539,26.58454,24597
2219,z3nf1n1ty,1,0.00407,6540,26.58861,24597
2220,zamai,1,0.00407,6541,26.59267,24597
2221,zanderson-aim,1,0.00407,6542,26.59674,24597
2222,zbagdzevicius,1,0.00407,6543,26.60080,24597
2223,zenoven,1,0.00407,6544,26.60487,24597
2224,zerda,1,0.00407,6545,26.60894,24597
2225,zhangyelong,1,0.00407,6546,26.61300,24597
2226,zhangzewen,1,0.00407,6547,26.61707,24597
2227,ziwon,1,0.00407,6548,26.62113,24597
2228,znat,1,0.00407,6549,26.62520,24597
2229,zolij,1,0.00407,6550,26.62926,24597
2230,Zowie,1,0.00407,6551,26.63333,24597
2231,zrcoder,1,0.00407,6552,26.63739,24597
2232,ztbrown,1,0.00407,6553,26.64146,24597
2233,zvozin,1,0.00407,6554,26.64553,24597
2234,zwtj,1,0.00407,6555,26.64959,24597
2235,zxdyumiao,1,0.00407,6556,26.65366,24597
2236,zz40404991,1,0.00407,6557,26.65772,24597
