rank_number,actor,contributions,percent,cumulative_sum,cumulative_percent,all_contributions
1,akien-mga,77408,23.37156,77408,23.37156,331206
2,Calinou,14154,4.27347,91562,27.64503,331206
3,reduz,12170,3.67445,103732,31.31948,331206
4,bojidar-bg,5826,1.75903,109558,33.07851,331206
5,neikeq,5054,1.52594,114612,34.60445,331206
6,vnen,5044,1.52292,119656,36.12736,331206
7,KoBeWi,4701,1.41936,124357,37.54672,331206
8,mhilbrunner,4346,1.31217,128703,38.85890,331206
9,Zylann,4141,1.25028,132844,40.10918,331206
10,aaronfranke,4076,1.23065,136920,41.33983,331206
11,groud,3991,1.20499,140911,42.54482,331206
12,clayjohn,3895,1.17601,144806,43.72083,331206
13,volzhs,3393,1.02444,148199,44.74526,331206
14,Chaosus,3232,0.97583,151431,45.72109,331206
15,YeldhamDev,2728,0.82366,154159,46.54475,331206
16,Noshyaar,2351,0.70983,156510,47.25458,331206
17,kubecz3k,2209,0.66696,158719,47.92154,331206
18,Xrayez,2155,0.65065,160874,48.57219,331206
19,NathanLovato,2150,0.64914,163024,49.22133,331206
20,hpvb,2148,0.64854,165172,49.86987,331206
21,Faless,2139,0.64582,167311,50.51569,331206
22,RandomShaper,2099,0.63374,169410,51.14944,331206
23,fire,2091,0.63133,171501,51.78076,331206
24,cbscribe,2066,0.62378,173567,52.40455,331206
25,bruvzg,1785,0.53894,175352,52.94349,331206
26,BastiaanOlij,1745,0.52686,177097,53.47035,331206
27,willnationsdev,1723,0.52022,178820,53.99057,331206
28,qarmin,1695,0.51177,180515,54.50233,331206
29,AndreaCatania,1653,0.49909,182168,55.00142,331206
30,eon-s,1652,0.49878,183820,55.50020,331206
31,toger5,1594,0.48127,185414,55.98147,331206
32,tagcup,1580,0.47704,186994,56.45852,331206
33,karroffel,1517,0.45802,188511,56.91654,331206
34,Zireael07,1485,0.44836,189996,57.36490,331206
35,djrm,1404,0.42391,191400,57.78881,331206
36,madmiraal,1121,0.33846,192521,58.12727,331206
37,Hinsbart,1111,0.33544,193632,58.46271,331206
38,pouleyKetchoupp,1077,0.32518,194709,58.78788,331206
39,avencherus,1065,0.32155,195774,59.10944,331206
40,lawnjelly,1061,0.32034,196835,59.42978,331206
41,marcelofg55,1017,0.30706,197852,59.73684,331206
42,Geequlim,978,0.29528,198830,60.03213,331206
43,guilhermefelipecgs,955,0.28834,199785,60.32047,331206
44,mjtorn,951,0.28713,200736,60.60760,331206
45,StraToN,938,0.28321,201674,60.89081,331206
46,Jason0214,905,0.27324,202579,61.16405,331206
47,AlexHolly,841,0.25392,203420,61.41797,331206
48,fleskesvor,801,0.24184,204221,61.65981,331206
49,m4gr3d,800,0.24154,205021,61.90135,331206
50,eska014,768,0.23188,205789,62.13323,331206
51,mysticfall,726,0.21920,206515,62.35243,331206
52,MarianoGnu,719,0.21709,207234,62.56952,331206
53,Paulb23,706,0.21316,207940,62.78268,331206
54,LikeLakers2,689,0.20803,208629,62.99071,331206
55,blurymind,685,0.20682,209314,63.19753,331206
56,golddotasksquestions,663,0.20018,209977,63.39770,331206
57,poke1024,654,0.19746,210631,63.59516,331206
58,Anutrix,651,0.19655,211282,63.79172,331206
59,punto-,640,0.19323,211922,63.98495,331206
60,capnm,634,0.19142,212556,64.17637,331206
61,slapin,626,0.18901,213182,64.36538,331206
62,girng,622,0.18780,213804,64.55318,331206
63,ThakeeNathees,587,0.17723,214391,64.73041,331206
64,Ranoller,584,0.17633,214975,64.90673,331206
65,skyace65,563,0.16998,215538,65.07672,331206
66,Jummit,535,0.16153,216073,65.23825,331206
67,NathanWarden,534,0.16123,216607,65.39948,331206
68,Naryosha,512,0.15459,217119,65.55407,331206
69,nunodonato,491,0.14825,217610,65.70231,331206
70,pycbouh,484,0.14613,218094,65.84844,331206
71,LinuxUserGD,473,0.14281,218567,65.99126,331206
72,mrcdk,467,0.14100,219034,66.13226,331206
73,swarnimarun,465,0.14040,219499,66.27265,331206
74,TheDuriel,457,0.13798,219956,66.41063,331206
75,QbieShay,456,0.13768,220412,66.54831,331206
76,endragor,450,0.13587,220862,66.68418,331206
77,TwistedTwigleg,439,0.13255,221301,66.81672,331206
78,SuperUserNameMan,426,0.12862,221727,66.94535,331206
79,SaracenOne,425,0.12832,222152,67.07366,331206
80,timoschwarzer,423,0.12772,222575,67.20138,331206
81,JFonS,414,0.12500,222989,67.32638,331206
82,n-pigeon,414,0.12500,223403,67.45137,331206
83,JuanDidNothingWrong4,408,0.12319,223811,67.57456,331206
84,Rubonnek,403,0.12168,224214,67.69624,331206
85,sdfgeoff,400,0.12077,224614,67.81701,331206
86,zaksnet,400,0.12077,225014,67.93778,331206
87,RevoluPowered,396,0.11956,225410,68.05734,331206
88,timothyqiu,388,0.11715,225798,68.17449,331206
89,DualMatrix,384,0.11594,226182,68.29043,331206
90,Shadowblitz16,380,0.11473,226562,68.40516,331206
91,Sslaxx,372,0.11232,226934,68.51748,331206
92,touilleMan,372,0.11232,227306,68.62980,331206
93,IronicallySerious,362,0.10930,227668,68.73909,331206
94,EricEzaM,359,0.10839,228027,68.84748,331206
95,RayKoopa,351,0.10598,228378,68.95346,331206
96,Dillybob92,348,0.10507,228726,69.05853,331206
97,exts,347,0.10477,229073,69.16330,331206
98,alexzheng,331,0.09994,229404,69.26324,331206
99,homer666,311,0.09390,229715,69.35714,331206
100,KellyThomas,309,0.09330,230024,69.45043,331206
101,Marqin,308,0.09299,230332,69.54343,331206
102,dalexeev,302,0.09118,230634,69.63461,331206
103,jasperbrooks79,302,0.09118,230936,69.72579,331206
104,JuanNeedsToRepent,298,0.08997,231234,69.81576,331206
105,raymoo,298,0.08997,231532,69.90574,331206
106,creikey,294,0.08877,231826,69.99450,331206
107,supagu,294,0.08877,232120,70.08327,331206
108,corrigentia,286,0.08635,232406,70.16962,331206
109,avril-gh,285,0.08605,232691,70.25567,331206
110,DrMoriarty,278,0.08394,232969,70.33961,331206
111,trollworkout,276,0.08333,233245,70.42294,331206
112,lupoDharkael,275,0.08303,233520,70.50597,331206
113,HaSa1002,274,0.08273,233794,70.58870,331206
114,asheraryam,273,0.08243,234067,70.67112,331206
115,samgreen,269,0.08122,234336,70.75234,331206
116,zaps166,262,0.07910,234598,70.83145,331206
117,jonbonazza,260,0.07850,234858,70.90995,331206
118,follower,256,0.07729,235114,70.98724,331206
119,ret80,254,0.07669,235368,71.06393,331206
120,starry-abyss,253,0.07639,235621,71.14032,331206
121,dreamsComeTrue,244,0.07367,235865,71.21399,331206
122,ibrahn,242,0.07307,236107,71.28705,331206
123,MoraleMaduzo,241,0.07276,236348,71.35982,331206
124,hungrymonkey,240,0.07246,236588,71.43228,331206
125,MightyPrinny,240,0.07246,236828,71.50474,331206
126,henriiquecampos,237,0.07156,237065,71.57630,331206
127,nathanwfranke,236,0.07125,237301,71.64755,331206
128,thebestnom,236,0.07125,237537,71.71881,331206
129,naithar,232,0.07005,237769,71.78886,331206
130,27thLiz,231,0.06975,238000,71.85860,331206
131,fracteed,229,0.06914,238229,71.92774,331206
132,git2013vb,226,0.06824,238455,71.99598,331206
133,nobuyukinyuu,224,0.06763,238679,72.06361,331206
134,marxin,221,0.06673,238900,72.13034,331206
135,CptPotato,220,0.06642,239120,72.19676,331206
136,Feniks-Gaming,220,0.06642,239340,72.26318,331206
137,paulloz,218,0.06582,239558,72.32900,331206
138,chanon,217,0.06552,239775,72.39452,331206
139,icnikerazah,215,0.06491,239990,72.45944,331206
140,razvanc-r,211,0.06371,240201,72.52314,331206
141,williamd1k0,211,0.06371,240412,72.58685,331206
142,PJB3005,210,0.06340,240622,72.65025,331206
143,CowThing,205,0.06190,240827,72.71215,331206
144,hubbyist,202,0.06099,241029,72.77314,331206
145,pwab,202,0.06099,241231,72.83413,331206
146,sersoong,201,0.06069,241432,72.89481,331206
147,HummusSamurai,200,0.06039,241632,72.95520,331206
148,hbina,198,0.05978,241830,73.01498,331206
149,Ace-Dragon,194,0.05857,242024,73.07356,331206
150,novemberist,191,0.05767,242215,73.13122,331206
151,hoontee,190,0.05737,242405,73.18859,331206
152,MCrafterzz,189,0.05706,242594,73.24565,331206
153,paper-pauper,189,0.05706,242783,73.30272,331206
154,sketchyfun,189,0.05706,242972,73.35978,331206
155,nathanfranke,187,0.05646,243159,73.41624,331206
156,Keetz,185,0.05586,243344,73.47210,331206
157,freemanfromgodotengine,184,0.05555,243528,73.52765,331206
158,tinmanjuggernaut,183,0.05525,243711,73.58291,331206
159,FeralBytes,181,0.05465,243892,73.63755,331206
160,Toshiwoz,181,0.05465,244073,73.69220,331206
161,DevMagicLord,177,0.05344,244250,73.74564,331206
162,puppetmaster-,177,0.05344,244427,73.79909,331206
163,mateusak,176,0.05314,244603,73.85222,331206
164,mitchcurtis,176,0.05314,244779,73.90536,331206
165,RebelliousX,176,0.05314,244955,73.95850,331206
166,kakoeimon,174,0.05254,245129,74.01104,331206
167,brainsick,172,0.05193,245301,74.06297,331206
168,merumelu,168,0.05072,245469,74.11369,331206
169,her001,166,0.05012,245635,74.16381,331206
170,rraallvv,165,0.04982,245800,74.21363,331206
171,leezh,163,0.04921,245963,74.26285,331206
172,OvermindDL1,163,0.04921,246126,74.31206,331206
173,piratesephiroth,163,0.04921,246289,74.36127,331206
174,TheHX,162,0.04891,246451,74.41019,331206
175,ArcFutahito,159,0.04801,246610,74.45819,331206
176,letheed,156,0.04710,246766,74.50529,331206
177,est31,155,0.04680,246921,74.55209,331206
178,ndarilek,155,0.04680,247076,74.59889,331206
179,DuskKittyIsHotAF,153,0.04619,247229,74.64508,331206
180,Krakean,153,0.04619,247382,74.69128,331206
181,LeonardMeagher2,153,0.04619,247535,74.73747,331206
182,dragmz,152,0.04589,247687,74.78337,331206
183,leonkrause,152,0.04589,247839,74.82926,331206
184,Ev1lbl0w,151,0.04559,247990,74.87485,331206
185,jahd2602,150,0.04529,248140,74.92014,331206
186,Ovnuniarchos,149,0.04499,248289,74.96513,331206
187,ZX-WT,149,0.04499,248438,75.01011,331206
188,m4nu3lf,148,0.04469,248586,75.05480,331206
189,pgruenbacher,148,0.04469,248734,75.09948,331206
190,ShyRed,148,0.04469,248882,75.14417,331206
191,J08nY,147,0.04438,249029,75.18855,331206
192,ISylvox,145,0.04378,249174,75.23233,331206
193,JuanDidNothingWrong3,145,0.04378,249319,75.27611,331206
194,chucklepie,141,0.04257,249460,75.31868,331206
195,rogeriodec,139,0.04197,249599,75.36065,331206
196,MaaaxiKing,138,0.04167,249737,75.40232,331206
197,gau-veldt,137,0.04136,249874,75.44368,331206
198,Jerome67000,136,0.04106,250010,75.48474,331206
199,ca3games,135,0.04076,250145,75.52550,331206
200,gamergamesz,135,0.04076,250280,75.56626,331206
201,nightblade9,135,0.04076,250415,75.60702,331206
202,xDGameStudios,135,0.04076,250550,75.64778,331206
203,allkhor,134,0.04046,250684,75.68824,331206
204,cjmxp,134,0.04046,250818,75.72870,331206
205,hetdegon,133,0.04016,250951,75.76886,331206
206,ondesic,133,0.04016,251084,75.80901,331206
207,samdze,133,0.04016,251217,75.84917,331206
208,DimitriyPS,132,0.03985,251349,75.88902,331206
209,PLyczkowski,132,0.03985,251481,75.92888,331206
210,raphael10241024,132,0.03985,251613,75.96873,331206
211,robfram,132,0.03985,251745,76.00859,331206
212,cart,131,0.03955,251876,76.04814,331206
213,Razoric480,130,0.03925,252006,76.08739,331206
214,santouits,130,0.03925,252136,76.12664,331206
215,SeleckyErik,130,0.03925,252266,76.16589,331206
216,kone9,129,0.03895,252395,76.20484,331206
217,somnivore,129,0.03895,252524,76.24379,331206
218,jitspoe,128,0.03865,252652,76.28243,331206
219,noidexe,128,0.03865,252780,76.32108,331206
220,TheoXD,127,0.03834,252907,76.35943,331206
221,Torguen,127,0.03834,253034,76.39777,331206
222,Janglee123,126,0.03804,253160,76.43581,331206
223,NilsIrl,126,0.03804,253286,76.47386,331206
224,mrushyendra,125,0.03774,253411,76.51160,331206
225,dankan1890,124,0.03744,253535,76.54904,331206
226,jedStevens,124,0.03744,253659,76.58647,331206
227,Meriipu,121,0.03653,253780,76.62301,331206
228,sparkart,121,0.03653,253901,76.65954,331206
229,RameshRavone,120,0.03623,254021,76.69577,331206
230,toasteater,119,0.03593,254140,76.73170,331206
231,tom-jk,119,0.03593,254259,76.76763,331206
232,curly-brace,118,0.03563,254377,76.80326,331206
233,isaacremnant,118,0.03563,254495,76.83889,331206
234,jabcross,117,0.03533,254612,76.87421,331206
235,jesperkondrup,117,0.03533,254729,76.90954,331206
236,HEAVYPOLY,116,0.03502,254845,76.94456,331206
237,Gibbz,115,0.03472,254960,76.97928,331206
238,Raj2032,115,0.03472,255075,77.01400,331206
239,Wavesonics,115,0.03472,255190,77.04872,331206
240,wyattbiker,115,0.03472,255305,77.08345,331206
241,nonunknown,114,0.03442,255419,77.11787,331206
242,SIsilicon,114,0.03442,255533,77.15229,331206
243,GeorgeS2019,113,0.03412,255646,77.18640,331206
244,menip,113,0.03412,255759,77.22052,331206
245,OlexiyKravchuk,113,0.03412,255872,77.25464,331206
246,pkowal1982,113,0.03412,255985,77.28876,331206
247,lekoder,112,0.03382,256097,77.32257,331206
248,puthre,112,0.03382,256209,77.35639,331206
249,theoway,112,0.03382,256321,77.39020,331206
250,char0xff,110,0.03321,256431,77.42342,331206
251,Eoin-ONeill-Yokai,110,0.03321,256541,77.45663,331206
252,hilfazer,110,0.03321,256651,77.48984,331206
253,vonflyhighace2,109,0.03291,256760,77.52275,331206
254,mnn,108,0.03261,256868,77.55536,331206
255,toby3d,108,0.03261,256976,77.58797,331206
256,jamie-pate,107,0.03231,257083,77.62027,331206
257,rubenjavier,107,0.03231,257190,77.65258,331206
258,ArdaE,106,0.03200,257296,77.68458,331206
259,Grosskopf,106,0.03200,257402,77.71659,331206
260,Warlaan,106,0.03200,257508,77.74859,331206
261,aqnuep,105,0.03170,257613,77.78029,331206
262,fossegutten,105,0.03170,257718,77.81200,331206
263,profan,105,0.03170,257823,77.84370,331206
264,shartte,105,0.03170,257928,77.87540,331206
265,henriquelalves,104,0.03140,258032,77.90680,331206
266,muiroc,104,0.03140,258136,77.93820,331206
267,mbrlabs,103,0.03110,258239,77.96930,331206
268,Razzlegames,103,0.03110,258342,78.00040,331206
269,cagdasc,102,0.03080,258444,78.03120,331206
270,Corruptinator,102,0.03080,258546,78.06199,331206
271,dodgyville,102,0.03080,258648,78.09279,331206
272,danilw,101,0.03049,258749,78.12328,331206
273,DimaKiva,101,0.03049,258850,78.15378,331206
274,ianb96,101,0.03049,258951,78.18427,331206
275,ricardoalcantara,101,0.03049,259052,78.21477,331206
276,SkyLucilfer,101,0.03049,259153,78.24526,331206
277,amanj120,99,0.02989,259252,78.27515,331206
278,Web-eWorks,99,0.02989,259351,78.30504,331206
279,RaTcHeT302,98,0.02959,259449,78.33463,331206
280,EIREXE,97,0.02929,259546,78.36392,331206
281,van800,97,0.02929,259643,78.39321,331206
282,2shady4u,96,0.02898,259739,78.42219,331206
283,damarindra,96,0.02898,259835,78.45118,331206
284,DleanJeans,96,0.02898,259931,78.48016,331206
285,fian46,96,0.02898,260027,78.50915,331206
286,JarLowrey,96,0.02898,260123,78.53813,331206
287,vicguedez,96,0.02898,260219,78.56712,331206
288,DavidSichma,95,0.02868,260314,78.59580,331206
289,marstaik,95,0.02868,260409,78.62448,331206
290,razcore-art,95,0.02868,260504,78.65316,331206
291,securas,95,0.02868,260599,78.68185,331206
292,Janders1800,94,0.02838,260693,78.71023,331206
293,sheepandshepherd,94,0.02838,260787,78.73861,331206
294,oeleo1,93,0.02808,260880,78.76669,331206
295,EzraT,92,0.02778,260972,78.79447,331206
296,leoddd,92,0.02778,261064,78.82224,331206
297,Megalomaniak,92,0.02778,261156,78.85002,331206
298,sanikoyes,91,0.02748,261247,78.87750,331206
299,hoelzl,90,0.02717,261337,78.90467,331206
300,Listwon,89,0.02687,261426,78.93154,331206
301,Norrox,89,0.02687,261515,78.95841,331206
302,set-killer,89,0.02687,261604,78.98528,331206
303,andy-noisyduck,88,0.02657,261692,79.01185,331206
304,Shin-NiL,88,0.02657,261780,79.03842,331206
305,Tybobobo,88,0.02657,261868,79.06499,331206
306,aspenforest,87,0.02627,261955,79.09126,331206
307,BeayemX,87,0.02627,262042,79.11753,331206
308,hinlopen,87,0.02627,262129,79.14380,331206
309,MattUV,87,0.02627,262216,79.17006,331206
310,samvila,87,0.02627,262303,79.19633,331206
311,eligt,86,0.02597,262389,79.22230,331206
312,fluffrabbit,86,0.02597,262475,79.24826,331206
313,ilyafuu,86,0.02597,262561,79.27423,331206
314,mattiascibien,86,0.02597,262647,79.30019,331206
315,Shatur95,86,0.02597,262733,79.32616,331206
316,jjay,85,0.02566,262818,79.35182,331206
317,Zephilinox,85,0.02566,262903,79.37749,331206
318,rminderhoud,84,0.02536,262987,79.40285,331206
319,codecustard,83,0.02506,263070,79.42791,331206
320,JoshuaGrams,83,0.02506,263153,79.45297,331206
321,Omicron666,83,0.02506,263236,79.47803,331206
322,Two-Tone,83,0.02506,263319,79.50309,331206
323,Alexia-AT-Digitecnology,82,0.02476,263401,79.52785,331206
324,Duroxxigar,82,0.02476,263483,79.55260,331206
325,elasota,82,0.02476,263565,79.57736,331206
326,hedgehog90,82,0.02476,263647,79.60212,331206
327,Griefchief,81,0.02446,263728,79.62658,331206
328,kuruk-mm,81,0.02446,263809,79.65103,331206
329,nhydock,81,0.02446,263890,79.67549,331206
330,nikhilCad,81,0.02446,263971,79.69995,331206
331,zszen,81,0.02446,264052,79.72440,331206
332,adolson,80,0.02415,264132,79.74856,331206
333,mefihl,79,0.02385,264211,79.77241,331206
334,remorse107,79,0.02385,264290,79.79626,331206
335,seadra,79,0.02385,264369,79.82011,331206
336,wingedadventurer,79,0.02385,264448,79.84396,331206
337,azagaya,78,0.02355,264526,79.86751,331206
338,Cradmon,78,0.02355,264604,79.89106,331206
339,Phischermen,78,0.02355,264682,79.91462,331206
340,Reneator,78,0.02355,264760,79.93817,331206
341,zzz-assault,78,0.02355,264838,79.96172,331206
342,burstina,77,0.02325,264915,79.98496,331206
343,lordadamson,77,0.02325,264992,80.00821,331206
344,MadEqua,77,0.02325,265069,80.03146,331206
345,maxim-sheronov,77,0.02325,265146,80.05471,331206
346,Relintai,77,0.02325,265223,80.07796,331206
347,Garrom,76,0.02295,265299,80.10090,331206
348,KidRigger,76,0.02295,265375,80.12385,331206
349,SuperDIMMaX,76,0.02295,265451,80.14680,331206
350,voithos,76,0.02295,265527,80.16974,331206
351,11clock,75,0.02264,265602,80.19239,331206
352,rgrams,75,0.02264,265677,80.21503,331206
353,rokasv,75,0.02264,265752,80.23768,331206
354,Skaruts,75,0.02264,265827,80.26032,331206
355,WalasPrime,75,0.02264,265902,80.28297,331206
356,iwek7,74,0.02234,265976,80.30531,331206
357,Lucrecious,74,0.02234,266050,80.32765,331206
358,ducdetronquito,73,0.02204,266123,80.34969,331206
359,magyar123,73,0.02204,266196,80.37173,331206
360,bfloch,72,0.02174,266268,80.39347,331206
361,DriNeo,72,0.02174,266340,80.41521,331206
362,Flavelius,72,0.02174,266412,80.43695,331206
363,Kanabenki,72,0.02174,266484,80.45869,331206
364,NeoSpark314,72,0.02174,266556,80.48043,331206
365,ordigdug,72,0.02174,266628,80.50216,331206
366,VitaZheltyakov,72,0.02174,266700,80.52390,331206
367,GammaGames,71,0.02144,266771,80.54534,331206
368,Gerarama,71,0.02144,266842,80.56678,331206
369,HeartoLazor,70,0.02113,266912,80.58791,331206
370,kosz78,70,0.02113,266982,80.60905,331206
371,malbach,70,0.02113,267052,80.63018,331206
372,toliaferrode,70,0.02113,267122,80.65132,331206
373,Windfisch,70,0.02113,267192,80.67245,331206
374,arkology,69,0.02083,267261,80.69328,331206
375,drmar,69,0.02083,267330,80.71412,331206
376,ElfEars,69,0.02083,267399,80.73495,331206
377,mohaalak,69,0.02083,267468,80.75578,331206
378,nylnook,69,0.02083,267537,80.77662,331206
379,OBKF,69,0.02083,267606,80.79745,331206
380,plucian,69,0.02083,267675,80.81828,331206
381,ShivamMukherjee,69,0.02083,267744,80.83912,331206
382,Teashrock,69,0.02083,267813,80.85995,331206
383,JoelMcMoron,68,0.02053,267881,80.88048,331206
384,megasoft78,68,0.02053,267949,80.90101,331206
385,romeojulietthotel,68,0.02053,268017,80.92154,331206
386,Silvea12,68,0.02053,268085,80.94207,331206
387,Tobi-La,68,0.02053,268153,80.96260,331206
388,agameraaron,67,0.02023,268220,80.98283,331206
389,BenjaminNavarro,67,0.02023,268287,81.00306,331206
390,bitbutter,67,0.02023,268354,81.02329,331206
391,CCODE05B,67,0.02023,268421,81.04352,331206
392,kaadmy,67,0.02023,268488,81.06375,331206
393,me2beats,67,0.02023,268555,81.08398,331206
394,mrezai,67,0.02023,268622,81.10421,331206
395,Muller-Castro,67,0.02023,268689,81.12444,331206
396,Nobelix,67,0.02023,268756,81.14467,331206
397,Phoenix1747,67,0.02023,268823,81.16489,331206
398,tavurth,67,0.02023,268890,81.18512,331206
399,and3rson,66,0.01993,268956,81.20505,331206
400,Antokolos,66,0.01993,269022,81.22498,331206
401,Dillybob1992,66,0.01993,269088,81.24490,331206
402,elieobeid7,66,0.01993,269154,81.26483,331206
403,jasonswearingen,66,0.01993,269220,81.28476,331206
404,m6502,66,0.01993,269286,81.30469,331206
405,asmaloney,65,0.01963,269351,81.32431,331206
406,CarlGustavAlbertDwarfsteinYung,65,0.01963,269416,81.34394,331206
407,coppolaemilio,65,0.01963,269481,81.36356,331206
408,puchik,65,0.01963,269546,81.38319,331206
409,TheSHEEEP,64,0.01932,269610,81.40251,331206
410,breakmt,63,0.01902,269673,81.42153,331206
411,ByTheQuietLake,63,0.01902,269736,81.44055,331206
412,ForLoveOfCats,63,0.01902,269799,81.45958,331206
413,Juankz,63,0.01902,269862,81.47860,331206
414,MunWolf,63,0.01902,269925,81.49762,331206
415,Nutriz,63,0.01902,269988,81.51664,331206
416,salvob41,63,0.01902,270051,81.53566,331206
417,TrickMe,63,0.01902,270114,81.55468,331206
418,Piet-G,62,0.01872,270176,81.57340,331206
419,Supatier,62,0.01872,270238,81.59212,331206
420,Vikram1323,62,0.01872,270300,81.61084,331206
421,viktor-ferenczi,62,0.01872,270362,81.62956,331206
422,Ahmed0425,61,0.01842,270423,81.64798,331206
423,Cygon,61,0.01842,270484,81.66639,331206
424,dark-penguin,61,0.01842,270545,81.68481,331206
425,earlroxas13,61,0.01842,270606,81.70323,331206
426,efornara,61,0.01842,270667,81.72165,331206
427,insomniacUNDERSCORElemon,61,0.01842,270728,81.74007,331206
428,mateusfccp,61,0.01842,270789,81.75848,331206
429,pcvonz,61,0.01842,270850,81.77690,331206
430,Bauxitedev,60,0.01812,270910,81.79502,331206
431,binbitten,60,0.01812,270970,81.81313,331206
432,Keyaku,60,0.01812,271030,81.83125,331206
433,lukaskotik,60,0.01812,271090,81.84936,331206
434,29jm,59,0.01781,271149,81.86718,331206
435,abhaskumarsinha,59,0.01781,271208,81.88499,331206
436,chuckeles,59,0.01781,271267,81.90280,331206
437,RabbitB,59,0.01781,271326,81.92062,331206
438,rosshadden,59,0.01781,271385,81.93843,331206
439,TheYokai,59,0.01781,271444,81.95624,331206
440,Tugsav,59,0.01781,271503,81.97406,331206
441,unfa,59,0.01781,271562,81.99187,331206
442,wombatstampede,59,0.01781,271621,82.00969,331206
443,DevinPentecost,58,0.01751,271679,82.02720,331206
444,Dragoncraft89,58,0.01751,271737,82.04471,331206
445,FlamyAT,58,0.01751,271795,82.06222,331206
446,JuanDidNothingWrong2,58,0.01751,271853,82.07973,331206
447,Lexpartizan,58,0.01751,271911,82.09724,331206
448,mcanders,58,0.01751,271969,82.11476,331206
449,Oranjoose,58,0.01751,272027,82.13227,331206
450,PetePete1984,58,0.01751,272085,82.14978,331206
451,ptrojahn,58,0.01751,272143,82.16729,331206
452,quantum-entangler,58,0.01751,272201,82.18480,331206
453,spongeboburu,58,0.01751,272259,82.20232,331206
454,stubbsy345,58,0.01751,272317,82.21983,331206
455,bdbaddog,57,0.01721,272374,82.23704,331206
456,ericrybick,57,0.01721,272431,82.25425,331206
457,gdesecrate,57,0.01721,272488,82.27146,331206
458,GlaDOSik,57,0.01721,272545,82.28867,331206
459,GrandFunkR,57,0.01721,272602,82.30588,331206
460,romlok,57,0.01721,272659,82.32309,331206
461,scottkunkel,57,0.01721,272716,82.34030,331206
462,CyanBlob,56,0.01691,272772,82.35720,331206
463,hedin-hiervard,56,0.01691,272828,82.37411,331206
464,mindinsomnia,56,0.01691,272884,82.39102,331206
465,ProbDenis,56,0.01691,272940,82.40793,331206
466,silverkorn,56,0.01691,272996,82.42484,331206
467,imekon,55,0.01661,273051,82.44144,331206
468,jmf,55,0.01661,273106,82.45805,331206
469,ofrank123,55,0.01661,273161,82.47465,331206
470,Bombfuse,54,0.01630,273215,82.49096,331206
471,ContinueToBuryHeadInSand,54,0.01630,273269,82.50726,331206
472,FEDE0D,54,0.01630,273323,82.52357,331206
473,rxlecky,54,0.01630,273377,82.53987,331206
474,ScotFlux,54,0.01630,273431,82.55617,331206
475,simpuid,54,0.01630,273485,82.57248,331206
476,willt,54,0.01630,273539,82.58878,331206
477,BrainBlasted,53,0.01600,273592,82.60478,331206
478,FlashDaggerX,53,0.01600,273645,82.62079,331206
479,hazarek,53,0.01600,273698,82.63679,331206
480,leiget,53,0.01600,273751,82.65279,331206
481,naturally-intelligent,53,0.01600,273804,82.66879,331206
482,sunnystormy,53,0.01600,273857,82.68479,331206
483,TomWor,53,0.01600,273910,82.70080,331206
484,buckle2000,52,0.01570,273962,82.71650,331206
485,DmitriySalnikov,52,0.01570,274014,82.73220,331206
486,garyo,52,0.01570,274066,82.74790,331206
487,HeadClot,52,0.01570,274118,82.76360,331206
488,mrjustaguy,52,0.01570,274170,82.77930,331206
489,NHodgesVFX,52,0.01570,274222,82.79500,331206
490,rafaelgdp,52,0.01570,274274,82.81070,331206
491,Riteo,52,0.01570,274326,82.82640,331206
492,cosmicchipsocket,51,0.01540,274377,82.84180,331206
493,jcs224,51,0.01540,274428,82.85719,331206
494,lethiandev,51,0.01540,274479,82.87259,331206
495,MillionOstrich,51,0.01540,274530,82.88799,331206
496,mrzapp,51,0.01540,274581,82.90339,331206
497,nezvers,51,0.01540,274632,82.91879,331206
498,PullTheStrings,51,0.01540,274683,82.93419,331206
499,Scony,51,0.01540,274734,82.94958,331206
500,tree786,51,0.01540,274785,82.96498,331206
501,turtletooth,51,0.01540,274836,82.98038,331206
502,vitorbalbio,51,0.01540,274887,82.99578,331206
503,AlexRixhardson,50,0.01510,274937,83.01088,331206
504,brunosxs,50,0.01510,274987,83.02597,331206
505,Byteron,50,0.01510,275037,83.04107,331206
506,Error7Studios,50,0.01510,275087,83.05616,331206
507,henkz1,50,0.01510,275137,83.07126,331206
508,hi-ogawa,50,0.01510,275187,83.08636,331206
509,matrem,50,0.01510,275237,83.10145,331206
510,MidZik,50,0.01510,275287,83.11655,331206
511,NewNodeGames,50,0.01510,275337,83.13165,331206
512,SekoiaTree,50,0.01510,275387,83.14674,331206
513,TeddyDD,50,0.01510,275437,83.16184,331206
514,Timofffee,50,0.01510,275487,83.17694,331206
515,Tooniis,50,0.01510,275537,83.19203,331206
516,AlmightyScientist,49,0.01479,275586,83.20683,331206
517,Andev08,49,0.01479,275635,83.22162,331206
518,Dentrax,49,0.01479,275684,83.23641,331206
519,khairul169,49,0.01479,275733,83.25121,331206
520,lavaduderDev,49,0.01479,275782,83.26600,331206
521,Leleat,49,0.01479,275831,83.28080,331206
522,lukostello,49,0.01479,275880,83.29559,331206
523,marcospb19,49,0.01479,275929,83.31039,331206
524,moiman100,49,0.01479,275978,83.32518,331206
525,ni-code,49,0.01479,276027,83.33998,331206
526,scayze,49,0.01479,276076,83.35477,331206
527,syskrank,49,0.01479,276125,83.36956,331206
528,TerminalJack,49,0.01479,276174,83.38436,331206
529,AtomaFajrovulpo,48,0.01449,276222,83.39885,331206
530,charliewhitfield,48,0.01449,276270,83.41334,331206
531,kawa-yoiko,48,0.01449,276318,83.42784,331206
532,lonesurvivor,48,0.01449,276366,83.44233,331206
533,MuffinManKen,48,0.01449,276414,83.45682,331206
534,mwerezak,48,0.01449,276462,83.47131,331206
535,RaXaR,48,0.01449,276510,83.48581,331206
536,SleepProgger,48,0.01449,276558,83.50030,331206
537,smedelyan,48,0.01449,276606,83.51479,331206
538,SolarLune,48,0.01449,276654,83.52928,331206
539,sprite-1,48,0.01449,276702,83.54378,331206
540,UgisBrekis,48,0.01449,276750,83.55827,331206
541,aole,47,0.01419,276797,83.57246,331206
542,CharlesWoodhill,47,0.01419,276844,83.58665,331206
543,Daw11,47,0.01419,276891,83.60084,331206
544,FeatherAntennae,47,0.01419,276938,83.61503,331206
545,hartsantler,47,0.01419,276985,83.62922,331206
546,hikari-no-yume,47,0.01419,277032,83.64341,331206
547,hmans,47,0.01419,277079,83.65760,331206
548,jknightdoeswork,47,0.01419,277126,83.67179,331206
549,NoFr1ends,47,0.01419,277173,83.68598,331206
550,suptoasty,47,0.01419,277220,83.70017,331206
551,Alex-doc,46,0.01389,277266,83.71406,331206
552,BenMcLean,46,0.01389,277312,83.72795,331206
553,DimOkGamer,46,0.01389,277358,83.74184,331206
554,EdwardAngeles,46,0.01389,277404,83.75573,331206
555,glaforte,46,0.01389,277450,83.76962,331206
556,grevius5,46,0.01389,277496,83.78351,331206
557,haxpor,46,0.01389,277542,83.79739,331206
558,JuanNeedsToApologize,46,0.01389,277588,83.81128,331206
559,NoodleSushi,46,0.01389,277634,83.82517,331206
560,NullConstant,46,0.01389,277680,83.83906,331206
561,paulhocker,46,0.01389,277726,83.85295,331206
562,pgoral,46,0.01389,277772,83.86684,331206
563,ScepticDope,46,0.01389,277818,83.88073,331206
564,vsrinu26f,46,0.01389,277864,83.89462,331206
565,WizzardMaker,46,0.01389,277910,83.90850,331206
566,beniwtv,45,0.01359,277955,83.92209,331206
567,Bonfi96,45,0.01359,278000,83.93568,331206
568,dsnopek,45,0.01359,278045,83.94926,331206
569,firecloud888,45,0.01359,278090,83.96285,331206
570,guzzard,45,0.01359,278135,83.97644,331206
571,iapps207,45,0.01359,278180,83.99002,331206
572,maksloboda,45,0.01359,278225,84.00361,331206
573,MichaelBelousov,45,0.01359,278270,84.01720,331206
574,MoriMalandro,45,0.01359,278315,84.03078,331206
575,ndee85,45,0.01359,278360,84.04437,331206
576,balloonpopper,44,0.01328,278404,84.05766,331206
577,Dar13,44,0.01328,278448,84.07094,331206
578,ealataur,44,0.01328,278492,84.08423,331206
579,lexum0,44,0.01328,278536,84.09751,331206
580,marcosbitetti,44,0.01328,278580,84.11080,331206
581,MrMaidx,44,0.01328,278624,84.12408,331206
582,rainlizard,44,0.01328,278668,84.13736,331206
583,rodolforg,44,0.01328,278712,84.15065,331206
584,silkentrance,44,0.01328,278756,84.16393,331206
585,Valentactive,44,0.01328,278800,84.17722,331206
586,ZodmanPerth,44,0.01328,278844,84.19050,331206
587,aurodev,43,0.01298,278887,84.20349,331206
588,DanielZTing,43,0.01298,278930,84.21647,331206
589,danilo2205,43,0.01298,278973,84.22945,331206
590,donkeybonks,43,0.01298,279016,84.24244,331206
591,Ertain,43,0.01298,279059,84.25542,331206
592,Goutte,43,0.01298,279102,84.26840,331206
593,ippan,43,0.01298,279145,84.28138,331206
594,JuanDidNothingWrong1,43,0.01298,279188,84.29437,331206
595,MJacred,43,0.01298,279231,84.30735,331206
596,name-here,43,0.01298,279274,84.32033,331206
597,profelis,43,0.01298,279317,84.33332,331206
598,TheMoye,43,0.01298,279360,84.34630,331206
599,TypeOverride,43,0.01298,279403,84.35928,331206
600,zatherz,43,0.01298,279446,84.37226,331206
601,90Moose,42,0.01268,279488,84.38494,331206
602,Boothand,42,0.01268,279530,84.39763,331206
603,Gastronok,42,0.01268,279572,84.41031,331206
604,Houkime,42,0.01268,279614,84.42299,331206
605,JupiterRider,42,0.01268,279656,84.43567,331206
606,takaturre,42,0.01268,279698,84.44835,331206
607,txj-mssl,42,0.01268,279740,84.46103,331206
608,vybr,42,0.01268,279782,84.47371,331206
609,hammeron-art,41,0.01238,279823,84.48609,331206
610,jtaart,41,0.01238,279864,84.49847,331206
611,luizcarlos1405,41,0.01238,279905,84.51085,331206
612,MelvinWM,41,0.01238,279946,84.52323,331206
613,MennoMax,41,0.01238,279987,84.53561,331206
614,MHillier98,41,0.01238,280028,84.54799,331206
615,OliPerraul,41,0.01238,280069,84.56036,331206
616,Overblob,41,0.01238,280110,84.57274,331206
617,rafaeldelboni,41,0.01238,280151,84.58512,331206
618,raould,41,0.01238,280192,84.59750,331206
619,sudoio,41,0.01238,280233,84.60988,331206
620,BigRed-118,40,0.01208,280273,84.62196,331206
621,ChronoDK,40,0.01208,280313,84.63403,331206
622,gururise,40,0.01208,280353,84.64611,331206
623,justinluk,40,0.01208,280393,84.65819,331206
624,r3d9u11,40,0.01208,280433,84.67027,331206
625,tuga3d,40,0.01208,280473,84.68234,331206
626,Vultraz,40,0.01208,280513,84.69442,331206
627,Brickcaster,39,0.01178,280552,84.70619,331206
628,CodeDarigan,39,0.01178,280591,84.71797,331206
629,Coldragon,39,0.01178,280630,84.72975,331206
630,David-Ochoa,39,0.01178,280669,84.74152,331206
631,dejaime,39,0.01178,280708,84.75330,331206
632,dploeger,39,0.01178,280747,84.76507,331206
633,genete,39,0.01178,280786,84.77685,331206
634,ghsoares,39,0.01178,280825,84.78862,331206
635,hickop,39,0.01178,280864,84.80040,331206
636,jkb0o,39,0.01178,280903,84.81217,331206
637,kestrelm,39,0.01178,280942,84.82395,331206
638,kirilledelman,39,0.01178,280981,84.83572,331206
639,kruglinski,39,0.01178,281020,84.84750,331206
640,MednauN,39,0.01178,281059,84.85927,331206
641,N0hbdy,39,0.01178,281098,84.87105,331206
642,nagasawamaki,39,0.01178,281137,84.88282,331206
643,Nallebeorn,39,0.01178,281176,84.89460,331206
644,primesoftware,39,0.01178,281215,84.90637,331206
645,redxdev,39,0.01178,281254,84.91815,331206
646,Spartan322,39,0.01178,281293,84.92992,331206
647,TX256,39,0.01178,281332,84.94170,331206
648,Vega-KH,39,0.01178,281371,84.95347,331206
649,xfactor2000,39,0.01178,281410,84.96525,331206
650,xix-xeaon,39,0.01178,281449,84.97702,331206
651,Akira1San,38,0.01147,281487,84.98850,331206
652,davidpgil,38,0.01147,281525,84.99997,331206
653,eduardonunesp,38,0.01147,281563,85.01144,331206
654,Gramps,38,0.01147,281601,85.02292,331206
655,hiulit,38,0.01147,281639,85.03439,331206
656,Larpon,38,0.01147,281677,85.04586,331206
657,lentsius-bark,38,0.01147,281715,85.05734,331206
658,romulox-x,38,0.01147,281753,85.06881,331206
659,saltares,38,0.01147,281791,85.08028,331206
660,sezit,38,0.01147,281829,85.09176,331206
661,Valeryn4,38,0.01147,281867,85.10323,331206
662,WindyDarian,38,0.01147,281905,85.11470,331206
663,wombatwingdings,38,0.01147,281943,85.12618,331206
664,alketii,37,0.01117,281980,85.13735,331206
665,Classy11,37,0.01117,282017,85.14852,331206
666,dbsGen,37,0.01117,282054,85.15969,331206
667,fabriceci,37,0.01117,282091,85.17086,331206
668,goatchurchprime,37,0.01117,282128,85.18203,331206
669,IlyaStuurFedorov,37,0.01117,282165,85.19320,331206
670,jaggygames,37,0.01117,282202,85.20437,331206
671,organicpencil,37,0.01117,282239,85.21555,331206
672,pchasco,37,0.01117,282276,85.22672,331206
673,PelegMedia,37,0.01117,282313,85.23789,331206
674,rileyrg,37,0.01117,282350,85.24906,331206
675,simpleyo,37,0.01117,282387,85.26023,331206
676,Superwaitsum,37,0.01117,282424,85.27140,331206
677,umarcor,37,0.01117,282461,85.28257,331206
678,zmanuel,37,0.01117,282498,85.29374,331206
679,20kdc,36,0.01087,282534,85.30461,331206
680,2plus2makes5,36,0.01087,282570,85.31548,331206
681,alex-evelyn,36,0.01087,282606,85.32635,331206
682,ankitpriyarup,36,0.01087,282642,85.33722,331206
683,Duehok,36,0.01087,282678,85.34809,331206
684,Einlander,36,0.01087,282714,85.35896,331206
685,ficoos,36,0.01087,282750,85.36983,331206
686,hasahmed,36,0.01087,282786,85.38070,331206
687,jeremyz,36,0.01087,282822,85.39157,331206
688,JohanAR,36,0.01087,282858,85.40244,331206
689,kjav,36,0.01087,282894,85.41331,331206
690,Linko-3D,36,0.01087,282930,85.42418,331206
691,lyuma,36,0.01087,282966,85.43505,331206
692,Malkverbena,36,0.01087,283002,85.44592,331206
693,MikeSchulze,36,0.01087,283038,85.45679,331206
694,rezgi,36,0.01087,283074,85.46765,331206
695,RodeoMcCabe,36,0.01087,283110,85.47852,331206
696,sicienss,36,0.01087,283146,85.48939,331206
697,zoiba,36,0.01087,283182,85.50026,331206
698,Barina,35,0.01057,283217,85.51083,331206
699,bkeys,35,0.01057,283252,85.52140,331206
700,blockspacer,35,0.01057,283287,85.53197,331206
701,dumitru-stama,35,0.01057,283322,85.54253,331206
702,firefly2442,35,0.01057,283357,85.55310,331206
703,GDScriptHacker5000LOL,35,0.01057,283392,85.56367,331206
704,giulianob,35,0.01057,283427,85.57423,331206
705,Jeto143,35,0.01057,283462,85.58480,331206
706,pixelpicosean,35,0.01057,283497,85.59537,331206
707,Ploppy3,35,0.01057,283532,85.60594,331206
708,sami8github,35,0.01057,283567,85.61650,331206
709,Sauermann,35,0.01057,283602,85.62707,331206
710,shackra,35,0.01057,283637,85.63764,331206
711,strank,35,0.01057,283672,85.64821,331206
712,vinod8990,35,0.01057,283707,85.65877,331206
713,willvincent,35,0.01057,283742,85.66934,331206
714,Aaron-Fleisher,34,0.01027,283776,85.67961,331206
715,bluenote10,34,0.01027,283810,85.68987,331206
716,BrahRah,34,0.01027,283844,85.70014,331206
717,DenisComtesse,34,0.01027,283878,85.71040,331206
718,giovanigsilva,34,0.01027,283912,85.72067,331206
719,katoneko,34,0.01027,283946,85.73093,331206
720,kb173,34,0.01027,283980,85.74120,331206
721,Lisapple,34,0.01027,284014,85.75147,331206
722,mega-bit,34,0.01027,284048,85.76173,331206
723,oldmerkum,34,0.01027,284082,85.77200,331206
724,Schweini07,34,0.01027,284116,85.78226,331206
725,songproducer,34,0.01027,284150,85.79253,331206
726,TheFlamyy,34,0.01027,284184,85.80279,331206
727,veryprofessionaldodo,34,0.01027,284218,85.81306,331206
728,vini-guerrero,34,0.01027,284252,85.82332,331206
729,Yetizone,34,0.01027,284286,85.83359,331206
730,Aegisofer,33,0.00996,284319,85.84355,331206
731,anakimluke,33,0.00996,284352,85.85352,331206
732,Arech,33,0.00996,284385,85.86348,331206
733,CakHuri,33,0.00996,284418,85.87344,331206
734,Cykyrios,33,0.00996,284451,85.88341,331206
735,flashyincceo,33,0.00996,284484,85.89337,331206
736,ivodopiviz,33,0.00996,284517,85.90334,331206
737,KelinciFX,33,0.00996,284550,85.91330,331206
738,KioriSun,33,0.00996,284583,85.92326,331206
739,MissKraya,33,0.00996,284616,85.93323,331206
740,monk-e-boy,33,0.00996,284649,85.94319,331206
741,mrawlingst,33,0.00996,284682,85.95315,331206
742,mrimvo,33,0.00996,284715,85.96312,331206
743,nhold,33,0.00996,284748,85.97308,331206
744,Qws,33,0.00996,284781,85.98304,331206
745,ShlomiRex,33,0.00996,284814,85.99301,331206
746,supaiku-o,33,0.00996,284847,86.00297,331206
747,TotCac,33,0.00996,284880,86.01293,331206
748,yuyubibibobibo,33,0.00996,284913,86.02290,331206
749,Alexander-Alekseev,32,0.00966,284945,86.03256,331206
750,Andrettin,32,0.00966,284977,86.04222,331206
751,anissen,32,0.00966,285009,86.05188,331206
752,anoadragon453,32,0.00966,285041,86.06154,331206
753,brakhane,32,0.00966,285073,86.07121,331206
754,carlosfvieira,32,0.00966,285105,86.08087,331206
755,CenTdemeern1,32,0.00966,285137,86.09053,331206
756,DDru,32,0.00966,285169,86.10019,331206
757,jbuck3,32,0.00966,285201,86.10985,331206
758,kurikaesu,32,0.00966,285233,86.11951,331206
759,matthew1006,32,0.00966,285265,86.12918,331206
760,rcurtis,32,0.00966,285297,86.13884,331206
761,rileylyman,32,0.00966,285329,86.14850,331206
762,Soaku,32,0.00966,285361,86.15816,331206
763,TailyFair,32,0.00966,285393,86.16782,331206
764,tofuhead,32,0.00966,285425,86.17748,331206
765,x1212,32,0.00966,285457,86.18715,331206
766,amisner2k,31,0.00936,285488,86.19651,331206
767,DuncanSparks,31,0.00936,285519,86.20587,331206
768,gad-o,31,0.00936,285550,86.21523,331206
769,goodyttoor,31,0.00936,285581,86.22459,331206
770,jotson,31,0.00936,285612,86.23395,331206
771,Mintormo,31,0.00936,285643,86.24330,331206
772,mrwanashraf,31,0.00936,285674,86.25266,331206
773,MrZak-dev,31,0.00936,285705,86.26202,331206
774,nathanjwtx,31,0.00936,285736,86.27138,331206
775,qonnop,31,0.00936,285767,86.28074,331206
776,splite,31,0.00936,285798,86.29010,331206
777,Steph155,31,0.00936,285829,86.29946,331206
778,TheSofox,31,0.00936,285860,86.30882,331206
779,t-karcher,31,0.00936,285891,86.31818,331206
780,ZingBlue,31,0.00936,285922,86.32754,331206
781,BBric,30,0.00906,285952,86.33660,331206
782,ChristopheLY,30,0.00906,285982,86.34566,331206
783,ClikCode,30,0.00906,286012,86.35472,331206
784,d9n,30,0.00906,286042,86.36377,331206
785,DegradedMind,30,0.00906,286072,86.37283,331206
786,Elinvention,30,0.00906,286102,86.38189,331206
787,Flairieve,30,0.00906,286132,86.39095,331206
788,HugeGameArtGD,30,0.00906,286162,86.40000,331206
789,maikramer,30,0.00906,286192,86.40906,331206
790,nazgulsenpai,30,0.00906,286222,86.41812,331206
791,nightrobin,30,0.00906,286252,86.42718,331206
792,Plasmmer,30,0.00906,286282,86.43624,331206
793,QuentinCaffeino,30,0.00906,286312,86.44529,331206
794,swenner,30,0.00906,286342,86.45435,331206
795,WilliamTambellini,30,0.00906,286372,86.46341,331206
796,WolfgangSenff,30,0.00906,286402,86.47247,331206
797,zhagsenkk,30,0.00906,286432,86.48153,331206
798,alex9099,29,0.00876,286461,86.49028,331206
799,antoniotorresm,29,0.00876,286490,86.49904,331206
800,Arrow-x,29,0.00876,286519,86.50779,331206
801,behelit2,29,0.00876,286548,86.51655,331206
802,bemyak,29,0.00876,286577,86.52530,331206
803,captainwasabi,29,0.00876,286606,86.53406,331206
804,cgbeutler,29,0.00876,286635,86.54282,331206
805,code-xD,29,0.00876,286664,86.55157,331206
806,Darenn,29,0.00876,286693,86.56033,331206
807,gotnospirit,29,0.00876,286722,86.56908,331206
808,gtsiam,29,0.00876,286751,86.57784,331206
809,JosephCatrambone,29,0.00876,286780,86.58660,331206
810,kiidmale,29,0.00876,286809,86.59535,331206
811,louisVottero,29,0.00876,286838,86.60411,331206
812,metaphoricalsasquash,29,0.00876,286867,86.61286,331206
813,norton-corbett,29,0.00876,286896,86.62162,331206
814,nounoursheureux,29,0.00876,286925,86.63038,331206
815,oisincar,29,0.00876,286954,86.63913,331206
816,pyacier,29,0.00876,286983,86.64789,331206
817,razvanc87,29,0.00876,287012,86.65664,331206
818,regakakobigman,29,0.00876,287041,86.66540,331206
819,robertdhernandez,29,0.00876,287070,86.67415,331206
820,robgraeber,29,0.00876,287099,86.68291,331206
821,ScyDev,29,0.00876,287128,86.69167,331206
822,usbhell,29,0.00876,287157,86.70042,331206
823,ViktorEvil,29,0.00876,287186,86.70918,331206
824,WiggleWizard,29,0.00876,287215,86.71793,331206
825,Amssat221,28,0.00845,287243,86.72639,331206
826,Arkhano,28,0.00845,287271,86.73484,331206
827,Arunkumar1998BOM,28,0.00845,287299,86.74330,331206
828,azurvii,28,0.00845,287327,86.75175,331206
829,bitwes,28,0.00845,287355,86.76020,331206
830,BraindeadBZH,28,0.00845,287383,86.76866,331206
831,CedNaru,28,0.00845,287411,86.77711,331206
832,Cevantime,28,0.00845,287439,86.78557,331206
833,Cheeseness,28,0.00845,287467,86.79402,331206
834,DEF7,28,0.00845,287495,86.80247,331206
835,dunyakilavuz,28,0.00845,287523,86.81093,331206
836,greenfox1505,28,0.00845,287551,86.81938,331206
837,khaledhosny,28,0.00845,287579,86.82784,331206
838,linkpy,28,0.00845,287607,86.83629,331206
839,mdahlgrengadd,28,0.00845,287635,86.84474,331206
840,miskatonicstudio,28,0.00845,287663,86.85320,331206
841,MrMinimal,28,0.00845,287691,86.86165,331206
842,Nufflee,28,0.00845,287719,86.87011,331206
843,PerduGames,28,0.00845,287747,86.87856,331206
844,radubolovan,28,0.00845,287775,86.88701,331206
845,RyanStein,28,0.00845,287803,86.89547,331206
846,sam-leo,28,0.00845,287831,86.90392,331206
847,sampengilly,28,0.00845,287859,86.91237,331206
848,ScottMakesGames,28,0.00845,287887,86.92083,331206
849,Shockblast,28,0.00845,287915,86.92928,331206
850,SonerSound,28,0.00845,287943,86.93774,331206
851,starryalley,28,0.00845,287971,86.94619,331206
852,TheWhiteLlama,28,0.00845,287999,86.95464,331206
853,TokageItLab,28,0.00845,288027,86.96310,331206
854,Vivraan,28,0.00845,288055,86.97155,331206
855,vortexofdoom,28,0.00845,288083,86.98001,331206
856,abaky,27,0.00815,288110,86.98816,331206
857,aBARICHELLO,27,0.00815,288137,86.99631,331206
858,alexwbc,27,0.00815,288164,87.00446,331206
859,austinried,27,0.00815,288191,87.01261,331206
860,chenjie199234,27,0.00815,288218,87.02077,331206
861,georgikoemdzhiev,27,0.00815,288245,87.02892,331206
862,haizhou37,27,0.00815,288272,87.03707,331206
863,Itachi124,27,0.00815,288299,87.04522,331206
864,jay3d,27,0.00815,288326,87.05337,331206
865,johannesgunnar,27,0.00815,288353,87.06153,331206
866,lakshay-angrish,27,0.00815,288380,87.06968,331206
867,LoneDespair,27,0.00815,288407,87.07783,331206
868,MrJustreborn,27,0.00815,288434,87.08598,331206
869,MysteryGM,27,0.00815,288461,87.09413,331206
870,N8n5h,27,0.00815,288488,87.10229,331206
871,qichunren,27,0.00815,288515,87.11044,331206
872,savegame,27,0.00815,288542,87.11859,331206
873,trommlbomml,27,0.00815,288569,87.12674,331206
874,underdoeg,27,0.00815,288596,87.13489,331206
875,vblanco20-1,27,0.00815,288623,87.14305,331206
876,vickylance,27,0.00815,288650,87.15120,331206
877,ywaby,27,0.00815,288677,87.15935,331206
878,19PHOBOSS98,26,0.00785,288703,87.16720,331206
879,aaronmzn,26,0.00785,288729,87.17505,331206
880,amedlock,26,0.00785,288755,87.18290,331206
881,Beuc,26,0.00785,288781,87.19075,331206
882,briansemrau,26,0.00785,288807,87.19860,331206
883,CereEnder,26,0.00785,288833,87.20645,331206
884,CitrusWire,26,0.00785,288859,87.21430,331206
885,ddevault,26,0.00785,288885,87.22215,331206
886,drtwisted,26,0.00785,288911,87.23000,331206
887,Elmapul,26,0.00785,288937,87.23785,331206
888,giarve,26,0.00785,288963,87.24570,331206
889,kerskuchen,26,0.00785,288989,87.25355,331206
890,lefay1982,26,0.00785,289015,87.26140,331206
891,lorenzobeccaro,26,0.00785,289041,87.26925,331206
892,lukaszbulzacki,26,0.00785,289067,87.27710,331206
893,Mavhod,26,0.00785,289093,87.28495,331206
894,megalike,26,0.00785,289119,87.29280,331206
895,njt1982,26,0.00785,289145,87.30065,331206
896,robbertzzz,26,0.00785,289171,87.30850,331206
897,thimenesup,26,0.00785,289197,87.31635,331206
898,tobiblender,26,0.00785,289223,87.32420,331206
899,triptych,26,0.00785,289249,87.33205,331206
900,winston-yallow,26,0.00785,289275,87.33990,331206
901,zhangshiqian1214,26,0.00785,289301,87.34775,331206
902,0nepixel,25,0.00755,289326,87.35530,331206
903,99alfie,25,0.00755,289351,87.36285,331206
904,alabd14313,25,0.00755,289376,87.37040,331206
905,AlexHoratio,25,0.00755,289401,87.37795,331206
906,buresu,25,0.00755,289426,87.38549,331206
907,chaosdrop,25,0.00755,289451,87.39304,331206
908,fsy98,25,0.00755,289476,87.40059,331206
909,FuzzyRhombus,25,0.00755,289501,87.40814,331206
910,Galileo53,25,0.00755,289526,87.41569,331206
911,gitcatrat,25,0.00755,289551,87.42324,331206
912,hurikhan,25,0.00755,289576,87.43078,331206
913,knadoor,25,0.00755,289601,87.43833,331206
914,koalefant,25,0.00755,289626,87.44588,331206
915,lmbarros,25,0.00755,289651,87.45343,331206
916,MasterPolska123,25,0.00755,289676,87.46098,331206
917,Miziziziz,25,0.00755,289701,87.46852,331206
918,Myran,25,0.00755,289726,87.47607,331206
919,nodj,25,0.00755,289751,87.48362,331206
920,owstetra,25,0.00755,289776,87.49117,331206
921,PonasKovas,25,0.00755,289801,87.49872,331206
922,RaTi17,25,0.00755,289826,87.50626,331206
923,Sphynxinator,25,0.00755,289851,87.51381,331206
924,spookdogg,25,0.00755,289876,87.52136,331206
925,TIBI4,25,0.00755,289901,87.52891,331206
926,Waridley,25,0.00755,289926,87.53646,331206
927,yaelatletl,25,0.00755,289951,87.54401,331206
928,YRTV,25,0.00755,289976,87.55155,331206
929,zaevi,25,0.00755,290001,87.55910,331206
930,Alastor01,24,0.00725,290025,87.56635,331206
931,benbishopnz,24,0.00725,290049,87.57359,331206
932,brylie,24,0.00725,290073,87.58084,331206
933,carlosmarti,24,0.00725,290097,87.58809,331206
934,caryoscelus,24,0.00725,290121,87.59533,331206
935,ChibiDenDen,24,0.00725,290145,87.60258,331206
936,Crazy-P,24,0.00725,290169,87.60983,331206
937,dariuspranskus,24,0.00725,290193,87.61707,331206
938,deepmax,24,0.00725,290217,87.62432,331206
939,DjPale,24,0.00725,290241,87.63156,331206
940,Giwayume,24,0.00725,290265,87.63881,331206
941,Hello445,24,0.00725,290289,87.64606,331206
942,Jiaming00,24,0.00725,290313,87.65330,331206
943,JiRuifanCR,24,0.00725,290337,87.66055,331206
944,juan-garcia-m,24,0.00725,290361,87.66780,331206
945,kbake,24,0.00725,290385,87.67504,331206
946,Klowner,24,0.00725,290409,87.68229,331206
947,lawsonry,24,0.00725,290433,87.68953,331206
948,lehthanis,24,0.00725,290457,87.69678,331206
949,malcolmhoward,24,0.00725,290481,87.70403,331206
950,manokara,24,0.00725,290505,87.71127,331206
951,MatiasVME,24,0.00725,290529,87.71852,331206
952,nopeson,24,0.00725,290553,87.72577,331206
953,okapii,24,0.00725,290577,87.73301,331206
954,Paavs-Git,24,0.00725,290601,87.74026,331206
955,purpleorangegames,24,0.00725,290625,87.74750,331206
956,qq715152910,24,0.00725,290649,87.75475,331206
957,RiverMesa,24,0.00725,290673,87.76200,331206
958,Rocket-Buddha,24,0.00725,290697,87.76924,331206
959,Ron5s,24,0.00725,290721,87.77649,331206
960,RonanZe,24,0.00725,290745,87.78374,331206
961,sambler,24,0.00725,290769,87.79098,331206
962,siddharth952,24,0.00725,290793,87.79823,331206
963,soloparatolos,24,0.00725,290817,87.80547,331206
964,sowfelicity,24,0.00725,290841,87.81272,331206
965,SpechtMagnus,24,0.00725,290865,87.81997,331206
966,Thaina,24,0.00725,290889,87.82721,331206
967,Xenoamor,24,0.00725,290913,87.83446,331206
968,yuyoDev,24,0.00725,290937,87.84171,331206
969,zEh-,24,0.00725,290961,87.84895,331206
970,316902108,23,0.00694,290984,87.85590,331206
971,amirea,23,0.00694,291007,87.86284,331206
972,AndersonFirmino,23,0.00694,291030,87.86978,331206
973,Ansraer,23,0.00694,291053,87.87673,331206
974,AntiSC2,23,0.00694,291076,87.88367,331206
975,API-Beast,23,0.00694,291099,87.89062,331206
976,batmanasb,23,0.00694,291122,87.89756,331206
977,bncastle,23,0.00694,291145,87.90451,331206
978,Catprog,23,0.00694,291168,87.91145,331206
979,cooperra,23,0.00694,291191,87.91840,331206
980,diowonderland,23,0.00694,291214,87.92534,331206
981,erammos,23,0.00694,291237,87.93228,331206
982,georgwacker,23,0.00694,291260,87.93923,331206
983,GiantBlargg,23,0.00694,291283,87.94617,331206
984,godofgrunts,23,0.00694,291306,87.95312,331206
985,GodotIsAMess,23,0.00694,291329,87.96006,331206
986,IuryBorges1993,23,0.00694,291352,87.96701,331206
987,ivanskodje,23,0.00694,291375,87.97395,331206
988,j2l,23,0.00694,291398,87.98089,331206
989,jeronimo-schreyer,23,0.00694,291421,87.98784,331206
990,JoshLee0915,23,0.00694,291444,87.99478,331206
991,lmjk,23,0.00694,291467,88.00173,331206
992,ludorverr,23,0.00694,291490,88.00867,331206
993,M4gma,23,0.00694,291513,88.01562,331206
994,mani144,23,0.00694,291536,88.02256,331206
995,MasonAsh,23,0.00694,291559,88.02950,331206
996,nazgum,23,0.00694,291582,88.03645,331206
997,Nibodhika,23,0.00694,291605,88.04339,331206
998,pepegadeveloper123,23,0.00694,291628,88.05034,331206
999,piyushdagar,23,0.00694,291651,88.05728,331206
1000,raulsntos,23,0.00694,291674,88.06423,331206
1001,rick551a,23,0.00694,291697,88.07117,331206
1002,rredesigns,23,0.00694,291720,88.07811,331206
1003,samuelgrigolato,23,0.00694,291743,88.08506,331206
1004,SecretPanda420,23,0.00694,291766,88.09200,331206
1005,seichter,23,0.00694,291789,88.09895,331206
1006,tamkcr,23,0.00694,291812,88.10589,331206
1007,TicklesTheBrain,23,0.00694,291835,88.11284,331206
1008,Type1J,23,0.00694,291858,88.11978,331206
1009,uldall,23,0.00694,291881,88.12672,331206
1010,UltyX,23,0.00694,291904,88.13367,331206
1011,vkbsb,23,0.00694,291927,88.14061,331206
1012,wmww,23,0.00694,291950,88.14756,331206
1013,zak-grumbles,23,0.00694,291973,88.15450,331206
1014,AlexAndDraw,22,0.00664,291995,88.16114,331206
1015,AllanDaemon,22,0.00664,292017,88.16779,331206
1016,bruno-reload,22,0.00664,292039,88.17443,331206
1017,canvasbushi,22,0.00664,292061,88.18107,331206
1018,ConnorBP,22,0.00664,292083,88.18771,331206
1019,cybereality,22,0.00664,292105,88.19436,331206
1020,Evrey,22,0.00664,292127,88.20100,331206
1021,flyingpimonster,22,0.00664,292149,88.20764,331206
1022,frankiezafe,22,0.00664,292171,88.21428,331206
1023,gcardozo123,22,0.00664,292193,88.22093,331206
1024,Giacom,22,0.00664,292215,88.22757,331206
1025,gitnob,22,0.00664,292237,88.23421,331206
1026,GoDino,22,0.00664,292259,88.24085,331206
1027,GovanifY,22,0.00664,292281,88.24750,331206
1028,Griatch,22,0.00664,292303,88.25414,331206
1029,Hromon,22,0.00664,292325,88.26078,331206
1030,jagt,22,0.00664,292347,88.26742,331206
1031,JohnCWakley,22,0.00664,292369,88.27407,331206
1032,JohnMeadow1,22,0.00664,292391,88.28071,331206
1033,jonri,22,0.00664,292413,88.28735,331206
1034,letsgamedev,22,0.00664,292435,88.29399,331206
1035,Nehluxhes,22,0.00664,292457,88.30063,331206
1036,nuke-makes-games,22,0.00664,292479,88.30728,331206
1037,ObaniGemini,22,0.00664,292501,88.31392,331206
1038,PoirotovBrk,22,0.00664,292523,88.32056,331206
1039,quantmint,22,0.00664,292545,88.32720,331206
1040,ranmaru90,22,0.00664,292567,88.33385,331206
1041,rieniter,22,0.00664,292589,88.34049,331206
1042,samuelpedrajas,22,0.00664,292611,88.34713,331206
1043,sbeca,22,0.00664,292633,88.35377,331206
1044,Schroedi,22,0.00664,292655,88.36042,331206
1045,ShalokShalom,22,0.00664,292677,88.36706,331206
1046,slurps-mad-rips,22,0.00664,292699,88.37370,331206
1047,Smellyhobo101,22,0.00664,292721,88.38034,331206
1048,TGRCdev,22,0.00664,292743,88.38699,331206
1049,theludovyc,22,0.00664,292765,88.39363,331206
1050,yeonghoey,22,0.00664,292787,88.40027,331206
1051,ZuBsPaCe,22,0.00664,292809,88.40691,331206
1052,111ukasz111,21,0.00634,292830,88.41325,331206
1053,adabru,21,0.00634,292851,88.41959,331206
1054,adeluiz,21,0.00634,292872,88.42593,331206
1055,Algrin6,21,0.00634,292893,88.43227,331206
1056,bigmonte,21,0.00634,292914,88.43862,331206
1057,bitbionic,21,0.00634,292935,88.44496,331206
1058,bruno-ortiz,21,0.00634,292956,88.45130,331206
1059,CalinouLovesElectronUI,21,0.00634,292977,88.45764,331206
1060,Capital-EX,21,0.00634,292998,88.46398,331206
1061,CodeforEvolution,21,0.00634,293019,88.47032,331206
1062,DisDoh,21,0.00634,293040,88.47666,331206
1063,etalot,21,0.00634,293061,88.48300,331206
1064,gattila,21,0.00634,293082,88.48934,331206
1065,honix,21,0.00634,293103,88.49568,331206
1066,I7SOD,21,0.00634,293124,88.50202,331206
1067,jebedaia360,21,0.00634,293145,88.50836,331206
1068,jgodfrey,21,0.00634,293166,88.51470,331206
1069,jv110,21,0.00634,293187,88.52104,331206
1070,karl-run,21,0.00634,293208,88.52738,331206
1071,ksvslk,21,0.00634,293229,88.53372,331206
1072,LaurentOngaro,21,0.00634,293250,88.54006,331206
1073,Lucky0710,21,0.00634,293271,88.54640,331206
1074,mateka,21,0.00634,293292,88.55274,331206
1075,mechPenSketch,21,0.00634,293313,88.55908,331206
1076,myhalibobo,21,0.00634,293334,88.56542,331206
1077,NelloDev,21,0.00634,293355,88.57177,331206
1078,OGMP-Gyrth,21,0.00634,293376,88.57811,331206
1079,opl-,21,0.00634,293397,88.58445,331206
1080,RicardRC,21,0.00634,293418,88.59079,331206
1081,ricpelo,21,0.00634,293439,88.59713,331206
1082,ryancheung,21,0.00634,293460,88.60347,331206
1083,samdaiya,21,0.00634,293481,88.60981,331206
1084,samH-FIT,21,0.00634,293502,88.61615,331206
1085,Socterean,21,0.00634,293523,88.62249,331206
1086,SoIAS,21,0.00634,293544,88.62883,331206
1087,T4g1,21,0.00634,293565,88.63517,331206
1088,teamblubee,21,0.00634,293586,88.64151,331206
1089,theboyboy,21,0.00634,293607,88.64785,331206
1090,vrbandwagon,21,0.00634,293628,88.65419,331206
1091,Wiadomy,21,0.00634,293649,88.66053,331206
1092,wijat,21,0.00634,293670,88.66687,331206
1093,x2f,21,0.00634,293691,88.67321,331206
1094,9BitStrider,20,0.00604,293711,88.67925,331206
1095,Adinimys,20,0.00604,293731,88.68529,331206
1096,AinaSG,20,0.00604,293751,88.69133,331206
1097,AttackButton,20,0.00604,293771,88.69737,331206
1098,Avantir-Chaosfire,20,0.00604,293791,88.70341,331206
1099,Banderi,20,0.00604,293811,88.70944,331206
1100,berserk82,20,0.00604,293831,88.71548,331206
1101,boruok,20,0.00604,293851,88.72152,331206
1102,Catchawink,20,0.00604,293871,88.72756,331206
1103,Causeless,20,0.00604,293891,88.73360,331206
1104,DarkMessiah,20,0.00604,293911,88.73964,331206
1105,deliciousfudge,20,0.00604,293931,88.74567,331206
1106,dertom95,20,0.00604,293951,88.75171,331206
1107,dh928,20,0.00604,293971,88.75775,331206
1108,drequivalent,20,0.00604,293991,88.76379,331206
1109,dualtagh,20,0.00604,294011,88.76983,331206
1110,Footurist,20,0.00604,294031,88.77587,331206
1111,Gfurst,20,0.00604,294051,88.78191,331206
1112,headkase,20,0.00604,294071,88.78794,331206
1113,hsandt,20,0.00604,294091,88.79398,331206
1114,Hubber116sx,20,0.00604,294111,88.80002,331206
1115,huhund,20,0.00604,294131,88.80606,331206
1116,jak6jak,20,0.00604,294151,88.81210,331206
1117,Jakob-PB,20,0.00604,294171,88.81814,331206
1118,jcarlosrc,20,0.00604,294191,88.82418,331206
1119,Jcozman,20,0.00604,294211,88.83021,331206
1120,Kazuo256,20,0.00604,294231,88.83625,331206
1121,KenHuang0917,20,0.00604,294251,88.84229,331206
1122,LATRio,20,0.00604,294271,88.84833,331206
1123,lightspot21,20,0.00604,294291,88.85437,331206
1124,logicor-cn,20,0.00604,294311,88.86041,331206
1125,Logmytech,20,0.00604,294331,88.86645,331206
1126,lopho,20,0.00604,294351,88.87248,331206
1127,MutantOctopus,20,0.00604,294371,88.87852,331206
1128,MWFIAE,20,0.00604,294391,88.88456,331206
1129,noshyaar,20,0.00604,294411,88.89060,331206
1130,PoqXert,20,0.00604,294431,88.89664,331206
1131,PostPollux,20,0.00604,294451,88.90268,331206
1132,procedural,20,0.00604,294471,88.90872,331206
1133,randibit,20,0.00604,294491,88.91475,331206
1134,semirix,20,0.00604,294511,88.92079,331206
1135,sergey-push,20,0.00604,294531,88.92683,331206
1136,Skyfish1,20,0.00604,294551,88.93287,331206
1137,Sl3dge78,20,0.00604,294571,88.93891,331206
1138,Smjert,20,0.00604,294591,88.94495,331206
1139,SneakyFish5,20,0.00604,294611,88.95099,331206
1140,stonekase,20,0.00604,294631,88.95702,331206
1141,TheAspiringHacker,20,0.00604,294651,88.96306,331206
1142,vjrossi,20,0.00604,294671,88.96910,331206
1143,xelivous,20,0.00604,294691,88.97514,331206
1144,zejji,20,0.00604,294711,88.98118,331206
1145,31,19,0.00574,294730,88.98691,331206
1146,aaschmitz,19,0.00574,294749,88.99265,331206
1147,alkhimey,19,0.00574,294768,88.99839,331206
1148,Altair1234,19,0.00574,294787,89.00412,331206
1149,ASavchenkov,19,0.00574,294806,89.00986,331206
1150,Ashafix,19,0.00574,294825,89.01560,331206
1151,AsherGlick,19,0.00574,294844,89.02133,331206
1152,balenol,19,0.00574,294863,89.02707,331206
1153,bd339,19,0.00574,294882,89.03281,331206
1154,Biliogadafr,19,0.00574,294901,89.03854,331206
1155,chiguireitor,19,0.00574,294920,89.04428,331206
1156,clayheaton,19,0.00574,294939,89.05002,331206
1157,CngKO,19,0.00574,294958,89.05575,331206
1158,damianday,19,0.00574,294977,89.06149,331206
1159,define-private-public,19,0.00574,294996,89.06723,331206
1160,Demmios,19,0.00574,295015,89.07296,331206
1161,DeybisMelendez,19,0.00574,295034,89.07870,331206
1162,divmgl,19,0.00574,295053,89.08444,331206
1163,erwincoumans,19,0.00574,295072,89.09017,331206
1164,GalanCM,19,0.00574,295091,89.09591,331206
1165,GlaDos28,19,0.00574,295110,89.10165,331206
1166,Gnumaru,19,0.00574,295129,89.10738,331206
1167,Hasenn,19,0.00574,295148,89.11312,331206
1168,Hassan-A,19,0.00574,295167,89.11886,331206
1169,ikostan,19,0.00574,295186,89.12459,331206
1170,jaykyburz,19,0.00574,295205,89.13033,331206
1171,JiahuiCai,19,0.00574,295224,89.13607,331206
1172,jonglae,19,0.00574,295243,89.14180,331206
1173,jpVm5jYYRE1VIKL,19,0.00574,295262,89.14754,331206
1174,Keplar1995,19,0.00574,295281,89.15328,331206
1175,Kequc,19,0.00574,295300,89.15901,331206
1176,kilojool,19,0.00574,295319,89.16475,331206
1177,Liangdi,19,0.00574,295338,89.17049,331206
1178,ligazetom,19,0.00574,295357,89.17622,331206
1179,loganjk,19,0.00574,295376,89.18196,331206
1180,minhdung321,19,0.00574,295395,89.18770,331206
1181,MirceaKitsune,19,0.00574,295414,89.19343,331206
1182,Mr-Slurpy,19,0.00574,295433,89.19917,331206
1183,nextdimension,19,0.00574,295452,89.20491,331206
1184,NieznanywInternetach,19,0.00574,295471,89.21064,331206
1185,NikodemL,19,0.00574,295490,89.21638,331206
1186,pajcek11,19,0.00574,295509,89.22212,331206
1187,PeterJSFChaplin,19,0.00574,295528,89.22785,331206
1188,Plopsiskopsis,19,0.00574,295547,89.23359,331206
1189,ryanpeach,19,0.00574,295566,89.23933,331206
1190,SaffronStreams,19,0.00574,295585,89.24506,331206
1191,Saitodepaula,19,0.00574,295604,89.25080,331206
1192,SamToorchi,19,0.00574,295623,89.25654,331206
1193,sherjilozair,19,0.00574,295642,89.26227,331206
1194,skarmiglione,19,0.00574,295661,89.26801,331206
1195,snoopdouglas,19,0.00574,295680,89.27375,331206
1196,squished-01,19,0.00574,295699,89.27948,331206
1197,sszigeti,19,0.00574,295718,89.28522,331206
1198,sumit0190,19,0.00574,295737,89.29095,331206
1199,supercom32,19,0.00574,295756,89.29669,331206
1200,TheNeoGameFactory,19,0.00574,295775,89.30243,331206
1201,Tommel1234,19,0.00574,295794,89.30816,331206
1202,Tribex,19,0.00574,295813,89.31390,331206
1203,tx350z,19,0.00574,295832,89.31964,331206
1204,vorblen,19,0.00574,295851,89.32537,331206
1205,acedogblast,18,0.00543,295869,89.33081,331206
1206,Alien1993,18,0.00543,295887,89.33624,331206
1207,ballerburg9005,18,0.00543,295905,89.34168,331206
1208,blurrred,18,0.00543,295923,89.34711,331206
1209,brandonlamb,18,0.00543,295941,89.35255,331206
1210,Bruce200,18,0.00543,295959,89.35798,331206
1211,Bucham,18,0.00543,295977,89.36342,331206
1212,bvbfan,18,0.00543,295995,89.36885,331206
1213,chandujr,18,0.00543,296013,89.37429,331206
1214,davarrcal,18,0.00543,296031,89.37972,331206
1215,dijam8,18,0.00543,296049,89.38516,331206
1216,DJKero,18,0.00543,296067,89.39059,331206
1217,dlnsk,18,0.00543,296085,89.39603,331206
1218,dominiks,18,0.00543,296103,89.40146,331206
1219,fab918,18,0.00543,296121,89.40689,331206
1220,FabiGjuzi,18,0.00543,296139,89.41233,331206
1221,Falke117,18,0.00543,296157,89.41776,331206
1222,fogine,18,0.00543,296175,89.42320,331206
1223,FrederickDesimpel,18,0.00543,296193,89.42863,331206
1224,Galomortal47,18,0.00543,296211,89.43407,331206
1225,gsegovia2018,18,0.00543,296229,89.43950,331206
1226,gusthe,18,0.00543,296247,89.44494,331206
1227,hnOsmium0001,18,0.00543,296265,89.45037,331206
1228,ImFlavo,18,0.00543,296283,89.45581,331206
1229,Jayman2000,18,0.00543,296301,89.46124,331206
1230,jluini,18,0.00543,296319,89.46668,331206
1231,JPTeasdale,18,0.00543,296337,89.47211,331206
1232,jscheel,18,0.00543,296355,89.47755,331206
1233,jumpy88,18,0.00543,296373,89.48298,331206
1234,kidrigger,18,0.00543,296391,89.48842,331206
1235,LifeIsStrange,18,0.00543,296409,89.49385,331206
1236,Lilith-In-Starlight,18,0.00543,296427,89.49928,331206
1237,MakeGodotGreatAgain,18,0.00543,296445,89.50472,331206
1238,mason-bially,18,0.00543,296463,89.51015,331206
1239,meld-cp,18,0.00543,296481,89.51559,331206
1240,Melix19,18,0.00543,296499,89.52102,331206
1241,nical,18,0.00543,296517,89.52646,331206
1242,noname1477,18,0.00543,296535,89.53189,331206
1243,NullNeska,18,0.00543,296553,89.53733,331206
1244,NutmegStudio,18,0.00543,296571,89.54276,331206
1245,nyenye,18,0.00543,296589,89.54820,331206
1246,PabloNeirotti,18,0.00543,296607,89.55363,331206
1247,panzergame,18,0.00543,296625,89.55907,331206
1248,rakkarage,18,0.00543,296643,89.56450,331206
1249,rcmz,18,0.00543,296661,89.56994,331206
1250,robertarnborg,18,0.00543,296679,89.57537,331206
1251,Rudigus,18,0.00543,296697,89.58080,331206
1252,Seel,18,0.00543,296715,89.58624,331206
1253,silvanocerza,18,0.00543,296733,89.59167,331206
1254,sudoman,18,0.00543,296751,89.59711,331206
1255,tam0705,18,0.00543,296769,89.60254,331206
1256,TheOnlyJoey,18,0.00543,296787,89.60798,331206
1257,thomas-goerlich,18,0.00543,296805,89.61341,331206
1258,totlmstr,18,0.00543,296823,89.61885,331206
1259,triverske,18,0.00543,296841,89.62428,331206
1260,warriormaster12,18,0.00543,296859,89.62972,331206
1261,xavierocampos,18,0.00543,296877,89.63515,331206
1262,Yanpas,18,0.00543,296895,89.64059,331206
1263,zedutchgandalf,18,0.00543,296913,89.64602,331206
1264,zendorf,18,0.00543,296931,89.65146,331206
1265,zorbathut,18,0.00543,296949,89.65689,331206
1266,0ttoman,17,0.00513,296966,89.66202,331206
1267,alexbosquin,17,0.00513,296983,89.66716,331206
1268,aron3097,17,0.00513,297000,89.67229,331206
1269,arypbatista,17,0.00513,297017,89.67742,331206
1270,beamer159,17,0.00513,297034,89.68255,331206
1271,BrodyEller,17,0.00513,297051,89.68769,331206
1272,busy8,17,0.00513,297068,89.69282,331206
1273,cbaal83,17,0.00513,297085,89.69795,331206
1274,CodeAndWeb,17,0.00513,297102,89.70309,331206
1275,ColinKinloch,17,0.00513,297119,89.70822,331206
1276,crazychenz,17,0.00513,297136,89.71335,331206
1277,DmDerbin,17,0.00513,297153,89.71848,331206
1278,Enhex,17,0.00513,297170,89.72362,331206
1279,Favkis,17,0.00513,297187,89.72875,331206
1280,gemkibeju,17,0.00513,297204,89.73388,331206
1281,gerardogc2378,17,0.00513,297221,89.73901,331206
1282,godot999,17,0.00513,297238,89.74415,331206
1283,Grandro,17,0.00513,297255,89.74928,331206
1284,IAmActuallyCthulhu,17,0.00513,297272,89.75441,331206
1285,io12,17,0.00513,297289,89.75955,331206
1286,Jackain,17,0.00513,297306,89.76468,331206
1287,jackmakesthings,17,0.00513,297323,89.76981,331206
1288,jeremi360,17,0.00513,297340,89.77494,331206
1289,Jimmio92,17,0.00513,297357,89.78008,331206
1290,juddrgledhill,17,0.00513,297374,89.78521,331206
1291,Kaligule,17,0.00513,297391,89.79034,331206
1292,Kinsman,17,0.00513,297408,89.79547,331206
1293,Krzycho666,17,0.00513,297425,89.80061,331206
1294,kzerot,17,0.00513,297442,89.80574,331206
1295,laverneth,17,0.00513,297459,89.81087,331206
1296,LittleWhite-tb,17,0.00513,297476,89.81601,331206
1297,MostafaMTH,17,0.00513,297493,89.82114,331206
1298,MrRevington,17,0.00513,297510,89.82627,331206
1299,MustaphaRashiduddin,17,0.00513,297527,89.83140,331206
1300,nadnam,17,0.00513,297544,89.83654,331206
1301,natrim,17,0.00513,297561,89.84167,331206
1302,nicktgn,17,0.00513,297578,89.84680,331206
1303,Nodragem,17,0.00513,297595,89.85194,331206
1304,Nophlock,17,0.00513,297612,89.85707,331206
1305,ntfwc,17,0.00513,297629,89.86220,331206
1306,olejr,17,0.00513,297646,89.86733,331206
1307,Omaranwa,17,0.00513,297663,89.87247,331206
1308,psuhas77,17,0.00513,297680,89.87760,331206
1309,QuLogic,17,0.00513,297697,89.88273,331206
1310,ripperdave,17,0.00513,297714,89.88786,331206
1311,rluders,17,0.00513,297731,89.89300,331206
1312,smt923,17,0.00513,297748,89.89813,331206
1313,SneakyMax,17,0.00513,297765,89.90326,331206
1314,staddy,17,0.00513,297782,89.90840,331206
1315,Technohacker,17,0.00513,297799,89.91353,331206
1316,teedoubleuu,17,0.00513,297816,89.91866,331206
1317,thankjura,17,0.00513,297833,89.92379,331206
1318,TiagoJoseMagalhaes,17,0.00513,297850,89.92893,331206
1319,Tilican,17,0.00513,297867,89.93406,331206
1320,timkrief,17,0.00513,297884,89.93919,331206
1321,vichug,17,0.00513,297901,89.94432,331206
1322,xdeadmonkx,17,0.00513,297918,89.94946,331206
1323,zacharytyhacz,17,0.00513,297935,89.95459,331206
1324,2dvision,16,0.00483,297951,89.95942,331206
1325,abueide,16,0.00483,297967,89.96425,331206
1326,afftor,16,0.00483,297983,89.96908,331206
1327,AgentEnder,16,0.00483,297999,89.97391,331206
1328,aleksfadini,16,0.00483,298015,89.97874,331206
1329,alexfreyre,16,0.00483,298031,89.98358,331206
1330,anark10n,16,0.00483,298047,89.98841,331206
1331,barbaros83,16,0.00483,298063,89.99324,331206
1332,Barugon,16,0.00483,298079,89.99807,331206
1333,bfishman,16,0.00483,298095,90.00290,331206
1334,BlenderNPR,16,0.00483,298111,90.00773,331206
1335,czlowiekimadlo,16,0.00483,298127,90.01256,331206
1336,DavidJVitale,16,0.00483,298143,90.01739,331206
1337,Diaspater,16,0.00483,298159,90.02222,331206
1338,Dimonasdf,16,0.00483,298175,90.02705,331206
1339,dioptryk,16,0.00483,298191,90.03188,331206
1340,DoctorAlpaca,16,0.00483,298207,90.03671,331206
1341,doradoro,16,0.00483,298223,90.04155,331206
1342,Duskitty,16,0.00483,298239,90.04638,331206
1343,free-vbucks,16,0.00483,298255,90.05121,331206
1344,gabrii,16,0.00483,298271,90.05604,331206
1345,Galaxy613,16,0.00483,298287,90.06087,331206
1346,gamedevsam,16,0.00483,298303,90.06570,331206
1347,gmarais,16,0.00483,298319,90.07053,331206
1348,grenzionky,16,0.00483,298335,90.07536,331206
1349,habamax,16,0.00483,298351,90.08019,331206
1350,harmonicsolutions,16,0.00483,298367,90.08502,331206
1351,hidemat,16,0.00483,298383,90.08985,331206
1352,iatenine,16,0.00483,298399,90.09468,331206
1353,IlTrain,16,0.00483,298415,90.09952,331206
1354,ivanarh,16,0.00483,298431,90.10435,331206
1355,jandrewlong,16,0.00483,298447,90.10918,331206
1356,jmintb,16,0.00483,298463,90.11401,331206
1357,jurgel,16,0.00483,298479,90.11884,331206
1358,JustYourAverageJosh,16,0.00483,298495,90.12367,331206
1359,karliss,16,0.00483,298511,90.12850,331206
1360,Kermer,16,0.00483,298527,90.13333,331206
1361,kitsune,16,0.00483,298543,90.13816,331206
1362,lucaslcode,16,0.00483,298559,90.14299,331206
1363,luzpaz,16,0.00483,298575,90.14782,331206
1364,MadaraZ,16,0.00483,298591,90.15265,331206
1365,maksimp04,16,0.00483,298607,90.15749,331206
1366,Marshal313,16,0.00483,298623,90.16232,331206
1367,Maveyyl,16,0.00483,298639,90.16715,331206
1368,Mellondill,16,0.00483,298655,90.17198,331206
1369,mownier,16,0.00483,298671,90.17681,331206
1370,MugenTwo,16,0.00483,298687,90.18164,331206
1371,OrenjiAkira,16,0.00483,298703,90.18647,331206
1372,prominentdetail,16,0.00483,298719,90.19130,331206
1373,PtrMan,16,0.00483,298735,90.19613,331206
1374,qdwang,16,0.00483,298751,90.20096,331206
1375,quinnyo,16,0.00483,298767,90.20579,331206
1376,RantingBob,16,0.00483,298783,90.21062,331206
1377,redoxCode,16,0.00483,298799,90.21546,331206
1378,RobertBColton,16,0.00483,298815,90.22029,331206
1379,RodZill4,16,0.00483,298831,90.22512,331206
1380,ronroniv,16,0.00483,298847,90.22995,331206
1381,Rriik,16,0.00483,298863,90.23478,331206
1382,rslepon,16,0.00483,298879,90.23961,331206
1383,Serenitor,16,0.00483,298895,90.24444,331206
1384,sin3point14,16,0.00483,298911,90.24927,331206
1385,smix8,16,0.00483,298927,90.25410,331206
1386,SoapSpangledGames,16,0.00483,298943,90.25893,331206
1387,Takanu,16,0.00483,298959,90.26376,331206
1388,therealrobster,16,0.00483,298975,90.26859,331206
1389,Timberland-7,16,0.00483,298991,90.27342,331206
1390,Triangle345,16,0.00483,299007,90.27826,331206
1391,ubaldy,16,0.00483,299023,90.28309,331206
1392,valentinAlkan,16,0.00483,299039,90.28792,331206
1393,Xananax,16,0.00483,299055,90.29275,331206
1394,Xydium,16,0.00483,299071,90.29758,331206
1395,Yazir,16,0.00483,299087,90.30241,331206
1396,zerornull,16,0.00483,299103,90.30724,331206
1397,aclave1,15,0.00453,299118,90.31177,331206
1398,afable,15,0.00453,299133,90.31630,331206
1399,alelepd,15,0.00453,299148,90.32083,331206
1400,alimalkhalifa,15,0.00453,299163,90.32536,331206
1401,Anarchid,15,0.00453,299178,90.32989,331206
1402,Angeloss,15,0.00453,299193,90.33441,331206
1403,Anyeos,15,0.00453,299208,90.33894,331206
1404,arccoza,15,0.00453,299223,90.34347,331206
1405,aswinmohanme,15,0.00453,299238,90.34800,331206
1406,asynts,15,0.00453,299253,90.35253,331206
1407,Berkru,15,0.00453,299268,90.35706,331206
1408,bruce965,15,0.00453,299283,90.36159,331206
1409,chalcosoma,15,0.00453,299298,90.36612,331206
1410,CosineP,15,0.00453,299313,90.37065,331206
1411,cutepig49,15,0.00453,299328,90.37517,331206
1412,DarknessCatt,15,0.00453,299343,90.37970,331206
1413,davthedev,15,0.00453,299358,90.38423,331206
1414,DerRidda,15,0.00453,299373,90.38876,331206
1415,DGWana,15,0.00453,299388,90.39329,331206
1416,drentsoft,15,0.00453,299403,90.39782,331206
1417,eiszfuchs,15,0.00453,299418,90.40235,331206
1418,evandropoa,15,0.00453,299433,90.40688,331206
1419,Fallayn,15,0.00453,299448,90.41141,331206
1420,fcobos,15,0.00453,299463,90.41593,331206
1421,Federico-Ciuffardi,15,0.00453,299478,90.42046,331206
1422,Fido789,15,0.00453,299493,90.42499,331206
1423,forbjok,15,0.00453,299508,90.42952,331206
1424,FrazerClews,15,0.00453,299523,90.43405,331206
1425,geekrelief,15,0.00453,299538,90.43858,331206
1426,grusad,15,0.00453,299553,90.44311,331206
1427,hunte922,15,0.00453,299568,90.44764,331206
1428,hyperglow,15,0.00453,299583,90.45217,331206
1429,igorskuhar,15,0.00453,299598,90.45669,331206
1430,ismslv,15,0.00453,299613,90.46122,331206
1431,Jellonator,15,0.00453,299628,90.46575,331206
1432,jfaust,15,0.00453,299643,90.47028,331206
1433,josempans,15,0.00453,299658,90.47481,331206
1434,JunShiozawa,15,0.00453,299673,90.47934,331206
1435,justinbarrett,15,0.00453,299688,90.48387,331206
1436,KoopHauss,15,0.00453,299703,90.48840,331206
1437,kotelifelif,15,0.00453,299718,90.49293,331206
1438,ktksgit,15,0.00453,299733,90.49745,331206
1439,Laura-Mauria,15,0.00453,299748,90.50198,331206
1440,levrik,15,0.00453,299763,90.50651,331206
1441,marechal-p,15,0.00453,299778,90.51104,331206
1442,Max-Might,15,0.00453,299793,90.51557,331206
1443,mcardellg,15,0.00453,299808,90.52010,331206
1444,mclark4386,15,0.00453,299823,90.52463,331206
1445,michaelpbl,15,0.00453,299838,90.52916,331206
1446,MickeMakaron,15,0.00453,299853,90.53369,331206
1447,mikeKulasinski,15,0.00453,299868,90.53821,331206
1448,Mochnant,15,0.00453,299883,90.54274,331206
1449,ModProg,15,0.00453,299898,90.54727,331206
1450,MoustafaC,15,0.00453,299913,90.55180,331206
1451,MrCrowley2,15,0.00453,299928,90.55633,331206
1452,nanodeath,15,0.00453,299943,90.56086,331206
1453,nattanielgrape,15,0.00453,299958,90.56539,331206
1454,nebs,15,0.00453,299973,90.56992,331206
1455,nikibobi,15,0.00453,299988,90.57445,331206
1456,nodefish,15,0.00453,300003,90.57898,331206
1457,npip99,15,0.00453,300018,90.58350,331206
1458,paulherman,15,0.00453,300033,90.58803,331206
1459,paulmiller,15,0.00453,300048,90.59256,331206
1460,phaitonican,15,0.00453,300063,90.59709,331206
1461,qarlosh,15,0.00453,300078,90.60162,331206
1462,Qudware,15,0.00453,300093,90.60615,331206
1463,Redwan13,15,0.00453,300108,90.61068,331206
1464,rkfg,15,0.00453,300123,90.61521,331206
1465,s0ra,15,0.00453,300138,90.61974,331206
1466,Sandvich,15,0.00453,300153,90.62426,331206
1467,sanja-sa,15,0.00453,300168,90.62879,331206
1468,shayneoneill,15,0.00453,300183,90.63332,331206
1469,spyres,15,0.00453,300198,90.63785,331206
1470,TheRealCatherine,15,0.00453,300213,90.64238,331206
1471,thirite,15,0.00453,300228,90.64691,331206
1472,t-mw,15,0.00453,300243,90.65144,331206
1473,tomoprime,15,0.00453,300258,90.65597,331206
1474,TyTYct,15,0.00453,300273,90.66050,331206
1475,vigreco,15,0.00453,300288,90.66502,331206
1476,Whimfoome,15,0.00453,300303,90.66955,331206
1477,XavierDD1st,15,0.00453,300318,90.67408,331206
1478,xyroclast,15,0.00453,300333,90.67861,331206
1479,ZahFox,15,0.00453,300348,90.68314,331206
1480,Zirak,15,0.00453,300363,90.68767,331206
1481,1000h,14,0.00423,300377,90.69190,331206
1482,2439905184,14,0.00423,300391,90.69612,331206
1483,2DemiGods,14,0.00423,300405,90.70035,331206
1484,Acvarium,14,0.00423,300419,90.70458,331206
1485,AlmostBearded,14,0.00423,300433,90.70880,331206
1486,AntohaRDNS,14,0.00423,300447,90.71303,331206
1487,Asmageddon,14,0.00423,300461,90.71726,331206
1488,Athomield,14,0.00423,300475,90.72148,331206
1489,AWKgamedev,14,0.00423,300489,90.72571,331206
1490,Awkor,14,0.00423,300503,90.72994,331206
1491,binotaliu,14,0.00423,300517,90.73417,331206
1492,BlueCannonBall,14,0.00423,300531,90.73839,331206
1493,bmolyneaux,14,0.00423,300545,90.74262,331206
1494,cgeadas,14,0.00423,300559,90.74685,331206
1495,crystalnoir,14,0.00423,300573,90.75107,331206
1496,cwook,14,0.00423,300587,90.75530,331206
1497,DanielKinsman,14,0.00423,300601,90.75953,331206
1498,dbenoy,14,0.00423,300615,90.76375,331206
1499,DenisBelmondo,14,0.00423,300629,90.76798,331206
1500,dsge,14,0.00423,300643,90.77221,331206
1501,ee0pdt,14,0.00423,300657,90.77644,331206
1502,epuscasu,14,0.00423,300671,90.78066,331206
1503,eyeEmotion,14,0.00423,300685,90.78489,331206
1504,Faustabov,14,0.00423,300699,90.78912,331206
1505,felaugmar,14,0.00423,300713,90.79334,331206
1506,florix91,14,0.00423,300727,90.79757,331206
1507,galmiza,14,0.00423,300741,90.80180,331206
1508,gokudomatic,14,0.00423,300755,90.80602,331206
1509,Grass-H0PEr,14,0.00423,300769,90.81025,331206
1510,HadesD,14,0.00423,300783,90.81448,331206
1511,hero2002,14,0.00423,300797,90.81870,331206
1512,homchom,14,0.00423,300811,90.82293,331206
1513,ignaloidas,14,0.00423,300825,90.82716,331206
1514,independentCog,14,0.00423,300839,90.83139,331206
1515,IndicaInkwell,14,0.00423,300853,90.83561,331206
1516,ismyhc,14,0.00423,300867,90.83984,331206
1517,jeansorgemoel,14,0.00423,300881,90.84407,331206
1518,jlahman,14,0.00423,300895,90.84829,331206
1519,johnnygossdev,14,0.00423,300909,90.85252,331206
1520,joleeee,14,0.00423,300923,90.85675,331206
1521,JonasT,14,0.00423,300937,90.86097,331206
1522,JustusPan,14,0.00423,300951,90.86520,331206
1523,Kaukamieli,14,0.00423,300965,90.86943,331206
1524,KnightNine,14,0.00423,300979,90.87366,331206
1525,LotsaBugs,14,0.00423,300993,90.87788,331206
1526,Lunatoid,14,0.00423,301007,90.88211,331206
1527,Mautar55,14,0.00423,301021,90.88634,331206
1528,mineevgleb,14,0.00423,301035,90.89056,331206
1529,MintStudios,14,0.00423,301049,90.89479,331206
1530,mo7sener,14,0.00423,301063,90.89902,331206
1531,MoraleMuffin5,14,0.00423,301077,90.90324,331206
1532,nabor,14,0.00423,301091,90.90747,331206
1533,needleful,14,0.00423,301105,90.91170,331206
1534,Nolkaloid,14,0.00423,301119,90.91593,331206
1535,novhack,14,0.00423,301133,90.92015,331206
1536,PaulTaulborg91,14,0.00423,301147,90.92438,331206
1537,phyffer,14,0.00423,301161,90.92861,331206
1538,polytect,14,0.00423,301175,90.93283,331206
1539,Poobslag,14,0.00423,301189,90.93706,331206
1540,Rabocop,14,0.00423,301203,90.94129,331206
1541,rasikrodri,14,0.00423,301217,90.94551,331206
1542,rdhafidh,14,0.00423,301231,90.94974,331206
1543,retrotails,14,0.00423,301245,90.95397,331206
1544,RichardEllicott,14,0.00423,301259,90.95820,331206
1545,Rinma,14,0.00423,301273,90.96242,331206
1546,Rinocrosser,14,0.00423,301287,90.96665,331206
1547,Rybadour,14,0.00423,301301,90.97088,331206
1548,sdhy,14,0.00423,301315,90.97510,331206
1549,Skullfurious,14,0.00423,301329,90.97933,331206
1550,Skyfrit,14,0.00423,301343,90.98356,331206
1551,takhimi,14,0.00423,301357,90.98778,331206
1552,TheMonsterFromTheDeep,14,0.00423,301371,90.99201,331206
1553,thismarty,14,0.00423,301385,90.99624,331206
1554,Thource,14,0.00423,301399,91.00046,331206
1555,TierraDelFuego,14,0.00423,301413,91.00469,331206
1556,Tinkersedge,14,0.00423,301427,91.00892,331206
1557,tko,14,0.00423,301441,91.01315,331206
1558,TomDobbelaere,14,0.00423,301455,91.01737,331206
1559,TritiatedWater,14,0.00423,301469,91.02160,331206
1560,wolfviking0,14,0.00423,301483,91.02583,331206
1561,WouterB15,14,0.00423,301497,91.03005,331206
1562,yanorax,14,0.00423,301511,91.03428,331206
1563,ZackingIt,14,0.00423,301525,91.03851,331206
1564,zxcvdev,14,0.00423,301539,91.04273,331206
1565,648trindade,13,0.00393,301552,91.04666,331206
1566,8thMage,13,0.00393,301565,91.05058,331206
1567,Abhicse079,13,0.00393,301578,91.05451,331206
1568,admiralzeech,13,0.00393,301591,91.05843,331206
1569,akanewf,13,0.00393,301604,91.06236,331206
1570,AKashyap86,13,0.00393,301617,91.06629,331206
1571,AlansCodeLog,13,0.00393,301630,91.07021,331206
1572,Algorithmus,13,0.00393,301643,91.07414,331206
1573,andriyDev,13,0.00393,301656,91.07806,331206
1574,aomimezura,13,0.00393,301669,91.08199,331206
1575,Applemann,13,0.00393,301682,91.08591,331206
1576,Arivval,13,0.00393,301695,91.08984,331206
1577,arvenjadeaguilar,13,0.00393,301708,91.09376,331206
1578,atoms118,13,0.00393,301721,91.09769,331206
1579,awalone995,13,0.00393,301734,91.10161,331206
1580,bebae,13,0.00393,301747,91.10554,331206
1581,BenjaminRiley,13,0.00393,301760,91.10946,331206
1582,blackwc,13,0.00393,301773,91.11339,331206
1583,Bleuzen,13,0.00393,301786,91.11731,331206
1584,brenttaylor,13,0.00393,301799,91.12124,331206
1585,chepulis,13,0.00393,301812,91.12516,331206
1586,chongdashu,13,0.00393,301825,91.12909,331206
1587,Chrisanthos,13,0.00393,301838,91.13301,331206
1588,CloudAlRio,13,0.00393,301851,91.13694,331206
1589,Cobradabest,13,0.00393,301864,91.14086,331206
1590,codespren,13,0.00393,301877,91.14479,331206
1591,CombustibleLemonade,13,0.00393,301890,91.14871,331206
1592,crym0nster,13,0.00393,301903,91.15264,331206
1593,damon-myers,13,0.00393,301916,91.15656,331206
1594,Dancovich,13,0.00393,301929,91.16049,331206
1595,DashCell,13,0.00393,301942,91.16441,331206
1596,davcri,13,0.00393,301955,91.16834,331206
1597,disks86,13,0.00393,301968,91.17226,331206
1598,d-j-a-y,13,0.00393,301981,91.17619,331206
1599,DmitryKrutskikh,13,0.00393,301994,91.18011,331206
1600,DoctorWhoof,13,0.00393,302007,91.18404,331206
1601,drambique,13,0.00393,302020,91.18796,331206
1602,drichardson,13,0.00393,302033,91.19189,331206
1603,ducklin5,13,0.00393,302046,91.19581,331206
1604,epth,13,0.00393,302059,91.19974,331206
1605,ethindp,13,0.00393,302072,91.20366,331206
1606,ExpiredPopsicle,13,0.00393,302085,91.20759,331206
1607,fakedeltatime,13,0.00393,302098,91.21151,331206
1608,flofriday,13,0.00393,302111,91.21544,331206
1609,GustavoMarciano,13,0.00393,302124,91.21936,331206
1610,GWRon,13,0.00393,302137,91.22329,331206
1611,hackini,13,0.00393,302150,91.22721,331206
1612,IBwWG,13,0.00393,302163,91.23114,331206
1613,Ijatsu,13,0.00393,302176,91.23506,331206
1614,IllusiveS,13,0.00393,302189,91.23899,331206
1615,inDigiNeous,13,0.00393,302202,91.24291,331206
1616,isnt-alice,13,0.00393,302215,91.24684,331206
1617,itsjavi,13,0.00393,302228,91.25076,331206
1618,Jvanmourik,13,0.00393,302241,91.25469,331206
1619,k7771911,13,0.00393,302254,91.25861,331206
1620,kenneth-leblanc,13,0.00393,302267,91.26254,331206
1621,kimjiy9607,13,0.00393,302280,91.26646,331206
1622,kn00tcn,13,0.00393,302293,91.27039,331206
1623,Kubees,13,0.00393,302306,91.27431,331206
1624,KylaCpper,13,0.00393,302319,91.27824,331206
1625,Lefl1,13,0.00393,302332,91.28216,331206
1626,leotada,13,0.00393,302345,91.28609,331206
1627,Levrault,13,0.00393,302358,91.29001,331206
1628,Limb,13,0.00393,302371,91.29394,331206
1629,lszl84,13,0.00393,302384,91.29786,331206
1630,luis-l,13,0.00393,302397,91.30179,331206
1631,Luraktinus,13,0.00393,302410,91.30571,331206
1632,MartinHaeusler,13,0.00393,302423,91.30964,331206
1633,mashumafi,13,0.00393,302436,91.31356,331206
1634,masoudbh3,13,0.00393,302449,91.31749,331206
1635,matiashak,13,0.00393,302462,91.32141,331206
1636,mattislorentzon,13,0.00393,302475,91.32534,331206
1637,MelimeliDev,13,0.00393,302488,91.32926,331206
1638,mintyleaf,13,0.00393,302501,91.33319,331206
1639,mnkylord,13,0.00393,302514,91.33711,331206
1640,mrbig033,13,0.00393,302527,91.34104,331206
1641,nice-shot,13,0.00393,302540,91.34496,331206
1642,nrcionline,13,0.00393,302553,91.34889,331206
1643,Olaf-007,13,0.00393,302566,91.35281,331206
1644,ondrowan,13,0.00393,302579,91.35674,331206
1645,opcon,13,0.00393,302592,91.36066,331206
1646,penguinroad,13,0.00393,302605,91.36459,331206
1647,PucklaMotzer09,13,0.00393,302618,91.36851,331206
1648,Razzeeyy,13,0.00393,302631,91.37244,331206
1649,Reapetitive,13,0.00393,302644,91.37636,331206
1650,RichardR01,13,0.00393,302657,91.38029,331206
1651,riirii,13,0.00393,302670,91.38421,331206
1652,ronchaine,13,0.00393,302683,91.38814,331206
1653,rssqian,13,0.00393,302696,91.39206,331206
1654,ruckustboom,13,0.00393,302709,91.39599,331206
1655,Schweigert,13,0.00393,302722,91.39991,331206
1656,SeaKarp,13,0.00393,302735,91.40384,331206
1657,ShrewdSpirit,13,0.00393,302748,91.40776,331206
1658,SilverSurfer1221,13,0.00393,302761,91.41169,331206
1659,simonpuchert,13,0.00393,302774,91.41561,331206
1660,somnathsarkar,13,0.00393,302787,91.41954,331206
1661,tanjunior,13,0.00393,302800,91.42346,331206
1662,tastesliketriangle,13,0.00393,302813,91.42739,331206
1663,tcrass,13,0.00393,302826,91.43131,331206
1664,telaviv,13,0.00393,302839,91.43524,331206
1665,Th0r12356,13,0.00393,302852,91.43916,331206
1666,th1z,13,0.00393,302865,91.44309,331206
1667,The5-1,13,0.00393,302878,91.44701,331206
1668,TheKetrab,13,0.00393,302891,91.45094,331206
1669,thorlucas,13,0.00393,302904,91.45486,331206
1670,thoughton,13,0.00393,302917,91.45879,331206
1671,ticnew,13,0.00393,302930,91.46272,331206
1672,tomuxmon,13,0.00393,302943,91.46664,331206
1673,verdog,13,0.00393,302956,91.47057,331206
1674,vixelz,13,0.00393,302969,91.47449,331206
1675,vorabrijesh,13,0.00393,302982,91.47842,331206
1676,waldson,13,0.00393,302995,91.48234,331206
1677,xKamuna,13,0.00393,303008,91.48627,331206
1678,zinkkrysty,13,0.00393,303021,91.49019,331206
1679,Zoomulator,13,0.00393,303034,91.49412,331206
1680,aaforcebox,12,0.00362,303046,91.49774,331206
1681,acfaruk,12,0.00362,303058,91.50136,331206
1682,affemannen,12,0.00362,303070,91.50498,331206
1683,AfterRebelion,12,0.00362,303082,91.50861,331206
1684,ageazrael,12,0.00362,303094,91.51223,331206
1685,ajweeks,12,0.00362,303106,91.51585,331206
1686,albinaask,12,0.00362,303118,91.51948,331206
1687,AndroidGod101,12,0.00362,303130,91.52310,331206
1688,andy5995,12,0.00362,303142,91.52672,331206
1689,aombk,12,0.00362,303154,91.53035,331206
1690,arrowinaknee,12,0.00362,303166,91.53397,331206
1691,atari83,12,0.00362,303178,91.53759,331206
1692,Av3r3tt,12,0.00362,303190,91.54122,331206
1693,Banduck,12,0.00362,303202,91.54484,331206
1694,BaseCrusher,12,0.00362,303214,91.54846,331206
1695,Bethleem,12,0.00362,303226,91.55209,331206
1696,blain1972,12,0.00362,303238,91.55571,331206
1697,BornStellarMakesEternalLasting,12,0.00362,303250,91.55933,331206
1698,brendor,12,0.00362,303262,91.56295,331206
1699,cmfcmf,12,0.00362,303274,91.56658,331206
1700,danboid,12,0.00362,303286,91.57020,331206
1701,Darkheron,12,0.00362,303298,91.57382,331206
1702,davismiculis,12,0.00362,303310,91.57745,331206
1703,DejaVuLoop,12,0.00362,303322,91.58107,331206
1704,Demiu,12,0.00362,303334,91.58469,331206
1705,Dentoid,12,0.00362,303346,91.58832,331206
1706,duckinator,12,0.00362,303358,91.59194,331206
1707,dynamite-ready,12,0.00362,303370,91.59556,331206
1708,eddex,12,0.00362,303382,91.59919,331206
1709,eminvergil,12,0.00362,303394,91.60281,331206
1710,enthus1ast,12,0.00362,303406,91.60643,331206
1711,ERUD1T3,12,0.00362,303418,91.61006,331206
1712,fahrstuhl,12,0.00362,303430,91.61368,331206
1713,FigyTuna,12,0.00362,303442,91.61730,331206
1714,fodinabor,12,0.00362,303454,91.62092,331206
1715,harrisyu,12,0.00362,303466,91.62455,331206
1716,iamacup,12,0.00362,303478,91.62817,331206
1717,iboshkov,12,0.00362,303490,91.63179,331206
1718,jbwyatt4,12,0.00362,303502,91.63542,331206
1719,jeffres,12,0.00362,303514,91.63904,331206
1720,JellyWX,12,0.00362,303526,91.64266,331206
1721,JimArtificer,12,0.00362,303538,91.64629,331206
1722,jimmyjonezz,12,0.00362,303550,91.64991,331206
1723,JosephHalter,12,0.00362,303562,91.65353,331206
1724,justin-calleja,12,0.00362,303574,91.65716,331206
1725,Kayomn,12,0.00362,303586,91.66078,331206
1726,kjohnson0451,12,0.00362,303598,91.66440,331206
1727,kkmzero,12,0.00362,303610,91.66803,331206
1728,krogank9,12,0.00362,303622,91.67165,331206
1729,LaBlazer,12,0.00362,303634,91.67527,331206
1730,LaBodilsen,12,0.00362,303646,91.67889,331206
1731,MaciejGorczycaGD,12,0.00362,303658,91.68252,331206
1732,markgarcia,12,0.00362,303670,91.68614,331206
1733,MateoMiccino,12,0.00362,303682,91.68976,331206
1734,Maykeye,12,0.00362,303694,91.69339,331206
1735,MazeChaZer,12,0.00362,303706,91.69701,331206
1736,Megamega53,12,0.00362,303718,91.70063,331206
1737,Mek101,12,0.00362,303730,91.70426,331206
1738,Miniblu858,12,0.00362,303742,91.70788,331206
1739,MrMrBlackDragon,12,0.00362,303754,91.71150,331206
1740,muchitto,12,0.00362,303766,91.71513,331206
1741,nathanmerrill,12,0.00362,303778,91.71875,331206
1742,nepitard,12,0.00362,303790,91.72237,331206
1743,Nikhil-42,12,0.00362,303802,91.72600,331206
1744,Norrolith,12,0.00362,303814,91.72962,331206
1745,oiblank,12,0.00362,303826,91.73324,331206
1746,ombre5733,12,0.00362,303838,91.73686,331206
1747,omegachysis,12,0.00362,303850,91.74049,331206
1748,OriginalAGP,12,0.00362,303862,91.74411,331206
1749,orosmatthew,12,0.00362,303874,91.74773,331206
1750,OsamaElHariri,12,0.00362,303886,91.75136,331206
1751,OverloadedOrama,12,0.00362,303898,91.75498,331206
1752,paezao,12,0.00362,303910,91.75860,331206
1753,pixelriot,12,0.00362,303922,91.76223,331206
1754,prenex,12,0.00362,303934,91.76585,331206
1755,rainerdeyke,12,0.00362,303946,91.76947,331206
1756,rarsp,12,0.00362,303958,91.77310,331206
1757,ReyAnthony,12,0.00362,303970,91.77672,331206
1758,rfht,12,0.00362,303982,91.78034,331206
1759,rhossack,12,0.00362,303994,91.78397,331206
1760,r-mice,12,0.00362,304006,91.78759,331206
1761,rnoriega31,12,0.00362,304018,91.79121,331206
1762,robinlamb,12,0.00362,304030,91.79483,331206
1763,rohanrhu,12,0.00362,304042,91.79846,331206
1764,rollenrolm,12,0.00362,304054,91.80208,331206
1765,RoryMcMaster,12,0.00362,304066,91.80570,331206
1766,salalex,12,0.00362,304078,91.80933,331206
1767,samtsejerome,12,0.00362,304090,91.81295,331206
1768,shmellyorc,12,0.00362,304102,91.81657,331206
1769,SinaZK,12,0.00362,304114,91.82020,331206
1770,sionroberts,12,0.00362,304126,91.82382,331206
1771,slooths,12,0.00362,304138,91.82744,331206
1772,sobotka,12,0.00362,304150,91.83107,331206
1773,SourceSkyBoxer,12,0.00362,304162,91.83469,331206
1774,SuzukaDev,12,0.00362,304174,91.83831,331206
1775,tadaaagames,12,0.00362,304186,91.84194,331206
1776,tapir,12,0.00362,304198,91.84556,331206
1777,TazeTSchnitzel,12,0.00362,304210,91.84918,331206
1778,TerraAr,12,0.00362,304222,91.85280,331206
1779,that-richard,12,0.00362,304234,91.85643,331206
1780,TheColorRed,12,0.00362,304246,91.86005,331206
1781,thomaslynge,12,0.00362,304258,91.86367,331206
1782,tmathews,12,0.00362,304270,91.86730,331206
1783,tomnahooy,12,0.00362,304282,91.87092,331206
1784,tomreyn,12,0.00362,304294,91.87454,331206
1785,trsh,12,0.00362,304306,91.87817,331206
1786,txigreman,12,0.00362,304318,91.88179,331206
1787,TypeOverride2,12,0.00362,304330,91.88541,331206
1788,UltimaN3rd,12,0.00362,304342,91.88904,331206
1789,varkatope,12,0.00362,304354,91.89266,331206
1790,WARIO-MDMA,12,0.00362,304366,91.89628,331206
1791,Wiering,12,0.00362,304378,91.89991,331206
1792,workless,12,0.00362,304390,91.90353,331206
1793,wyrmling,12,0.00362,304402,91.90715,331206
1794,youreperfect,12,0.00362,304414,91.91077,331206
1795,yrk06,12,0.00362,304426,91.91440,331206
1796,zwz,12,0.00362,304438,91.91802,331206
1797,1shevelov,11,0.00332,304449,91.92134,331206
1798,anneomcl,11,0.00332,304460,91.92466,331206
1799,aphelionz,11,0.00332,304471,91.92798,331206
1800,arthurferrai,11,0.00332,304482,91.93131,331206
1801,ArturM,11,0.00332,304493,91.93463,331206
1802,Ashesh3,11,0.00332,304504,91.93795,331206
1803,atologist-pratik,11,0.00332,304515,91.94127,331206
1804,AureaFUNSoft,11,0.00332,304526,91.94459,331206
1805,bartosz-m,11,0.00332,304537,91.94791,331206
1806,bcr3ative,11,0.00332,304548,91.95123,331206
1807,BenStigsen,11,0.00332,304559,91.95455,331206
1808,bigcatrik,11,0.00332,304570,91.95788,331206
1809,Bladum,11,0.00332,304581,91.96120,331206
1810,Bugsbane,11,0.00332,304592,91.96452,331206
1811,Byzantian,11,0.00332,304603,91.96784,331206
1812,CaptainDario,11,0.00332,304614,91.97116,331206
1813,CaptainProton42,11,0.00332,304625,91.97448,331206
1814,chesscommands,11,0.00332,304636,91.97780,331206
1815,clktmr,11,0.00332,304647,91.98112,331206
1816,ComancheAk,11,0.00332,304658,91.98444,331206
1817,conankzhang,11,0.00332,304669,91.98777,331206
1818,cyclopsian,11,0.00332,304680,91.99109,331206
1819,daniel-abbott,11,0.00332,304691,91.99441,331206
1820,davehayes,11,0.00332,304702,91.99773,331206
1821,DeuxAlpha,11,0.00332,304713,92.00105,331206
1822,diiiiiiiii,11,0.00332,304724,92.00437,331206
1823,doot24,11,0.00332,304735,92.00769,331206
1824,Dr4kzor,11,0.00332,304746,92.01101,331206
1825,DrZanuff,11,0.00332,304757,92.01434,331206
1826,eaglecat,11,0.00332,304768,92.01766,331206
1827,e-e,11,0.00332,304779,92.02098,331206
1828,ejnij,11,0.00332,304790,92.02430,331206
1829,elijahscherz,11,0.00332,304801,92.02762,331206
1830,EmeraldSlash,11,0.00332,304812,92.03094,331206
1831,ericdsw,11,0.00332,304823,92.03426,331206
1832,evandikt,11,0.00332,304834,92.03758,331206
1833,Eymux,11,0.00332,304845,92.04091,331206
1834,faculezcano,11,0.00332,304856,92.04423,331206
1835,fdmarcin,11,0.00332,304867,92.04755,331206
1836,ffaristocrat,11,0.00332,304878,92.05087,331206
1837,fgictfgfokpf,11,0.00332,304889,92.05419,331206
1838,flashice2030,11,0.00332,304900,92.05751,331206
1839,Foxcataria,11,0.00332,304911,92.06083,331206
1840,francipvb,11,0.00332,304922,92.06415,331206
1841,freestraws,11,0.00332,304933,92.06747,331206
1842,Frontrider,11,0.00332,304944,92.07080,331206
1843,glatteis,11,0.00332,304955,92.07412,331206
1844,greenbigfrog,11,0.00332,304966,92.07744,331206
1845,gvekan,11,0.00332,304977,92.08076,331206
1846,H4kor,11,0.00332,304988,92.08408,331206
1847,hodgej,11,0.00332,304999,92.08740,331206
1848,homarox,11,0.00332,305010,92.09072,331206
1849,hormoz1,11,0.00332,305021,92.09404,331206
1850,HungryProton,11,0.00332,305032,92.09737,331206
1851,ishidex2,11,0.00332,305043,92.10069,331206
1852,itgenie98,11,0.00332,305054,92.10401,331206
1853,Ivan-Tigan,11,0.00332,305065,92.10733,331206
1854,Jalu1,11,0.00332,305076,92.11065,331206
1855,jamesaddy789,11,0.00332,305087,92.11397,331206
1856,jeremyjh,11,0.00332,305098,92.11729,331206
1857,jgrauman0,11,0.00332,305109,92.12061,331206
1858,jmb462,11,0.00332,305120,92.12393,331206
1859,Jose-Moreno,11,0.00332,305131,92.12726,331206
1860,JuanDidNothingWrong,11,0.00332,305142,92.13058,331206
1861,jvdnbus,11,0.00332,305153,92.13390,331206
1862,Klesomik,11,0.00332,305164,92.13722,331206
1863,lainv0hndyrec,11,0.00332,305175,92.14054,331206
1864,lizistorm,11,0.00332,305186,92.14386,331206
1865,lordkettune,11,0.00332,305197,92.14718,331206
1866,LuizAntonioPereira,11,0.00332,305208,92.15050,331206
1867,marcosjouron,11,0.00332,305219,92.15383,331206
1868,marsmoon,11,0.00332,305230,92.15715,331206
1869,mayuso,11,0.00332,305241,92.16047,331206
1870,MegaMech,11,0.00332,305252,92.16379,331206
1871,MeiHouwang,11,0.00332,305263,92.16711,331206
1872,meruiden,11,0.00332,305274,92.17043,331206
1873,MJBrune,11,0.00332,305285,92.17375,331206
1874,mokalux,11,0.00332,305296,92.17707,331206
1875,mrmoon117,11,0.00332,305307,92.18040,331206
1876,Nannaquin,11,0.00332,305318,92.18372,331206
1877,narunsa,11,0.00332,305329,92.18704,331206
1878,NedJaims,11,0.00332,305340,92.19036,331206
1879,neilw1,11,0.00332,305351,92.19368,331206
1880,NNesh,11,0.00332,305362,92.19700,331206
1881,NoGodDamnName,11,0.00332,305373,92.20032,331206
1882,notmushroomoverhere,11,0.00332,305384,92.20364,331206
1883,ntsik,11,0.00332,305395,92.20696,331206
1884,Paluth,11,0.00332,305406,92.21029,331206
1885,Paulloz,11,0.00332,305417,92.21361,331206
1886,payload,11,0.00332,305428,92.21693,331206
1887,pbrunet,11,0.00332,305439,92.22025,331206
1888,Pobega,11,0.00332,305450,92.22357,331206
1889,ptato,11,0.00332,305461,92.22689,331206
1890,puzzud,11,0.00332,305472,92.23021,331206
1891,Rdna123,11,0.00332,305483,92.23353,331206
1892,realManix,11,0.00332,305494,92.23686,331206
1893,Rexxilion-ex,11,0.00332,305505,92.24018,331206
1894,Rhathe,11,0.00332,305516,92.24350,331206
1895,robrtsql,11,0.00332,305527,92.24682,331206
1896,rofl0r,11,0.00332,305538,92.25014,331206
1897,RoyBerube,11,0.00332,305549,92.25346,331206
1898,Sajo8,11,0.00332,305560,92.25678,331206
1899,Scemenzo,11,0.00332,305571,92.26010,331206
1900,Scipi,11,0.00332,305582,92.26343,331206
1901,shafnaz,11,0.00332,305593,92.26675,331206
1902,ShawnMcCool,11,0.00332,305604,92.27007,331206
1903,skgalaxy,11,0.00332,305615,92.27339,331206
1904,skoovo,11,0.00332,305626,92.27671,331206
1905,SlothDevLlama,11,0.00332,305637,92.28003,331206
1906,SmithJohnFirst,11,0.00332,305648,92.28335,331206
1907,snougo,11,0.00332,305659,92.28667,331206
1908,solfen,11,0.00332,305670,92.28999,331206
1909,star-tek-mb,11,0.00332,305681,92.29332,331206
1910,Stratos695,11,0.00332,305692,92.29664,331206
1911,sturm30,11,0.00332,305703,92.29996,331206
1912,SubSage,11,0.00332,305714,92.30328,331206
1913,tcoxon,11,0.00332,305725,92.30660,331206
1914,TestDotCom,11,0.00332,305736,92.30992,331206
1915,theblockhouse,11,0.00332,305747,92.31324,331206
1916,TheCire,11,0.00332,305758,92.31656,331206
1917,theowiik,11,0.00332,305769,92.31989,331206
1918,TigerCaldwell,11,0.00332,305780,92.32321,331206
1919,timothyparez,11,0.00332,305791,92.32653,331206
1920,udit,11,0.00332,305802,92.32985,331206
1921,Unholydeath,11,0.00332,305813,92.33317,331206
1922,UnleavenedEagle,11,0.00332,305824,92.33649,331206
1923,unpause,11,0.00332,305835,92.33981,331206
1924,Uradamus,11,0.00332,305846,92.34313,331206
1925,V0idExp,11,0.00332,305857,92.34646,331206
1926,verbalshadow,11,0.00332,305868,92.34978,331206
1927,viniciuscsg,11,0.00332,305879,92.35310,331206
1928,vmjcv,11,0.00332,305890,92.35642,331206
1929,WatchThemFall,11,0.00332,305901,92.35974,331206
1930,wlodeqp,11,0.00332,305912,92.36306,331206
1931,wscalf,11,0.00332,305923,92.36638,331206
1932,y0nd0,11,0.00332,305934,92.36970,331206
1933,zaniar,11,0.00332,305945,92.37302,331206
1934,zer0problem,11,0.00332,305956,92.37635,331206
1935,zero2000,11,0.00332,305967,92.37967,331206
1936,2821869675,10,0.00302,305977,92.38269,331206
1937,37TS,10,0.00302,305987,92.38571,331206
1938,aburg,10,0.00302,305997,92.38872,331206
1939,Airbus5717,10,0.00302,306007,92.39174,331206
1940,akerudesu,10,0.00302,306017,92.39476,331206
1941,albertomjp10,10,0.00302,306027,92.39778,331206
1942,alcroito,10,0.00302,306037,92.40080,331206
1943,AlexZan,10,0.00302,306047,92.40382,331206
1944,AlphaOneProject,10,0.00302,306057,92.40684,331206
1945,alvaromunoz,10,0.00302,306067,92.40986,331206
1946,AnaDenisa,10,0.00302,306077,92.41288,331206
1947,andrekim93,10,0.00302,306087,92.41590,331206
1948,antonyjones67,10,0.00302,306097,92.41892,331206
1949,aragar,10,0.00302,306107,92.42194,331206
1950,argylelabcoat,10,0.00302,306117,92.42496,331206
1951,ArisKallergis,10,0.00302,306127,92.42798,331206
1952,arturjpv,10,0.00302,306137,92.43099,331206
1953,Astrych,10,0.00302,306147,92.43401,331206
1954,b1skit,10,0.00302,306157,92.43703,331206
1955,Baekalfen,10,0.00302,306167,92.44005,331206
1956,balfrog,10,0.00302,306177,92.44307,331206
1957,Beechside,10,0.00302,306187,92.44609,331206
1958,Beefster09,10,0.00302,306197,92.44911,331206
1959,BenjaDev,10,0.00302,306207,92.45213,331206
1960,benjarmstrong,10,0.00302,306217,92.45515,331206
1961,bferguson3,10,0.00302,306227,92.45817,331206
1962,BiRD4,10,0.00302,306237,92.46119,331206
1963,Bitiquinho,10,0.00302,306247,92.46421,331206
1964,Bonkuraazu,10,0.00302,306257,92.46723,331206
1965,boukew99,10,0.00302,306267,92.47025,331206
1966,BracerJack,10,0.00302,306277,92.47326,331206
1967,brigazvi,10,0.00302,306287,92.47628,331206
1968,brogan89,10,0.00302,306297,92.47930,331206
1969,bugfi5h,10,0.00302,306307,92.48232,331206
1970,Burnsedia,10,0.00302,306317,92.48534,331206
1971,Ceryni,10,0.00302,306327,92.48836,331206
1972,CJNA,10,0.00302,306337,92.49138,331206
1973,clarkejm,10,0.00302,306347,92.49440,331206
1974,CoolOppo,10,0.00302,306357,92.49742,331206
1975,CorattiS86,10,0.00302,306367,92.50044,331206
1976,Cosciad,10,0.00302,306377,92.50346,331206
1977,cynicaldevil,10,0.00302,306387,92.50648,331206
1978,danielkotzer,10,0.00302,306397,92.50950,331206
1979,darmie,10,0.00302,306407,92.51251,331206
1980,darrylryan,10,0.00302,306417,92.51553,331206
1981,davidholiday,10,0.00302,306427,92.51855,331206
1982,davidkbd,10,0.00302,306437,92.52157,331206
1983,DDL-Blue,10,0.00302,306447,92.52459,331206
1984,dekaravanhoc,10,0.00302,306457,92.52761,331206
1985,deleteaccount1234567890,10,0.00302,306467,92.53063,331206
1986,Dieselpirat,10,0.00302,306477,92.53365,331206
1987,dirkk0,10,0.00302,306487,92.53667,331206
1988,dns,10,0.00302,306497,92.53969,331206
1989,Dogpot,10,0.00302,306507,92.54271,331206
1990,DonSkeleton,10,0.00302,306517,92.54573,331206
1991,dracc,10,0.00302,306527,92.54875,331206
1992,DSteve595,10,0.00302,306537,92.55177,331206
1993,ElectricCoffee,10,0.00302,306547,92.55478,331206
1994,eltharionx,10,0.00302,306557,92.55780,331206
1995,enchantedraven,10,0.00302,306567,92.56082,331206
1996,Essojadojef,10,0.00302,306577,92.56384,331206
1997,ex,10,0.00302,306587,92.56686,331206
1998,Favorlock,10,0.00302,306597,92.56988,331206
1999,finkizo,10,0.00302,306607,92.57290,331206
2000,Flonka,10,0.00302,306617,92.57592,331206
2001,FrischerHering,10,0.00302,306627,92.57894,331206
2002,frugs,10,0.00302,306637,92.58196,331206
2003,GlaceGwyneth,10,0.00302,306647,92.58498,331206
2004,gregeryb,10,0.00302,306657,92.58800,331206
2005,GuidoRevers,10,0.00302,306667,92.59102,331206
2006,GuiltyPixel,10,0.00302,306677,92.59404,331206
2007,herman-rogers,10,0.00302,306687,92.59705,331206
2008,Hevedy,10,0.00302,306697,92.60007,331206
2009,Hodes,10,0.00302,306707,92.60309,331206
2010,hubslave,10,0.00302,306717,92.60611,331206
2011,HugoSlt,10,0.00302,306727,92.60913,331206
2012,iajrz,10,0.00302,306737,92.61215,331206
2013,ikelaiah,10,0.00302,306747,92.61517,331206
2014,iman-salmani,10,0.00302,306757,92.61819,331206
2015,insraq,10,0.00302,306767,92.62121,331206
2016,iRadEntertainment,10,0.00302,306777,92.62423,331206
2017,itsabhiaryan,10,0.00302,306787,92.62725,331206
2018,juspky,10,0.00302,306797,92.63027,331206
2019,justchen1369,10,0.00302,306807,92.63329,331206
2020,kareed44,10,0.00302,306817,92.63630,331206
2021,keegano,10,0.00302,306827,92.63932,331206
2022,keenfoong,10,0.00302,306837,92.64234,331206
2023,kis3lori,10,0.00302,306847,92.64536,331206
2024,kleonc,10,0.00302,306857,92.64838,331206
2025,kopcion,10,0.00302,306867,92.65140,331206
2026,lewislepton,10,0.00302,306877,92.65442,331206
2027,lmerriam,10,0.00302,306887,92.65744,331206
2028,LockManipulator,10,0.00302,306897,92.66046,331206
2029,Lodugh,10,0.00302,306907,92.66348,331206
2030,Mantissa-23,10,0.00302,306917,92.66650,331206
2031,markotaht,10,0.00302,306927,92.66952,331206
2032,MarkuBu,10,0.00302,306937,92.67254,331206
2033,martys71,10,0.00302,306947,92.67556,331206
2034,mastermarkus,10,0.00302,306957,92.67857,331206
2035,mathias17,10,0.00302,306967,92.68159,331206
2036,matty,10,0.00302,306977,92.68461,331206
2037,Maujoe,10,0.00302,306987,92.68763,331206
2038,MBetters,10,0.00302,306997,92.69065,331206
2039,m-irigoyen,10,0.00302,307007,92.69367,331206
2040,MirrasHue,10,0.00302,307017,92.69669,331206
2041,msmshazan,10,0.00302,307027,92.69971,331206
2042,mthnzbk,10,0.00302,307037,92.70273,331206
2043,mudbile,10,0.00302,307047,92.70575,331206
2044,Muzz,10,0.00302,307057,92.70877,331206
2045,MVPLades,10,0.00302,307067,92.71179,331206
2046,nanella,10,0.00302,307077,92.71481,331206
2047,nate066,10,0.00302,307087,92.71783,331206
2048,nisovin,10,0.00302,307097,92.72084,331206
2049,ntfshard,10,0.00302,307107,92.72386,331206
2050,olivergs,10,0.00302,307117,92.72688,331206
2051,olsonjeffery,10,0.00302,307127,92.72990,331206
2052,p10tr3k,10,0.00302,307137,92.73292,331206
2053,Paritosh97,10,0.00302,307147,92.73594,331206
2054,PaulTaulbord81,10,0.00302,307157,92.73896,331206
2055,podpathos,10,0.00302,307167,92.74198,331206
2056,P-Star7,10,0.00302,307177,92.74500,331206
2057,rafael-arreola,10,0.00302,307187,92.74802,331206
2058,ravenblackx,10,0.00302,307197,92.75104,331206
2059,RealAquilus,10,0.00302,307207,92.75406,331206
2060,RibalGZ,10,0.00302,307217,92.75708,331206
2061,rivok,10,0.00302,307227,92.76009,331206
2062,RodrigoMedeirosRS,10,0.00302,307237,92.76311,331206
2063,RySchmitt,10,0.00302,307247,92.76613,331206
2064,Saikol,10,0.00302,307257,92.76915,331206
2065,SamuelDeboni,10,0.00302,307267,92.77217,331206
2066,SaviHex,10,0.00302,307277,92.77519,331206
2067,shawkes,10,0.00302,307287,92.77821,331206
2068,shinyclaw,10,0.00302,307297,92.78123,331206
2069,skyburchard,10,0.00302,307307,92.78425,331206
2070,SMaiLubis,10,0.00302,307317,92.78727,331206
2071,smeikx,10,0.00302,307327,92.79029,331206
2072,SouzaGuilherme,10,0.00302,307337,92.79331,331206
2073,spkingr,10,0.00302,307347,92.79633,331206
2074,stebulba,10,0.00302,307357,92.79935,331206
2075,stephdin,10,0.00302,307367,92.80236,331206
2076,stormi,10,0.00302,307377,92.80538,331206
2077,surashu,10,0.00302,307387,92.80840,331206
2078,svendixon,10,0.00302,307397,92.81142,331206
2079,swaggerbeer1,10,0.00302,307407,92.81444,331206
2080,swdeseng,10,0.00302,307417,92.81746,331206
2081,szamq,10,0.00302,307427,92.82048,331206
2082,tanchar,10,0.00302,307437,92.82350,331206
2083,taner1es,10,0.00302,307447,92.82652,331206
2084,Ternvein,10,0.00302,307457,92.82954,331206
2085,thebluefish,10,0.00302,307467,92.83256,331206
2086,theisegeberg,10,0.00302,307477,92.83558,331206
2087,themvl,10,0.00302,307487,92.83860,331206
2088,theOtherHolmes,10,0.00302,307497,92.84162,331206
2089,thiagoamendola,10,0.00302,307507,92.84463,331206
2090,tom95,10,0.00302,307517,92.84765,331206
2091,tomasantunes,10,0.00302,307527,92.85067,331206
2092,Tony-Goat,10,0.00302,307537,92.85369,331206
2093,t-persson,10,0.00302,307547,92.85671,331206
2094,twinpigs,10,0.00302,307557,92.85973,331206
2095,TZubiri,10,0.00302,307567,92.86275,331206
2096,uzimonkey,10,0.00302,307577,92.86577,331206
2097,vesk4000,10,0.00302,307587,92.86879,331206
2098,vinterskog,10,0.00302,307597,92.87181,331206
2099,wafemand,10,0.00302,307607,92.87483,331206
2100,wareya,10,0.00302,307617,92.87785,331206
2101,wargreen,10,0.00302,307627,92.88087,331206
2102,wass3r,10,0.00302,307637,92.88388,331206
2103,Willowblade,10,0.00302,307647,92.88690,331206
2104,WorkShoft,10,0.00302,307657,92.88992,331206
2105,yurchor,10,0.00302,307667,92.89294,331206
2106,ZainlessBrombie,10,0.00302,307677,92.89596,331206
2107,zarsystem,10,0.00302,307687,92.89898,331206
2108,Zeph-dev,10,0.00302,307697,92.90200,331206
2109,zlsa,10,0.00302,307707,92.90502,331206
2110,zombieCraig,10,0.00302,307717,92.90804,331206
2111,zqyoung1,10,0.00302,307727,92.91106,331206
2112,zzwx,10,0.00302,307737,92.91408,331206
2113,Aa20475,9,0.00272,307746,92.91679,331206
2114,abgenullt,9,0.00272,307755,92.91951,331206
2115,abitofbyte,9,0.00272,307764,92.92223,331206
2116,abustin,9,0.00272,307773,92.92495,331206
2117,ajacobsen,9,0.00272,307782,92.92766,331206
2118,AkatDeen,9,0.00272,307791,92.93038,331206
2119,alessiodeltrecco,9,0.00272,307800,92.93310,331206
2120,alexandervrs,9,0.00272,307809,92.93582,331206
2121,alexdlm,9,0.00272,307818,92.93853,331206
2122,alexfonseka,9,0.00272,307827,92.94125,331206
2123,alexolin,9,0.00272,307836,92.94397,331206
2124,Araken,9,0.00272,307845,92.94669,331206
2125,arimus,9,0.00272,307854,92.94940,331206
2126,arnoldochavez,9,0.00272,307863,92.95212,331206
2127,aroncds,9,0.00272,307872,92.95484,331206
2128,AssjackGames,9,0.00272,307881,92.95756,331206
2129,AttSee,9,0.00272,307890,92.96027,331206
2130,AurumStein,9,0.00272,307899,92.96299,331206
2131,beetbeet,9,0.00272,307908,92.96571,331206
2132,BE-NeverGames,9,0.00272,307917,92.96842,331206
2133,bfelbo,9,0.00272,307926,92.97114,331206
2134,blaeberry,9,0.00272,307935,92.97386,331206
2135,BloodyMess,9,0.00272,307944,92.97658,331206
2136,bmadgett,9,0.00272,307953,92.97929,331206
2137,bnpfeife,9,0.00272,307962,92.98201,331206
2138,brachna,9,0.00272,307971,92.98473,331206
2139,cajallen,9,0.00272,307980,92.98745,331206
2140,cat-kitten,9,0.00272,307989,92.99016,331206
2141,Chibin,9,0.00272,307998,92.99288,331206
2142,CJCarns,9,0.00272,308007,92.99560,331206
2143,cobreen,9,0.00272,308016,92.99832,331206
2144,codeape,9,0.00272,308025,93.00103,331206
2145,colludium,9,0.00272,308034,93.00375,331206
2146,ComicoTeam,9,0.00272,308043,93.00647,331206
2147,CritCorsac,9,0.00272,308052,93.00918,331206
2148,daglilley,9,0.00272,308061,93.01190,331206
2149,danboo,9,0.00272,308070,93.01462,331206
2150,DannyWarp,9,0.00272,308079,93.01734,331206
2151,DarkKilauea,9,0.00272,308088,93.02005,331206
2152,darthdeus,9,0.00272,308097,93.02277,331206
2153,DebugGameStudios,9,0.00272,308106,93.02549,331206
2154,DeerTears,9,0.00272,308115,93.02821,331206
2155,dfleury2,9,0.00272,308124,93.03092,331206
2156,dherring,9,0.00272,308133,93.03364,331206
2157,DiogoASTeixeira,9,0.00272,308142,93.03636,331206
2158,Disputer,9,0.00272,308151,93.03908,331206
2159,djrain,9,0.00272,308160,93.04179,331206
2160,docquantum,9,0.00272,308169,93.04451,331206
2161,doyouknowaboutq,9,0.00272,308178,93.04723,331206
2162,dsaltares,9,0.00272,308187,93.04994,331206
2163,duane-r,9,0.00272,308196,93.05266,331206
2164,eluadyl,9,0.00272,308205,93.05538,331206
2165,escargot-sans-gluten,9,0.00272,308214,93.05810,331206
2166,ewesche,9,0.00272,308223,93.06081,331206
2167,Exonaut,9,0.00272,308232,93.06353,331206
2168,eXponenta,9,0.00272,308241,93.06625,331206
2169,felyperennan,9,0.00272,308250,93.06897,331206
2170,Firty,9,0.00272,308259,93.07168,331206
2171,fmenozzi,9,0.00272,308268,93.07440,331206
2172,frank-lesser,9,0.00272,308277,93.07712,331206
2173,frojo,9,0.00272,308286,93.07984,331206
2174,fstiewitz,9,0.00272,308295,93.08255,331206
2175,Gamepreie,9,0.00272,308304,93.08527,331206
2176,gavriil07,9,0.00272,308313,93.08799,331206
2177,gravit22,9,0.00272,308322,93.09070,331206
2178,green-coder,9,0.00272,308331,93.09342,331206
2179,hinasis,9,0.00272,308340,93.09614,331206
2180,hk-32,9,0.00272,308349,93.09886,331206
2181,iggyvolz,9,0.00272,308358,93.10157,331206
2182,ILoveGodot,9,0.00272,308367,93.10429,331206
2183,Imerion,9,0.00272,308376,93.10701,331206
2184,Iskustvo,9,0.00272,308385,93.10973,331206
2185,jaccen,9,0.00272,308394,93.11244,331206
2186,jackwilsdon,9,0.00272,308403,93.11516,331206
2187,jacobspeicher,9,0.00272,308412,93.11788,331206
2188,jacoby34,9,0.00272,308421,93.12060,331206
2189,jdavid82,9,0.00272,308430,93.12331,331206
2190,jeancallisti,9,0.00272,308439,93.12603,331206
2191,jejay,9,0.00272,308448,93.12875,331206
2192,johngirvin,9,0.00272,308457,93.13147,331206
2193,JohnSilverLong,9,0.00272,308466,93.13418,331206
2194,Jose-Paulo-FaD,9,0.00272,308475,93.13690,331206
2195,josh18,9,0.00272,308484,93.13962,331206
2196,jxfaith,9,0.00272,308493,93.14233,331206
2197,Kartik1397,9,0.00272,308502,93.14505,331206
2198,Keelar,9,0.00272,308511,93.14777,331206
2199,keito940,9,0.00272,308520,93.15049,331206
2200,KLee1248,9,0.00272,308529,93.15320,331206
2201,Kobrar,9,0.00272,308538,93.15592,331206
2202,KokaKnut,9,0.00272,308547,93.15864,331206
2203,KoukouStudios,9,0.00272,308556,93.16136,331206
2204,Kowbell,9,0.00272,308565,93.16407,331206
2205,kristiannotari,9,0.00272,308574,93.16679,331206
2206,kroltan,9,0.00272,308583,93.16951,331206
2207,kukiric,9,0.00272,308592,93.17223,331206
2208,kurtisharms,9,0.00272,308601,93.17494,331206
2209,kyledayton,9,0.00272,308610,93.17766,331206
2210,leakim34,9,0.00272,308619,93.18038,331206
2211,lifelike,9,0.00272,308628,93.18309,331206
2212,likea-boss,9,0.00272,308637,93.18581,331206
2213,logzero,9,0.00272,308646,93.18853,331206
2214,LunaSquee,9,0.00272,308655,93.19125,331206
2215,MaGaRCaN,9,0.00272,308664,93.19396,331206
2216,markdibarry,9,0.00272,308673,93.19668,331206
2217,Marre246810,9,0.00272,308682,93.19940,331206
2218,MarufSarker,9,0.00272,308691,93.20212,331206
2219,masmartyg,9,0.00272,308700,93.20483,331206
2220,Mastermori,9,0.00272,308709,93.20755,331206
2221,Maxpilot,9,0.00272,308718,93.21027,331206
2222,mbrickn,9,0.00272,308727,93.21299,331206
2223,miblooming,9,0.00272,308736,93.21570,331206
2224,michaelsjackson,9,0.00272,308745,93.21842,331206
2225,migueldeicaza,9,0.00272,308754,93.22114,331206
2226,mikica1986vee,9,0.00272,308763,93.22385,331206
2227,mikkac,9,0.00272,308772,93.22657,331206
2228,milkowski,9,0.00272,308781,93.22929,331206
2229,minifigmaster125,9,0.00272,308790,93.23201,331206
2230,mio991,9,0.00272,308799,93.23472,331206
2231,mishapsi,9,0.00272,308808,93.23744,331206
2232,mokamars,9,0.00272,308817,93.24016,331206
2233,NedAlex94,9,0.00272,308826,93.24288,331206
2234,nmearl,9,0.00272,308835,93.24559,331206
2235,notepade,9,0.00272,308844,93.24831,331206
2236,nshusa,9,0.00272,308853,93.25103,331206
2237,nthana,9,0.00272,308862,93.25375,331206
2238,NVriezen,9,0.00272,308871,93.25646,331206
2239,PabloF7,9,0.00272,308880,93.25918,331206
2240,pcmxms,9,0.00272,308889,93.26190,331206
2241,pgregory,9,0.00272,308898,93.26461,331206
2242,popenke,9,0.00272,308907,93.26733,331206
2243,PrestonKnopp,9,0.00272,308916,93.27005,331206
2244,pulkomandy,9,0.00272,308925,93.27277,331206
2245,pwnorbitals,9,0.00272,308934,93.27548,331206
2246,qbradq,9,0.00272,308943,93.27820,331206
2247,r1cebank,9,0.00272,308952,93.28092,331206
2248,rakun99,9,0.00272,308961,93.28364,331206
2249,Ramh5,9,0.00272,308970,93.28635,331206
2250,randall-fulton,9,0.00272,308979,93.28907,331206
2251,rathren,9,0.00272,308988,93.29179,331206
2252,Ratinod,9,0.00272,308997,93.29451,331206
2253,rburing,9,0.00272,309006,93.29722,331206
2254,rdcklinux,9,0.00272,309015,93.29994,331206
2255,Reousa,9,0.00272,309024,93.30266,331206
2256,rhode2nh,9,0.00272,309033,93.30537,331206
2257,richard14110,9,0.00272,309042,93.30809,331206
2258,rico345100,9,0.00272,309051,93.31081,331206
2259,RockyMadio,9,0.00272,309060,93.31353,331206
2260,Rodeo-McCabe,9,0.00272,309069,93.31624,331206
2261,satyries,9,0.00272,309078,93.31896,331206
2262,SeleDreams,9,0.00272,309087,93.32168,331206
2263,Shinryuuji,9,0.00272,309096,93.32440,331206
2264,shintiger,9,0.00272,309105,93.32711,331206
2265,simoncrawford2018,9,0.00272,309114,93.32983,331206
2266,sjml,9,0.00272,309123,93.33255,331206
2267,SnailBones,9,0.00272,309132,93.33527,331206
2268,SoftLaunch,9,0.00272,309141,93.33798,331206
2269,StarWolf3000,9,0.00272,309150,93.34070,331206
2270,steelxtreme,9,0.00272,309159,93.34342,331206
2271,tdaffin,9,0.00272,309168,93.34614,331206
2272,tetious,9,0.00272,309177,93.34885,331206
2273,TheMadScientist1234,9,0.00272,309186,93.35157,331206
2274,tinyleolin,9,0.00272,309195,93.35429,331206
2275,toiletsnakes,9,0.00272,309204,93.35700,331206
2276,tr0q,9,0.00272,309213,93.35972,331206
2277,Trayani,9,0.00272,309222,93.36244,331206
2278,twinderw,9,0.00272,309231,93.36516,331206
2279,unicomp21,9,0.00272,309240,93.36787,331206
2280,Ursus-Z,9,0.00272,309249,93.37059,331206
2281,VAVUS7,9,0.00272,309258,93.37331,331206
2282,VedatGunel,9,0.00272,309267,93.37603,331206
2283,Wapit1,9,0.00272,309276,93.37874,331206
2284,wetiontop,9,0.00272,309285,93.38146,331206
2285,Xylord,9,0.00272,309294,93.38418,331206
2286,yalcin-ata,9,0.00272,309303,93.38690,331206
2287,yamgent,9,0.00272,309312,93.38961,331206
2288,YBPN,9,0.00272,309321,93.39233,331206
2289,yehjaemin,9,0.00272,309330,93.39505,331206
2290,zwostein,9,0.00272,309339,93.39776,331206
2291,2bit-hack,8,0.00242,309347,93.40018,331206
2292,abhinav4987,8,0.00242,309355,93.40260,331206
2293,adamreichold,8,0.00242,309363,93.40501,331206
2294,addmix,8,0.00242,309371,93.40743,331206
2295,aganm,8,0.00242,309379,93.40984,331206
2296,alekmlynek,8,0.00242,309387,93.41226,331206
2297,Aleksul,8,0.00242,309395,93.41467,331206
2298,AlexZ005,8,0.00242,309403,93.41709,331206
2299,AllenKll,8,0.00242,309411,93.41950,331206
2300,alugarius,8,0.00242,309419,93.42192,331206
2301,amkk,8,0.00242,309427,93.42433,331206
2302,AndHalfAFish,8,0.00242,309435,93.42675,331206
2303,AngelOnFira,8,0.00242,309443,93.42916,331206
2304,AnilBK,8,0.00242,309451,93.43158,331206
2305,anthonyromano,8,0.00242,309459,93.43400,331206
2306,aqt,8,0.00242,309467,93.43641,331206
2307,Arakash,8,0.00242,309475,93.43883,331206
2308,ArcOfDream,8,0.00242,309483,93.44124,331206
2309,arlez80,8,0.00242,309491,93.44366,331206
2310,Arnklit,8,0.00242,309499,93.44607,331206
2311,Aroweeri,8,0.00242,309507,93.44849,331206
2312,artism90,8,0.00242,309515,93.45090,331206
2313,asmoaesl,8,0.00242,309523,93.45332,331206
2314,ax95,8,0.00242,309531,93.45573,331206
2315,BanchouBoo,8,0.00242,309539,93.45815,331206
2316,Bat-Computer,8,0.00242,309547,93.46057,331206
2317,bdero,8,0.00242,309555,93.46298,331206
2318,belen-albeza,8,0.00242,309563,93.46540,331206
2319,BLaDoM,8,0.00242,309571,93.46781,331206
2320,boogabelly,8,0.00242,309579,93.47023,331206
2321,Brayacon,8,0.00242,309587,93.47264,331206
2322,brmassa,8,0.00242,309595,93.47506,331206
2323,butterflyeight,8,0.00242,309603,93.47747,331206
2324,byfron,8,0.00242,309611,93.47989,331206
2325,bzztbomb,8,0.00242,309619,93.48230,331206
2326,Calamander,8,0.00242,309627,93.48472,331206
2327,CalebMRichardson,8,0.00242,309635,93.48713,331206
2328,carllacan,8,0.00242,309643,93.48955,331206
2329,CarlosAlmarcha,8,0.00242,309651,93.49197,331206
2330,catafest,8,0.00242,309659,93.49438,331206
2331,CezaryKopias,8,0.00242,309667,93.49680,331206
2332,CheeryLee,8,0.00242,309675,93.49921,331206
2333,christoffersch,8,0.00242,309683,93.50163,331206
2334,comradekingu,8,0.00242,309691,93.50404,331206
2335,cur33,8,0.00242,309699,93.50646,331206
2336,D3ZAX,8,0.00242,309707,93.50887,331206
2337,DagobertDev,8,0.00242,309715,93.51129,331206
2338,dancroote,8,0.00242,309723,93.51370,331206
2339,danielkulas,8,0.00242,309731,93.51612,331206
2340,danilojr,8,0.00242,309739,93.51854,331206
2341,David-security,8,0.00242,309747,93.52095,331206
2342,DeadlyLampshade,8,0.00242,309755,93.52337,331206
2343,demipixel,8,0.00242,309763,93.52578,331206
2344,DiemenDesign,8,0.00242,309771,93.52820,331206
2345,djole1973,8,0.00242,309779,93.53061,331206
2346,DocoDan,8,0.00242,309787,93.53303,331206
2347,DoubleDeez,8,0.00242,309795,93.53544,331206
2348,Draghi,8,0.00242,309803,93.53786,331206
2349,Dumbeldor,8,0.00242,309811,93.54027,331206
2350,DynasoulStudio,8,0.00242,309819,93.54269,331206
2351,ellenhp,8,0.00242,309827,93.54510,331206
2352,EmrysMyrddin,8,0.00242,309835,93.54752,331206
2353,eswartz,8,0.00242,309843,93.54994,331206
2354,extremety1989,8,0.00242,309851,93.55235,331206
2355,fahmyrm,8,0.00242,309859,93.55477,331206
2356,fejnartal,8,0.00242,309867,93.55718,331206
2357,FIF15,8,0.00242,309875,93.55960,331206
2358,flurick,8,0.00242,309883,93.56201,331206
2359,frewq,8,0.00242,309891,93.56443,331206
2360,fry-,8,0.00242,309899,93.56684,331206
2361,G392,8,0.00242,309907,93.56926,331206
2362,georgescumihail-gh,8,0.00242,309915,93.57167,331206
2363,GetLocalPlayer,8,0.00242,309923,93.57409,331206
2364,ginobean,8,0.00242,309931,93.57651,331206
2365,GNSS-Stylist,8,0.00242,309939,93.57892,331206
2366,golfinq,8,0.00242,309947,93.58134,331206
2367,Gorgexpress,8,0.00242,309955,93.58375,331206
2368,GreenBeakCrow,8,0.00242,309963,93.58617,331206
2369,griant,8,0.00242,309971,93.58858,331206
2370,guelinator,8,0.00242,309979,93.59100,331206
2371,Gurigraphics,8,0.00242,309987,93.59341,331206
2372,Gyrth,8,0.00242,309995,93.59583,331206
2373,h4de5,8,0.00242,310003,93.59824,331206
2374,Haledire,8,0.00242,310011,93.60066,331206
2375,HazmatDemon,8,0.00242,310019,93.60307,331206
2376,hcorion,8,0.00242,310027,93.60549,331206
2377,HumanSheeple,8,0.00242,310035,93.60791,331206
2378,icarito,8,0.00242,310043,93.61032,331206
2379,ICatRegister,8,0.00242,310051,93.61274,331206
2380,javidcf,8,0.00242,310059,93.61515,331206
2381,jdknox,8,0.00242,310067,93.61757,331206
2382,jefvaia,8,0.00242,310075,93.61998,331206
2383,jfmichaud31,8,0.00242,310083,93.62240,331206
2384,jjbob1234,8,0.00242,310091,93.62481,331206
2385,Jlalond,8,0.00242,310099,93.62723,331206
2386,jlopezcur,8,0.00242,310107,93.62964,331206
2387,JoaquinsVoid,8,0.00242,310115,93.63206,331206
2388,JohnJLight,8,0.00242,310123,93.63448,331206
2389,JohnMHarrisJr,8,0.00242,310131,93.63689,331206
2390,Joleeee,8,0.00242,310139,93.63931,331206
2391,JosiasAurel,8,0.00242,310147,93.64172,331206
2392,jpcima,8,0.00242,310155,93.64414,331206
2393,jshlw,8,0.00242,310163,93.64655,331206
2394,jzulauf-lunarg,8,0.00242,310171,93.64897,331206
2395,K9Kraken,8,0.00242,310179,93.65138,331206
2396,karolgotowala,8,0.00242,310187,93.65380,331206
2397,Khyzan,8,0.00242,310195,93.65621,331206
2398,Kinrany,8,0.00242,310203,93.65863,331206
2399,kisiel090,8,0.00242,310211,93.66104,331206
2400,Kopfenheim,8,0.00242,310219,93.66346,331206
2401,KoreTeknology,8,0.00242,310227,93.66588,331206
2402,Koyper,8,0.00242,310235,93.66829,331206
2403,KutayGuler,8,0.00242,310243,93.67071,331206
2404,kvonspiczak,8,0.00242,310251,93.67312,331206
2405,LaurentTreguier,8,0.00242,310259,93.67554,331206
2406,LillyByte,8,0.00242,310267,93.67795,331206
2407,Llcoolsouder,8,0.00242,310275,93.68037,331206
2408,Logharaa,8,0.00242,310283,93.68278,331206
2409,lolligerjoj,8,0.00242,310291,93.68520,331206
2410,lrgilbert,8,0.00242,310299,93.68761,331206
2411,m6c7l,8,0.00242,310307,93.69003,331206
2412,MackeyK24,8,0.00242,310315,93.69245,331206
2413,made10223,8,0.00242,310323,93.69486,331206
2414,magpie514,8,0.00242,310331,93.69728,331206
2415,mattsp1290,8,0.00242,310339,93.69969,331206
2416,Max-Hollywood,8,0.00242,310347,93.70211,331206
2417,MetaSaval,8,0.00242,310355,93.70452,331206
2418,MoraleIsNone,8,0.00242,310363,93.70694,331206
2419,mororo250,8,0.00242,310371,93.70935,331206
2420,mourning20s,8,0.00242,310379,93.71177,331206
2421,mr746866,8,0.00242,310387,93.71418,331206
2422,MrModez,8,0.00242,310395,93.71660,331206
2423,mth2610,8,0.00242,310403,93.71901,331206
2424,NaughtyGnosiophile,8,0.00242,310411,93.72143,331206
2425,need12648430,8,0.00242,310419,93.72385,331206
2426,nesja,8,0.00242,310427,93.72626,331206
2427,nettocavalcanti,8,0.00242,310435,93.72868,331206
2428,nictaylr,8,0.00242,310443,93.73109,331206
2429,Nimmda,8,0.00242,310451,93.73351,331206
2430,njor,8,0.00242,310459,93.73592,331206
2431,Noisefever,8,0.00242,310467,93.73834,331206
2432,norkn,8,0.00242,310475,93.74075,331206
2433,officialjacobgray,8,0.00242,310483,93.74317,331206
2434,Olm-e,8,0.00242,310491,93.74558,331206
2435,ol-smaug,8,0.00242,310499,93.74800,331206
2436,oreismatheus,8,0.00242,310507,93.75042,331206
2437,OscarOG,8,0.00242,310515,93.75283,331206
2438,oxrock,8,0.00242,310523,93.75525,331206
2439,paraclete-pizza,8,0.00242,310531,93.75766,331206
2440,PaulHMason,8,0.00242,310539,93.76008,331206
2441,pawilon,8,0.00242,310547,93.76249,331206
2442,pedrozaalex,8,0.00242,310555,93.76491,331206
2443,piever,8,0.00242,310563,93.76732,331206
2444,pip-byte,8,0.00242,310571,93.76974,331206
2445,PopeRigby,8,0.00242,310579,93.77215,331206
2446,programaths,8,0.00242,310587,93.77457,331206
2447,quendera,8,0.00242,310595,93.77698,331206
2448,Radbuglet,8,0.00242,310603,93.77940,331206
2449,rapsaGnauJ,8,0.00242,310611,93.78182,331206
2450,rdmtt,8,0.00242,310619,93.78423,331206
2451,ricochet1k,8,0.00242,310627,93.78665,331206
2452,RKelln,8,0.00242,310635,93.78906,331206
2453,RobKohr,8,0.00242,310643,93.79148,331206
2454,robojumper,8,0.00242,310651,93.79389,331206
2455,rodrigofbm,8,0.00242,310659,93.79631,331206
2456,RoloDMonkey,8,0.00242,310667,93.79872,331206
2457,saranvdev,8,0.00242,310675,93.80114,331206
2458,sean256,8,0.00242,310683,93.80355,331206
2459,setzer22,8,0.00242,310691,93.80597,331206
2460,shafy,8,0.00242,310699,93.80839,331206
2461,shianiawhite,8,0.00242,310707,93.81080,331206
2462,SirRamEsq,8,0.00242,310715,93.81322,331206
2463,Skalli,8,0.00242,310723,93.81563,331206
2464,skison,8,0.00242,310731,93.81805,331206
2465,slasktotten,8,0.00242,310739,93.82046,331206
2466,snichols,8,0.00242,310747,93.82288,331206
2467,softgripper,8,0.00242,310755,93.82529,331206
2468,SolarMongoose,8,0.00242,310763,93.82771,331206
2469,Solvero,8,0.00242,310771,93.83012,331206
2470,songangel72,8,0.00242,310779,93.83254,331206
2471,ssj71,8,0.00242,310787,93.83495,331206
2472,steveday4u,8,0.00242,310795,93.83737,331206
2473,taylorjoshuaw,8,0.00242,310803,93.83979,331206
2474,TheKK,8,0.00242,310811,93.84220,331206
2475,TheRadMatt,8,0.00242,310819,93.84462,331206
2476,thomasbaijot,8,0.00242,310827,93.84703,331206
2477,thomasruiz,8,0.00242,310835,93.84945,331206
2478,threaderic,8,0.00242,310843,93.85186,331206
2479,ThunderFD,8,0.00242,310851,93.85428,331206
2480,timower,8,0.00242,310859,93.85669,331206
2481,timroes,8,0.00242,310867,93.85911,331206
2482,TimurKhan,8,0.00242,310875,93.86152,331206
2483,tiniuclx,8,0.00242,310883,93.86394,331206
2484,Toizi,8,0.00242,310891,93.86636,331206
2485,tommywalkie,8,0.00242,310899,93.86877,331206
2486,Tunous,8,0.00242,310907,93.87119,331206
2487,tygree,8,0.00242,310915,93.87360,331206
2488,vagrantG,8,0.00242,310923,93.87602,331206
2489,viprip,8,0.00242,310931,93.87843,331206
2490,vipsbpig,8,0.00242,310939,93.88085,331206
2491,vntxx,8,0.00242,310947,93.88326,331206
2492,vurpo,8,0.00242,310955,93.88568,331206
2493,w84death,8,0.00242,310963,93.88809,331206
2494,wagnerfs,8,0.00242,310971,93.89051,331206
2495,winadam,8,0.00242,310979,93.89292,331206
2496,xphere,8,0.00242,310987,93.89534,331206
2497,ykoc,8,0.00242,310995,93.89776,331206
2498,YugoCode,8,0.00242,311003,93.90017,331206
2499,zappedfish,8,0.00242,311011,93.90259,331206
2500,zohozer,8,0.00242,311019,93.90500,331206
2501,zyansheep,8,0.00242,311027,93.90742,331206
2502,5N08,7,0.00211,311034,93.90953,331206
2503,98teg,7,0.00211,311041,93.91164,331206
2504,Acclution,7,0.00211,311048,93.91376,331206
2505,Acytra,7,0.00211,311055,93.91587,331206
2506,AdamRatai,7,0.00211,311062,93.91798,331206
2507,aheinous,7,0.00211,311069,93.92010,331206
2508,aitorCerecetoGlovoApp,7,0.00211,311076,93.92221,331206
2509,Akronae,7,0.00211,311083,93.92433,331206
2510,AlexAlappsis,7,0.00211,311090,93.92644,331206
2511,alexey-makarenko,7,0.00211,311097,93.92855,331206
2512,Allexit,7,0.00211,311104,93.93067,331206
2513,AMS21,7,0.00211,311111,93.93278,331206
2514,anasofgo,7,0.00211,311118,93.93489,331206
2515,Anchakor,7,0.00211,311125,93.93701,331206
2516,andreyrk,7,0.00211,311132,93.93912,331206
2517,andrycodestuffs,7,0.00211,311139,93.94123,331206
2518,AniMerrill,7,0.00211,311146,93.94335,331206
2519,arnaudcoj,7,0.00211,311153,93.94546,331206
2520,artellblender,7,0.00211,311160,93.94757,331206
2521,ArthurAttout,7,0.00211,311167,93.94969,331206
2522,AshSamir,7,0.00211,311174,93.95180,331206
2523,AspenBlack,7,0.00211,311181,93.95391,331206
2524,astrale-sharp,7,0.00211,311188,93.95603,331206
2525,athal24,7,0.00211,311195,93.95814,331206
2526,Atherz97,7,0.00211,311202,93.96025,331206
2527,ATryder,7,0.00211,311209,93.96237,331206
2528,attilix,7,0.00211,311216,93.96448,331206
2529,avahe-kellenberger,7,0.00211,311223,93.96659,331206
2530,badrazizi,7,0.00211,311230,93.96871,331206
2531,basharabdullah,7,0.00211,311237,93.97082,331206
2532,Battlefrog,7,0.00211,311244,93.97294,331206
2533,bennbollay,7,0.00211,311251,93.97505,331206
2534,bluepandion,7,0.00211,311258,93.97716,331206
2535,brettle,7,0.00211,311265,93.97928,331206
2536,bretzl,7,0.00211,311272,93.98139,331206
2537,casd82,7,0.00211,311279,93.98350,331206
2538,cenullum,7,0.00211,311286,93.98562,331206
2539,cgxeiji,7,0.00211,311293,93.98773,331206
2540,CheesecakeCG,7,0.00211,311300,93.98984,331206
2541,Chinmaygoyal,7,0.00211,311307,93.99196,331206
2542,chrishatch52,7,0.00211,311314,93.99407,331206
2543,cimpresovec,7,0.00211,311321,93.99618,331206
2544,cloewen8,7,0.00211,311328,93.99830,331206
2545,clofresh,7,0.00211,311335,94.00041,331206
2546,coasterspaul,7,0.00211,311342,94.00252,331206
2547,Coleim,7,0.00211,311349,94.00464,331206
2548,CROmartin,7,0.00211,311356,94.00675,331206
2549,cryptonaut,7,0.00211,311363,94.00886,331206
2550,cxong,7,0.00211,311370,94.01098,331206
2551,d3v0x,7,0.00211,311377,94.01309,331206
2552,dalton5000,7,0.00211,311384,94.01521,331206
2553,dannygaray60,7,0.00211,311391,94.01732,331206
2554,dbrova15,7,0.00211,311398,94.01943,331206
2555,ddekany,7,0.00211,311405,94.02155,331206
2556,demolitions,7,0.00211,311412,94.02366,331206
2557,denisw,7,0.00211,311419,94.02577,331206
2558,der-ac,7,0.00211,311426,94.02789,331206
2559,desperate-coder,7,0.00211,311433,94.03000,331206
2560,devolonter,7,0.00211,311440,94.03211,331206
2561,dlasalle,7,0.00211,311447,94.03423,331206
2562,domske,7,0.00211,311454,94.03634,331206
2563,DrNochi,7,0.00211,311461,94.03845,331206
2564,duckinferno,7,0.00211,311468,94.04057,331206
2565,eduardohmrodrigues,7,0.00211,311475,94.04268,331206
2566,eh-jogos,7,0.00211,311482,94.04479,331206
2567,elfring,7,0.00211,311489,94.04691,331206
2568,endlesstravel,7,0.00211,311496,94.04902,331206
2569,ericvoid,7,0.00211,311503,94.05113,331206
2570,esbennn,7,0.00211,311510,94.05325,331206
2571,EspeuteClement,7,0.00211,311517,94.05536,331206
2572,etamity,7,0.00211,311524,94.05747,331206
2573,faintdeception,7,0.00211,311531,94.05959,331206
2574,FayeAlephNil,7,0.00211,311538,94.06170,331206
2575,ferhand,7,0.00211,311545,94.06382,331206
2576,Filius-Patris,7,0.00211,311552,94.06593,331206
2577,fkollmann,7,0.00211,311559,94.06804,331206
2578,fractilegames,7,0.00211,311566,94.07016,331206
2579,Fulkman,7,0.00211,311573,94.07227,331206
2580,funabab,7,0.00211,311580,94.07438,331206
2581,gabrielformiga,7,0.00211,311587,94.07650,331206
2582,gaudecker,7,0.00211,311594,94.07861,331206
2583,gexpult,7,0.00211,311601,94.08072,331206
2584,Gianclgar,7,0.00211,311608,94.08284,331206
2585,giviz,7,0.00211,311615,94.08495,331206
2586,gr4ph0s,7,0.00211,311622,94.08706,331206
2587,greygraphics,7,0.00211,311629,94.08918,331206
2588,guineapenguin,7,0.00211,311636,94.09129,331206
2589,HassanHeydariNasab,7,0.00211,311643,94.09340,331206
2590,HectorCastelli,7,0.00211,311650,94.09552,331206
2591,heikytr,7,0.00211,311657,94.09763,331206
2592,hellodenq,7,0.00211,311664,94.09974,331206
2593,heretique,7,0.00211,311671,94.10186,331206
2594,Howardw3,7,0.00211,311678,94.10397,331206
2595,HubKing,7,0.00211,311685,94.10609,331206
2596,hussainm89,7,0.00211,311692,94.10820,331206
2597,iammangod96,7,0.00211,311699,94.11031,331206
2598,iamrahul404,7,0.00211,311706,94.11243,331206
2599,ianscottcamp,7,0.00211,311713,94.11454,331206
2600,iapicca,7,0.00211,311720,94.11665,331206
2601,IceflowRE,7,0.00211,311727,94.11877,331206
2602,imjp94,7,0.00211,311734,94.12088,331206
2603,InfiniteAnts,7,0.00211,311741,94.12299,331206
2604,InsightGit,7,0.00211,311748,94.12511,331206
2605,iox,7,0.00211,311755,94.12722,331206
2606,irmantus,7,0.00211,311762,94.12933,331206
2607,jaja00100,7,0.00211,311769,94.13145,331206
2608,jasmaa,7,0.00211,311776,94.13356,331206
2609,JeroMiya,7,0.00211,311783,94.13567,331206
2610,jhojantobonm,7,0.00211,311790,94.13779,331206
2611,JimmyJames707,7,0.00211,311797,94.13990,331206
2612,jjmontesl,7,0.00211,311804,94.14201,331206
2613,joelgomes1994,7,0.00211,311811,94.14413,331206
2614,JonathanPicques,7,0.00211,311818,94.14624,331206
2615,jsphpio,7,0.00211,311825,94.14835,331206
2616,juancolacelli,7,0.00211,311832,94.15047,331206
2617,JulienGio,7,0.00211,311839,94.15258,331206
2618,JulioYagami,7,0.00211,311846,94.15470,331206
2619,Kaideu,7,0.00211,311853,94.15681,331206
2620,KeithArch,7,0.00211,311860,94.15892,331206
2621,Kiaazad,7,0.00211,311867,94.16104,331206
2622,kkga,7,0.00211,311874,94.16315,331206
2623,klimi15,7,0.00211,311881,94.16526,331206
2624,KoltesDigital,7,0.00211,311888,94.16738,331206
2625,LandonPowell,7,0.00211,311895,94.16949,331206
2626,lastrodamo,7,0.00211,311902,94.17160,331206
2627,lazyvainglory,7,0.00211,311909,94.17372,331206
2628,Lebostein,7,0.00211,311916,94.17583,331206
2629,lee12321,7,0.00211,311923,94.17794,331206
2630,legione,7,0.00211,311930,94.18006,331206
2631,liquidape,7,0.00211,311937,94.18217,331206
2632,loohoo,7,0.00211,311944,94.18428,331206
2633,LordBrkica,7,0.00211,311951,94.18640,331206
2634,mablin7,7,0.00211,311958,94.18851,331206
2635,marcotc,7,0.00211,311965,94.19062,331206
2636,martindzejky,7,0.00211,311972,94.19274,331206
2637,martinruefenacht,7,0.00211,311979,94.19485,331206
2638,MarvinKehl,7,0.00211,311986,94.19697,331206
2639,masi456,7,0.00211,311993,94.19908,331206
2640,matheusmdx,7,0.00211,312000,94.20119,331206
2641,matthewedogawa,7,0.00211,312007,94.20331,331206
2642,mephiticstudios,7,0.00211,312014,94.20542,331206
2643,mewin,7,0.00211,312021,94.20753,331206
2644,michaellee8,7,0.00211,312028,94.20965,331206
2645,michelbehr,7,0.00211,312035,94.21176,331206
2646,mickdekkers,7,0.00211,312042,94.21387,331206
2647,mika314,7,0.00211,312049,94.21599,331206
2648,MinaRashad,7,0.00211,312056,94.21810,331206
2649,mmarramarco,7,0.00211,312063,94.22021,331206
2650,MohamedAlFahim,7,0.00211,312070,94.22233,331206
2651,mohamedhany4116,7,0.00211,312077,94.22444,331206
2652,MohammadKhashashneh,7,0.00211,312084,94.22655,331206
2653,MostafaMThabet,7,0.00211,312091,94.22867,331206
2654,mrdev023,7,0.00211,312098,94.23078,331206
2655,m-r-hunt,7,0.00211,312105,94.23289,331206
2656,MrJDR,7,0.00211,312112,94.23501,331206
2657,mudlee,7,0.00211,312119,94.23712,331206
2658,Mudley,7,0.00211,312126,94.23923,331206
2659,mutantbob,7,0.00211,312133,94.24135,331206
2660,MxZhur,7,0.00211,312140,94.24346,331206
2661,MyNameIsDabin,7,0.00211,312147,94.24558,331206
2662,Nathan173AB,7,0.00211,312154,94.24769,331206
2663,NaymanHohnheimer,7,0.00211,312161,94.24980,331206
2664,nedimmuminovic,7,0.00211,312168,94.25192,331206
2665,Neicul,7,0.00211,312175,94.25403,331206
2666,NeonIridescent,7,0.00211,312182,94.25614,331206
2667,neqs20,7,0.00211,312189,94.25826,331206
2668,NetroScript,7,0.00211,312196,94.26037,331206
2669,ngreve,7,0.00211,312203,94.26248,331206
2670,nicomitchell,7,0.00211,312210,94.26460,331206
2671,nikolatesla20,7,0.00211,312217,94.26671,331206
2672,novemberisms,7,0.00211,312224,94.26882,331206
2673,nthrack,7,0.00211,312231,94.27094,331206
2674,nu-fulla,7,0.00211,312238,94.27305,331206
2675,ObsidianBlk,7,0.00211,312245,94.27516,331206
2676,Ohmnivore,7,0.00211,312252,94.27728,331206
2677,oliver-ruehl,7,0.00211,312259,94.27939,331206
2678,OniLink,7,0.00211,312266,94.28150,331206
2679,PapaFl,7,0.00211,312273,94.28362,331206
2680,PeaceSells50,7,0.00211,312280,94.28573,331206
2681,Peter-Crawley,7,0.00211,312287,94.28785,331206
2682,P-GLEZ,7,0.00211,312294,94.28996,331206
2683,phantomdesvin,7,0.00211,312301,94.29207,331206
2684,piiertho,7,0.00211,312308,94.29419,331206
2685,pikachuk,7,0.00211,312315,94.29630,331206
2686,Pikl,7,0.00211,312322,94.29841,331206
2687,Pilvinen,7,0.00211,312329,94.30053,331206
2688,pintu236,7,0.00211,312336,94.30264,331206
2689,pshe94,7,0.00211,312343,94.30475,331206
2690,punyi23,7,0.00211,312350,94.30687,331206
2691,q4a,7,0.00211,312357,94.30898,331206
2692,quabug,7,0.00211,312364,94.31109,331206
2693,radicaled,7,0.00211,312371,94.31321,331206
2694,randyyaj,7,0.00211,312378,94.31532,331206
2695,raniejade,7,0.00211,312385,94.31743,331206
2696,rayojarr,7,0.00211,312392,94.31955,331206
2697,reaply,7,0.00211,312399,94.32166,331206
2698,RegalMedia,7,0.00211,312406,94.32377,331206
2699,reisraff,7,0.00211,312413,94.32589,331206
2700,renatodex,7,0.00211,312420,94.32800,331206
2701,Ridote,7,0.00211,312427,94.33011,331206
2702,RileyGuy,7,0.00211,312434,94.33223,331206
2703,rilpires,7,0.00211,312441,94.33434,331206
2704,rmvermeulen,7,0.00211,312448,94.33646,331206
2705,RobertoMalatesta,7,0.00211,312455,94.33857,331206
2706,rolfpancake,7,0.00211,312462,94.34068,331206
2707,rszibele,7,0.00211,312469,94.34280,331206
2708,rtroncoso,7,0.00211,312476,94.34491,331206
2709,RyanJEC,7,0.00211,312483,94.34702,331206
2710,ryukinix,7,0.00211,312490,94.34914,331206
2711,S3B4S,7,0.00211,312497,94.35125,331206
2712,samuncle,7,0.00211,312504,94.35336,331206
2713,sancarn,7,0.00211,312511,94.35548,331206
2714,SASUPERNOVA,7,0.00211,312518,94.35759,331206
2715,Sceluswe,7,0.00211,312525,94.35970,331206
2716,sebastian-heinz,7,0.00211,312532,94.36182,331206
2717,seenloitering,7,0.00211,312539,94.36393,331206
2718,ShatReal,7,0.00211,312546,94.36604,331206
2719,Shfty,7,0.00211,312553,94.36816,331206
2720,shlomif,7,0.00211,312560,94.37027,331206
2721,sigma0x,7,0.00211,312567,94.37238,331206
2722,Simiopsis,7,0.00211,312574,94.37450,331206
2723,siradam7th,7,0.00211,312581,94.37661,331206
2724,Skwint,7,0.00211,312588,94.37873,331206
2725,sleepcircle,7,0.00211,312595,94.38084,331206
2726,sonic2kk,7,0.00211,312602,94.38295,331206
2727,Soockee,7,0.00211,312609,94.38507,331206
2728,SoulForMachine,7,0.00211,312616,94.38718,331206
2729,soundgnome,7,0.00211,312623,94.38929,331206
2730,Sousio,7,0.00211,312630,94.39141,331206
2731,spikestheraccon,7,0.00211,312637,94.39352,331206
2732,ssd71,7,0.00211,312644,94.39563,331206
2733,Sseriously,7,0.00211,312651,94.39775,331206
2734,stevenabb,7,0.00211,312658,94.39986,331206
2735,stillinthe90s,7,0.00211,312665,94.40197,331206
2736,stoofin,7,0.00211,312672,94.40409,331206
2737,strattonbrazil,7,0.00211,312679,94.40620,331206
2738,SuperRobinHood,7,0.00211,312686,94.40831,331206
2739,susnux,7,0.00211,312693,94.41043,331206
2740,tajmone,7,0.00211,312700,94.41254,331206
2741,tecbeast42,7,0.00211,312707,94.41465,331206
2742,tempdoom,7,0.00211,312714,94.41677,331206
2743,ThaBalla1148,7,0.00211,312721,94.41888,331206
2744,thebspin,7,0.00211,312728,94.42099,331206
2745,thecogdoctor,7,0.00211,312735,94.42311,331206
2746,ThomasUijlen,7,0.00211,312742,94.42522,331206
2747,tkurby,7,0.00211,312749,94.42734,331206
2748,tommila,7,0.00211,312756,94.42945,331206
2749,TomNCatz,7,0.00211,312763,94.43156,331206
2750,TryPixel,7,0.00211,312770,94.43368,331206
2751,TvoyBatek,7,0.00211,312777,94.43579,331206
2752,TwoOfDiamonds,7,0.00211,312784,94.43790,331206
2753,tylerecouture,7,0.00211,312791,94.44002,331206
2754,Tyler-Yocolano,7,0.00211,312798,94.44213,331206
2755,u32i64,7,0.00211,312805,94.44424,331206
2756,unclearimage86,7,0.00211,312812,94.44636,331206
2757,vandalk,7,0.00211,312819,94.44847,331206
2758,VansonLeung,7,0.00211,312826,94.45058,331206
2759,VardenTheOne,7,0.00211,312833,94.45270,331206
2760,VictorSeven,7,0.00211,312840,94.45481,331206
2761,vintprox,7,0.00211,312847,94.45692,331206
2762,virtualritz,7,0.00211,312854,94.45904,331206
2763,vitrig,7,0.00211,312861,94.46115,331206
2764,voxelv,7,0.00211,312868,94.46326,331206
2765,vpellen,7,0.00211,312875,94.46538,331206
2766,WallyCZ,7,0.00211,312882,94.46749,331206
2767,wazzy47,7,0.00211,312889,94.46961,331206
2768,wmigor,7,0.00211,312896,94.47172,331206
2769,woubuc,7,0.00211,312903,94.47383,331206
2770,xkenoma,7,0.00211,312910,94.47595,331206
2771,xLordDaniel,7,0.00211,312917,94.47806,331206
2772,YannBurrett,7,0.00211,312924,94.48017,331206
2773,Zadck,7,0.00211,312931,94.48229,331206
2774,Zebcash,7,0.00211,312938,94.48440,331206
2775,zetashift,7,0.00211,312945,94.48651,331206
2776,1abinitio1,6,0.00181,312951,94.48832,331206
2777,3top1a,6,0.00181,312957,94.49014,331206
2778,999eagle,6,0.00181,312963,94.49195,331206
2779,aaaaeinai,6,0.00181,312969,94.49376,331206
2780,abakobo,6,0.00181,312975,94.49557,331206
2781,Abbix13,6,0.00181,312981,94.49738,331206
2782,accidentalrebel,6,0.00181,312987,94.49919,331206
2783,adamprocter,6,0.00181,312993,94.50101,331206
2784,Adriankhl,6,0.00181,312999,94.50282,331206
2785,adriansnetlis,6,0.00181,313005,94.50463,331206
2786,adtofaust,6,0.00181,313011,94.50644,331206
2787,ah0y,6,0.00181,313017,94.50825,331206
2788,ahmed6192,6,0.00181,313023,94.51006,331206
2789,ahmedyounis75,6,0.00181,313029,94.51187,331206
2790,Ajgamer28,6,0.00181,313035,94.51369,331206
2791,alanjds,6,0.00181,313041,94.51550,331206
2792,Alex533704,6,0.00181,313047,94.51731,331206
2793,alexchond,6,0.00181,313053,94.51912,331206
2794,AlexeyGrishin,6,0.00181,313059,94.52093,331206
2795,a-lexu,6,0.00181,313065,94.52274,331206
2796,AllenPocketGamer,6,0.00181,313071,94.52456,331206
2797,alt3r3dgd,6,0.00181,313077,94.52637,331206
2798,Althar93,6,0.00181,313083,94.52818,331206
2799,anantn,6,0.00181,313089,94.52999,331206
2800,andreasschuele,6,0.00181,313095,94.53180,331206
2801,Andre-Rb,6,0.00181,313101,94.53361,331206
2802,Andy0903,6,0.00181,313107,94.53543,331206
2803,Angular-Angel,6,0.00181,313113,94.53724,331206
2804,antoni4040,6,0.00181,313119,94.53905,331206
2805,arcticmatt,6,0.00181,313125,94.54086,331206
2806,ardanees-jatali,6,0.00181,313131,94.54267,331206
2807,Asaurus1,6,0.00181,313137,94.54448,331206
2808,AshfordN,6,0.00181,313143,94.54629,331206
2809,austinirvine,6,0.00181,313149,94.54811,331206
2810,authenticate,6,0.00181,313155,94.54992,331206
2811,aviraljanveja,6,0.00181,313161,94.55173,331206
2812,baldanders-skulltuna,6,0.00181,313167,94.55354,331206
2813,Bassie-c,6,0.00181,313173,94.55535,331206
2814,beocat,6,0.00181,313179,94.55716,331206
2815,bigelod,6,0.00181,313185,94.55898,331206
2816,Bimi124,6,0.00181,313191,94.56079,331206
2817,bitdom8,6,0.00181,313197,94.56260,331206
2818,bitsawer,6,0.00181,313203,94.56441,331206
2819,bitstopper,6,0.00181,313209,94.56622,331206
2820,bjr29,6,0.00181,313215,94.56803,331206
2821,bosman697,6,0.00181,313221,94.56984,331206
2822,bundabrg,6,0.00181,313227,94.57166,331206
2823,ByteSizeOtter,6,0.00181,313233,94.57347,331206
2824,calviken,6,0.00181,313239,94.57528,331206
2825,cbondurant,6,0.00181,313245,94.57709,331206
2826,cemeai,6,0.00181,313251,94.57890,331206
2827,Chatto,6,0.00181,313257,94.58071,331206
2828,chiboreache,6,0.00181,313263,94.58253,331206
2829,chitalian,6,0.00181,313269,94.58434,331206
2830,chon-panic,6,0.00181,313275,94.58615,331206
2831,chrisphyffer,6,0.00181,313281,94.58796,331206
2832,Chrisstar56,6,0.00181,313287,94.58977,331206
2833,Chuck5ta,6,0.00181,313293,94.59158,331206
2834,Claptrapwubwub,6,0.00181,313299,94.59340,331206
2835,CodeEasyYT,6,0.00181,313305,94.59521,331206
2836,codewing,6,0.00181,313311,94.59702,331206
2837,colorworlds,6,0.00181,313317,94.59883,331206
2838,ComanderKai77,6,0.00181,313323,94.60064,331206
2839,comfort-stereo,6,0.00181,313329,94.60245,331206
2840,ConorLPBoyle,6,0.00181,313335,94.60426,331206
2841,copygirl,6,0.00181,313341,94.60608,331206
2842,corbac,6,0.00181,313347,94.60789,331206
2843,Craig-Stoneham,6,0.00181,313353,94.60970,331206
2844,CrazyGuy108,6,0.00181,313359,94.61151,331206
2845,CreativeBuilds,6,0.00181,313365,94.61332,331206
2846,CRHough,6,0.00181,313371,94.61513,331206
2847,crud-boy,6,0.00181,313377,94.61695,331206
2848,Cryszon,6,0.00181,313383,94.61876,331206
2849,Cwiiis,6,0.00181,313389,94.62057,331206
2850,d0rf3n,6,0.00181,313395,94.62238,331206
2851,daafu,6,0.00181,313401,94.62419,331206
2852,dahiyabunty1,6,0.00181,313407,94.62600,331206
2853,daimeng,6,0.00181,313413,94.62781,331206
2854,DaividFrank,6,0.00181,313419,94.62963,331206
2855,dala00,6,0.00181,313425,94.63144,331206
2856,dallinbeutler,6,0.00181,313431,94.63325,331206
2857,daniellimws,6,0.00181,313437,94.63506,331206
2858,DanielMatarov,6,0.00181,313443,94.63687,331206
2859,daniloulf,6,0.00181,313449,94.63868,331206
2860,dariomnz,6,0.00181,313455,94.64050,331206
2861,DarkEngineer,6,0.00181,313461,94.64231,331206
2862,DavidMannes,6,0.00181,313467,94.64412,331206
2863,daviewales,6,0.00181,313473,94.64593,331206
2864,dbrookman,6,0.00181,313479,94.64774,331206
2865,DeH4er,6,0.00181,313485,94.64955,331206
2866,DeleteSystem32,6,0.00181,313491,94.65137,331206
2867,Deluvi,6,0.00181,313497,94.65318,331206
2868,deniscomtesse,6,0.00181,313503,94.65499,331206
2869,DigitalMonkeyPa1,6,0.00181,313509,94.65680,331206
2870,DillonFlohr,6,0.00181,313515,94.65861,331206
2871,Dimev,6,0.00181,313521,94.66042,331206
2872,dmlo,6,0.00181,313527,94.66223,331206
2873,dncnmckn,6,0.00181,313533,94.66405,331206
2874,Dodoveloper,6,0.00181,313539,94.66586,331206
2875,dolorismachina,6,0.00181,313545,94.66767,331206
2876,DomsterKB,6,0.00181,313551,94.66948,331206
2877,donut-on-ice,6,0.00181,313557,94.67129,331206
2878,Doraflara,6,0.00181,313563,94.67310,331206
2879,dos1,6,0.00181,313569,94.67492,331206
2880,DrAlta,6,0.00181,313575,94.67673,331206
2881,droqen,6,0.00181,313581,94.67854,331206
2882,dryw,6,0.00181,313587,94.68035,331206
2883,edouardgr,6,0.00181,313593,94.68216,331206
2884,Ekho7,6,0.00181,313599,94.68397,331206
2885,ElefanteNoi,6,0.00181,313605,94.68578,331206
2886,elizaho,6,0.00181,313611,94.68760,331206
2887,EludeQ,6,0.00181,313617,94.68941,331206
2888,ericstoneking,6,0.00181,313623,94.69122,331206
2889,ErwinBr,6,0.00181,313629,94.69303,331206
2890,EugenEistrach,6,0.00181,313635,94.69484,331206
2891,fahall,6,0.00181,313641,94.69665,331206
2892,felipefs,6,0.00181,313647,94.69847,331206
2893,FelixNemis,6,0.00181,313653,94.70028,331206
2894,F-He,6,0.00181,313659,94.70209,331206
2895,fidli,6,0.00181,313665,94.70390,331206
2896,FilipLundby,6,0.00181,313671,94.70571,331206
2897,firebelley,6,0.00181,313677,94.70752,331206
2898,Fisto69,6,0.00181,313683,94.70933,331206
2899,fpv999,6,0.00181,313689,94.71115,331206
2900,FransGerards,6,0.00181,313695,94.71296,331206
2901,FrederickKDP,6,0.00181,313701,94.71477,331206
2902,fredkozlowski,6,0.00181,313707,94.71658,331206
2903,fxdave,6,0.00181,313713,94.71839,331206
2904,gdgamedev,6,0.00181,313719,94.72020,331206
2905,gdupr,6,0.00181,313725,94.72202,331206
2906,GearStarter,6,0.00181,313731,94.72383,331206
2907,geoffder,6,0.00181,313737,94.72564,331206
2908,gerardabello,6,0.00181,313743,94.72745,331206
2909,gerchicov-bp,6,0.00181,313749,94.72926,331206
2910,gforceg,6,0.00181,313755,94.73107,331206
2911,gingerbeardman,6,0.00181,313761,94.73289,331206
2912,GiorgiBeriashvili,6,0.00181,313767,94.73470,331206
2913,greenmoggle,6,0.00181,313773,94.73651,331206
2914,GungnirInd,6,0.00181,313779,94.73832,331206
2915,gytsen,6,0.00181,313785,94.74013,331206
2916,hadrien-psydk,6,0.00181,313791,94.74194,331206
2917,hakro,6,0.00181,313797,94.74375,331206
2918,hamad-almamari,6,0.00181,313803,94.74557,331206
2919,hamoom,6,0.00181,313809,94.74738,331206
2920,hardikbhalodi,6,0.00181,313815,94.74919,331206
2921,Hendrikto,6,0.00181,313821,94.75100,331206
2922,HoneyPony,6,0.00181,313827,94.75281,331206
2923,hoxu,6,0.00181,313833,94.75462,331206
2924,hyperJJmaster,6,0.00181,313839,94.75644,331206
2925,imdjs,6,0.00181,313845,94.75825,331206
2926,IntricateMachinations,6,0.00181,313851,94.76006,331206
2927,IRONIC3D,6,0.00181,313857,94.76187,331206
2928,j5E01,6,0.00181,313863,94.76368,331206
2929,japietru2004,6,0.00181,313869,94.76549,331206
2930,jaran,6,0.00181,313875,94.76730,331206
2931,jarfil,6,0.00181,313881,94.76912,331206
2932,JayFontenot,6,0.00181,313887,94.77093,331206
2933,JeffVenancius,6,0.00181,313893,94.77274,331206
2934,JeromeOrtali,6,0.00181,313899,94.77455,331206
2935,jersten,6,0.00181,313905,94.77636,331206
2936,jhm-ciberman,6,0.00181,313911,94.77817,331206
2937,jiteshvm,6,0.00181,313917,94.77999,331206
2938,JoaoAlvaroFerreira,6,0.00181,313923,94.78180,331206
2939,joaquin-montesdeoca,6,0.00181,313929,94.78361,331206
2940,John0456,6,0.00181,313935,94.78542,331206
2941,JohnGabrielUK,6,0.00181,313941,94.78723,331206
2942,JohnnyLeone,6,0.00181,313947,94.78904,331206
2943,JordanMotta,6,0.00181,313953,94.79086,331206
2944,Josh012422,6,0.00181,313959,94.79267,331206
2945,Jubjub,6,0.00181,313965,94.79448,331206
2946,JulianGmp,6,0.00181,313971,94.79629,331206
2947,julienduroure,6,0.00181,313977,94.79810,331206
2948,Jylhis,6,0.00181,313983,94.79991,331206
2949,kaermorchen,6,0.00181,313989,94.80172,331206
2950,kane-thornwyrd,6,0.00181,313995,94.80354,331206
2951,karlygeeky,6,0.00181,314001,94.80535,331206
2952,KarsSloeserwij,6,0.00181,314007,94.80716,331206
2953,KawanWeege,6,0.00181,314013,94.80897,331206
2954,kgensou,6,0.00181,314019,94.81078,331206
2955,khinbaptista,6,0.00181,314025,94.81259,331206
2956,Kinwailo,6,0.00181,314031,94.81441,331206
2957,kramer425,6,0.00181,314037,94.81622,331206
2958,kripken,6,0.00181,314043,94.81803,331206
2959,laGrossePistache,6,0.00181,314049,94.81984,331206
2960,Lamoot,6,0.00181,314055,94.82165,331206
2961,larix45,6,0.00181,314061,94.82346,331206
2962,lboklin,6,0.00181,314067,94.82527,331206
2963,leandrodreamer,6,0.00181,314073,94.82709,331206
2964,Leytak,6,0.00181,314079,94.82890,331206
2965,linuxuser44,6,0.00181,314085,94.83071,331206
2966,liryu1973,6,0.00181,314091,94.83252,331206
2967,lliberadzki,6,0.00181,314097,94.83433,331206
2968,locness3,6,0.00181,314103,94.83614,331206
2969,Lohan120,6,0.00181,314109,94.83796,331206
2970,lonegamedev,6,0.00181,314115,94.83977,331206
2971,lpn,6,0.00181,314121,94.84158,331206
2972,luislodosm,6,0.00181,314127,94.84339,331206
2973,lukad,6,0.00181,314133,94.84520,331206
2974,MagellanicGames,6,0.00181,314139,94.84701,331206
2975,mahdisml,6,0.00181,314145,94.84883,331206
2976,MandL27,6,0.00181,314151,94.85064,331206
2977,Master-J,6,0.00181,314157,94.85245,331206
2978,MateusMP,6,0.00181,314163,94.85426,331206
2979,matzebond,6,0.00181,314169,94.85607,331206
2980,MBZSoftProds,6,0.00181,314175,94.85788,331206
2981,meem40,6,0.00181,314181,94.85969,331206
2982,memoryruins,6,0.00181,314187,94.86151,331206
2983,meowxiik,6,0.00181,314193,94.86332,331206
2984,MGeymer,6,0.00181,314199,94.86513,331206
2985,michaeljoy255,6,0.00181,314205,94.86694,331206
2986,mijo-gracanin,6,0.00181,314211,94.86875,331206
2987,Mikadini,6,0.00181,314217,94.87056,331206
2988,mikeant42,6,0.00181,314223,94.87238,331206
2989,Mikerhinos,6,0.00181,314229,94.87419,331206
2990,MilosLukic,6,0.00181,314235,94.87600,331206
2991,missed-ledgedash,6,0.00181,314241,94.87781,331206
2992,mnemotic,6,0.00181,314247,94.87962,331206
2993,mohsenph69,6,0.00181,314253,94.88143,331206
2994,molevision,6,0.00181,314259,94.88324,331206
2995,moneyghost,6,0.00181,314265,94.88506,331206
2996,Mootook,6,0.00181,314271,94.88687,331206
2997,mrmakeit,6,0.00181,314277,94.88868,331206
2998,munirehmad,6,0.00181,314283,94.89049,331206
2999,mwichmann,6,0.00181,314289,94.89230,331206
3000,n31r0,6,0.00181,314295,94.89411,331206
3001,narcissawright,6,0.00181,314301,94.89593,331206
3002,Nateao7,6,0.00181,314307,94.89774,331206
3003,nathanleiby,6,0.00181,314313,94.89955,331206
3004,navaronbracke,6,0.00181,314319,94.90136,331206
3005,navett52,6,0.00181,314325,94.90317,331206
3006,nbanks,6,0.00181,314331,94.90498,331206
3007,nemerle,6,0.00181,314337,94.90680,331206
3008,nervaccio,6,0.00181,314343,94.90861,331206
3009,nicholatian,6,0.00181,314349,94.91042,331206
3010,NielsVanM,6,0.00181,314355,94.91223,331206
3011,nippysaurus,6,0.00181,314361,94.91404,331206
3012,niu2x,6,0.00181,314367,94.91585,331206
3013,noh4ck,6,0.00181,314373,94.91766,331206
3014,nonameentername,6,0.00181,314379,94.91948,331206
3015,norlowski,6,0.00181,314385,94.92129,331206
3016,NoSilver2018,6,0.00181,314391,94.92310,331206
3017,notwarp,6,0.00181,314397,94.92491,331206
3018,NovemberDev,6,0.00181,314403,94.92672,331206
3019,NyxTheShield,6,0.00181,314409,94.92853,331206
3020,Obr00007576,6,0.00181,314415,94.93035,331206
3021,OlegDydy,6,0.00181,314421,94.93216,331206
3022,omar25h,6,0.00181,314427,94.93397,331206
3023,onur,6,0.00181,314433,94.93578,331206
3024,oOo0oOo,6,0.00181,314439,94.93759,331206
3025,Osimedias,6,0.00181,314445,94.93940,331206
3026,OttisWang,6,0.00181,314451,94.94121,331206
3027,p4ngy4,6,0.00181,314457,94.94303,331206
3028,pakchano,6,0.00181,314463,94.94484,331206
3029,pallavnawani,6,0.00181,314469,94.94665,331206
3030,pastra98,6,0.00181,314475,94.94846,331206
3031,path9263,6,0.00181,314481,94.95027,331206
3032,paulcosmos,6,0.00181,314487,94.95208,331206
3033,pedroalopes,6,0.00181,314493,94.95390,331206
3034,Penguin63,6,0.00181,314499,94.95571,331206
3035,Pennycook,6,0.00181,314505,94.95752,331206
3036,Pete-The-Penguin,6,0.00181,314511,94.95933,331206
3037,phelioz,6,0.00181,314517,94.96114,331206
3038,PkayJava,6,0.00181,314523,94.96295,331206
3039,Placinta,6,0.00181,314529,94.96477,331206
3040,Pleto,6,0.00181,314535,94.96658,331206
3041,Pr0methean,6,0.00181,314541,94.96839,331206
3042,PranavSK,6,0.00181,314547,94.97020,331206
3043,proarunas,6,0.00181,314553,94.97201,331206
3044,probonopd,6,0.00181,314559,94.97382,331206
3045,przmkg,6,0.00181,314565,94.97563,331206
3046,psoslash,6,0.00181,314571,94.97745,331206
3047,pyrophone,6,0.00181,314577,94.97926,331206
3048,Qualitymix,6,0.00181,314583,94.98107,331206
3049,Ragnoroct,6,0.00181,314589,94.98288,331206
3050,Raidenkyu,6,0.00181,314595,94.98469,331206
3051,Railwanderer,6,0.00181,314601,94.98650,331206
3052,rainbowism,6,0.00181,314607,94.98832,331206
3053,RajatGoswami,6,0.00181,314613,94.99013,331206
3054,Ramshell,6,0.00181,314619,94.99194,331206
3055,raphaklaus,6,0.00181,314625,94.99375,331206
3056,rayosdev,6,0.00181,314631,94.99556,331206
3057,ReturnMinusOne,6,0.00181,314637,94.99737,331206
3058,RevenantX,6,0.00181,314643,94.99918,331206
3059,rhulha,6,0.00181,314649,95.00100,331206
3060,ricardoprins,6,0.00181,314655,95.00281,331206
3061,r-lodahl,6,0.00181,314661,95.00462,331206
3062,robertsonb93,6,0.00181,314667,95.00643,331206
3063,RolandMQuiros,6,0.00181,314673,95.00824,331206
3064,rontarrant,6,0.00181,314679,95.01005,331206
3065,RuiPDeJe,6,0.00181,314685,95.01187,331206
3066,runt1m33rr0r,6,0.00181,314691,95.01368,331206
3067,ryliejamesthomas,6,0.00181,314697,95.01549,331206
3068,sairam4123,6,0.00181,314703,95.01730,331206
3069,saranshgupta1995,6,0.00181,314709,95.01911,331206
3070,schertudi,6,0.00181,314715,95.02092,331206
3071,schweigert,6,0.00181,314721,95.02274,331206
3072,seixasfelipe,6,0.00181,314727,95.02455,331206
3073,seyacat,6,0.00181,314733,95.02636,331206
3074,Simran-B,6,0.00181,314739,95.02817,331206
3075,Sintinium,6,0.00181,314745,95.02998,331206
3076,smartin015,6,0.00181,314751,95.03179,331206
3077,sndels,6,0.00181,314757,95.03360,331206
3078,softwaredev101,6,0.00181,314763,95.03542,331206
3079,somedumbfox,6,0.00181,314769,95.03723,331206
3080,Sposito,6,0.00181,314775,95.03904,331206
3081,sprucely,6,0.00181,314781,95.04085,331206
3082,sps014,6,0.00181,314787,95.04266,331206
3083,SPTelur,6,0.00181,314793,95.04447,331206
3084,spusnei-pbsc,6,0.00181,314799,95.04629,331206
3085,Srogozins,6,0.00181,314805,95.04810,331206
3086,staalduinen,6,0.00181,314811,95.04991,331206
3087,stickynoteme,6,0.00181,314817,95.05172,331206
3088,Sungray,6,0.00181,314823,95.05353,331206
3089,sunkper,6,0.00181,314829,95.05534,331206
3090,survivant,6,0.00181,314835,95.05715,331206
3091,Tarocco,6,0.00181,314841,95.05897,331206
3092,TCLNA,6,0.00181,314847,95.06078,331206
3093,teko1987,6,0.00181,314853,95.06259,331206
3094,Tetane,6,0.00181,314859,95.06440,331206
3095,TextusGames,6,0.00181,314865,95.06621,331206
3096,thanksbuddy1980,6,0.00181,314871,95.06802,331206
3097,thanwah,6,0.00181,314877,95.06984,331206
3098,thduynguyen,6,0.00181,314883,95.07165,331206
3099,TheBlue-1,6,0.00181,314889,95.07346,331206
3100,TheHarvard,6,0.00181,314895,95.07527,331206
3101,TheLuigiplayer,6,0.00181,314901,95.07708,331206
3102,TheMisteryMan,6,0.00181,314907,95.07889,331206
3103,TheoLeeCJ,6,0.00181,314913,95.08071,331206
3104,TheRealNOIG,6,0.00181,314919,95.08252,331206
3105,TheTrope,6,0.00181,314925,95.08433,331206
3106,thisismike97,6,0.00181,314931,95.08614,331206
3107,TingPing,6,0.00181,314937,95.08795,331206
3108,tlahn,6,0.00181,314943,95.08976,331206
3109,TomatoVerified,6,0.00181,314949,95.09157,331206
3110,tomglenn,6,0.00181,314955,95.09339,331206
3111,ujjawal49,6,0.00181,314961,95.09520,331206
3112,unbu,6,0.00181,314967,95.09701,331206
3113,UnwarySage,6,0.00181,314973,95.09882,331206
3114,urusuru,6,0.00181,314979,95.10063,331206
3115,Validbit,6,0.00181,314985,95.10244,331206
3116,vankessel,6,0.00181,314991,95.10426,331206
3117,varshard,6,0.00181,314997,95.10607,331206
3118,viibr,6,0.00181,315003,95.10788,331206
3119,viktorias,6,0.00181,315009,95.10969,331206
3120,vinf100,6,0.00181,315015,95.11150,331206
3121,vitalfadeev,6,0.00181,315021,95.11331,331206
3122,voidplayer,6,0.00181,315027,95.11512,331206
3123,Volcano339,6,0.00181,315033,95.11694,331206
3124,vonagam,6,0.00181,315039,95.11875,331206
3125,voylin,6,0.00181,315045,95.12056,331206
3126,wardPlaced,6,0.00181,315051,95.12237,331206
3127,wdevan,6,0.00181,315057,95.12418,331206
3128,WeAthFoLD,6,0.00181,315063,95.12599,331206
3129,winNixz,6,0.00181,315069,95.12781,331206
3130,wiped1,6,0.00181,315075,95.12962,331206
3131,xahon,6,0.00181,315081,95.13143,331206
3132,Xancett,6,0.00181,315087,95.13324,331206
3133,xemjeff,6,0.00181,315093,95.13505,331206
3134,xklakoux,6,0.00181,315099,95.13686,331206
3135,YeOldeDM,6,0.00181,315105,95.13868,331206
3136,Yo1L,6,0.00181,315111,95.14049,331206
3137,Yogoda,6,0.00181,315117,95.14230,331206
3138,Yorkshire-Volker,6,0.00181,315123,95.14411,331206
3139,Yukitty,6,0.00181,315129,95.14592,331206
3140,zacryol,6,0.00181,315135,95.14773,331206
3141,Zambzz,6,0.00181,315141,95.14954,331206
3142,zbhatti-dev,6,0.00181,315147,95.15136,331206
3143,ZedMcJack,6,0.00181,315153,95.15317,331206
3144,zzador,6,0.00181,315159,95.15498,331206
3145,Zzzzac,6,0.00181,315165,95.15679,331206
3146,ZZZZZcode,6,0.00181,315171,95.15860,331206
3147,0IJon0,5,0.00151,315176,95.16011,331206
3148,10bag,5,0.00151,315181,95.16162,331206
3149,10jasper10,5,0.00151,315186,95.16313,331206
3150,a12n,5,0.00151,315191,95.16464,331206
3151,AaronWizard,5,0.00151,315196,95.16615,331206
3152,aarroz,5,0.00151,315201,95.16766,331206
3153,aayushchhabra,5,0.00151,315206,95.16917,331206
3154,AbandonedCode,5,0.00151,315211,95.17068,331206
3155,AberrantWolf,5,0.00151,315216,95.17219,331206
3156,AbhimanyuAryan,5,0.00151,315221,95.17370,331206
3157,acmepjz,5,0.00151,315226,95.17521,331206
3158,AdamA9,5,0.00151,315231,95.17672,331206
3159,adam-bates,5,0.00151,315236,95.17823,331206
3160,AdarshRise,5,0.00151,315241,95.17974,331206
3161,agmcleod,5,0.00151,315246,95.18125,331206
3162,ahouts,5,0.00151,315251,95.18276,331206
3163,AlexFlasch,5,0.00151,315256,95.18427,331206
3164,alfredbaudisch,5,0.00151,315261,95.18578,331206
3165,algorev,5,0.00151,315266,95.18729,331206
3166,Allespro,5,0.00151,315271,95.18879,331206
3167,alvaroHernandez,5,0.00151,315276,95.19030,331206
3168,Alzter,5,0.00151,315281,95.19181,331206
3169,Anaxagor14,5,0.00151,315286,95.19332,331206
3170,and3md,5,0.00151,315291,95.19483,331206
3171,anderejd,5,0.00151,315296,95.19634,331206
3172,andrewstrauch,5,0.00151,315301,95.19785,331206
3173,andrew-wilkes,5,0.00151,315306,95.19936,331206
3174,Animatical,5,0.00151,315311,95.20087,331206
3175,AnomalyAces,5,0.00151,315316,95.20238,331206
3176,AntonSalazar,5,0.00151,315321,95.20389,331206
3177,Anudin,5,0.00151,315326,95.20540,331206
3178,Anukriti12,5,0.00151,315331,95.20691,331206
3179,APoniatowski,5,0.00151,315336,95.20842,331206
3180,Archeia,5,0.00151,315341,95.20993,331206
3181,ariromano,5,0.00151,315346,95.21144,331206
3182,AriWD40,5,0.00151,315351,95.21295,331206
3183,Arjan219,5,0.00151,315356,95.21446,331206
3184,awindahl,5,0.00151,315361,95.21597,331206
3185,Axeltherabbit,5,0.00151,315366,95.21748,331206
3186,Azza292,5,0.00151,315371,95.21899,331206
3187,bbkane,5,0.00151,315376,95.22050,331206
3188,BearDooks,5,0.00151,315381,95.22201,331206
3189,beaverusiv,5,0.00151,315386,95.22352,331206
3190,ben-humphries,5,0.00151,315391,95.22503,331206
3191,bigbic127,5,0.00151,315396,95.22654,331206
3192,BigDC,5,0.00151,315401,95.22805,331206
3193,bill8224,5,0.00151,315406,95.22956,331206
3194,Black-Cat,5,0.00151,315411,95.23106,331206
3195,Blackwinter258,5,0.00151,315416,95.23257,331206
3196,bobylito,5,0.00151,315421,95.23408,331206
3197,Boivin92,5,0.00151,315426,95.23559,331206
3198,boulabiar,5,0.00151,315431,95.23710,331206
3199,brentbartlett,5,0.00151,315436,95.23861,331206
3200,BridgetNichols,5,0.00151,315441,95.24012,331206
3201,br-n518,5,0.00151,315446,95.24163,331206
3202,CarlFink,5,0.00151,315451,95.24314,331206
3203,cassio-raposa,5,0.00151,315456,95.24465,331206
3204,Castlemark,5,0.00151,315461,95.24616,331206
3205,CatThingy,5,0.00151,315466,95.24767,331206
3206,CDWimmer,5,0.00151,315471,95.24918,331206
3207,cefleet,5,0.00151,315476,95.25069,331206
3208,ChemicalInk,5,0.00151,315481,95.25220,331206
3209,CHIESOFTWARE,5,0.00151,315486,95.25371,331206
3210,ChinaChenMingQuan,5,0.00151,315491,95.25522,331206
3211,ChipChance,5,0.00151,315496,95.25673,331206
3212,city41,5,0.00151,315501,95.25824,331206
3213,Clocktown,5,0.00151,315506,95.25975,331206
3214,CoalaJoe,5,0.00151,315511,95.26126,331206
3215,codevenkat,5,0.00151,315516,95.26277,331206
3216,codingHahn,5,0.00151,315521,95.26428,331206
3217,comrade96,5,0.00151,315526,95.26579,331206
3218,CowKeyMan,5,0.00151,315531,95.26730,331206
3219,csotiriou,5,0.00151,315536,95.26881,331206
3220,CyberFoxHax,5,0.00151,315541,95.27032,331206
3221,Cybolic,5,0.00151,315546,95.27182,331206
3222,dacrystal,5,0.00151,315551,95.27333,331206
3223,DaDude,5,0.00151,315556,95.27484,331206
3224,dam482,5,0.00151,315561,95.27635,331206
3225,DamKoVosh,5,0.00151,315566,95.27786,331206
3226,DanielReyns,5,0.00151,315571,95.27937,331206
3227,davidCentervention,5,0.00151,315576,95.28088,331206
3228,daviel,5,0.00151,315581,95.28239,331206
3229,davincif,5,0.00151,315586,95.28390,331206
3230,dawkot,5,0.00151,315591,95.28541,331206
3231,db0,5,0.00151,315596,95.28692,331206
3232,dc740,5,0.00151,315601,95.28843,331206
3233,DCowboy,5,0.00151,315606,95.28994,331206
3234,dcramer,5,0.00151,315611,95.29145,331206
3235,de11ed,5,0.00151,315616,95.29296,331206
3236,deaton1337,5,0.00151,315621,95.29447,331206
3237,Delpire,5,0.00151,315626,95.29598,331206
3238,demonpig,5,0.00151,315631,95.29749,331206
3239,denormative,5,0.00151,315636,95.29900,331206
3240,DesertLithiumFlower,5,0.00151,315641,95.30051,331206
3241,devvoid,5,0.00151,315646,95.30202,331206
3242,dgellow,5,0.00151,315651,95.30353,331206
3243,dkaste,5,0.00151,315656,95.30504,331206
3244,DKesserich,5,0.00151,315661,95.30655,331206
3245,Dobbias,5,0.00151,315666,95.30806,331206
3246,dorkbox,5,0.00151,315671,95.30957,331206
3247,dotquixote,5,0.00151,315676,95.31108,331206
3248,drako0812,5,0.00151,315681,95.31258,331206
3249,drarem,5,0.00151,315686,95.31409,331206
3250,d-rex-15,5,0.00151,315691,95.31560,331206
3251,droc101,5,0.00151,315696,95.31711,331206
3252,DualLayer,5,0.00151,315701,95.31862,331206
3253,dweremeichik,5,0.00151,315706,95.32013,331206
3254,dxzone12,5,0.00151,315711,95.32164,331206
3255,Dziban-dev,5,0.00151,315716,95.32315,331206
3256,eastrd,5,0.00151,315721,95.32466,331206
3257,edaojs,5,0.00151,315726,95.32617,331206
3258,eetson,5,0.00151,315731,95.32768,331206
3259,eevee,5,0.00151,315736,95.32919,331206
3260,ejamshidiasl,5,0.00151,315741,95.33070,331206
3261,ElContreh,5,0.00151,315746,95.33221,331206
3262,ElGatoNinja,5,0.00151,315751,95.33372,331206
3263,eliaperantoni,5,0.00151,315756,95.33523,331206
3264,EllaKreal,5,0.00151,315761,95.33674,331206
3265,Elronnd,5,0.00151,315766,95.33825,331206
3266,emanuelcds,5,0.00151,315771,95.33976,331206
3267,EmanuelOzorio,5,0.00151,315776,95.34127,331206
3268,engineer0x47,5,0.00151,315781,95.34278,331206
3269,entro-pi,5,0.00151,315786,95.34429,331206
3270,enzogupi,5,0.00151,315791,95.34580,331206
3271,esblinuxcss,5,0.00151,315796,95.34731,331206
3272,Esharsid,5,0.00151,315801,95.34882,331206
3273,EstevanBR,5,0.00151,315806,95.35033,331206
3274,ETdoFresh,5,0.00151,315811,95.35184,331206
3275,evan-boissonnot,5,0.00151,315816,95.35335,331206
3276,evolarium,5,0.00151,315821,95.35485,331206
3277,eye776,5,0.00151,315826,95.35636,331206
3278,ezabba,5,0.00151,315831,95.35787,331206
3279,Faymoon,5,0.00151,315836,95.35938,331206
3280,felixpy,5,0.00151,315841,95.36089,331206
3281,fenix-hub,5,0.00151,315846,95.36240,331206
3282,fghibellini,5,0.00151,315851,95.36391,331206
3283,Filippopotamus,5,0.00151,315856,95.36542,331206
3284,fish2091852127,5,0.00151,315861,95.36693,331206
3285,fjordyo0707,5,0.00151,315866,95.36844,331206
3286,fkrick,5,0.00151,315871,95.36995,331206
3287,FlavoredCactus,5,0.00151,315876,95.37146,331206
3288,flomar,5,0.00151,315881,95.37297,331206
3289,Floriaen,5,0.00151,315886,95.37448,331206
3290,floydnunez,5,0.00151,315891,95.37599,331206
3291,FlutterTal,5,0.00151,315896,95.37750,331206
3292,Fr0sk,5,0.00151,315901,95.37901,331206
3293,FragileBoxGames,5,0.00151,315906,95.38052,331206
3294,Francesco149,5,0.00151,315911,95.38203,331206
3295,francogarcia,5,0.00151,315916,95.38354,331206
3296,Fredlyb,5,0.00151,315921,95.38505,331206
3297,Frooztyes,5,0.00151,315926,95.38656,331206
3298,FroznMine,5,0.00151,315931,95.38807,331206
3299,fsecilia,5,0.00151,315936,95.38958,331206
3300,fvasquezv,5,0.00151,315941,95.39109,331206
3301,fx21,5,0.00151,315946,95.39260,331206
3302,Gabriel-Diaz,5,0.00151,315951,95.39411,331206
3303,gamesoil,5,0.00151,315956,95.39561,331206
3304,ganlub,5,0.00151,315961,95.39712,331206
3305,Garmelon,5,0.00151,315966,95.39863,331206
3306,garuhester,5,0.00151,315971,95.40014,331206
3307,GeorgeGRz,5,0.00151,315976,95.40165,331206
3308,germanandino,5,0.00151,315981,95.40316,331206
3309,ghmart,5,0.00151,315986,95.40467,331206
3310,giogadi,5,0.00151,315991,95.40618,331206
3311,GittyGrubHub85,5,0.00151,315996,95.40769,331206
3312,Gogsi,5,0.00151,316001,95.40920,331206
3313,gonzo191,5,0.00151,316006,95.41071,331206
3314,GrooveStomp,5,0.00151,316011,95.41222,331206
3315,Grula,5,0.00151,316016,95.41373,331206
3316,guohongci,5,0.00151,316021,95.41524,331206
3317,guppy42,5,0.00151,316026,95.41675,331206
3318,hakoptak,5,0.00151,316031,95.41826,331206
3319,halzy,5,0.00151,316036,95.41977,331206
3320,Hamed2012-dr,5,0.00151,316041,95.42128,331206
3321,helenaMontenegro,5,0.00151,316046,95.42279,331206
3322,hermit8888,5,0.00151,316051,95.42430,331206
3323,hjegor,5,0.00151,316056,95.42581,331206
3324,holzmb,5,0.00151,316061,95.42732,331206
3325,Hoten,5,0.00151,316066,95.42883,331206
3326,hpn33,5,0.00151,316071,95.43034,331206
3327,Huxellberger,5,0.00151,316076,95.43185,331206
3328,iBoonie,5,0.00151,316081,95.43336,331206
3329,IceCubeDev,5,0.00151,316086,95.43487,331206
3330,Iddmeister,5,0.00151,316091,95.43637,331206
3331,ihigg,5,0.00151,316096,95.43788,331206
3332,IL7Games,5,0.00151,316101,95.43939,331206
3333,ImAReplicant,5,0.00151,316106,95.44090,331206
3334,Immortal000,5,0.00151,316111,95.44241,331206
3335,ImperatorS79,5,0.00151,316116,95.44392,331206
3336,indiemaatheus,5,0.00151,316121,95.44543,331206
3337,InkTide,5,0.00151,316126,95.44694,331206
3338,iPatso,5,0.00151,316131,95.44845,331206
3339,iplusMario,5,0.00151,316136,95.44996,331206
3340,iSynth,5,0.00151,316141,95.45147,331206
3341,ITomi78,5,0.00151,316146,95.45298,331206
3342,JA-Developer,5,0.00151,316151,95.45449,331206
3343,James-Pickett,5,0.00151,316156,95.45600,331206
3344,janvanhoudt,5,0.00151,316161,95.45751,331206
3345,JBacal,5,0.00151,316166,95.45902,331206
3346,jcs090218,5,0.00151,316171,95.46053,331206
3347,jejung,5,0.00151,316176,95.46204,331206
3348,jfcg,5,0.00151,316181,95.46355,331206
3349,jfmajor,5,0.00151,316186,95.46506,331206
3350,jhch3,5,0.00151,316191,95.46657,331206
3351,jjjuande,5,0.00151,316196,95.46808,331206
3352,JMS55,5,0.00151,316201,95.46959,331206
3353,joaopdrosors,5,0.00151,316206,95.47110,331206
3354,joaopedrosgs,5,0.00151,316211,95.47261,331206
3355,joealam,5,0.00151,316216,95.47412,331206
3356,JonathanGrant92,5,0.00151,316221,95.47563,331206
3357,jonathanhirz,5,0.00151,316226,95.47714,331206
3358,jordgubben,5,0.00151,316231,95.47864,331206
3359,JoseMcMaster,5,0.00151,316236,95.48015,331206
3360,JoshMarshall756,5,0.00151,316241,95.48166,331206
3361,jospic,5,0.00151,316246,95.48317,331206
3362,jsena42,5,0.00151,316251,95.48468,331206
3363,juanpaexpedite,5,0.00151,316256,95.48619,331206
3364,julianaito,5,0.00151,316261,95.48770,331206
3365,junkajii,5,0.00151,316266,95.48921,331206
3366,JustAntoRS,5,0.00151,316271,95.49072,331206
3367,jwittenbach,5,0.00151,316276,95.49223,331206
3368,jyoung9028,5,0.00151,316281,95.49374,331206
3369,Kadhel,5,0.00151,316286,95.49525,331206
3370,KaDokta,5,0.00151,316291,95.49676,331206
3371,kaiec,5,0.00151,316296,95.49827,331206
3372,KamiGrave,5,0.00151,316301,95.49978,331206
3373,KantarBruceAdams,5,0.00151,316306,95.50129,331206
3374,Kaonnull,5,0.00151,316311,95.50280,331206
3375,Kashouryo,5,0.00151,316316,95.50431,331206
3376,kellams,5,0.00151,316321,95.50582,331206
3377,kemojal,5,0.00151,316326,95.50733,331206
3378,kennebel,5,0.00151,316331,95.50884,331206
3379,keshavgbpecdelhi,5,0.00151,316336,95.51035,331206
3380,KevinStirling,5,0.00151,316341,95.51186,331206
3381,Kibouo,5,0.00151,316346,95.51337,331206
3382,kidandcat,5,0.00151,316351,95.51488,331206
3383,Kiel97,5,0.00151,316356,95.51639,331206
3384,kienvn,5,0.00151,316361,95.51790,331206
3385,KieranCarden,5,0.00151,316366,95.51940,331206
3386,kiiada,5,0.00151,316371,95.52091,331206
3387,kimamb,5,0.00151,316376,95.52242,331206
3388,Kinerius,5,0.00151,316381,95.52393,331206
3389,Kiotenhariyo,5,0.00151,316386,95.52544,331206
3390,Kloppie5,5,0.00151,316391,95.52695,331206
3391,Krumelur,5,0.00151,316396,95.52846,331206
3392,kryzmak,5,0.00151,316401,95.52997,331206
3393,Kylogias,5,0.00151,316406,95.53148,331206
3394,landon912,5,0.00151,316411,95.53299,331206
3395,LaRusCat,5,0.00151,316416,95.53450,331206
3396,laurentP,5,0.00151,316421,95.53601,331206
3397,leodimano,5,0.00151,316426,95.53752,331206
3398,libre8bit,5,0.00151,316431,95.53903,331206
3399,LinkDoyle,5,0.00151,316436,95.54054,331206
3400,LinuxDonald,5,0.00151,316441,95.54205,331206
3401,lipki,5,0.00151,316446,95.54356,331206
3402,lobinuxsoft,5,0.00151,316451,95.54507,331206
3403,lolzyman,5,0.00151,316456,95.54658,331206
3404,lstep,5,0.00151,316461,95.54809,331206
3405,LudovicGuerra,5,0.00151,316466,95.54960,331206
3406,luiz-pv9,5,0.00151,316471,95.55111,331206
3407,luke13139,5,0.00151,316476,95.55262,331206
3408,LynnCelest,5,0.00151,316481,95.55413,331206
3409,m50,5,0.00151,316486,95.55564,331206
3410,maciek134,5,0.00151,316491,95.55715,331206
3411,macjuul,5,0.00151,316496,95.55866,331206
3412,Magurosenbei,5,0.00151,316501,95.56016,331206
3413,mahubu,5,0.00151,316506,95.56167,331206
3414,marmitaTH,5,0.00151,316511,95.56318,331206
3415,marmitoTH,5,0.00151,316516,95.56469,331206
3416,martok,5,0.00151,316521,95.56620,331206
3417,MatejsBalodis,5,0.00151,316526,95.56771,331206
3418,MathiasBaumgartinger,5,0.00151,316531,95.56922,331206
3419,MatiasPi,5,0.00151,316536,95.57073,331206
3420,matkoniecz,5,0.00151,316541,95.57224,331206
3421,matthjes,5,0.00151,316546,95.57375,331206
3422,matwhill,5,0.00151,316551,95.57526,331206
3423,mawenzy,5,0.00151,316556,95.57677,331206
3424,McGittyHub,5,0.00151,316561,95.57828,331206
3425,medakk,5,0.00151,316566,95.57979,331206
3426,Megaguy32,5,0.00151,316571,95.58130,331206
3427,meirusfandi,5,0.00151,316576,95.58281,331206
3428,metadirective,5,0.00151,316581,95.58432,331206
3429,Michael-Jalloh,5,0.00151,316586,95.58583,331206
3430,Miezpiez,5,0.00151,316591,95.58734,331206
3431,mikeleeman,5,0.00151,316596,95.58885,331206
3432,MikeMnD,5,0.00151,316601,95.59036,331206
3433,mikowiec,5,0.00151,316606,95.59187,331206
3434,MissEmbyr,5,0.00151,316611,95.59338,331206
3435,mohammedzero43,5,0.00151,316616,95.59489,331206
3436,moonshineTheleocat,5,0.00151,316621,95.59640,331206
3437,msc29,5,0.00151,316626,95.59791,331206
3438,mschulzeLpz,5,0.00151,316631,95.59942,331206
3439,mtk4000,5,0.00151,316636,95.60093,331206
3440,MyriaCore,5,0.00151,316641,95.60243,331206
3441,n1rvana,5,0.00151,316646,95.60394,331206
3442,nadako,5,0.00151,316651,95.60545,331206
3443,najarvis,5,0.00151,316656,95.60696,331206
3444,namedtoaster,5,0.00151,316661,95.60847,331206
3445,nanaian,5,0.00151,316666,95.60998,331206
3446,nanoblit,5,0.00151,316671,95.61149,331206
3447,Nappael,5,0.00151,316676,95.61300,331206
3448,needfulthing,5,0.00151,316681,95.61451,331206
3449,ngoluan,5,0.00151,316686,95.61602,331206
3450,nicklunt,5,0.00151,316691,95.61753,331206
3451,NiclasEriksen,5,0.00151,316696,95.61904,331206
3452,nijel,5,0.00151,316701,95.62055,331206
3453,NikeYoungFr,5,0.00151,316706,95.62206,331206
3454,ninjanomnom,5,0.00151,316711,95.62357,331206
3455,nipunG314,5,0.00151,316716,95.62508,331206
3456,Nitroretro,5,0.00151,316721,95.62659,331206
3457,noass,5,0.00151,316726,95.62810,331206
3458,nolikenet,5,0.00151,316731,95.62961,331206
3459,Nosrick,5,0.00151,316736,95.63112,331206
3460,nrfaikar,5,0.00151,316741,95.63263,331206
3461,NykolaR,5,0.00151,316746,95.63414,331206
3462,oap-bram,5,0.00151,316751,95.63565,331206
3463,obsoke,5,0.00151,316756,95.63716,331206
3464,odragora,5,0.00151,316761,95.63867,331206
3465,Oleksandrigo,5,0.00151,316766,95.64018,331206
3466,Omiminpo,5,0.00151,316771,95.64169,331206
3467,oskarious,5,0.00151,316776,95.64319,331206
3468,oskude,5,0.00151,316781,95.64470,331206
3469,owlnical,5,0.00151,316786,95.64621,331206
3470,p3terparker,5,0.00151,316791,95.64772,331206
3471,PanosTrak,5,0.00151,316796,95.64923,331206
3472,Paradisebird,5,0.00151,316801,95.65074,331206
3473,passeride,5,0.00151,316806,95.65225,331206
3474,patrickelectric,5,0.00151,316811,95.65376,331206
3475,paulmasri,5,0.00151,316816,95.65527,331206
3476,PaulTaulborg,5,0.00151,316821,95.65678,331206
3477,paultech,5,0.00151,316826,95.65829,331206
3478,paviro,5,0.00151,316831,95.65980,331206
3479,pegasusearl,5,0.00151,316836,95.66131,331206
3480,Penguinum,5,0.00151,316841,95.66282,331206
3481,Perrottacooking,5,0.00151,316846,95.66433,331206
3482,petergilmour1987,5,0.00151,316851,95.66584,331206
3483,pfertyk,5,0.00151,316856,95.66735,331206
3484,phryk,5,0.00151,316861,95.66886,331206
3485,piece-o-ham,5,0.00151,316866,95.67037,331206
3486,pikmeir,5,0.00151,316871,95.67188,331206
3487,PrinceMerluza,5,0.00151,316876,95.67339,331206
3488,Procyon3,5,0.00151,316881,95.67490,331206
3489,psstoyanov,5,0.00151,316886,95.67641,331206
3490,PTrottier,5,0.00151,316891,95.67792,331206
3491,Qard,5,0.00151,316896,95.67943,331206
3492,quentincaffeino,5,0.00151,316901,95.68094,331206
3493,Quique1222,5,0.00151,316906,95.68245,331206
3494,rafahpdm,5,0.00151,316911,95.68396,331206
3495,RafalLauterbach,5,0.00151,316916,95.68546,331206
3496,Ralf12358,5,0.00151,316921,95.68697,331206
3497,randomness128,5,0.00151,316926,95.68848,331206
3498,Rastrizh,5,0.00151,316931,95.68999,331206
3499,ratsdiov,5,0.00151,316936,95.69150,331206
3500,RedMser,5,0.00151,316941,95.69301,331206
3501,Remixful,5,0.00151,316946,95.69452,331206
3502,Reno57,5,0.00151,316951,95.69603,331206
3503,RichyHBM,5,0.00151,316956,95.69754,331206
3504,RickSanch3z,5,0.00151,316961,95.69905,331206
3505,RikazuDev,5,0.00151,316966,95.70056,331206
3506,rmangino,5,0.00151,316971,95.70207,331206
3507,RobotUnderscore,5,0.00151,316976,95.70358,331206
3508,RobTheFiveNine,5,0.00151,316981,95.70509,331206
3509,RodeoMcCoy,5,0.00151,316986,95.70660,331206
3510,RomanAkberov,5,0.00151,316991,95.70811,331206
3511,romulasry,5,0.00151,316996,95.70962,331206
3512,rudrrayan,5,0.00151,317001,95.71113,331206
3513,rumangerst,5,0.00151,317006,95.71264,331206
3514,runapp,5,0.00151,317011,95.71415,331206
3515,RUSshy,5,0.00151,317016,95.71566,331206
3516,rxadmin,5,0.00151,317021,95.71717,331206
3517,ryerrappa,5,0.00151,317026,95.71868,331206
3518,ryneandal,5,0.00151,317031,95.72019,331206
3519,Ryptun,5,0.00151,317036,95.72170,331206
3520,rzuf79,5,0.00151,317041,95.72321,331206
3521,sackondeeznuts1,5,0.00151,317046,95.72472,331206
3522,salahchafai,5,0.00151,317051,95.72622,331206
3523,Salvakiya,5,0.00151,317056,95.72773,331206
3524,salviati,5,0.00151,317061,95.72924,331206
3525,SamSindt,5,0.00151,317066,95.73075,331206
3526,santiagoalvarez,5,0.00151,317071,95.73226,331206
3527,satscape,5,0.00151,317076,95.73377,331206
3528,Sawrr,5,0.00151,317081,95.73528,331206
3529,Schazzwozzer,5,0.00151,317086,95.73679,331206
3530,Scintillo,5,0.00151,317091,95.73830,331206
3531,scmccarthy,5,0.00151,317096,95.73981,331206
3532,scorpion81,5,0.00151,317101,95.74132,331206
3533,scurvycapn,5,0.00151,317106,95.74283,331206
3534,seandheffernan,5,0.00151,317111,95.74434,331206
3535,Sephumbra,5,0.00151,317116,95.74585,331206
3536,severin-lemaignan,5,0.00151,317121,95.74736,331206
3537,sfotm,5,0.00151,317126,95.74887,331206
3538,ShawkMusic,5,0.00151,317131,95.75038,331206
3539,ShiftyAxel,5,0.00151,317136,95.75189,331206
3540,shredder2004,5,0.00151,317141,95.75340,331206
3541,shyenjian,5,0.00151,317146,95.75491,331206
3542,siamak-s,5,0.00151,317151,95.75642,331206
3543,silocoder,5,0.00151,317156,95.75793,331206
3544,silverweed,5,0.00151,317161,95.75944,331206
3545,SimoB,5,0.00151,317166,95.76095,331206
3546,SimplyMiha,5,0.00151,317171,95.76246,331206
3547,sinoz,5,0.00151,317176,95.76397,331206
3548,Sipaha,5,0.00151,317181,95.76548,331206
3549,sjrogers,5,0.00151,317186,95.76698,331206
3550,Skywolf285,5,0.00151,317191,95.76849,331206
3551,slabgames,5,0.00151,317196,95.77000,331206
3552,SLGamesCregg,5,0.00151,317201,95.77151,331206
3553,Smilex,5,0.00151,317206,95.77302,331206
3554,snakept,5,0.00151,317211,95.77453,331206
3555,soundsbeard,5,0.00151,317216,95.77604,331206
3556,sp33dy,5,0.00151,317221,95.77755,331206
3557,Spark01,5,0.00151,317226,95.77906,331206
3558,speakk,5,0.00151,317231,95.78057,331206
3559,ssoher,5,0.00151,317236,95.78208,331206
3560,ssw99,5,0.00151,317241,95.78359,331206
3561,Stajin,5,0.00151,317246,95.78510,331206
3562,StaticDynamics,5,0.00151,317251,95.78661,331206
3563,steincodes,5,0.00151,317256,95.78812,331206
3564,Stoeoeoe,5,0.00151,317261,95.78963,331206
3565,studioschade,5,0.00151,317266,95.79114,331206
3566,stur86,5,0.00151,317271,95.79265,331206
3567,stwupton,5,0.00151,317276,95.79416,331206
3568,sulai,5,0.00151,317281,95.79567,331206
3569,sunoru,5,0.00151,317286,95.79718,331206
3570,SuperWig,5,0.00151,317291,95.79869,331206
3571,swiftsword94,5,0.00151,317296,95.80020,331206
3572,taeyoonwf,5,0.00151,317301,95.80171,331206
3573,tanskudaa,5,0.00151,317306,95.80322,331206
3574,Taywee,5,0.00151,317311,95.80473,331206
3575,TehcJS,5,0.00151,317316,95.80624,331206
3576,TeoTwawki,5,0.00151,317321,95.80775,331206
3577,testman42,5,0.00151,317326,95.80925,331206
3578,thedaneeffect,5,0.00151,317331,95.81076,331206
3579,TheDevelo,5,0.00151,317336,95.81227,331206
3580,TheJackiMonster,5,0.00151,317341,95.81378,331206
3581,TheMikirog,5,0.00151,317346,95.81529,331206
3582,themindoverall,5,0.00151,317351,95.81680,331206
3583,TheNeedJedi,5,0.00151,317356,95.81831,331206
3584,theoniko,5,0.00151,317361,95.81982,331206
3585,TheSkyOne,5,0.00151,317366,95.82133,331206
3586,thloh85,5,0.00151,317371,95.82284,331206
3587,thomazette,5,0.00151,317376,95.82435,331206
3588,thottee,5,0.00151,317381,95.82586,331206
3589,thzero,5,0.00151,317386,95.82737,331206
3590,timCopwell,5,0.00151,317391,95.82888,331206
3591,timhberry,5,0.00151,317396,95.83039,331206
3592,tmoat,5,0.00151,317401,95.83190,331206
3593,tom-dreamviewer,5,0.00151,317406,95.83341,331206
3594,Tom-III,5,0.00151,317411,95.83492,331206
3595,tomlechner,5,0.00151,317416,95.83643,331206
3596,torugok,5,0.00151,317421,95.83794,331206
3597,treymerkley,5,0.00151,317426,95.83945,331206
3598,TristanWLB,5,0.00151,317431,95.84096,331206
3599,turtlewit,5,0.00151,317436,95.84247,331206
3600,TutorialDoctor,5,0.00151,317441,95.84398,331206
3601,tyoungjr,5,0.00151,317446,95.84549,331206
3602,ulvido,5,0.00151,317451,95.84700,331206
3603,UnityFuchs,5,0.00151,317456,95.84851,331206
3604,user5145,5,0.00151,317461,95.85001,331206
3605,VadeFOAM,5,0.00151,317466,95.85152,331206
3606,Vadimledyaev,5,0.00151,317471,95.85303,331206
3607,Vasanthan-,5,0.00151,317476,95.85454,331206
3608,Vasiliy-Medvid,5,0.00151,317481,95.85605,331206
3609,vazzup,5,0.00151,317486,95.85756,331206
3610,VenteXx,5,0.00151,317491,95.85907,331206
3611,ventr1x,5,0.00151,317496,95.86058,331206
3612,VercingetorixChief,5,0.00151,317501,95.86209,331206
3613,vetoed,5,0.00151,317506,95.86360,331206
3614,vetu11,5,0.00151,317511,95.86511,331206
3615,vexille,5,0.00151,317516,95.86662,331206
3616,VicentGJ,5,0.00151,317521,95.86813,331206
3617,victorbstan,5,0.00151,317526,95.86964,331206
3618,vladikoles,5,0.00151,317531,95.87115,331206
3619,vpenades,5,0.00151,317536,95.87266,331206
3620,vzex,5,0.00151,317541,95.87417,331206
3621,wandomPewlin,5,0.00151,317546,95.87568,331206
3622,WellFiredDevelopment,5,0.00151,317551,95.87719,331206
3623,werdnahull,5,0.00151,317556,95.87870,331206
3624,wfowler1,5,0.00151,317561,95.88021,331206
3625,whitelion351,5,0.00151,317566,95.88172,331206
3626,Wickersun,5,0.00151,317571,95.88323,331206
3627,william01110111,5,0.00151,317576,95.88474,331206
3628,winipcfg,5,0.00151,317581,95.88625,331206
3629,winteraa,5,0.00151,317586,95.88776,331206
3630,WolfGangsta,5,0.00151,317591,95.88927,331206
3631,woollysammoth,5,0.00151,317596,95.89077,331206
3632,wtarr,5,0.00151,317601,95.89228,331206
3633,X52p,5,0.00151,317606,95.89379,331206
3634,xfixium,5,0.00151,317611,95.89530,331206
3635,Xgor,5,0.00151,317616,95.89681,331206
3636,yesitsmattharris,5,0.00151,317621,95.89832,331206
3637,yetha,5,0.00151,317626,95.89983,331206
3638,yleduc,5,0.00151,317631,95.90134,331206
3639,yosoyfreeman,5,0.00151,317636,95.90285,331206
3640,zantyru,5,0.00151,317641,95.90436,331206
3641,zayuim,5,0.00151,317646,95.90587,331206
3642,zerc,5,0.00151,317651,95.90738,331206
3643,zeze0556,5,0.00151,317656,95.90889,331206
3644,ziomio,5,0.00151,317661,95.91040,331206
3645,Zizico2,5,0.00151,317666,95.91191,331206
3646,zolartan,5,0.00151,317671,95.91342,331206
3647,zspinelli,5,0.00151,317676,95.91493,331206
3648,ZTarget,5,0.00151,317681,95.91644,331206
3649,Zuppor,5,0.00151,317686,95.91795,331206
3650,0SAITO5,4,0.00121,317690,95.91916,331206
3651,1Snakel,4,0.00121,317694,95.92036,331206
3652,1xch,4,0.00121,317698,95.92157,331206
3653,5H4D0WILA,4,0.00121,317702,95.92278,331206
3654,95camarones,4,0.00121,317706,95.92399,331206
3655,abdullahzubair109,4,0.00121,317710,95.92519,331206
3656,Acissathar,4,0.00121,317714,95.92640,331206
3657,adam4235,4,0.00121,317718,95.92761,331206
3658,AdelMahjoub,4,0.00121,317722,95.92882,331206
3659,adfaure,4,0.00121,317726,95.93003,331206
3660,adityabmv27,4,0.00121,317730,95.93123,331206
3661,Adjective-Object,4,0.00121,317734,95.93244,331206
3662,agar3s,4,0.00121,317738,95.93365,331206
3663,agausmann,4,0.00121,317742,95.93486,331206
3664,agjohnson,4,0.00121,317746,95.93606,331206
3665,AkaRyu,4,0.00121,317750,95.93727,331206
3666,akim8,4,0.00121,317754,95.93848,331206
3667,akiraKido,4,0.00121,317758,95.93969,331206
3668,akjulu,4,0.00121,317762,95.94089,331206
3669,albfan,4,0.00121,317766,95.94210,331206
3670,aldatsa,4,0.00121,317770,95.94331,331206
3671,Alderin1974,4,0.00121,317774,95.94452,331206
3672,alexkh,4,0.00121,317778,95.94573,331206
3673,Alficiro,4,0.00121,317782,95.94693,331206
3674,alforium,4,0.00121,317786,95.94814,331206
3675,alperencaliskan,4,0.00121,317790,95.94935,331206
3676,Alvati,4,0.00121,317794,95.95056,331206
3677,amoriqbal,4,0.00121,317798,95.95176,331206
3678,amzker,4,0.00121,317802,95.95297,331206
3679,anderlli0053,4,0.00121,317806,95.95418,331206
3680,AnderRasoVazquez,4,0.00121,317810,95.95539,331206
3681,Andevid,4,0.00121,317814,95.95659,331206
3682,AndrewMorsillo,4,0.00121,317818,95.95780,331206
3683,andyfreer,4,0.00121,317822,95.95901,331206
3684,AnJ95,4,0.00121,317826,95.96022,331206
3685,antocors,4,0.00121,317830,95.96143,331206
3686,aozasori,4,0.00121,317834,95.96263,331206
3687,ApachOC,4,0.00121,317838,95.96384,331206
3688,apezel,4,0.00121,317842,95.96505,331206
3689,Apprehentice,4,0.00121,317846,95.96626,331206
3690,aqez,4,0.00121,317850,95.96746,331206
3691,Arcnor,4,0.00121,317854,95.96867,331206
3692,argent0,4,0.00121,317858,95.96988,331206
3693,argento2,4,0.00121,317862,95.97109,331206
3694,arichnad,4,0.00121,317866,95.97230,331206
3695,arkD,4,0.00121,317870,95.97350,331206
3696,arnerak,4,0.00121,317874,95.97471,331206
3697,arronm,4,0.00121,317878,95.97592,331206
3698,Arskyle,4,0.00121,317882,95.97713,331206
3699,asluizh,4,0.00121,317886,95.97833,331206
3700,Aster89,4,0.00121,317890,95.97954,331206
3701,attishno1,4,0.00121,317894,95.98075,331206
3702,aure2006,4,0.00121,317898,95.98196,331206
3703,axilirate,4,0.00121,317902,95.98316,331206
3704,ay200,4,0.00121,317906,95.98437,331206
3705,aztecsensei,4,0.00121,317910,95.98558,331206
3706,basdp,4,0.00121,317914,95.98679,331206
3707,batiste,4,0.00121,317918,95.98800,331206
3708,bbeco,4,0.00121,317922,95.98920,331206
3709,Beelzenef,4,0.00121,317926,95.99041,331206
3710,Beliaar,4,0.00121,317930,95.99162,331206
3711,BenjaminAndre,4,0.00121,317934,95.99283,331206
3712,Benoit9,4,0.00121,317938,95.99403,331206
3713,bevinhex,4,0.00121,317942,95.99524,331206
3714,bg641,4,0.00121,317946,95.99645,331206
3715,bggd,4,0.00121,317950,95.99766,331206
3716,b-hayes,4,0.00121,317954,95.99886,331206
3717,Bios-Marcel,4,0.00121,317958,96.00007,331206
3718,BkDevDude,4,0.00121,317962,96.00128,331206
3719,BlackCatter,4,0.00121,317966,96.00249,331206
3720,BloodPawsey,4,0.00121,317970,96.00370,331206
3721,bluegamepoy,4,0.00121,317974,96.00490,331206
3722,borcun,4,0.00121,317978,96.00611,331206
3723,breadnone,4,0.00121,317982,96.00732,331206
3724,briangular,4,0.00121,317986,96.00853,331206
3725,brisdalen,4,0.00121,317990,96.00973,331206
3726,brndel,4,0.00121,317994,96.01094,331206
3727,BrockGod,4,0.00121,317998,96.01215,331206
3728,brodiefairhall,4,0.00121,318002,96.01336,331206
3729,btzr-io,4,0.00121,318006,96.01456,331206
3730,bugcaptor,4,0.00121,318010,96.01577,331206
3731,bukkits-,4,0.00121,318014,96.01698,331206
3732,Burnout156,4,0.00121,318018,96.01819,331206
3733,bydavenet,4,0.00121,318022,96.01940,331206
3734,c0rrup7eq,4,0.00121,318026,96.02060,331206
3735,Caenhorn,4,0.00121,318030,96.02181,331206
3736,CammiePone,4,0.00121,318034,96.02302,331206
3737,CaptainKraft,4,0.00121,318038,96.02423,331206
3738,CaptainStack,4,0.00121,318042,96.02543,331206
3739,CarlBeniz,4,0.00121,318046,96.02664,331206
3740,cata0309,4,0.00121,318050,96.02785,331206
3741,CathodeRayBlues,4,0.00121,318054,96.02906,331206
3742,CatsNipYummy,4,0.00121,318058,96.03027,331206
3743,cbolgiano,4,0.00121,318062,96.03147,331206
3744,Censacrof,4,0.00121,318066,96.03268,331206
3745,Chaotikmind,4,0.00121,318070,96.03389,331206
3746,chaserdoe,4,0.00121,318074,96.03510,331206
3747,chenzhekl,4,0.00121,318078,96.03630,331206
3748,Chiitoo,4,0.00121,318082,96.03751,331206
3749,christislord12,4,0.00121,318086,96.03872,331206
3750,christophut4,4,0.00121,318090,96.03993,331206
3751,ChrootDoot,4,0.00121,318094,96.04113,331206
3752,Clean3d,4,0.00121,318098,96.04234,331206
3753,ClementRivaille,4,0.00121,318102,96.04355,331206
3754,CloudTsang,4,0.00121,318106,96.04476,331206
3755,codecachet,4,0.00121,318110,96.04597,331206
3756,codeclem,4,0.00121,318114,96.04717,331206
3757,ComradeJay,4,0.00121,318118,96.04838,331206
3758,contested-space,4,0.00121,318122,96.04959,331206
3759,coolepicguy,4,0.00121,318126,96.05080,331206
3760,cosmoddd,4,0.00121,318130,96.05200,331206
3761,covariantlabs,4,0.00121,318134,96.05321,331206
3762,Crare,4,0.00121,318138,96.05442,331206
3763,CrazyHat62,4,0.00121,318142,96.05563,331206
3764,credman0,4,0.00121,318146,96.05683,331206
3765,crfeliz,4,0.00121,318150,96.05804,331206
3766,Crispian-Troyo369,4,0.00121,318154,96.05925,331206
3767,Crystalwarrior,4,0.00121,318158,96.06046,331206
3768,CylonMuffins,4,0.00121,318162,96.06167,331206
3769,CyrilBos,4,0.00121,318166,96.06287,331206
3770,dagophil,4,0.00121,318170,96.06408,331206
3771,dali99,4,0.00121,318174,96.06529,331206
3772,DanEEStar,4,0.00121,318178,96.06650,331206
3773,daniel-luper,4,0.00121,318182,96.06770,331206
3774,danielspaniol,4,0.00121,318186,96.06891,331206
3775,danvalho,4,0.00121,318190,96.07012,331206
3776,darkhog,4,0.00121,318194,96.07133,331206
3777,DarkMarmot,4,0.00121,318198,96.07253,331206
3778,darkyuu,4,0.00121,318202,96.07374,331206
3779,DASchechtman,4,0.00121,318206,96.07495,331206
3780,datgame,4,0.00121,318210,96.07616,331206
3781,davidreif,4,0.00121,318214,96.07737,331206
3782,deadcodeonly,4,0.00121,318218,96.07857,331206
3783,DeathTBO,4,0.00121,318222,96.07978,331206
3784,Delectus98,4,0.00121,318226,96.08099,331206
3785,deltasquad451,4,0.00121,318230,96.08220,331206
3786,DeRobyJ,4,0.00121,318234,96.08340,331206
3787,Derzo,4,0.00121,318238,96.08461,331206
3788,DesiQuintans,4,0.00121,318242,96.08582,331206
3789,devnexen,4,0.00121,318246,96.08703,331206
3790,Dexterminator,4,0.00121,318250,96.08824,331206
3791,dexterslaboratory,4,0.00121,318254,96.08944,331206
3792,diegodelarocha,4,0.00121,318258,96.09065,331206
3793,dissidently,4,0.00121,318262,96.09186,331206
3794,Dizeeee,4,0.00121,318266,96.09307,331206
3795,dkotfis,4,0.00121,318270,96.09427,331206
3796,doko-desuka,4,0.00121,318274,96.09548,331206
3797,Domarius,4,0.00121,318278,96.09669,331206
3798,domen-rs,4,0.00121,318282,96.09790,331206
3799,dominiccooney,4,0.00121,318286,96.09910,331206
3800,Doomish2005,4,0.00121,318290,96.10031,331206
3801,dovker,4,0.00121,318294,96.10152,331206
3802,Dragometh,4,0.00121,318298,96.10273,331206
3803,DragonAxe,4,0.00121,318302,96.10394,331206
3804,DroppingBass,4,0.00121,318306,96.10514,331206
3805,Dr-Primary,4,0.00121,318310,96.10635,331206
3806,drwhut,4,0.00121,318314,96.10756,331206
3807,dslul,4,0.00121,318318,96.10877,331206
3808,Ducote,4,0.00121,318322,96.10997,331206
3809,dustinjamescondon,4,0.00121,318326,96.11118,331206
3810,dylantmarsh,4,0.00121,318330,96.11239,331206
3811,dylmeadows,4,0.00121,318334,96.11360,331206
3812,e8johan,4,0.00121,318338,96.11480,331206
3813,Eagle-Faulkner,4,0.00121,318342,96.11601,331206
3814,EbbDrop,4,0.00121,318346,96.11722,331206
3815,echebbi,4,0.00121,318350,96.11843,331206
3816,echo-Mike,4,0.00121,318354,96.11964,331206
3817,Edmanbosch,4,0.00121,318358,96.12084,331206
3818,emersonmx,4,0.00121,318362,96.12205,331206
3819,EmNudge,4,0.00121,318366,96.12326,331206
3820,emperorofmars,4,0.00121,318370,96.12447,331206
3821,Endojo,4,0.00121,318374,96.12567,331206
3822,ennQ,4,0.00121,318378,96.12688,331206
3823,Erawpalassalg,4,0.00121,318382,96.12809,331206
3824,ericmccarthy7,4,0.00121,318386,96.12930,331206
3825,etisdew,4,0.00121,318390,96.13050,331206
3826,ezefran,4,0.00121,318394,96.13171,331206
3827,fabslab,4,0.00121,318398,96.13292,331206
3828,Fachtna,4,0.00121,318402,96.13413,331206
3829,fadexmusic,4,0.00121,318406,96.13534,331206
3830,Famous5000,4,0.00121,318410,96.13654,331206
3831,fangang190,4,0.00121,318414,96.13775,331206
3832,FaultyFunctions,4,0.00121,318418,96.13896,331206
3833,fengjiongmax,4,0.00121,318422,96.14017,331206
3834,Fermats-Fish,4,0.00121,318426,96.14137,331206
3835,fgoo,4,0.00121,318430,96.14258,331206
3836,finchMFG,4,0.00121,318434,96.14379,331206
3837,Fiona,4,0.00121,318438,96.14500,331206
3838,fixitman,4,0.00121,318442,96.14621,331206
3839,Flarkk,4,0.00121,318446,96.14741,331206
3840,fliar,4,0.00121,318450,96.14862,331206
3841,flight714,4,0.00121,318454,96.14983,331206
3842,folays,4,0.00121,318458,96.15104,331206
3843,fozbstudios,4,0.00121,318462,96.15224,331206
3844,FrankAlbella,4,0.00121,318466,96.15345,331206
3845,FrenchKrab,4,0.00121,318470,96.15466,331206
3846,fuzzeemic,4,0.00121,318474,96.15587,331206
3847,fzwoch,4,0.00121,318478,96.15707,331206
3848,G4MR,4,0.00121,318482,96.15828,331206
3849,GaidamakUA,4,0.00121,318486,96.15949,331206
3850,galbacarys,4,0.00121,318490,96.16070,331206
3851,Gavin-Williams,4,0.00121,318494,96.16191,331206
3852,gbutler69,4,0.00121,318498,96.16311,331206
3853,G-Fuchter,4,0.00121,318502,96.16432,331206
3854,GhostWalker562,4,0.00121,318506,96.16553,331206
3855,ghur,4,0.00121,318510,96.16674,331206
3856,giangm9,4,0.00121,318514,96.16794,331206
3857,gianllucah,4,0.00121,318518,96.16915,331206
3858,GitHubCenterCore,4,0.00121,318522,96.17036,331206
3859,gmoretti,4,0.00121,318526,96.17157,331206
3860,gnipe,4,0.00121,318530,96.17277,331206
3861,GogetaX,4,0.00121,318534,96.17398,331206
3862,golonia,4,0.00121,318538,96.17519,331206
3863,Gordon-F,4,0.00121,318542,96.17640,331206
3864,GrayJacketStudios,4,0.00121,318546,96.17761,331206
3865,gregoriB,4,0.00121,318550,96.17881,331206
3866,gregoryfein,4,0.00121,318554,96.18002,331206
3867,grotar00,4,0.00121,318558,96.18123,331206
3868,Guaranapps,4,0.00121,318562,96.18244,331206
3869,Gyeff,4,0.00121,318566,96.18364,331206
3870,gyrosp,4,0.00121,318570,96.18485,331206
3871,h5n1xp,4,0.00121,318574,96.18606,331206
3872,HAMSAMS,4,0.00121,318578,96.18727,331206
3873,hanst99,4,0.00121,318582,96.18847,331206
3874,haplotypegames,4,0.00121,318586,96.18968,331206
3875,harrypujols,4,0.00121,318590,96.19089,331206
3876,Harutami,4,0.00121,318594,96.19210,331206
3877,HatisEm,4,0.00121,318598,96.19331,331206
3878,hedrickbt,4,0.00121,318602,96.19451,331206
3879,HellonLegs,4,0.00121,318606,96.19572,331206
3880,henri-nourel,4,0.00121,318610,96.19693,331206
3881,Heryhelder,4,0.00121,318614,96.19814,331206
3882,hexdump2002,4,0.00121,318618,96.19934,331206
3883,hgouveia,4,0.00121,318622,96.20055,331206
3884,hhsdev,4,0.00121,318626,96.20176,331206
3885,hhyyrylainen,4,0.00121,318630,96.20297,331206
3886,hodgerti,4,0.00121,318634,96.20418,331206
3887,Host32,4,0.00121,318638,96.20538,331206
3888,hot-energy,4,0.00121,318642,96.20659,331206
3889,hrubymar10,4,0.00121,318646,96.20780,331206
3890,Huberion,4,0.00121,318650,96.20901,331206
3891,hubertekvall,4,0.00121,318654,96.21021,331206
3892,hunar1997,4,0.00121,318658,96.21142,331206
3893,hunterkjones,4,0.00121,318662,96.21263,331206
3894,huxingyi,4,0.00121,318666,96.21384,331206
3895,i80and,4,0.00121,318670,96.21504,331206
3896,ibenx,4,0.00121,318674,96.21625,331206
3897,ibrakap,4,0.00121,318678,96.21746,331206
3898,icuseven,4,0.00121,318682,96.21867,331206
3899,idoby,4,0.00121,318686,96.21988,331206
3900,ikicapitan,4,0.00121,318690,96.22108,331206
3901,immccc,4,0.00121,318694,96.22229,331206
3902,Indie-Siggi,4,0.00121,318698,96.22350,331206
3903,indolering,4,0.00121,318702,96.22471,331206
3904,indubitablement2,4,0.00121,318706,96.22591,331206
3905,i-need-to-tell-you-something,4,0.00121,318710,96.22712,331206
3906,Inlinkcraft,4,0.00121,318714,96.22833,331206
3907,instantaphex,4,0.00121,318718,96.22954,331206
3908,itsbrainmeat,4,0.00121,318722,96.23074,331206
3909,jaacko-torus,4,0.00121,318726,96.23195,331206
3910,janisskuja,4,0.00121,318730,96.23316,331206
3911,JankMultiMediaStudio,4,0.00121,318734,96.23437,331206
3912,janmarcano,4,0.00121,318738,96.23558,331206
3913,jarlarntzen,4,0.00121,318742,96.23678,331206
3914,jascase901,4,0.00121,318746,96.23799,331206
3915,java-py-c-cpp-js,4,0.00121,318750,96.23920,331206
3916,jcdfc,4,0.00121,318754,96.24041,331206
3917,jcoombes,4,0.00121,318758,96.24161,331206
3918,jdbener,4,0.00121,318762,96.24282,331206
3919,jeangit,4,0.00121,318766,96.24403,331206
3920,Jedzkie,4,0.00121,318770,96.24524,331206
3921,Jermaine0Forbes,4,0.00121,318774,96.24644,331206
3922,jhamil1222,4,0.00121,318778,96.24765,331206
3923,jhlothamer,4,0.00121,318782,96.24886,331206
3924,jhonnystene,4,0.00121,318786,96.25007,331206
3925,jinruozai,4,0.00121,318790,96.25128,331206
3926,jjmontes,4,0.00121,318794,96.25248,331206
3927,jmorton06,4,0.00121,318798,96.25369,331206
3928,johhnry,4,0.00121,318802,96.25490,331206
3929,johnoneil,4,0.00121,318806,96.25611,331206
3930,Jonasfxh,4,0.00121,318810,96.25731,331206
3931,jonwolski,4,0.00121,318814,96.25852,331206
3932,josephskelly,4,0.00121,318818,96.25973,331206
3933,jpcy,4,0.00121,318822,96.26094,331206
3934,jself,4,0.00121,318826,96.26215,331206
3935,jtoar,4,0.00121,318830,96.26335,331206
3936,JulianDH97,4,0.00121,318834,96.26456,331206
3937,JUNZ1,4,0.00121,318838,96.26577,331206
3938,JustDevs,4,0.00121,318842,96.26698,331206
3939,justinbowes,4,0.00121,318846,96.26818,331206
3940,justinngdev,4,0.00121,318850,96.26939,331206
3941,jwatte,4,0.00121,318854,96.27060,331206
3942,karen-sch,4,0.00121,318858,96.27181,331206
3943,kcaze,4,0.00121,318862,96.27301,331206
3944,kendinitto,4,0.00121,318866,96.27422,331206
3945,KennethWilke,4,0.00121,318870,96.27543,331206
3946,keyboardmuffin45,4,0.00121,318874,96.27664,331206
3947,khoulihan,4,0.00121,318878,96.27785,331206
3948,khushit-shah,4,0.00121,318882,96.27905,331206
3949,kingpinzs,4,0.00121,318886,96.28026,331206
3950,kodiakbehr,4,0.00121,318890,96.28147,331206
3951,kopias,4,0.00121,318894,96.28268,331206
3952,korsakjakub,4,0.00121,318898,96.28388,331206
3953,kpkhxlgy0,4,0.00121,318902,96.28509,331206
3954,Krakob,4,0.00121,318906,96.28630,331206
3955,krdluzni,4,0.00121,318910,96.28751,331206
3956,kreaninw,4,0.00121,318914,96.28871,331206
3957,krfgbhoiaeuzr,4,0.00121,318918,96.28992,331206
3958,Kryptocron,4,0.00121,318922,96.29113,331206
3959,ktosox,4,0.00121,318926,96.29234,331206
3960,kurinoku,4,0.00121,318930,96.29355,331206
3961,kuryart,4,0.00121,318934,96.29475,331206
3962,kusaflow,4,0.00121,318938,96.29596,331206
3963,kutoman,4,0.00121,318942,96.29717,331206
3964,kzietek,4,0.00121,318946,96.29838,331206
3965,lancefreedlund1,4,0.00121,318950,96.29958,331206
3966,larsonjj,4,0.00121,318954,96.30079,331206
3967,larvasapiens,4,0.00121,318958,96.30200,331206
3968,Lathuys,4,0.00121,318962,96.30321,331206
3969,learis,4,0.00121,318966,96.30441,331206
3970,leecommamichael,4,0.00121,318970,96.30562,331206
3971,legendiguess,4,0.00121,318974,96.30683,331206
3972,LeonFretter,4,0.00121,318978,96.30804,331206
3973,leptoGen,4,0.00121,318982,96.30925,331206
3974,Lerc,4,0.00121,318986,96.31045,331206
3975,Lerg,4,0.00121,318990,96.31166,331206
3976,Lightnet,4,0.00121,318994,96.31287,331206
3977,LinArcX,4,0.00121,318998,96.31408,331206
3978,Linicks,4,0.00121,319002,96.31528,331206
3979,linky00,4,0.00121,319006,96.31649,331206
3980,lisacvuk,4,0.00121,319010,96.31770,331206
3981,lislis,4,0.00121,319014,96.31891,331206
3982,ljfantin,4,0.00121,319018,96.32011,331206
3983,lorenzobotti,4,0.00121,319022,96.32132,331206
3984,Lucresis,4,0.00121,319026,96.32253,331206
3985,LuigiVanacore,4,0.00121,319030,96.32374,331206
3986,lukepass,4,0.00121,319034,96.32495,331206
3987,lunoctis,4,0.00121,319038,96.32615,331206
3988,lvivtotoro,4,0.00121,319042,96.32736,331206
3989,lvlzyro,4,0.00121,319046,96.32857,331206
3990,M4RCU5G1850N,4,0.00121,319050,96.32978,331206
3991,maartenheremans,4,0.00121,319054,96.33098,331206
3992,macramole,4,0.00121,319058,96.33219,331206
3993,madadam,4,0.00121,319062,96.33340,331206
3994,mafiesto4,4,0.00121,319066,96.33461,331206
3995,Malkierian,4,0.00121,319070,96.33582,331206
3996,Mandscharo,4,0.00121,319074,96.33702,331206
3997,manglemix,4,0.00121,319078,96.33823,331206
3998,mangomago,4,0.00121,319082,96.33944,331206
3999,marcJV,4,0.00121,319086,96.34065,331206
4000,markidak,4,0.00121,319090,96.34185,331206
4001,MarqusJonsson,4,0.00121,319094,96.34306,331206
4002,MarshallJDem,4,0.00121,319098,96.34427,331206
4003,MartinMajewski,4,0.00121,319102,96.34548,331206
4004,massanchik,4,0.00121,319106,96.34668,331206
4005,MatteoJoliveau,4,0.00121,319110,96.34789,331206
4006,MatthewJulian,4,0.00121,319114,96.34910,331206
4007,matthieudesprez,4,0.00121,319118,96.35031,331206
4008,MattSays,4,0.00121,319122,96.35152,331206
4009,maujin111,4,0.00121,319126,96.35272,331206
4010,MaximoTG98,4,0.00121,319130,96.35393,331206
4011,Maxsior,4,0.00121,319134,96.35514,331206
4012,MaywormIII,4,0.00121,319138,96.35635,331206
4013,Meister1593,4,0.00121,319142,96.35755,331206
4014,Melendeze13,4,0.00121,319146,96.35876,331206
4015,melvyniandrag,4,0.00121,319150,96.35997,331206
4016,MerKki,4,0.00121,319154,96.36118,331206
4017,MessinaBrothers,4,0.00121,319158,96.36238,331206
4018,metalDS,4,0.00121,319162,96.36359,331206
4019,mgilski,4,0.00121,319166,96.36480,331206
4020,micfan,4,0.00121,319170,96.36601,331206
4021,MichaelMacha,4,0.00121,319174,96.36722,331206
4022,michalove,4,0.00121,319178,96.36842,331206
4023,michasng,4,0.00121,319182,96.36963,331206
4024,michelmontenegro,4,0.00121,319186,96.37084,331206
4025,mickael-h,4,0.00121,319190,96.37205,331206
4026,Migar4,4,0.00121,319194,96.37325,331206
4027,mightyCelu,4,0.00121,319198,96.37446,331206
4028,mihai-dragan,4,0.00121,319202,96.37567,331206
4029,mikeandtherest,4,0.00121,319206,96.37688,331206
4030,mikeepiazza,4,0.00121,319210,96.37808,331206
4031,MinecraftPlaye,4,0.00121,319214,96.37929,331206
4032,Miniputs,4,0.00121,319218,96.38050,331206
4033,MInner,4,0.00121,319222,96.38171,331206
4034,MinnowMike,4,0.00121,319226,96.38292,331206
4035,MJ-meo-dmt,4,0.00121,319230,96.38412,331206
4036,mjones409,4,0.00121,319234,96.38533,331206
4037,mo-moxi,4,0.00121,319238,96.38654,331206
4038,mooseyfaith,4,0.00121,319242,96.38775,331206
4039,MordechaiHadad,4,0.00121,319246,96.38895,331206
4040,mortem-malum,4,0.00121,319250,96.39016,331206
4041,mosujiba,4,0.00121,319254,96.39137,331206
4042,MotasemZakarneh,4,0.00121,319258,96.39258,331206
4043,mpounsett,4,0.00121,319262,96.39379,331206
4044,MrDudeIII,4,0.00121,319266,96.39499,331206
4045,MrInformatic,4,0.00121,319270,96.39620,331206
4046,mryannisp,4,0.00121,319274,96.39741,331206
4047,MSaIim,4,0.00121,319278,96.39862,331206
4048,mthreis,4,0.00121,319282,96.39982,331206
4049,muafakul,4,0.00121,319286,96.40103,331206
4050,MuktadaCreations,4,0.00121,319290,96.40224,331206
4051,mundusnine,4,0.00121,319294,96.40345,331206
4052,MungMoongYi,4,0.00121,319298,96.40465,331206
4053,Murii,4,0.00121,319302,96.40586,331206
4054,murphy-slaw,4,0.00121,319306,96.40707,331206
4055,mutato,4,0.00121,319310,96.40828,331206
4056,myrage2000,4,0.00121,319314,96.40949,331206
4057,myrmidon-media,4,0.00121,319318,96.41069,331206
4058,Nanotross,4,0.00121,319322,96.41190,331206
4059,nargacu83,4,0.00121,319326,96.41311,331206
4060,natehitchcock,4,0.00121,319330,96.41432,331206
4061,Nathan-P-B,4,0.00121,319334,96.41552,331206
4062,Nebulean,4,0.00121,319338,96.41673,331206
4063,nellodotca,4,0.00121,319342,96.41794,331206
4064,neonsoup,4,0.00121,319346,96.41915,331206
4065,netblink-cobreen,4,0.00121,319350,96.42035,331206
4066,netcell,4,0.00121,319354,96.42156,331206
4067,nhair,4,0.00121,319358,96.42277,331206
4068,Nhiqill,4,0.00121,319362,96.42398,331206
4069,niodyn,4,0.00121,319366,96.42519,331206
4070,niokasgami,4,0.00121,319370,96.42639,331206
4071,nkrapivin,4,0.00121,319374,96.42760,331206
4072,nleehone,4,0.00121,319378,96.42881,331206
4073,Nogal,4,0.00121,319382,96.43002,331206
4074,noideatbh,4,0.00121,319386,96.43122,331206
4075,nonchip,4,0.00121,319390,96.43243,331206
4076,NoohAlavi,4,0.00121,319394,96.43364,331206
4077,notonfire,4,0.00121,319398,96.43485,331206
4078,novawerkz,4,0.00121,319402,96.43605,331206
4079,NQNStudios,4,0.00121,319406,96.43726,331206
4080,nsrosenqvist,4,0.00121,319410,96.43847,331206
4081,Nubilous,4,0.00121,319414,96.43968,331206
4082,nxrighthere,4,0.00121,319418,96.44089,331206
4083,Nyeksenn,4,0.00121,319422,96.44209,331206
4084,octopus-io,4,0.00121,319426,96.44330,331206
4085,Oen44,4,0.00121,319430,96.44451,331206
4086,oguzhantopcu,4,0.00121,319434,96.44572,331206
4087,omerkling,4,0.00121,319438,96.44692,331206
4088,Ophiolith,4,0.00121,319442,96.44813,331206
4089,OrchestralBb,4,0.00121,319446,96.44934,331206
4090,oreyabak,4,0.00121,319450,96.45055,331206
4091,ottolulau,4,0.00121,319454,96.45176,331206
4092,Outrider0x400,4,0.00121,319458,96.45296,331206
4093,paul-dosenbrot,4,0.00121,319462,96.45417,331206
4094,paulmyers-0,4,0.00121,319466,96.45538,331206
4095,PauloPatez,4,0.00121,319470,96.45659,331206
4096,Pawel82S,4,0.00121,319474,96.45779,331206
4097,peterhoglund,4,0.00121,319478,96.45900,331206
4098,petkovsc,4,0.00121,319482,96.46021,331206
4099,Petross404,4,0.00121,319486,96.46142,331206
4100,pgruenbacher-TSUS,4,0.00121,319490,96.46262,331206
4101,Philosopho,4,0.00121,319494,96.46383,331206
4102,photex,4,0.00121,319498,96.46504,331206
4103,PhysicsLime,4,0.00121,319502,96.46625,331206
4104,pixelinkmedia,4,0.00121,319506,96.46746,331206
4105,pjlg,4,0.00121,319510,96.46866,331206
4106,pkdawson,4,0.00121,319514,96.46987,331206
4107,pkruszynski,4,0.00121,319518,96.47108,331206
4108,playster000,4,0.00121,319522,96.47229,331206
4109,plfx,4,0.00121,319526,96.47349,331206
4110,PoignardAzur,4,0.00121,319530,96.47470,331206
4111,pol3waf,4,0.00121,319534,96.47591,331206
4112,ProfessorKaos64,4,0.00121,319538,96.47712,331206
4113,psiker,4,0.00121,319542,96.47832,331206
4114,QiuleiWang,4,0.00121,319546,96.47953,331206
4115,quanixstudio,4,0.00121,319550,96.48074,331206
4116,qubodup,4,0.00121,319554,96.48195,331206
4117,radenling,4,0.00121,319558,96.48316,331206
4118,radishes,4,0.00121,319562,96.48436,331206
4119,rafaelferreiraql,4,0.00121,319566,96.48557,331206
4120,Rahov,4,0.00121,319570,96.48678,331206
4121,rajeebk,4,0.00121,319574,96.48799,331206
4122,Ranito,4,0.00121,319578,96.48919,331206
4123,Rattel,4,0.00121,319582,96.49040,331206
4124,ravisharma1987,4,0.00121,319586,96.49161,331206
4125,RazorDE,4,0.00121,319590,96.49282,331206
4126,red1939,4,0.00121,319594,96.49402,331206
4127,redtoorange,4,0.00121,319598,96.49523,331206
4128,resynth1943,4,0.00121,319602,96.49644,331206
4129,ReubenU,4,0.00121,319606,96.49765,331206
4130,RezaPouya,4,0.00121,319610,96.49886,331206
4131,richardjuan,4,0.00121,319614,96.50006,331206
4132,rinart73,4,0.00121,319618,96.50127,331206
4133,rjack,4,0.00121,319622,96.50248,331206
4134,rmullin7286,4,0.00121,319626,96.50369,331206
4135,robspsj,4,0.00121,319630,96.50489,331206
4136,rogererens,4,0.00121,319634,96.50610,331206
4137,roiteee,4,0.00121,319638,96.50731,331206
4138,rokonxr,4,0.00121,319642,96.50852,331206
4139,RonTang,4,0.00121,319646,96.50973,331206
4140,rpopovici,4,0.00121,319650,96.51093,331206
4141,RubrumExPlaneta,4,0.00121,319654,96.51214,331206
4142,ruki3,4,0.00121,319658,96.51335,331206
4143,Rukiri,4,0.00121,319662,96.51456,331206
4144,Ruud88x,4,0.00121,319666,96.51576,331206
4145,rvenson,4,0.00121,319670,96.51697,331206
4146,RWmkII,4,0.00121,319674,96.51818,331206
4147,rzllmr,4,0.00121,319678,96.51939,331206
4148,Sajyd,4,0.00121,319682,96.52059,331206
4149,Sakar,4,0.00121,319686,96.52180,331206
4150,Samitier,4,0.00121,319690,96.52301,331206
4151,Sandheaver,4,0.00121,319694,96.52422,331206
4152,saneery,4,0.00121,319698,96.52543,331206
4153,sargeantPig,4,0.00121,319702,96.52663,331206
4154,Sarun515s,4,0.00121,319706,96.52784,331206
4155,sas41,4,0.00121,319710,96.52905,331206
4156,SciWiFi,4,0.00121,319714,96.53026,331206
4157,scovelme,4,0.00121,319718,96.53146,331206
4158,ScratchOs,4,0.00121,319722,96.53267,331206
4159,sdhr7314,4,0.00121,319726,96.53388,331206
4160,seanpackham,4,0.00121,319730,96.53509,331206
4161,seebs,4,0.00121,319734,96.53629,331206
4162,Sektor13,4,0.00121,319738,96.53750,331206
4163,serados,4,0.00121,319742,96.53871,331206
4164,Serge108,4,0.00121,319746,96.53992,331206
4165,sethboyles,4,0.00121,319750,96.54113,331206
4166,SgtLion,4,0.00121,319754,96.54233,331206
4167,S-h-0-X,4,0.00121,319758,96.54354,331206
4168,shecky2000,4,0.00121,319762,96.54475,331206
4169,shiMusa,4,0.00121,319766,96.54596,331206
4170,Shpendicus,4,0.00121,319770,96.54716,331206
4171,shubhamcodez,4,0.00121,319774,96.54837,331206
4172,sian2005,4,0.00121,319778,96.54958,331206
4173,sijpkes,4,0.00121,319782,96.55079,331206
4174,simon-budig,4,0.00121,319786,96.55199,331206
4175,SimonLarsen,4,0.00121,319790,96.55320,331206
4176,SimonSikstrom,4,0.00121,319794,96.55441,331206
4177,sirinath,4,0.00121,319798,96.55562,331206
4178,Sixmorphugus,4,0.00121,319802,96.55683,331206
4179,sixo,4,0.00121,319806,96.55803,331206
4180,sjharb,4,0.00121,319810,96.55924,331206
4181,SkaceKamen,4,0.00121,319814,96.56045,331206
4182,SkanerSoft,4,0.00121,319818,96.56166,331206
4183,skelewir,4,0.00121,319822,96.56286,331206
4184,SmartySmart702,4,0.00121,319826,96.56407,331206
4185,snake3276120,4,0.00121,319830,96.56528,331206
4186,Sogomn,4,0.00121,319834,96.56649,331206
4187,sonenko,4,0.00121,319838,96.56770,331206
4188,sorcierlegrand,4,0.00121,319842,96.56890,331206
4189,souryogurt,4,0.00121,319846,96.57011,331206
4190,spaghiajoeojo,4,0.00121,319850,96.57132,331206
4191,Speedphoenix,4,0.00121,319854,96.57253,331206
4192,stayseek,4,0.00121,319858,96.57373,331206
4193,steevLP,4,0.00121,319862,96.57494,331206
4194,Stof25,4,0.00121,319866,96.57615,331206
4195,Straskal,4,0.00121,319870,96.57736,331206
4196,Straw8,4,0.00121,319874,96.57856,331206
4197,StudyPerDay,4,0.00121,319878,96.57977,331206
4198,substract,4,0.00121,319882,96.58098,331206
4199,sudoman281,4,0.00121,319886,96.58219,331206
4200,sugarmaster,4,0.00121,319890,96.58340,331206
4201,sungvzer,4,0.00121,319894,96.58460,331206
4202,supaiku0,4,0.00121,319898,96.58581,331206
4203,superlou,4,0.00121,319902,96.58702,331206
4204,SVA-developer,4,0.00121,319906,96.58823,331206
4205,swipis,4,0.00121,319910,96.58943,331206
4206,Sylvain303,4,0.00121,319914,96.59064,331206
4207,Tabas32,4,0.00121,319918,96.59185,331206
4208,TanZng,4,0.00121,319922,96.59306,331206
4209,Tassim,4,0.00121,319926,96.59426,331206
4210,Tazshelby2016,4,0.00121,319930,96.59547,331206
4211,tchernia,4,0.00121,319934,96.59668,331206
4212,Temesian,4,0.00121,319938,96.59789,331206
4213,Teradile,4,0.00121,319942,96.59910,331206
4214,Tercus,4,0.00121,319946,96.60030,331206
4215,TerraDev64,4,0.00121,319950,96.60151,331206
4216,thChickenOD,4,0.00121,319954,96.60272,331206
4217,thebricco,4,0.00121,319958,96.60393,331206
4218,TheConceptBoy,4,0.00121,319962,96.60513,331206
4219,thegamerx1,4,0.00121,319966,96.60634,331206
4220,thenolfar,4,0.00121,319970,96.60755,331206
4221,thePalindrome,4,0.00121,319974,96.60876,331206
4222,ThePublicHacker,4,0.00121,319978,96.60996,331206
4223,TheSecurityDev,4,0.00121,319982,96.61117,331206
4224,TheSporkBard,4,0.00121,319986,96.61238,331206
4225,thumbline,4,0.00121,319990,96.61359,331206
4226,tienlocnguyen,4,0.00121,319994,96.61480,331206
4227,tinxx,4,0.00121,319998,96.61600,331206
4228,tm-nihonsuki,4,0.00121,320002,96.61721,331206
4229,tokc,4,0.00121,320006,96.61842,331206
4230,tomascw,4,0.00121,320010,96.61963,331206
4231,tonymtbird,4,0.00121,320014,96.62083,331206
4232,toqueteos,4,0.00121,320018,96.62204,331206
4233,Tornadowarnung,4,0.00121,320022,96.62325,331206
4234,torohaifisch,4,0.00121,320026,96.62446,331206
4235,torshid,4,0.00121,320030,96.62566,331206
4236,TrainDoctor,4,0.00121,320034,96.62687,331206
4237,travisryte,4,0.00121,320038,96.62808,331206
4238,travm,4,0.00121,320042,96.62929,331206
4239,TrevorPeyton,4,0.00121,320046,96.63050,331206
4240,trifox,4,0.00121,320050,96.63170,331206
4241,Triplelexx,4,0.00121,320054,96.63291,331206
4242,trond,4,0.00121,320058,96.63412,331206
4243,trtstm,4,0.00121,320062,96.63533,331206
4244,TrueMisterJeanP,4,0.00121,320066,96.63653,331206
4245,Turkm,4,0.00121,320070,96.63774,331206
4246,Turysaz,4,0.00121,320074,96.63895,331206
4247,TylerCompiler,4,0.00121,320078,96.64016,331206
4248,Tyrannosaurus1234,4,0.00121,320082,96.64137,331206
4249,Tzoop,4,0.00121,320086,96.64257,331206
4250,unSkind,4,0.00121,320090,96.64378,331206
4251,uuuuuup,4,0.00121,320094,96.64499,331206
4252,valdemar-const,4,0.00121,320098,96.64620,331206
4253,vanyasem,4,0.00121,320102,96.64740,331206
4254,Vascofr,4,0.00121,320106,96.64861,331206
4255,veloc1,4,0.00121,320110,96.64982,331206
4256,verhalenn,4,0.00121,320114,96.65103,331206
4257,veyluna,4,0.00121,320118,96.65223,331206
4258,VFlorin,4,0.00121,320122,96.65344,331206
4259,VictorRogers,4,0.00121,320126,96.65465,331206
4260,VinegarLove,4,0.00121,320130,96.65586,331206
4261,VizuaaLOG,4,0.00121,320134,96.65707,331206
4262,vonzimr,4,0.00121,320138,96.65827,331206
4263,Vorion86,4,0.00121,320142,96.65948,331206
4264,voronoipotato,4,0.00121,320146,96.66069,331206
4265,Vrzasq,4,0.00121,320150,96.66190,331206
4266,vsiles,4,0.00121,320154,96.66310,331206
4267,vspin,4,0.00121,320158,96.66431,331206
4268,Waasha,4,0.00121,320162,96.66552,331206
4269,wahyuadiramadan,4,0.00121,320166,96.66673,331206
4270,walknotes,4,0.00121,320170,96.66793,331206
4271,Wallyzhuk,4,0.00121,320174,96.66914,331206
4272,wamiqurrehman093,4,0.00121,320178,96.67035,331206
4273,Waranoi,4,0.00121,320182,96.67156,331206
4274,waterdu,4,0.00121,320186,96.67277,331206
4275,wbrbr,4,0.00121,320190,96.67397,331206
4276,wbulot,4,0.00121,320194,96.67518,331206
4277,wcbx,4,0.00121,320198,96.67639,331206
4278,websterek,4,0.00121,320202,96.67760,331206
4279,weckr,4,0.00121,320206,96.67880,331206
4280,Wend1go,4,0.00121,320210,96.68001,331206
4281,werty37,4,0.00121,320214,96.68122,331206
4282,WFKany,4,0.00121,320218,96.68243,331206
4283,whplh,4,0.00121,320222,96.68363,331206
4284,WickedInsignia,4,0.00121,320226,96.68484,331206
4285,willy1920,4,0.00121,320230,96.68605,331206
4286,wilska,4,0.00121,320234,96.68726,331206
4287,wlycdgrfromflatiron,4,0.00121,320238,96.68847,331206
4288,WolfieMario,4,0.00121,320242,96.68967,331206
4289,wwrzal,4,0.00121,320246,96.69088,331206
4290,xenicle,4,0.00121,320250,96.69209,331206
4291,Xiuhman,4,0.00121,320254,96.69330,331206
4292,XLIVE99,4,0.00121,320258,96.69450,331206
4293,XnetLoL,4,0.00121,320262,96.69571,331206
4294,xodene,4,0.00121,320266,96.69692,331206
4295,xpol,4,0.00121,320270,96.69813,331206
4296,Xs1v3,4,0.00121,320274,96.69934,331206
4297,xsaliniere,4,0.00121,320278,96.70054,331206
4298,xXrandomryzeXx,4,0.00121,320282,96.70175,331206
4299,Yar-Mukhamedov,4,0.00121,320286,96.70296,331206
4300,yonaskolb,4,0.00121,320290,96.70417,331206
4301,z80,4,0.00121,320294,96.70537,331206
4302,ZachIsAGardner,4,0.00121,320298,96.70658,331206
4303,zann1x,4,0.00121,320302,96.70779,331206
4304,Zaphodious,4,0.00121,320306,96.70900,331206
4305,Zappo-II,4,0.00121,320310,96.71020,331206
4306,zavb074,4,0.00121,320314,96.71141,331206
4307,Zaxuhe,4,0.00121,320318,96.71262,331206
4308,zayngdev,4,0.00121,320322,96.71383,331206
4309,Ziflin,4,0.00121,320326,96.71504,331206
4310,zinnschlag,4,0.00121,320330,96.71624,331206
4311,zio-hub,4,0.00121,320334,96.71745,331206
4312,ZippoLag,4,0.00121,320338,96.71866,331206
4313,zodywoolsey,4,0.00121,320342,96.71987,331206
4314,Zouch,4,0.00121,320346,96.72107,331206
4315,zvodd,4,0.00121,320350,96.72228,331206
4316,zzelle6767,4,0.00121,320354,96.72349,331206
4317,zziinnjj,4,0.00121,320358,96.72470,331206
4318,2nafish117,3,0.00091,320361,96.72560,331206
4319,3koozy,3,0.00091,320364,96.72651,331206
4320,44m0n,3,0.00091,320367,96.72741,331206
4321,4remy,3,0.00091,320370,96.72832,331206
4322,64epicks,3,0.00091,320373,96.72923,331206
4323,838116504,3,0.00091,320376,96.73013,331206
4324,aaqib7,3,0.00091,320379,96.73104,331206
4325,AaronCRobinson,3,0.00091,320382,96.73194,331206
4326,abcde13,3,0.00091,320385,96.73285,331206
4327,abdlquadri,3,0.00091,320388,96.73375,331206
4328,AbominableMonkey,3,0.00091,320391,96.73466,331206
4329,ace24713,3,0.00091,320394,96.73557,331206
4330,Acwok,3,0.00091,320397,96.73647,331206
4331,ADeeds,3,0.00091,320400,96.73738,331206
4332,Adeering,3,0.00091,320403,96.73828,331206
4333,adrianperreault,3,0.00091,320406,96.73919,331206
4334,Adrien-was-already-taken,3,0.00091,320409,96.74010,331206
4335,Afsar-Pasha,3,0.00091,320412,96.74100,331206
4336,ahervella,3,0.00091,320415,96.74191,331206
4337,ahmedSamy31,3,0.00091,320418,96.74281,331206
4338,aidanhs,3,0.00091,320421,96.74372,331206
4339,AidenHuxley,3,0.00091,320424,96.74462,331206
4340,aikoncwd,3,0.00091,320427,96.74553,331206
4341,ailernx,3,0.00091,320430,96.74644,331206
4342,AiurTemplar,3,0.00091,320433,96.74734,331206
4343,akirayui,3,0.00091,320436,96.74825,331206
4344,Akylzhan,3,0.00091,320439,96.74915,331206
4345,alagos,3,0.00091,320442,96.75006,331206
4346,A-Lamia,3,0.00091,320445,96.75096,331206
4347,Alan-FGR,3,0.00091,320448,96.75187,331206
4348,AlanLynn,3,0.00091,320451,96.75278,331206
4349,alan-w-255,3,0.00091,320454,96.75368,331206
4350,AlecFaye,3,0.00091,320457,96.75459,331206
4351,Alecsis,3,0.00091,320460,96.75549,331206
4352,alejodiazg,3,0.00091,320463,96.75640,331206
4353,alemedero,3,0.00091,320466,96.75731,331206
4354,AlexanderO88,3,0.00091,320469,96.75821,331206
4355,AlexanderPavlenko,3,0.00091,320472,96.75912,331206
4356,AlexGHz1,3,0.00091,320475,96.76002,331206
4357,AlexNight1986,3,0.00091,320478,96.76093,331206
4358,alexporth,3,0.00091,320481,96.76183,331206
4359,alglez,3,0.00091,320484,96.76274,331206
4360,AlGrande,3,0.00091,320487,96.76365,331206
4361,alixvoor,3,0.00091,320490,96.76455,331206
4362,AlonzoTG,3,0.00091,320493,96.76546,331206
4363,AlphinAlbukhari,3,0.00091,320496,96.76636,331206
4364,alpinus4,3,0.00091,320499,96.76727,331206
4365,Alternicity,3,0.00091,320502,96.76817,331206
4366,alvarlagerlof,3,0.00091,320505,96.76908,331206
4367,AlveLarsson,3,0.00091,320508,96.76999,331206
4368,alwaysusa,3,0.00091,320511,96.77089,331206
4369,Alzy,3,0.00091,320514,96.77180,331206
4370,Amatrelan,3,0.00091,320517,96.77270,331206
4371,ameen96mk,3,0.00091,320520,96.77361,331206
4372,amonroejj,3,0.00091,320523,96.77451,331206
4373,andersmmg,3,0.00091,320526,96.77542,331206
4374,andersongomes001,3,0.00091,320529,96.77633,331206
4375,AnderssonPeter,3,0.00091,320532,96.77723,331206
4376,AndreevAndrei,3,0.00091,320535,96.77814,331206
4377,andrejp88,3,0.00091,320538,96.77904,331206
4378,andrevenlibretrend,3,0.00091,320541,96.77995,331206
4379,andrewdbanks,3,0.00091,320544,96.78086,331206
4380,AndyGFX,3,0.00091,320547,96.78176,331206
4381,ANeller,3,0.00091,320550,96.78267,331206
4382,AnJo888,3,0.00091,320553,96.78357,331206
4383,Anonyore,3,0.00091,320556,96.78448,331206
4384,anotherREYY,3,0.00091,320559,96.78538,331206
4385,AnthonyYoManz,3,0.00091,320562,96.78629,331206
4386,anticmatic,3,0.00091,320565,96.78720,331206
4387,anvilbearryan,3,0.00091,320568,96.78810,331206
4388,Anynak,3,0.00091,320571,96.78901,331206
4389,aqnouch,3,0.00091,320574,96.78991,331206
4390,Aranir,3,0.00091,320577,96.79082,331206
4391,ArchangelZeero,3,0.00091,320580,96.79172,331206
4392,Arecher,3,0.00091,320583,96.79263,331206
4393,argentite,3,0.00091,320586,96.79354,331206
4394,arigoru,3,0.00091,320589,96.79444,331206
4395,arkadye,3,0.00091,320592,96.79535,331206
4396,armican,3,0.00091,320595,96.79625,331206
4397,arrowgamer,3,0.00091,320598,96.79716,331206
4398,artemtech,3,0.00091,320601,96.79807,331206
4399,arthur109,3,0.00091,320604,96.79897,331206
4400,Artifir,3,0.00091,320607,96.79988,331206
4401,art-kandy,3,0.00091,320610,96.80078,331206
4402,asg08dev,3,0.00091,320613,96.80169,331206
4403,asteinwedel,3,0.00091,320616,96.80259,331206
4404,aterlamia,3,0.00091,320619,96.80350,331206
4405,atllllll,3,0.00091,320622,96.80441,331206
4406,atsuzaki,3,0.00091,320625,96.80531,331206
4407,a-type,3,0.00091,320628,96.80622,331206
4408,auderer,3,0.00091,320631,96.80712,331206
4409,Aunter1992,3,0.00091,320634,96.80803,331206
4410,austinprog,3,0.00091,320637,96.80893,331206
4411,austinrseabolt,3,0.00091,320640,96.80984,331206
4412,automatrio,3,0.00091,320643,96.81075,331206
4413,AyeTbk,3,0.00091,320646,96.81165,331206
4414,AzariasB,3,0.00091,320649,96.81256,331206
4415,AzureDVBB,3,0.00091,320652,96.81346,331206
4416,b00sher,3,0.00091,320655,96.81437,331206
4417,babak-karimi-asl,3,0.00091,320658,96.81528,331206
4418,baekdahl,3,0.00091,320661,96.81618,331206
4419,baptx,3,0.00091,320664,96.81709,331206
4420,BaronVonPerko,3,0.00091,320667,96.81799,331206
4421,barrrettt,3,0.00091,320670,96.81890,331206
4422,baudren,3,0.00091,320673,96.81980,331206
4423,bayleak,3,0.00091,320676,96.82071,331206
4424,Be101,3,0.00091,320679,96.82162,331206
4425,beepboep,3,0.00091,320682,96.82252,331206
4426,BenoitKH,3,0.00091,320685,96.82343,331206
4427,bergmannf,3,0.00091,320688,96.82433,331206
4428,bheesham,3,0.00091,320691,96.82524,331206
4429,BigZaphod,3,0.00091,320694,96.82614,331206
4430,bioghost,3,0.00091,320697,96.82705,331206
4431,blakeearth,3,0.00091,320700,96.82796,331206
4432,BlaXpirit,3,0.00091,320703,96.82886,331206
4433,Bloodyaugust,3,0.00091,320706,96.82977,331206
4434,blueberrymountains,3,0.00091,320709,96.83067,331206
4435,Bluecoreg,3,0.00091,320712,96.83158,331206
4436,BlueNoise,3,0.00091,320715,96.83248,331206
4437,bluwork,3,0.00091,320718,96.83339,331206
4438,bmer,3,0.00091,320721,96.83430,331206
4439,bnowak22,3,0.00091,320724,96.83520,331206
4440,boluochoufeng,3,0.00091,320727,96.83611,331206
4441,boris1dev,3,0.00091,320730,96.83701,331206
4442,botteu,3,0.00091,320733,96.83792,331206
4443,braniii,3,0.00091,320736,96.83883,331206
4444,Brett-Mitchell,3,0.00091,320739,96.83973,331206
4445,Bropocalypse,3,0.00091,320742,96.84064,331206
4446,BrunoFerreira94,3,0.00091,320745,96.84154,331206
4447,brunorochanuveo,3,0.00091,320748,96.84245,331206
4448,BryceBarbara,3,0.00091,320751,96.84335,331206
4449,BTaskaya,3,0.00091,320754,96.84426,331206
4450,bugmenot2,3,0.00091,320757,96.84517,331206
4451,bugstew,3,0.00091,320760,96.84607,331206
4452,bunianox,3,0.00091,320763,96.84698,331206
4453,Burchard36,3,0.00091,320766,96.84788,331206
4454,burzum85,3,0.00091,320769,96.84879,331206
4455,bushig,3,0.00091,320772,96.84969,331206
4456,butelo,3,0.00091,320775,96.85060,331206
4457,bwasty,3,0.00091,320778,96.85151,331206
4458,c2titan,3,0.00091,320781,96.85241,331206
4459,caelan-douglas,3,0.00091,320784,96.85332,331206
4460,caffeine-mgn,3,0.00091,320787,96.85422,331206
4461,caizu,3,0.00091,320790,96.85513,331206
4462,Calamari,3,0.00091,320793,96.85604,331206
4463,CaptainSusuwatari,3,0.00091,320796,96.85694,331206
4464,casey-mc,3,0.00091,320799,96.85785,331206
4465,CatMaster983,3,0.00091,320802,96.85875,331206
4466,CawawaC,3,0.00091,320805,96.85966,331206
4467,CEDoromal,3,0.00091,320808,96.86056,331206
4468,cesarpinho,3,0.00091,320811,96.86147,331206
4469,chaigler,3,0.00091,320814,96.86238,331206
4470,cheece,3,0.00091,320817,96.86328,331206
4471,cheesymoo,3,0.00091,320820,96.86419,331206
4472,cheomanigua,3,0.00091,320823,96.86509,331206
4473,chexmo,3,0.00091,320826,96.86600,331206
4474,ChickenScratch,3,0.00091,320829,96.86690,331206
4475,Chownie,3,0.00091,320832,96.86781,331206
4476,chrisb123,3,0.00091,320835,96.86872,331206
4477,ChrisOKay,3,0.00091,320838,96.86962,331206
4478,christophgomez,3,0.00091,320841,96.87053,331206
4479,ChrisWhatever1980,3,0.00091,320844,96.87143,331206
4480,chronos38,3,0.00091,320847,96.87234,331206
4481,Chtobi,3,0.00091,320850,96.87325,331206
4482,chuckhacker,3,0.00091,320853,96.87415,331206
4483,ciaoSora,3,0.00091,320856,96.87506,331206
4484,CiaraBurkett,3,0.00091,320859,96.87596,331206
4485,cjthomp,3,0.00091,320862,96.87687,331206
4486,clabe45,3,0.00091,320865,96.87777,331206
4487,clarfonthey,3,0.00091,320868,96.87868,331206
4488,Clyybber,3,0.00091,320871,96.87959,331206
4489,CNate,3,0.00091,320874,96.88049,331206
4490,codectile,3,0.00091,320877,96.88140,331206
4491,CodeLazier,3,0.00091,320880,96.88230,331206
4492,Codelurkers,3,0.00091,320883,96.88321,331206
4493,coder69er,3,0.00091,320886,96.88411,331206
4494,codetorex,3,0.00091,320889,96.88502,331206
4495,CodeTortoise,3,0.00091,320892,96.88593,331206
4496,codz01,3,0.00091,320895,96.88683,331206
4497,complot49,3,0.00091,320898,96.88774,331206
4498,ComradeKeys,3,0.00091,320901,96.88864,331206
4499,ComradeSparklePony,3,0.00091,320904,96.88955,331206
4500,CornerLord,3,0.00091,320907,96.89045,331206
4501,cory171185,3,0.00091,320910,96.89136,331206
4502,cosmicgenius,3,0.00091,320913,96.89227,331206
4503,cotmat,3,0.00091,320916,96.89317,331206
4504,cpnielsen,3,0.00091,320919,96.89408,331206
4505,crabcrabcam,3,0.00091,320922,96.89498,331206
4506,crecs,3,0.00091,320925,96.89589,331206
4507,creutzerb,3,0.00091,320928,96.89680,331206
4508,crr0004,3,0.00091,320931,96.89770,331206
4509,culot,3,0.00091,320934,96.89861,331206
4510,curtisxk38,3,0.00091,320937,96.89951,331206
4511,cvvs,3,0.00091,320940,96.90042,331206
4512,cwkx,3,0.00091,320943,96.90132,331206
4513,cwwhitfield,3,0.00091,320946,96.90223,331206
4514,cyaoeu,3,0.00091,320949,96.90314,331206
4515,Cyber-host,3,0.00091,320952,96.90404,331206
4516,CyborgCabbage,3,0.00091,320955,96.90495,331206
4517,D00T24,3,0.00091,320958,96.90585,331206
4518,daemeh,3,0.00091,320961,96.90676,331206
4519,Dafuqz,3,0.00091,320964,96.90766,331206
4520,dakennedyd,3,0.00091,320967,96.90857,331206
4521,damasko,3,0.00091,320970,96.90948,331206
4522,dam-coder,3,0.00091,320973,96.91038,331206
4523,Damianu,3,0.00091,320976,96.91129,331206
4524,DamnWidget,3,0.00091,320979,96.91219,331206
4525,Danathus,3,0.00091,320982,96.91310,331206
4526,DaNeubi,3,0.00091,320985,96.91401,331206
4527,DanielAccorsi,3,0.00091,320988,96.91491,331206
4528,danielpcs,3,0.00091,320991,96.91582,331206
4529,danielytics,3,0.00091,320994,96.91672,331206
4530,DaniilDigtyar,3,0.00091,320997,96.91763,331206
4531,dankjank91,3,0.00091,321000,96.91853,331206
4532,dannyangmy,3,0.00091,321003,96.91944,331206
4533,danreeves,3,0.00091,321006,96.92035,331206
4534,dantesguilherme,3,0.00091,321009,96.92125,331206
4535,Daporan,3,0.00091,321012,96.92216,331206
4536,DaRealNim,3,0.00091,321015,96.92306,331206
4537,DarkEnchanter1,3,0.00091,321018,96.92397,331206
4538,darkfoxprime,3,0.00091,321021,96.92487,331206
4539,dasreyh,3,0.00091,321024,96.92578,331206
4540,David2753,3,0.00091,321027,96.92669,331206
4541,davidbejlej,3,0.00091,321030,96.92759,331206
4542,DavidHusicka,3,0.00091,321033,96.92850,331206
4543,davidpwbrown,3,0.00091,321036,96.92940,331206
4544,davied9,3,0.00091,321039,96.93031,331206
4545,definite-d,3,0.00091,321042,96.93122,331206
4546,dengtao49,3,0.00091,321045,96.93212,331206
4547,derderder77,3,0.00091,321048,96.93303,331206
4548,Deregon,3,0.00091,321051,96.93393,331206
4549,dest1,3,0.00091,321054,96.93484,331206
4550,Devashishsingh98,3,0.00091,321057,96.93574,331206
4551,devendra618,3,0.00091,321060,96.93665,331206
4552,devin-e,3,0.00091,321063,96.93756,331206
4553,Devlin556,3,0.00091,321066,96.93846,331206
4554,dewolen,3,0.00091,321069,96.93937,331206
4555,DEXIT33,3,0.00091,321072,96.94027,331206
4556,DGSitze,3,0.00091,321075,96.94118,331206
4557,dianshane,3,0.00091,321078,96.94208,331206
4558,Didine-SG,3,0.00091,321081,96.94299,331206
4559,diegomachado,3,0.00091,321084,96.94390,331206
4560,diegoph,3,0.00091,321087,96.94480,331206
4561,DigbyMW,3,0.00091,321090,96.94571,331206
4562,dimpletherat,3,0.00091,321093,96.94661,331206
4563,DionHo,3,0.00091,321096,96.94752,331206
4564,DiV4,3,0.00091,321099,96.94842,331206
4565,djgaspa,3,0.00091,321102,96.94933,331206
4566,dkrutskikh,3,0.00091,321105,96.95024,331206
4567,dmitryuck,3,0.00091,321108,96.95114,331206
4568,dnadan2,3,0.00091,321111,96.95205,331206
4569,DocTdb,3,0.00091,321114,96.95295,331206
4570,dodosiz,3,0.00091,321117,96.95386,331206
4571,Dokugan,3,0.00091,321120,96.95477,331206
4572,DominicSina,3,0.00091,321123,96.95567,331206
4573,downhillGames,3,0.00091,321126,96.95658,331206
4574,DoYouRockBaby,3,0.00091,321129,96.95748,331206
4575,draconicfae,3,0.00091,321132,96.95839,331206
4576,draxdeveloper,3,0.00091,321135,96.95929,331206
4577,drcucaracha,3,0.00091,321138,96.96020,331206
4578,drop1down,3,0.00091,321141,96.96111,331206
4579,dryluggage,3,0.00091,321144,96.96201,331206
4580,dsuter76,3,0.00091,321147,96.96292,331206
4581,DTV96Calibre,3,0.00091,321150,96.96382,331206
4582,duartencar,3,0.00091,321153,96.96473,331206
4583,Dudemanjude,3,0.00091,321156,96.96563,331206
4584,DuendeBrek,3,0.00091,321159,96.96654,331206
4585,dugramen,3,0.00091,321162,96.96745,331206
4586,D-Undefined,3,0.00091,321165,96.96835,331206
4587,dwafafiki,3,0.00091,321168,96.96926,331206
4588,DwanaG,3,0.00091,321171,96.97016,331206
4589,dydokamil,3,0.00091,321174,96.97107,331206
4590,dymk,3,0.00091,321177,96.97198,331206
4591,ebenson6295,3,0.00091,321180,96.97288,331206
4592,ebrahimebrahim,3,0.00091,321183,96.97379,331206
4593,edoartworks,3,0.00091,321186,96.97469,331206
4594,efigi,3,0.00091,321189,96.97560,331206
4595,ehutch79,3,0.00091,321192,96.97650,331206
4596,eka,3,0.00091,321195,96.97741,331206
4597,emanuele-scarsella,3,0.00091,321198,96.97832,331206
4598,emreozkartal,3,0.00091,321201,96.97922,331206
4599,EngBraga,3,0.00091,321204,96.98013,331206
4600,Enn3Developer,3,0.00091,321207,96.98103,331206
4601,enrikqose,3,0.00091,321210,96.98194,331206
4602,ericdl,3,0.00091,321213,96.98284,331206
4603,EricPlayZ,3,0.00091,321216,96.98375,331206
4604,erikscott128,3,0.00091,321219,96.98466,331206
4605,err0r1nc0de,3,0.00091,321222,96.98556,331206
4606,esbvaGames,3,0.00091,321225,96.98647,331206
4607,EternalColor,3,0.00091,321228,96.98737,331206
4608,eugeneBecker,3,0.00091,321231,96.98828,331206
4609,eureton,3,0.00091,321234,96.98918,331206
4610,evanandrewrose,3,0.00091,321237,96.99009,331206
4611,EveAwesome,3,0.00091,321240,96.99100,331206
4612,EvolutionPixels,3,0.00091,321243,96.99190,331206
4613,evsey9,3,0.00091,321246,96.99281,331206
4614,ExoidAgent,3,0.00091,321249,96.99371,331206
4615,extrawurst,3,0.00091,321252,96.99462,331206
4616,f000x,3,0.00091,321255,96.99553,331206
4617,FabianoFabiouchi,3,0.00091,321258,96.99643,331206
4618,FabIV,3,0.00091,321261,96.99734,331206
4619,fabriciopapa,3,0.00091,321264,96.99824,331206
4620,facePlanted,3,0.00091,321267,96.99915,331206
4621,falquinho,3,0.00091,321270,97.00005,331206
4622,Fatesight,3,0.00091,321273,97.00096,331206
4623,fazjaxton,3,0.00091,321276,97.00187,331206
4624,fbcosentino,3,0.00091,321279,97.00277,331206
4625,FCRx,3,0.00091,321282,97.00368,331206
4626,FeniksGaming,3,0.00091,321285,97.00458,331206
4627,FernandoValcazara,3,0.00091,321288,97.00549,331206
4628,fershopls,3,0.00091,321291,97.00639,331206
4629,ffxsam,3,0.00091,321294,97.00730,331206
4630,fieldmops,3,0.00091,321297,97.00821,331206
4631,finalherizo,3,0.00091,321300,97.00911,331206
4632,fkossyvas,3,0.00091,321303,97.01002,331206
4633,flakusha,3,0.00091,321306,97.01092,331206
4634,flamendless,3,0.00091,321309,97.01183,331206
4635,FlavioFS,3,0.00091,321312,97.01274,331206
4636,flintsteel7,3,0.00091,321315,97.01364,331206
4637,FlorianWeissensteiner,3,0.00091,321318,97.01455,331206
4638,FlossProject,3,0.00091,321321,97.01545,331206
4639,Fluffel,3,0.00091,321324,97.01636,331206
4640,fogelfish,3,0.00091,321327,97.01726,331206
4641,Ford81,3,0.00091,321330,97.01817,331206
4642,foumfo,3,0.00091,321333,97.01908,331206
4643,Foxomat,3,0.00091,321336,97.01998,331206
4644,fpg1503,3,0.00091,321339,97.02089,331206
4645,FrancisXIrizarry,3,0.00091,321342,97.02179,331206
4646,FrankJRix,3,0.00091,321345,97.02270,331206
4647,FrazzleTime,3,0.00091,321348,97.02360,331206
4648,freekoy,3,0.00091,321351,97.02451,331206
4649,Fruitseller,3,0.00091,321354,97.02542,331206
4650,fuha18,3,0.00091,321357,97.02632,331206
4651,FyiurAmron,3,0.00091,321360,97.02723,331206
4652,g2ffi,3,0.00091,321363,97.02813,331206
4653,gabimunt,3,0.00091,321366,97.02904,331206
4654,GAGANsinghmsitece,3,0.00091,321369,97.02995,331206
4655,GagaPete,3,0.00091,321372,97.03085,331206
4656,garyritchie,3,0.00091,321375,97.03176,331206
4657,GautamGottipati,3,0.00091,321378,97.03266,331206
4658,gber,3,0.00091,321381,97.03357,331206
4659,GDJason12,3,0.00091,321384,97.03447,331206
4660,Geaxle,3,0.00091,321387,97.03538,331206
4661,gehvaugeh,3,0.00091,321390,97.03629,331206
4662,genaside,3,0.00091,321393,97.03719,331206
4663,geomorillo,3,0.00091,321396,97.03810,331206
4664,george-norton,3,0.00091,321399,97.03900,331206
4665,georgesboris,3,0.00091,321402,97.03991,331206
4666,gevonstria,3,0.00091,321405,97.04081,331206
4667,gfeller,3,0.00091,321408,97.04172,331206
4668,ghostfreeman,3,0.00091,321411,97.04263,331206
4669,GhostNr1,3,0.00091,321414,97.04353,331206
4670,gibberingmouther,3,0.00091,321417,97.04444,331206
4671,GitGozer,3,0.00091,321420,97.04534,331206
4672,giusdp,3,0.00091,321423,97.04625,331206
4673,gloryofrobots,3,0.00091,321426,97.04715,331206
4674,godotludos,3,0.00091,321429,97.04806,331206
4675,Goe23,3,0.00091,321432,97.04897,331206
4676,gogo199432,3,0.00091,321435,97.04987,331206
4677,gorgo,3,0.00091,321438,97.05078,331206
4678,GreatBlambo,3,0.00091,321441,97.05168,331206
4679,grenappels,3,0.00091,321444,97.05259,331206
4680,Grinshpon,3,0.00091,321447,97.05350,331206
4681,groug,3,0.00091,321450,97.05440,331206
4682,GryphonClaw,3,0.00091,321453,97.05531,331206
4683,Gulum,3,0.00091,321456,97.05621,331206
4684,gusg21,3,0.00091,321459,97.05712,331206
4685,gustavottc,3,0.00091,321462,97.05802,331206
4686,gvdb,3,0.00091,321465,97.05893,331206
4687,hacker1122,3,0.00091,321468,97.05984,331206
4688,HacsonRED123,3,0.00091,321471,97.06074,331206
4689,hagsteel,3,0.00091,321474,97.06165,331206
4690,Halogen32,3,0.00091,321477,97.06255,331206
4691,Handja,3,0.00091,321480,97.06346,331206
4692,hankedan000,3,0.00091,321483,97.06436,331206
4693,hansenrobert,3,0.00091,321486,97.06527,331206
4694,haonkrub,3,0.00091,321489,97.06618,331206
4695,happydpc,3,0.00091,321492,97.06708,331206
4696,HardCockJones,3,0.00091,321495,97.06799,331206
4697,Harrisoncook12,3,0.00091,321498,97.06889,331206
4698,hasherkeen,3,0.00091,321501,97.06980,331206
4699,hashusfb,3,0.00091,321504,97.07071,331206
4700,Hayden4126,3,0.00091,321507,97.07161,331206
4701,hcmlax,3,0.00091,321510,97.07252,331206
4702,Heikki00,3,0.00091,321513,97.07342,331206
4703,hemagx,3,0.00091,321516,97.07433,331206
4704,Henelik,3,0.00091,321519,97.07523,331206
4705,herrnett,3,0.00091,321522,97.07614,331206
4706,Hersir88,3,0.00091,321525,97.07705,331206
4707,hmumm,3,0.00091,321528,97.07795,331206
4708,Hoimar,3,0.00091,321531,97.07886,331206
4709,hollowsaibot,3,0.00091,321534,97.07976,331206
4710,Holo74,3,0.00091,321537,97.08067,331206
4711,holybreath,3,0.00091,321540,97.08157,331206
4712,honghaoli,3,0.00091,321543,97.08248,331206
4713,HoucineChelbi,3,0.00091,321546,97.08339,331206
4714,htory327,3,0.00091,321549,97.08429,331206
4715,huisedenanhai,3,0.00091,321552,97.08520,331206
4716,Husky110,3,0.00091,321555,97.08610,331206
4717,Hypnotron,3,0.00091,321558,97.08701,331206
4718,iap-mutant,3,0.00091,321561,97.08792,331206
4719,ic3bug,3,0.00091,321564,97.08882,331206
4720,ice-blaze,3,0.00091,321567,97.08973,331206
4721,ideasman42,3,0.00091,321570,97.09063,331206
4722,IEXWER,3,0.00091,321573,97.09154,331206
4723,ignusfast,3,0.00091,321576,97.09244,331206
4724,igorashs,3,0.00091,321579,97.09335,331206
4725,iirelu,3,0.00091,321582,97.09426,331206
4726,Illiander,3,0.00091,321585,97.09516,331206
4727,illogically,3,0.00091,321588,97.09607,331206
4728,imnphil,3,0.00091,321591,97.09697,331206
4729,Imvoo,3,0.00091,321594,97.09788,331206
4730,Incblob,3,0.00091,321597,97.09878,331206
4731,Incipium,3,0.00091,321600,97.09969,331206
4732,increpare,3,0.00091,321603,97.10060,331206
4733,indiemaniac,3,0.00091,321606,97.10150,331206
4734,Inferno630,3,0.00091,321609,97.10241,331206
4735,InsomniaWins,3,0.00091,321612,97.10331,331206
4736,intra32,3,0.00091,321615,97.10422,331206
4737,IoriBranford,3,0.00091,321618,97.10512,331206
4738,iownall555,3,0.00091,321621,97.10603,331206
4739,IranosMorloy,3,0.00091,321624,97.10694,331206
4740,Iris-6,3,0.00091,321627,97.10784,331206
4741,Iris616,3,0.00091,321630,97.10875,331206
4742,ironicnet,3,0.00091,321633,97.10965,331206
4743,IronStudios,3,0.00091,321636,97.11056,331206
4744,isHaacK,3,0.00091,321639,97.11147,331206
4745,islam1999h,3,0.00091,321642,97.11237,331206
4746,Istalriblaka,3,0.00091,321645,97.11328,331206
4747,ivancek,3,0.00091,321648,97.11418,331206
4748,iway1,3,0.00091,321651,97.11509,331206
4749,iwHiteRabbiT,3,0.00091,321654,97.11599,331206
4750,jababo,3,0.00091,321657,97.11690,331206
4751,Jabbschy,3,0.00091,321660,97.11781,331206
4752,Jack-MoG,3,0.00091,321663,97.11871,331206
4753,JacobTheHeartless,3,0.00091,321666,97.11962,331206
4754,jacopofar,3,0.00091,321669,97.12052,331206
4755,jaggzh,3,0.00091,321672,97.12143,331206
4756,JakSparro98,3,0.00091,321675,97.12233,331206
4757,ja-kub,3,0.00091,321678,97.12324,331206
4758,jakubg1,3,0.00091,321681,97.12415,331206
4759,jamesdkay,3,0.00091,321684,97.12505,331206
4760,jamesreiati,3,0.00091,321687,97.12596,331206
4761,javaphpsql,3,0.00091,321690,97.12686,331206
4762,javawag,3,0.00091,321693,97.12777,331206
4763,jayanam,3,0.00091,321696,97.12868,331206
4764,Jayanth-L,3,0.00091,321699,97.12958,331206
4765,jaydonteh,3,0.00091,321702,97.13049,331206
4766,JayStringer,3,0.00091,321705,97.13139,331206
4767,J-Camilleri,3,0.00091,321708,97.13230,331206
4768,jdjddjdj,3,0.00091,321711,97.13320,331206
4769,jegor377,3,0.00091,321714,97.13411,331206
4770,Jepulisk,3,0.00091,321717,97.13502,331206
4771,jeremiah,3,0.00091,321720,97.13592,331206
4772,JeremiahLR,3,0.00091,321723,97.13683,331206
4773,jfvvinente,3,0.00091,321726,97.13773,331206
4774,jgedri,3,0.00091,321729,97.13864,331206
4775,jholstein,3,0.00091,321732,97.13954,331206
4776,jhonatanoliveira,3,0.00091,321735,97.14045,331206
4777,Jiagi,3,0.00091,321738,97.14136,331206
4778,jjgh,3,0.00091,321741,97.14226,331206
4779,jjgriff93,3,0.00091,321744,97.14317,331206
4780,jkirsons,3,0.00091,321747,97.14407,331206
4781,jmca,3,0.00091,321750,97.14498,331206
4782,Joe23232,3,0.00091,321753,97.14589,331206
4783,joesdu,3,0.00091,321756,97.14679,331206
4784,johannnovak,3,0.00091,321759,97.14770,331206
4785,johnhamilton,3,0.00091,321762,97.14860,331206
4786,JohnnyDynamite,3,0.00091,321765,97.14951,331206
4787,jomilam,3,0.00091,321768,97.15041,331206
4788,josephbmanley,3,0.00091,321771,97.15132,331206
4789,joshchristiane,3,0.00091,321774,97.15223,331206
4790,JoshS,3,0.00091,321777,97.15313,331206
4791,JoshuaCoffman,3,0.00091,321780,97.15404,331206
4792,joshuacox,3,0.00091,321783,97.15494,331206
4793,jrimclean,3,0.00091,321786,97.15585,331206
4794,J-ru,3,0.00091,321789,97.15675,331206
4795,jsbeckr,3,0.00091,321792,97.15766,331206
4796,jshorty,3,0.00091,321795,97.15857,331206
4797,juanfrangarro,3,0.00091,321798,97.15947,331206
4798,Julian-Vos,3,0.00091,321801,97.16038,331206
4799,jupmorenor,3,0.00091,321804,97.16128,331206
4800,jusroberts,3,0.00091,321807,97.16219,331206
4801,justjoeyuk,3,0.00091,321810,97.16309,331206
4802,jvitoroc,3,0.00091,321813,97.16400,331206
4803,jwijngaarde,3,0.00091,321816,97.16491,331206
4804,jwurzer,3,0.00091,321819,97.16581,331206
4805,K1NGM4RV,3,0.00091,321822,97.16672,331206
4806,k4y4k,3,0.00091,321825,97.16762,331206
4807,k59,3,0.00091,321828,97.16853,331206
4808,kacmak7,3,0.00091,321831,97.16944,331206
4809,kagonzalez,3,0.00091,321834,97.17034,331206
4810,KaidenTBIO,3,0.00091,321837,97.17125,331206
4811,kalbfled,3,0.00091,321840,97.17215,331206
4812,kapes232,3,0.00091,321843,97.17306,331206
4813,katekligman,3,0.00091,321846,97.17396,331206
4814,kavika13,3,0.00091,321849,97.17487,331206
4815,kbajno,3,0.00091,321852,97.17578,331206
4816,kboxsoft,3,0.00091,321855,97.17668,331206
4817,kelvin13,3,0.00091,321858,97.17759,331206
4818,Kenska,3,0.00091,321861,97.17849,331206
4819,Kepler-Br,3,0.00091,321864,97.17940,331206
4820,Keppl,3,0.00091,321867,97.18030,331206
4821,kerbingamer376,3,0.00091,321870,97.18121,331206
4822,Kersoph,3,0.00091,321873,97.18212,331206
4823,keyframer,3,0.00091,321876,97.18302,331206
4824,kezzbracey,3,0.00091,321879,97.18393,331206
4825,Kibelon,3,0.00091,321882,97.18483,331206
4826,king-numsgil,3,0.00091,321885,97.18574,331206
4827,Kingofd,3,0.00091,321888,97.18665,331206
4828,kirk-github,3,0.00091,321891,97.18755,331206
4829,Kirs-one,3,0.00091,321894,97.18846,331206
4830,KiwiColoredHorror,3,0.00091,321897,97.18936,331206
4831,Kjili,3,0.00091,321900,97.19027,331206
4832,kmcphillips,3,0.00091,321903,97.19117,331206
4833,kn1ght99,3,0.00091,321906,97.19208,331206
4834,Knuckl3head,3,0.00091,321909,97.19299,331206
4835,kockahonza,3,0.00091,321912,97.19389,331206
4836,kodkuce,3,0.00091,321915,97.19480,331206
4837,kojow7,3,0.00091,321918,97.19570,331206
4838,Kolrath,3,0.00091,321921,97.19661,331206
4839,kowww,3,0.00091,321924,97.19751,331206
4840,kozaluss,3,0.00091,321927,97.19842,331206
4841,kraghot,3,0.00091,321930,97.19933,331206
4842,krayon,3,0.00091,321933,97.20023,331206
4843,krisleesc,3,0.00091,321936,97.20114,331206
4844,kristijandraca,3,0.00091,321939,97.20204,331206
4845,Kristonitas,3,0.00091,321942,97.20295,331206
4846,Kronkleberry,3,0.00091,321945,97.20386,331206
4847,kroppt,3,0.00091,321948,97.20476,331206
4848,Krosh,3,0.00091,321951,97.20567,331206
4849,krscott,3,0.00091,321954,97.20657,331206
4850,Kryper,3,0.00091,321957,97.20748,331206
4851,kryptot7,3,0.00091,321960,97.20838,331206
4852,kubaxius,3,0.00091,321963,97.20929,331206
4853,kudige,3,0.00091,321966,97.21020,331206
4854,kuon,3,0.00091,321969,97.21110,331206
4855,kuroodo,3,0.00091,321972,97.21201,331206
4856,KvaGram,3,0.00091,321975,97.21291,331206
4857,kvvojciechowski,3,0.00091,321978,97.21382,331206
4858,Kwu564,3,0.00091,321981,97.21472,331206
4859,kyle-marshall,3,0.00091,321984,97.21563,331206
4860,lachiko,3,0.00091,321987,97.21654,331206
4861,Lachlan-uts,3,0.00091,321990,97.21744,331206
4862,lalalaring,3,0.00091,321993,97.21835,331206
4863,LanceJZ,3,0.00091,321996,97.21925,331206
4864,Langrisser001,3,0.00091,321999,97.22016,331206
4865,LarsGut,3,0.00091,322002,97.22106,331206
4866,LastSize,3,0.00091,322005,97.22197,331206
4867,lauren-emily75,3,0.00091,322008,97.22288,331206
4868,lazybullfrog,3,0.00091,322011,97.22378,331206
4869,Lechjocker,3,0.00091,322014,97.22469,331206
4870,lectronice,3,0.00091,322017,97.22559,331206
4871,LeDernier,3,0.00091,322020,97.22650,331206
4872,leolimasa,3,0.00091,322023,97.22741,331206
4873,leon196,3,0.00091,322026,97.22831,331206
4874,LethargicDeveloper,3,0.00091,322029,97.22922,331206
4875,letmejustfixthat,3,0.00091,322032,97.23012,331206
4876,lexwraith,3,0.00091,322035,97.23103,331206
4877,lfkdev,3,0.00091,322038,97.23193,331206
4878,lfzinho,3,0.00091,322041,97.23284,331206
4879,lightspeedlucas,3,0.00091,322044,97.23375,331206
4880,Likkkez,3,0.00091,322047,97.23465,331206
4881,linkoboy,3,0.00091,322050,97.23556,331206
4882,LionArt,3,0.00091,322053,97.23646,331206
4883,liorda,3,0.00091,322056,97.23737,331206
4884,LisacPisac,3,0.00091,322059,97.23827,331206
4885,literalcitrus,3,0.00091,322062,97.23918,331206
4886,LittleDev1,3,0.00091,322065,97.24009,331206
4887,liungkejin,3,0.00091,322068,97.24099,331206
4888,lmsonic,3,0.00091,322071,97.24190,331206
4889,lordee,3,0.00091,322074,97.24280,331206
4890,lordoffox,3,0.00091,322077,97.24371,331206
4891,loris-olsem,3,0.00091,322080,97.24462,331206
4892,losinggeneration,3,0.00091,322083,97.24552,331206
4893,LostMyAccount,3,0.00091,322086,97.24643,331206
4894,louis1lal,3,0.00091,322089,97.24733,331206
4895,louisgjohnson,3,0.00091,322092,97.24824,331206
4896,Lovewyrm,3,0.00091,322095,97.24914,331206
4897,lozhev,3,0.00091,322098,97.25005,331206
4898,luccapedrini,3,0.00091,322101,97.25096,331206
4899,LuckyB4stard,3,0.00091,322104,97.25186,331206
4900,LuckySvenn,3,0.00091,322107,97.25277,331206
4901,LucSps,3,0.00091,322110,97.25367,331206
4902,luiz-lima,3,0.00091,322113,97.25458,331206
4903,lukruh,3,0.00091,322116,97.25548,331206
4904,Lulink13,3,0.00091,322119,97.25639,331206
4905,lunariusis,3,0.00091,322122,97.25730,331206
4906,lundybernard,3,0.00091,322125,97.25820,331206
4907,lungdart,3,0.00091,322128,97.25911,331206
4908,Lutalli,3,0.00091,322131,97.26001,331206
4909,Luuk3333,3,0.00091,322134,97.26092,331206
4910,lvottero,3,0.00091,322137,97.26182,331206
4911,m1233,3,0.00091,322140,97.26273,331206
4912,m93a,3,0.00091,322143,97.26364,331206
4913,Machalord,3,0.00091,322146,97.26454,331206
4914,maddin200,3,0.00091,322149,97.26545,331206
4915,maeb,3,0.00091,322152,97.26635,331206
4916,majkowskir,3,0.00091,322155,97.26726,331206
4917,MajorCooke,3,0.00091,322158,97.26817,331206
4918,MakMcFly,3,0.00091,322161,97.26907,331206
4919,maksimkulis,3,0.00091,322164,97.26998,331206
4920,marCOmics,3,0.00091,322167,97.27088,331206
4921,marcosdon,3,0.00091,322170,97.27179,331206
4922,marcosn41,3,0.00091,322173,97.27269,331206
4923,MarcosRRM,3,0.00091,322176,97.27360,331206
4924,marcusViniciusMP,3,0.00091,322179,97.27451,331206
4925,mariambukenya,3,0.00091,322182,97.27541,331206
4926,marianokpo,3,0.00091,322185,97.27632,331206
4927,maringuu,3,0.00091,322188,97.27722,331206
4928,MarioLiebisch,3,0.00091,322191,97.27813,331206
4929,marionauta,3,0.00091,322194,97.27903,331206
4930,markawilson,3,0.00091,322197,97.27994,331206
4931,MarkSort,3,0.00091,322200,97.28085,331206
4932,markusgod,3,0.00091,322203,97.28175,331206
4933,martijnbolt,3,0.00091,322206,97.28266,331206
4934,Martin1991zab,3,0.00091,322209,97.28356,331206
4935,MartinBlondin,3,0.00091,322212,97.28447,331206
4936,martinpelli,3,0.00091,322215,97.28538,331206
4937,masonjoyers,3,0.00091,322218,97.28628,331206
4938,mastercake10,3,0.00091,322221,97.28719,331206
4939,MasTho0128,3,0.00091,322224,97.28809,331206
4940,mastorak,3,0.00091,322227,97.28900,331206
4941,mateosss,3,0.00091,322230,97.28990,331206
4942,mathpeseg,3,0.00091,322233,97.29081,331206
4943,matriax,3,0.00091,322236,97.29172,331206
4944,MatthewDLudwig,3,0.00091,322239,97.29262,331206
4945,mattintriago,3,0.00091,322242,97.29353,331206
4946,matyasm,3,0.00091,322245,97.29443,331206
4947,MaurizioMacri,3,0.00091,322248,97.29534,331206
4948,MAVREE,3,0.00091,322251,97.29624,331206
4949,maxime4000,3,0.00091,322254,97.29715,331206
4950,mazen-mardini,3,0.00091,322257,97.29806,331206
4951,MB3hel,3,0.00091,322260,97.29896,331206
4952,mcccclean,3,0.00091,322263,97.29987,331206
4953,mcclure,3,0.00091,322266,97.30077,331206
4954,McFarts,3,0.00091,322269,97.30168,331206
4955,mdraw,3,0.00091,322272,97.30259,331206
4956,meatballcoder,3,0.00091,322275,97.30349,331206
4957,medavox,3,0.00091,322278,97.30440,331206
4958,meigel,3,0.00091,322281,97.30530,331206
4959,MeikelLP,3,0.00091,322284,97.30621,331206
4960,MeshVoid,3,0.00091,322287,97.30711,331206
4961,metalfrog2018,3,0.00091,322290,97.30802,331206
4962,metobalano6,3,0.00091,322293,97.30893,331206
4963,mhdchehade,3,0.00091,322296,97.30983,331206
4964,miere43,3,0.00091,322299,97.31074,331206
4965,Mietzsche81,3,0.00091,322302,97.31164,331206
4966,migoun,3,0.00091,322305,97.31255,331206
4967,mikolasan,3,0.00091,322308,97.31345,331206
4968,miladh06,3,0.00091,322311,97.31436,331206
4969,MilanGodot,3,0.00091,322314,97.31527,331206
4970,minitrope,3,0.00091,322317,97.31617,331206
4971,Mirodil,3,0.00091,322320,97.31708,331206
4972,mliitfall,3,0.00091,322323,97.31798,331206
4973,mmatttheww,3,0.00091,322326,97.31889,331206
4974,mmermerkaya,3,0.00091,322329,97.31979,331206
4975,MMichael789,3,0.00091,322332,97.32070,331206
4976,Mo0dy,3,0.00091,322335,97.32161,331206
4977,mobileben,3,0.00091,322338,97.32251,331206
4978,Moghedien,3,0.00091,322341,97.32342,331206
4979,mohrcore,3,0.00091,322344,97.32432,331206
4980,MomoHunter,3,0.00091,322347,97.32523,331206
4981,mookiexl,3,0.00091,322350,97.32614,331206
4982,moonlightarcana,3,0.00091,322353,97.32704,331206
4983,MoonsPod,3,0.00091,322356,97.32795,331206
4984,Mooseloser,3,0.00091,322359,97.32885,331206
4985,mord79,3,0.00091,322362,97.32976,331206
4986,mpatraw,3,0.00091,322365,97.33066,331206
4987,mphe,3,0.00091,322368,97.33157,331206
4988,mpue,3,0.00091,322371,97.33248,331206
4989,MPWrobel,3,0.00091,322374,97.33338,331206
4990,mralve,3,0.00091,322377,97.33429,331206
4991,MrHankey,3,0.00091,322380,97.33519,331206
4992,mrn00bpro,3,0.00091,322383,97.33610,331206
4993,MrOneTwo,3,0.00091,322386,97.33700,331206
4994,MrSquigy,3,0.00091,322389,97.33791,331206
4995,mshayden1998,3,0.00091,322392,97.33882,331206
4996,mss1451,3,0.00091,322395,97.33972,331206
4997,MSZAL,3,0.00091,322398,97.34063,331206
4998,mtttz,3,0.00091,322401,97.34153,331206
4999,MuffinMan50,3,0.00091,322404,97.34244,331206
5000,mujpao,3,0.00091,322407,97.34335,331206
5001,muzzician,3,0.00091,322410,97.34425,331206
5002,mvpggez,3,0.00091,322413,97.34516,331206
5003,myclay,3,0.00091,322416,97.34606,331206
5004,mysamdog,3,0.00091,322419,97.34697,331206
5005,mythicsmt,3,0.00091,322422,97.34787,331206
5006,n4nn31355,3,0.00091,322425,97.34878,331206
5007,namtran166,3,0.00091,322428,97.34969,331206
5008,nanoframe,3,0.00091,322431,97.35059,331206
5009,Nanox19435,3,0.00091,322434,97.35150,331206
5010,nathanthesnooper,3,0.00091,322437,97.35240,331206
5011,nbcks,3,0.00091,322440,97.35331,331206
5012,nealith,3,0.00091,322443,97.35421,331206
5013,Nearoo,3,0.00091,322446,97.35512,331206
5014,NebulousWeb,3,0.00091,322449,97.35603,331206
5015,Necco-Z,3,0.00091,322452,97.35693,331206
5016,NeeleW,3,0.00091,322455,97.35784,331206
5017,Nermit,3,0.00091,322458,97.35874,331206
5018,netpoetica,3,0.00091,322461,97.35965,331206
5019,neverdieboy,3,0.00091,322464,97.36056,331206
5020,newnoiseworks,3,0.00091,322467,97.36146,331206
5021,nicolasdiehl,3,0.00091,322470,97.36237,331206
5022,nicolls1,3,0.00091,322473,97.36327,331206
5023,nikitavondel,3,0.00091,322476,97.36418,331206
5024,NikolaBerovic,3,0.00091,322479,97.36508,331206
5025,nimenko,3,0.00091,322482,97.36599,331206
5026,NiNEngine,3,0.00091,322485,97.36690,331206
5027,ninetones,3,0.00091,322488,97.36780,331206
5028,n-k-chilagani,3,0.00091,322491,97.36871,331206
5029,nlehuen,3,0.00091,322494,97.36961,331206
5030,nnmsIsaac,3,0.00091,322497,97.37052,331206
5031,NobleValerian,3,0.00091,322500,97.37142,331206
5032,nongvantinh,3,0.00091,322503,97.37233,331206
5033,noobaldrin,3,0.00091,322506,97.37324,331206
5034,notRenaissance,3,0.00091,322509,97.37414,331206
5035,not-surt,3,0.00091,322512,97.37505,331206
5036,NSasquatch,3,0.00091,322515,97.37595,331206
5037,Nurali9999,3,0.00091,322518,97.37686,331206
5038,nuriu,3,0.00091,322521,97.37776,331206
5039,nxfs,3,0.00091,322524,97.37867,331206
5040,nyx,3,0.00091,322527,97.37958,331206
5041,ocdmonkey,3,0.00091,322530,97.38048,331206
5042,Odyhayek,3,0.00091,322533,97.38139,331206
5043,OFTekk,3,0.00091,322536,97.38229,331206
5044,omarbassam88,3,0.00091,322539,97.38320,331206
5045,omenos,3,0.00091,322542,97.38411,331206
5046,OneraG4M3R,3,0.00091,322545,97.38501,331206
5047,Orangestar12,3,0.00091,322548,97.38592,331206
5048,orelvis15,3,0.00091,322551,97.38682,331206
5049,ouabing,3,0.00091,322554,97.38773,331206
5050,ouck02,3,0.00091,322557,97.38863,331206
5051,OuTopos,3,0.00091,322560,97.38954,331206
5052,ozanyurtsever,3,0.00091,322563,97.39045,331206
5053,Pahasz,3,0.00091,322566,97.39135,331206
5054,pamartn,3,0.00091,322569,97.39226,331206
5055,PanaDeluxe,3,0.00091,322572,97.39316,331206
5056,PanTrakX,3,0.00091,322575,97.39407,331206
5057,PapaCheese,3,0.00091,322578,97.39497,331206
5058,ParradoxSVK,3,0.00091,322581,97.39588,331206
5059,PatheticJuan,3,0.00091,322584,97.39679,331206
5060,patrickdevivo,3,0.00091,322587,97.39769,331206
5061,patwretchedsuspect,3,0.00091,322590,97.39860,331206
5062,paul59,3,0.00091,322593,97.39950,331206
5063,paulallenbright,3,0.00091,322596,97.40041,331206
5064,paulens12,3,0.00091,322599,97.40132,331206
5065,paulineribeyre,3,0.00091,322602,97.40222,331206
5066,paultz54,3,0.00091,322605,97.40313,331206
5067,pcbeard,3,0.00091,322608,97.40403,331206
5068,pedromundo,3,0.00091,322611,97.40494,331206
5069,Pegus1936,3,0.00091,322614,97.40584,331206
5070,PeterDavidCarter,3,0.00091,322617,97.40675,331206
5071,Peter-Lavigne,3,0.00091,322620,97.40766,331206
5072,pezcode,3,0.00091,322623,97.40856,331206
5073,pfagurel,3,0.00091,322626,97.40947,331206
5074,pfthroaway,3,0.00091,322629,97.41037,331206
5075,phas0r,3,0.00091,322632,97.41128,331206
5076,phil123456,3,0.00091,322635,97.41218,331206
5077,Phil889,3,0.00091,322638,97.41309,331206
5078,philiplb,3,0.00091,322641,97.41400,331206
5079,Philius,3,0.00091,322644,97.41490,331206
5080,Phin236,3,0.00091,322647,97.41581,331206
5081,PhoenixStroh,3,0.00091,322650,97.41671,331206
5082,pihdastudios,3,0.00091,322653,97.41762,331206
5083,pixeltao,3,0.00091,322656,97.41853,331206
5084,PixsaOJ,3,0.00091,322659,97.41943,331206
5085,playmyskay,3,0.00091,322662,97.42034,331206
5086,poeaod,3,0.00091,322665,97.42124,331206
5087,pomalley,3,0.00091,322668,97.42215,331206
5088,popey,3,0.00091,322671,97.42305,331206
5089,pragmaticsystematic,3,0.00091,322674,97.42396,331206
5090,prateekamana,3,0.00091,322677,97.42487,331206
5091,PravinKumar95,3,0.00091,322680,97.42577,331206
5092,pret3nti0u5,3,0.00091,322683,97.42668,331206
5093,Prime-Eight,3,0.00091,322686,97.42758,331206
5094,Prisalized,3,0.00091,322689,97.42849,331206
5095,ProfesorTartelett,3,0.00091,322692,97.42939,331206
5096,Project-Magenta,3,0.00091,322695,97.43030,331206
5097,protito,3,0.00091,322698,97.43121,331206
5098,prsolucoes,3,0.00091,322701,97.43211,331206
5099,ptodorov0123,3,0.00091,322704,97.43302,331206
5100,Pxllux,3,0.00091,322707,97.43392,331206
5101,pyceanx,3,0.00091,322710,97.43483,331206
5102,qqwa,3,0.00091,322713,97.43573,331206
5103,Quadtree,3,0.00091,322716,97.43664,331206
5104,quantumnoctus,3,0.00091,322719,97.43755,331206
5105,qufaud99,3,0.00091,322722,97.43845,331206
5106,Qu-inn,3,0.00091,322725,97.43936,331206
5107,quiro9,3,0.00091,322728,97.44026,331206
5108,R-033,3,0.00091,322731,97.44117,331206
5109,raffomania,3,0.00091,322734,97.44208,331206
5110,ragas,3,0.00091,322737,97.44298,331206
5111,ragtag,3,0.00091,322740,97.44389,331206
5112,rakibulhaq,3,0.00091,322743,97.44479,331206
5113,ramizbalayil,3,0.00091,322746,97.44570,331206
5114,ramoas86,3,0.00091,322749,97.44660,331206
5115,raumkraut,3,0.00091,322752,97.44751,331206
5116,raymestalez,3,0.00091,322755,97.44842,331206
5117,rcarjan,3,0.00091,322758,97.44932,331206
5118,rdb,3,0.00091,322761,97.45023,331206
5119,realbrazilhours,3,0.00091,322764,97.45113,331206
5120,RealTehreal,3,0.00091,322767,97.45204,331206
5121,RedHeadphone,3,0.00091,322770,97.45294,331206
5122,Redsandro,3,0.00091,322773,97.45385,331206
5123,reegankens,3,0.00091,322776,97.45476,331206
5124,Regnaris,3,0.00091,322779,97.45566,331206
5125,Reizenchuu,3,0.00091,322782,97.45657,331206
5126,Renari,3,0.00091,322785,97.45747,331206
5127,Reticulatas,3,0.00091,322788,97.45838,331206
5128,RetroZvoc,3,0.00091,322791,97.45929,331206
5129,reyalpsirc,3,0.00091,322794,97.46019,331206
5130,rezich,3,0.00091,322797,97.46110,331206
5131,ricmzn,3,0.00091,322800,97.46200,331206
5132,Rindbee,3,0.00091,322803,97.46291,331206
5133,rlegonidec,3,0.00091,322806,97.46381,331206
5134,rmasp98,3,0.00091,322809,97.46472,331206
5135,rmazzier,3,0.00091,322812,97.46563,331206
5136,RMKD,3,0.00091,322815,97.46653,331206
5137,robbiespeed,3,0.00091,322818,97.46744,331206
5138,RobertBrunhage,3,0.00091,322821,97.46834,331206
5139,roblovelett,3,0.00091,322824,97.46925,331206
5140,roired,3,0.00091,322827,97.47015,331206
5141,rojekabc,3,0.00091,322830,97.47106,331206
5142,rolbr,3,0.00091,322833,97.47197,331206
5143,rollergo11,3,0.00091,322836,97.47287,331206
5144,roman2861,3,0.00091,322839,97.47378,331206
5145,romiandhika29blogspot,3,0.00091,322842,97.47468,331206
5146,RPicster,3,0.00091,322845,97.47559,331206
5147,Rsgm,3,0.00091,322848,97.47649,331206
5148,rSixDroid,3,0.00091,322851,97.47740,331206
5149,ruffiely,3,0.00091,322854,97.47831,331206
5150,ryancito02,3,0.00091,322857,97.47921,331206
5151,Ryangr0,3,0.00091,322860,97.48012,331206
5152,Rycerzyk,3,0.00091,322863,97.48102,331206
5153,s9menine,3,0.00091,322866,97.48193,331206
5154,Saad29,3,0.00091,322869,97.48284,331206
5155,saarantras,3,0.00091,322872,97.48374,331206
5156,sadeepdarshana,3,0.00091,322875,97.48465,331206
5157,SamanthaClarke1,3,0.00091,322878,97.48555,331206
5158,samjabrahams,3,0.00091,322881,97.48646,331206
5159,samuelhwilliams,3,0.00091,322884,97.48736,331206
5160,SamuelNewhouse,3,0.00091,322887,97.48827,331206
5161,sarneeh,3,0.00091,322890,97.48918,331206
5162,satyayelgatte,3,0.00091,322893,97.49008,331206
5163,sauer2,3,0.00091,322896,97.49099,331206
5164,Saxito,3,0.00091,322899,97.49189,331206
5165,scambier,3,0.00091,322902,97.49280,331206
5166,Scellow,3,0.00091,322905,97.49370,331206
5167,schmidh,3,0.00091,322908,97.49461,331206
5168,Schmowser,3,0.00091,322911,97.49552,331206
5169,schneiderl,3,0.00091,322914,97.49642,331206
5170,scott-lin,3,0.00091,322917,97.49733,331206
5171,scottmpowell,3,0.00091,322920,97.49823,331206
5172,scroolewse2,3,0.00091,322923,97.49914,331206
5173,sctincman,3,0.00091,322926,97.50005,331206
5174,seeQuayah,3,0.00091,322929,97.50095,331206
5175,sergicollado,3,0.00091,322932,97.50186,331206
5176,sesenta,3,0.00091,322935,97.50276,331206
5177,sethdmoore,3,0.00091,322938,97.50367,331206
5178,SethRzeszutek,3,0.00091,322941,97.50457,331206
5179,SevastyanDark,3,0.00091,322944,97.50548,331206
5180,seven-two-eight,3,0.00091,322947,97.50639,331206
5181,sevkin,3,0.00091,322950,97.50729,331206
5182,sghawkes,3,0.00091,322953,97.50820,331206
5183,ShabbyX,3,0.00091,322956,97.50910,331206
5184,shanbee,3,0.00091,322959,97.51001,331206
5185,Shane-S,3,0.00091,322962,97.51091,331206
5186,ShareLovePeople,3,0.00091,322965,97.51182,331206
5187,sharkist,3,0.00091,322968,97.51273,331206
5188,Shawak,3,0.00091,322971,97.51363,331206
5189,ShonFrazier,3,0.00091,322974,97.51454,331206
5190,ShraddhaDevaiya,3,0.00091,322977,97.51544,331206
5191,Shulito,3,0.00091,322980,97.51635,331206
5192,sidtheone,3,0.00091,322983,97.51726,331206
5193,Sioma112233,3,0.00091,322986,97.51816,331206
5194,SJerin,3,0.00091,322989,97.51907,331206
5195,Skallwar,3,0.00091,322992,97.51997,331206
5196,skhello27,3,0.00091,322995,97.52088,331206
5197,skyttedk,3,0.00091,322998,97.52178,331206
5198,smashbrosonic,3,0.00091,323001,97.52269,331206
5199,SmiggsGDog,3,0.00091,323004,97.52360,331206
5200,SolarGranulation,3,0.00091,323007,97.52450,331206
5201,solarplexus6,3,0.00091,323010,97.52541,331206
5202,Soluss,3,0.00091,323013,97.52631,331206
5203,SomethingFawful,3,0.00091,323016,97.52722,331206
5204,sonoblaise,3,0.00091,323019,97.52812,331206
5205,sooonism,3,0.00091,323022,97.52903,331206
5206,Sosasees,3,0.00091,323025,97.52994,331206
5207,SpaceAceMonkey,3,0.00091,323028,97.53084,331206
5208,spacechase0,3,0.00091,323031,97.53175,331206
5209,spookyboo,3,0.00091,323034,97.53265,331206
5210,sporeservant,3,0.00091,323037,97.53356,331206
5211,squareduck,3,0.00091,323040,97.53446,331206
5212,Srekel,3,0.00091,323043,97.53537,331206
5213,srseil,3,0.00091,323046,97.53628,331206
5214,sschellhoff,3,0.00091,323049,97.53718,331206
5215,SShehriyar,3,0.00091,323052,97.53809,331206
5216,ssokolow,3,0.00091,323055,97.53899,331206
5217,StanleySweet,3,0.00091,323058,97.53990,331206
5218,starsparrow,3,0.00091,323061,97.54081,331206
5219,SteapaSnotor,3,0.00091,323064,97.54171,331206
5220,stephanngamedev,3,0.00091,323067,97.54262,331206
5221,StephenEdnave,3,0.00091,323070,97.54352,331206
5222,stewartnjohnston,3,0.00091,323073,97.54443,331206
5223,StianTheDark,3,0.00091,323076,97.54533,331206
5224,StickyAI,3,0.00091,323079,97.54624,331206
5225,StJohn3D,3,0.00091,323082,97.54715,331206
5226,stoikerty,3,0.00091,323085,97.54805,331206
5227,stranker,3,0.00091,323088,97.54896,331206
5228,strasnybubak,3,0.00091,323091,97.54986,331206
5229,StStep,3,0.00091,323094,97.55077,331206
5230,Stzx,3,0.00091,323097,97.55167,331206
5231,subtyven,3,0.00091,323100,97.55258,331206
5232,SuperGameMaker,3,0.00091,323103,97.55349,331206
5233,superpotatofudge,3,0.00091,323106,97.55439,331206
5234,swashdev,3,0.00091,323109,97.55530,331206
5235,swordhorn,3,0.00091,323112,97.55620,331206
5236,sxkod,3,0.00091,323115,97.55711,331206
5237,synasius,3,0.00091,323118,97.55802,331206
5238,system-accelerator,3,0.00091,323121,97.55892,331206
5239,szenasitibi,3,0.00091,323124,97.55983,331206
5240,Tadaboody,3,0.00091,323127,97.56073,331206
5241,Takuyax,3,0.00091,323130,97.56164,331206
5242,tangdou1,3,0.00091,323133,97.56254,331206
5243,Taulborg01,3,0.00091,323136,97.56345,331206
5244,TBDEV,3,0.00091,323139,97.56436,331206
5245,Tegu,3,0.00091,323142,97.56526,331206
5246,tekeldnb,3,0.00091,323145,97.56617,331206
5247,tekknovator,3,0.00091,323148,97.56707,331206
5248,teliVision,3,0.00091,323151,97.56798,331206
5249,terahxluna,3,0.00091,323154,97.56888,331206
5250,TesserWreck,3,0.00091,323157,97.56979,331206
5251,texaco,3,0.00091,323160,97.57070,331206
5252,ThalesDavidsen,3,0.00091,323163,97.57160,331206
5253,theAbsolute96,3,0.00091,323166,97.57251,331206
5254,thebartyparty,3,0.00091,323169,97.57341,331206
5255,TheCoderNextdoor,3,0.00091,323172,97.57432,331206
5256,TheDarkWeasel,3,0.00091,323175,97.57523,331206
5257,TheGoklayeh,3,0.00091,323178,97.57613,331206
5258,thejacer87,3,0.00091,323181,97.57704,331206
5259,themangomago,3,0.00091,323184,97.57794,331206
5260,ther0n,3,0.00091,323187,97.57885,331206
5261,TheShed412,3,0.00091,323190,97.57975,331206
5262,TheSymbolSystem,3,0.00091,323193,97.58066,331206
5263,TheUltimateAbsol,3,0.00091,323196,97.58157,331206
5264,ThibaultLemaire,3,0.00091,323199,97.58247,331206
5265,thirite2,3,0.00091,323202,97.58338,331206
5266,thomasDelaporte,3,0.00091,323205,97.58428,331206
5267,thotoh,3,0.00091,323208,97.58519,331206
5268,throwaway14,3,0.00091,323211,97.58609,331206
5269,tidanneels,3,0.00091,323214,97.58700,331206
5270,tilpner,3,0.00091,323217,97.58791,331206
5271,TimCarp,3,0.00091,323220,97.58881,331206
5272,timmbrooks,3,0.00091,323223,97.58972,331206
5273,TimPlay,3,0.00091,323226,97.59062,331206
5274,tjpalmer,3,0.00091,323229,97.59153,331206
5275,tjysdsg,3,0.00091,323232,97.59243,331206
5276,tnibert,3,0.00091,323235,97.59334,331206
5277,tobia88,3,0.00091,323238,97.59425,331206
5278,TobiasDev,3,0.00091,323241,97.59515,331206
5279,toddgibson,3,0.00091,323244,97.59606,331206
5280,TomCoursow,3,0.00091,323247,97.59696,331206
5281,tommiemartin,3,0.00091,323250,97.59787,331206
5282,tomsharratt,3,0.00091,323253,97.59878,331206
5283,Topicranger,3,0.00091,323256,97.59968,331206
5284,TotallyNotAVirus,3,0.00091,323259,97.60059,331206
5285,towai,3,0.00091,323262,97.60149,331206
5286,Towerism,3,0.00091,323265,97.60240,331206
5287,ToxicCrack,3,0.00091,323268,97.60330,331206
5288,ToxiCore,3,0.00091,323271,97.60421,331206
5289,tperraut,3,0.00091,323274,97.60512,331206
5290,TPHRyan,3,0.00091,323277,97.60602,331206
5291,TrickyWidget,3,0.00091,323280,97.60693,331206
5292,TristanAppDev,3,0.00091,323283,97.60783,331206
5293,trit,3,0.00091,323286,97.60874,331206
5294,TrueSgtMonkey,3,0.00091,323289,97.60964,331206
5295,tsiegleauq,3,0.00091,323292,97.61055,331206
5296,Tsutsukakushi,3,0.00091,323295,97.61146,331206
5297,ttux,3,0.00091,323298,97.61236,331206
5298,Tuatarian,3,0.00091,323301,97.61327,331206
5299,tuckersn,3,0.00091,323304,97.61417,331206
5300,Turbito,3,0.00091,323307,97.61508,331206
5301,Turupawn,3,0.00091,323310,97.61599,331206
5302,twegg,3,0.00091,323313,97.61689,331206
5303,TwitchtvCarbs,3,0.00091,323316,97.61780,331206
5304,txzeenath,3,0.00091,323319,97.61870,331206
5305,ty-newton,3,0.00091,323322,97.61961,331206
5306,typedefJorge,3,0.00091,323325,97.62051,331206
5307,uapaladin,3,0.00091,323328,97.62142,331206
5308,ultimateprogramer,3,0.00091,323331,97.62233,331206
5309,un0btanium,3,0.00091,323334,97.62323,331206
5310,undeton,3,0.00091,323337,97.62414,331206
5311,Unholypanda,3,0.00091,323340,97.62504,331206
5312,UnmannedOcelot,3,0.00091,323343,97.62595,331206
5313,unrealidiot,3,0.00091,323346,97.62685,331206
5314,usernameisalreadytakennn,3,0.00091,323349,97.62776,331206
5315,uSources,3,0.00091,323352,97.62867,331206
5316,vader-coder,3,0.00091,323355,97.62957,331206
5317,Vaiktorg,3,0.00091,323358,97.63048,331206
5318,Varicus,3,0.00091,323361,97.63138,331206
5319,Velfi,3,0.00091,323364,97.63229,331206
5320,VenHayz,3,0.00091,323367,97.63320,331206
5321,vesko24,3,0.00091,323370,97.63410,331206
5322,Veyrdite,3,0.00091,323373,97.63501,331206
5323,vganin,3,0.00091,323376,97.63591,331206
5324,Vicmas21,3,0.00091,323379,97.63682,331206
5325,VictorLamoine,3,0.00091,323382,97.63772,331206
5326,ville2304,3,0.00091,323385,97.63863,331206
5327,VinnieH01,3,0.00091,323388,97.63954,331206
5328,violinbg,3,0.00091,323391,97.64044,331206
5329,vishwakantmishra,3,0.00091,323394,97.64135,331206
5330,vithuranvishnuthas,3,0.00091,323397,97.64225,331206
5331,vitvakatu,3,0.00091,323400,97.64316,331206
5332,vi-wer,3,0.00091,323403,97.64406,331206
5333,vlad-ed-git,3,0.00091,323406,97.64497,331206
5334,vladimirzb,3,0.00091,323409,97.64588,331206
5335,vlogozzo,3,0.00091,323412,97.64678,331206
5336,volcanoauthors,3,0.00091,323415,97.64769,331206
5337,voOID12,3,0.00091,323418,97.64859,331206
5338,vtaepe,3,0.00091,323421,97.64950,331206
5339,vtoriafisher,3,0.00091,323424,97.65040,331206
5340,vunnysher,3,0.00091,323427,97.65131,331206
5341,Wafflily,3,0.00091,323430,97.65222,331206
5342,walomator,3,0.00091,323433,97.65312,331206
5343,Wanchai,3,0.00091,323436,97.65403,331206
5344,wanobano,3,0.00091,323439,97.65493,331206
5345,weihu120,3,0.00091,323442,97.65584,331206
5346,WhatNot911,3,0.00091,323445,97.65675,331206
5347,Whiskydog,3,0.00091,323448,97.65765,331206
5348,Whyimsobroke,3,0.00091,323451,97.65856,331206
5349,Willralph,3,0.00091,323454,97.65946,331206
5350,wilsoncoding,3,0.00091,323457,97.66037,331206
5351,wilsonevangelista,3,0.00091,323460,97.66127,331206
5352,WimbledonLabs,3,0.00091,323463,97.66218,331206
5353,winstonliu,3,0.00091,323466,97.66309,331206
5354,wivlaro,3,0.00091,323469,97.66399,331206
5355,wizardlu,3,0.00091,323472,97.66490,331206
5356,WizardOhio24,3,0.00091,323475,97.66580,331206
5357,wojtasss,3,0.00091,323478,97.66671,331206
5358,Worly,3,0.00091,323481,97.66761,331206
5359,WRENCHLIN,3,0.00091,323484,97.66852,331206
5360,WuTangPanda,3,0.00091,323487,97.66943,331206
5361,wytzen,3,0.00091,323490,97.67033,331206
5362,Wyxaldir,3,0.00091,323493,97.67124,331206
5363,xa8et67,3,0.00091,323496,97.67214,331206
5364,xakz,3,0.00091,323499,97.67305,331206
5365,xarrynator,3,0.00091,323502,97.67396,331206
5366,xaviermonin,3,0.00091,323505,97.67486,331206
5367,xBeepx,3,0.00091,323508,97.67577,331206
5368,xcrdev,3,0.00091,323511,97.67667,331206
5369,xdee,3,0.00091,323514,97.67758,331206
5370,Xekkel,3,0.00091,323517,97.67848,331206
5371,xenthe,3,0.00091,323520,97.67939,331206
5372,xhk1992,3,0.00091,323523,97.68030,331206
5373,xiaolei123,3,0.00091,323526,97.68120,331206
5374,xibz,3,0.00091,323529,97.68211,331206
5375,xPucTu4,3,0.00091,323532,97.68301,331206
5376,xR3alx,3,0.00091,323535,97.68392,331206
5377,xtcPanda,3,0.00091,323538,97.68482,331206
5378,Xyrio,3,0.00091,323541,97.68573,331206
5379,Yashwanth-CN,3,0.00091,323544,97.68664,331206
5380,Ydjeen,3,0.00091,323547,97.68754,331206
5381,YLL,3,0.00091,323550,97.68845,331206
5382,yodamerlin,3,0.00091,323553,97.68935,331206
5383,yogasadana,3,0.00091,323556,97.69026,331206
5384,Yomic,3,0.00091,323559,97.69117,331206
5385,Yoshi72,3,0.00091,323562,97.69207,331206
5386,yoskeleton,3,0.00091,323565,97.69298,331206
5387,yskang,3,0.00091,323568,97.69388,331206
5388,yusdacra,3,0.00091,323571,97.69479,331206
5389,zackurben,3,0.00091,323574,97.69569,331206
5390,zaibacu,3,0.00091,323577,97.69660,331206
5391,Zakkumaru,3,0.00091,323580,97.69751,331206
5392,Zaltora,3,0.00091,323583,97.69841,331206
5393,zauberparacelsus,3,0.00091,323586,97.69932,331206
5394,zaywolfe,3,0.00091,323589,97.70022,331206
5395,ZDDM,3,0.00091,323592,97.70113,331206
5396,ZeerDonker,3,0.00091,323595,97.70203,331206
5397,zenvoid,3,0.00091,323598,97.70294,331206
5398,zeplaz,3,0.00091,323601,97.70385,331206
5399,zettyfactory,3,0.00091,323604,97.70475,331206
5400,zhouchengming99,3,0.00091,323607,97.70566,331206
5401,Zimakili,3,0.00091,323610,97.70656,331206
5402,zomman,3,0.00091,323613,97.70747,331206
5403,Zonacas,3,0.00091,323616,97.70837,331206
5404,zorgsoft,3,0.00091,323619,97.70928,331206
5405,ZPhantomlord123,3,0.00091,323622,97.71019,331206
5406,zryan3,3,0.00091,323625,97.71109,331206
5407,zzz125,3,0.00091,323628,97.71200,331206
5408,01271,2,0.00060,323630,97.71260,331206
5409,11thPenguin,2,0.00060,323632,97.71321,331206
5410,201604830,2,0.00060,323634,97.71381,331206
5411,221V,2,0.00060,323636,97.71441,331206
5412,37576677a,2,0.00060,323638,97.71502,331206
5413,3lis4,2,0.00060,323640,97.71562,331206
5414,3mic4nia,2,0.00060,323642,97.71622,331206
5415,40detectives,2,0.00060,323644,97.71683,331206
5416,4ian,2,0.00060,323646,97.71743,331206
5417,54696d654a6f6c74,2,0.00060,323648,97.71804,331206
5418,8bitkitkat,2,0.00060,323650,97.71864,331206
5419,8nouk,2,0.00060,323652,97.71924,331206
5420,96AA48,2,0.00060,323654,97.71985,331206
5421,Aandree5,2,0.00060,323656,97.72045,331206
5422,aareynolds,2,0.00060,323658,97.72106,331206
5423,aaron64,2,0.00060,323660,97.72166,331206
5424,aaronelias1,2,0.00060,323662,97.72226,331206
5425,aaronjohnson92,2,0.00060,323664,97.72287,331206
5426,aarqon,2,0.00060,323666,97.72347,331206
5427,aash29,2,0.00060,323668,97.72408,331206
5428,abeisgoat,2,0.00060,323670,97.72468,331206
5429,abhinavsagar,2,0.00060,323672,97.72528,331206
5430,abmyii,2,0.00060,323674,97.72589,331206
5431,abogilovic,2,0.00060,323676,97.72649,331206
5432,abstractr,2,0.00060,323678,97.72709,331206
5433,acalc,2,0.00060,323680,97.72770,331206
5434,acarlson1994,2,0.00060,323682,97.72830,331206
5435,ACB-prgm,2,0.00060,323684,97.72891,331206
5436,AceBreadman,2,0.00060,323686,97.72951,331206
5437,acsr,2,0.00060,323688,97.73011,331206
5438,AC-Webbyninja,2,0.00060,323690,97.73072,331206
5439,AdamantGaming,2,0.00060,323692,97.73132,331206
5440,adamz5k,2,0.00060,323694,97.73193,331206
5441,addieous,2,0.00060,323696,97.73253,331206
5442,addixff,2,0.00060,323698,97.73313,331206
5443,adikhel,2,0.00060,323700,97.73374,331206
5444,adityahas,2,0.00060,323702,97.73434,331206
5445,Adrenesis,2,0.00060,323704,97.73494,331206
5446,AdrianSima,2,0.00060,323706,97.73555,331206
5447,Aeogen,2,0.00060,323708,97.73615,331206
5448,afauchille,2,0.00060,323710,97.73676,331206
5449,afeener2016,2,0.00060,323712,97.73736,331206
5450,afiestas,2,0.00060,323714,97.73796,331206
5451,afonsolage,2,0.00060,323716,97.73857,331206
5452,AfterCadaver,2,0.00060,323718,97.73917,331206
5453,afxgroup,2,0.00060,323720,97.73978,331206
5454,ageofabenius,2,0.00060,323722,97.74038,331206
5455,agusbena,2,0.00060,323724,97.74098,331206
5456,ahalfmontynun,2,0.00060,323726,97.74159,331206
5457,Aireek,2,0.00060,323728,97.74219,331206
5458,ajahar,2,0.00060,323730,97.74279,331206
5459,Ajver,2,0.00060,323732,97.74340,331206
5460,akhlaqhossain,2,0.00060,323734,97.74400,331206
5461,Albatros53113,2,0.00060,323736,97.74461,331206
5462,albertas,2,0.00060,323738,97.74521,331206
5463,AldieNightStar,2,0.00060,323740,97.74581,331206
5464,alejandrocoria,2,0.00060,323742,97.74642,331206
5465,AlekhineDev,2,0.00060,323744,97.74702,331206
5466,AleksandrHovhannisyan,2,0.00060,323746,97.74763,331206
5467,AlekseyLoykuts,2,0.00060,323748,97.74823,331206
5468,alekseyt,2,0.00060,323750,97.74883,331206
5469,alessandrofama,2,0.00060,323752,97.74944,331206
5470,alexandersmak,2,0.00060,323754,97.75004,331206
5471,AlexBSoft,2,0.00060,323756,97.75064,331206
5472,alexeykorshak,2,0.00060,323758,97.75125,331206
5473,alexgomes09,2,0.00060,323760,97.75185,331206
5474,alexjamesritchie,2,0.00060,323762,97.75246,331206
5475,AlexSabourinDev,2,0.00060,323764,97.75306,331206
5476,alforiumstudios,2,0.00060,323766,97.75366,331206
5477,alikifah,2,0.00060,323768,97.75427,331206
5478,allumbra,2,0.00060,323770,97.75487,331206
5479,allysonsouza,2,0.00060,323772,97.75548,331206
5480,alperc84,2,0.00060,323774,97.75608,331206
5481,altertango,2,0.00060,323776,97.75668,331206
5482,AlvaroAV,2,0.00060,323778,97.75729,331206
5483,alxxlc,2,0.00060,323780,97.75789,331206
5484,Alyks,2,0.00060,323782,97.75849,331206
5485,amedley,2,0.00060,323784,97.75910,331206
5486,AmericanTrailMix,2,0.00060,323786,97.75970,331206
5487,ameyp,2,0.00060,323788,97.76031,331206
5488,Amr512,2,0.00060,323790,97.76091,331206
5489,an0mali,2,0.00060,323792,97.76151,331206
5490,AnantAhuja,2,0.00060,323794,97.76212,331206
5491,andit001,2,0.00060,323796,97.76272,331206
5492,AndresBBB,2,0.00060,323798,97.76333,331206
5493,andresilvasantos,2,0.00060,323800,97.76393,331206
5494,andrew-field,2,0.00060,323802,97.76453,331206
5495,AndrewJakubowicz,2,0.00060,323804,97.76514,331206
5496,andrew-klassen,2,0.00060,323806,97.76574,331206
5497,andrew-njoroge,2,0.00060,323808,97.76634,331206
5498,AndrewPomorski,2,0.00060,323810,97.76695,331206
5499,AndreyKarpov,2,0.00060,323812,97.76755,331206
5500,androclus,2,0.00060,323814,97.76816,331206
5501,andyroiiid,2,0.00060,323816,97.76876,331206
5502,anemol,2,0.00060,323818,97.76936,331206
5503,anhhh11,2,0.00060,323820,97.76997,331206
5504,animanoir,2,0.00060,323822,97.77057,331206
5505,ankeris,2,0.00060,323824,97.77118,331206
5506,AnnA-Ayms,2,0.00060,323826,97.77178,331206
5507,ano1a,2,0.00060,323828,97.77238,331206
5508,Anthys,2,0.00060,323830,97.77299,331206
5509,AntonWedemeier,2,0.00060,323832,97.77359,331206
5510,AntonWetzel,2,0.00060,323834,97.77419,331206
5511,APakrohk,2,0.00060,323836,97.77480,331206
5512,arahulc91,2,0.00060,323838,97.77540,331206
5513,aras-p,2,0.00060,323840,97.77601,331206
5514,arcangeli,2,0.00060,323842,97.77661,331206
5515,archetypitect,2,0.00060,323844,97.77721,331206
5516,arezaee,2,0.00060,323846,97.77782,331206
5517,ArgentArts,2,0.00060,323848,97.77842,331206
5518,ArkDShiggy,2,0.00060,323850,97.77903,331206
5519,Arknark,2,0.00060,323852,97.77963,331206
5520,ArmonOyster,2,0.00060,323854,97.78023,331206
5521,aroldanju,2,0.00060,323856,97.78084,331206
5522,arrkiin,2,0.00060,323858,97.78144,331206
5523,arthurpaulino,2,0.00060,323860,97.78205,331206
5524,ArtursKadikis,2,0.00060,323862,97.78265,331206
5525,Arun-N,2,0.00060,323864,97.78325,331206
5526,Asad144,2,0.00060,323866,97.78386,331206
5527,aschuhardt,2,0.00060,323868,97.78446,331206
5528,asciifaceman,2,0.00060,323870,97.78506,331206
5529,Asedi,2,0.00060,323872,97.78567,331206
5530,Asoth,2,0.00060,323874,97.78627,331206
5531,AssimiIation,2,0.00060,323876,97.78688,331206
5532,Astral-Cyrusa,2,0.00060,323878,97.78748,331206
5533,astrilchuk,2,0.00060,323880,97.78808,331206
5534,Atalanttore,2,0.00060,323882,97.78869,331206
5535,atbigelow,2,0.00060,323884,97.78929,331206
5536,athalean,2,0.00060,323886,97.78990,331206
5537,atomius0,2,0.00060,323888,97.79050,331206
5538,ATOshailesh,2,0.00060,323890,97.79110,331206
5539,Avarobin,2,0.00060,323892,97.79171,331206
5540,avsoftlabs,2,0.00060,323894,97.79231,331206
5541,AxDSan,2,0.00060,323896,97.79291,331206
5542,b3nnee,2,0.00060,323898,97.79352,331206
5543,badunius,2,0.00060,323900,97.79412,331206
5544,BalGu,2,0.00060,323902,97.79473,331206
5545,bartalluyn,2,0.00060,323904,97.79533,331206
5546,basteez,2,0.00060,323906,97.79593,331206
5547,bastisawesome,2,0.00060,323908,97.79654,331206
5548,BattyBovine,2,0.00060,323910,97.79714,331206
5549,baymefe,2,0.00060,323912,97.79775,331206
5550,bbcbreno,2,0.00060,323914,97.79835,331206
5551,bbcooper29,2,0.00060,323916,97.79895,331206
5552,bdunks,2,0.00060,323918,97.79956,331206
5553,Beliriel,2,0.00060,323920,97.80016,331206
5554,BeLuckyDaf,2,0.00060,323922,97.80076,331206
5555,Ben1138,2,0.00060,323924,97.80137,331206
5556,bene95,2,0.00060,323926,97.80197,331206
5557,benjamintomad,2,0.00060,323928,97.80258,331206
5558,BenoitKH2,2,0.00060,323930,97.80318,331206
5559,berosoboy,2,0.00060,323932,97.80378,331206
5560,bestdani,2,0.00060,323934,97.80439,331206
5561,bgreen,2,0.00060,323936,97.80499,331206
5562,bhavin2707,2,0.00060,323938,97.80560,331206
5563,bhgsbatista,2,0.00060,323940,97.80620,331206
5564,Bhgt,2,0.00060,323942,97.80680,331206
5565,biglari,2,0.00060,323944,97.80741,331206
5566,billop,2,0.00060,323946,97.80801,331206
5567,Bionicobot,2,0.00060,323948,97.80861,331206
5568,birdinforest,2,0.00060,323950,97.80922,331206
5569,Birdulon,2,0.00060,323952,97.80982,331206
5570,bitmammoth,2,0.00060,323954,97.81043,331206
5571,bkaradzic,2,0.00060,323956,97.81103,331206
5572,BlackAp3rture,2,0.00060,323958,97.81163,331206
5573,BlackPhoenix134,2,0.00060,323960,97.81224,331206
5574,BlackSabot,2,0.00060,323962,97.81284,331206
5575,bladesero,2,0.00060,323964,97.81345,331206
5576,blankonn,2,0.00060,323966,97.81405,331206
5577,BloodOrange,2,0.00060,323968,97.81465,331206
5578,BluePhoenixGame,2,0.00060,323970,97.81526,331206
5579,BluePrintRandom,2,0.00060,323972,97.81586,331206
5580,blukatstudios,2,0.00060,323974,97.81646,331206
5581,boagz57,2,0.00060,323976,97.81707,331206
5582,Bob-the-Martian,2,0.00060,323978,97.81767,331206
5583,bodamat,2,0.00060,323980,97.81828,331206
5584,bogdanaslt,2,0.00060,323982,97.81888,331206
5585,Boiethios,2,0.00060,323984,97.81948,331206
5586,bojjenclon,2,0.00060,323986,97.82009,331206
5587,borlox,2,0.00060,323988,97.82069,331206
5588,bosinpai,2,0.00060,323990,97.82130,331206
5589,bpopp93,2,0.00060,323992,97.82190,331206
5590,Braboware,2,0.00060,323994,97.82250,331206
5591,brainard52,2,0.00060,323996,97.82311,331206
5592,brainmulator,2,0.00060,323998,97.82371,331206
5593,BrandonClapp,2,0.00060,324000,97.82431,331206
5594,BrentAFlynn,2,0.00060,324002,97.82492,331206
5595,Brettink,2,0.00060,324004,97.82552,331206
5596,Brokolireis,2,0.00060,324006,97.82613,331206
5597,Bromeon,2,0.00060,324008,97.82673,331206
5598,brunodantas,2,0.00060,324010,97.82733,331206
5599,BrunoLucas,2,0.00060,324012,97.82794,331206
5600,brunoramoslu,2,0.00060,324014,97.82854,331206
5601,Brusi,2,0.00060,324016,97.82915,331206
5602,BrutPitt,2,0.00060,324018,97.82975,331206
5603,bryantfhayes,2,0.00060,324020,97.83035,331206
5604,bsil78,2,0.00060,324022,97.83096,331206
5605,bsmaran,2,0.00060,324024,97.83156,331206
5606,btn0s,2,0.00060,324026,97.83216,331206
5607,Bucklandevelopment,2,0.00060,324028,97.83277,331206
5608,BurningWood,2,0.00060,324030,97.83337,331206
5609,Bytenex,2,0.00060,324032,97.83398,331206
5610,C0NPAQ,2,0.00060,324034,97.83458,331206
5611,CairoJack02,2,0.00060,324036,97.83518,331206
5612,calebjcox,2,0.00060,324038,97.83579,331206
5613,Calebm90,2,0.00060,324040,97.83639,331206
5614,Calzzetta,2,0.00060,324042,97.83700,331206
5615,cameron195,2,0.00060,324044,97.83760,331206
5616,cameronsteele,2,0.00060,324046,97.83820,331206
5617,canadaduane,2,0.00060,324048,97.83881,331206
5618,CapsLockkk,2,0.00060,324050,97.83941,331206
5619,carlinitos,2,0.00060,324052,97.84001,331206
5620,carlixyz,2,0.00060,324054,97.84062,331206
5621,CartridgeSoft,2,0.00060,324056,97.84122,331206
5622,cassioraposa,2,0.00060,324058,97.84183,331206
5623,CastilloDel,2,0.00060,324060,97.84243,331206
5624,CatSauce66,2,0.00060,324062,97.84303,331206
5625,Cavas85,2,0.00060,324064,97.84364,331206
5626,CaveJohnson376,2,0.00060,324066,97.84424,331206
5627,cccccroge,2,0.00060,324068,97.84485,331206
5628,c-cesar,2,0.00060,324070,97.84545,331206
5629,cchipont,2,0.00060,324072,97.84605,331206
5630,CelestialCreator,2,0.00060,324074,97.84666,331206
5631,celioreyes,2,0.00060,324076,97.84726,331206
5632,cfibre,2,0.00060,324078,97.84787,331206
5633,cg1743gmail,2,0.00060,324080,97.84847,331206
5634,Chainsawkitten,2,0.00060,324082,97.84907,331206
5635,Chais,2,0.00060,324084,97.84968,331206
5636,CharlesAnjos,2,0.00060,324086,97.85028,331206
5637,cheesegreater,2,0.00060,324088,97.85088,331206
5638,chrissanford,2,0.00060,324090,97.85149,331206
5639,chrisskeddy,2,0.00060,324092,97.85209,331206
5640,christianbender,2,0.00060,324094,97.85270,331206
5641,christianclavet,2,0.00060,324096,97.85330,331206
5642,christiandreher,2,0.00060,324098,97.85390,331206
5643,Christian-Pickett,2,0.00060,324100,97.85451,331206
5644,Chrisyss,2,0.00060,324102,97.85511,331206
5645,chungnx,2,0.00060,324104,97.85572,331206
5646,cj-dimaggio,2,0.00060,324106,97.85632,331206
5647,cjxgm,2,0.00060,324108,97.85692,331206
5648,ckeschnat,2,0.00060,324110,97.85753,331206
5649,clangdo,2,0.00060,324112,97.85813,331206
5650,claushellsing,2,0.00060,324114,97.85873,331206
5651,clay53,2,0.00060,324116,97.85934,331206
5652,claytongulick,2,0.00060,324118,97.85994,331206
5653,ClubEdNZ,2,0.00060,324120,97.86055,331206
5654,cmbarnett87,2,0.00060,324122,97.86115,331206
5655,codeFlu,2,0.00060,324124,97.86175,331206
5656,coderguy1777,2,0.00060,324126,97.86236,331206
5657,CodingInfraviolet,2,0.00060,324128,97.86296,331206
5658,ColinJTod,2,0.00060,324130,97.86357,331206
5659,colorcube,2,0.00060,324132,97.86417,331206
5660,combatwombat,2,0.00060,324134,97.86477,331206
5661,ComLarsic,2,0.00060,324136,97.86538,331206
5662,CompassDevs,2,0.00060,324138,97.86598,331206
5663,Connall,2,0.00060,324140,97.86658,331206
5664,ConnorDY,2,0.00060,324142,97.86719,331206
5665,Conrim,2,0.00060,324144,97.86779,331206
5666,Constannnnnt,2,0.00060,324146,97.86840,331206
5667,cook1ee,2,0.00060,324148,97.86900,331206
5668,CoreChg,2,0.00060,324150,97.86960,331206
5669,Corentin-pro,2,0.00060,324152,97.87021,331206
5670,corjohnson,2,0.00060,324154,97.87081,331206
5671,CornyjK,2,0.00060,324156,97.87142,331206
5672,cosarara97,2,0.00060,324158,97.87202,331206
5673,cosmos841,2,0.00060,324160,97.87262,331206
5674,CowboyTim,2,0.00060,324162,97.87323,331206
5675,Cpl-snafu,2,0.00060,324164,97.87383,331206
5676,cpodgell,2,0.00060,324166,97.87443,331206
5677,CptnRoughnight,2,0.00060,324168,97.87504,331206
5678,CraftyManiac,2,0.00060,324170,97.87564,331206
5679,CrazyLegoMind,2,0.00060,324172,97.87625,331206
5680,creeperdeking,2,0.00060,324174,97.87685,331206
5681,Creuilcreuil,2,0.00060,324176,97.87745,331206
5682,CrimsonPiZza,2,0.00060,324178,97.87806,331206
5683,CrimsonZA,2,0.00060,324180,97.87866,331206
5684,crisestudio,2,0.00060,324182,97.87927,331206
5685,critcap,2,0.00060,324184,97.87987,331206
5686,crouthamela,2,0.00060,324186,97.88047,331206
5687,Cruel,2,0.00060,324188,97.88108,331206
5688,cryptoquick,2,0.00060,324190,97.88168,331206
5689,Cschlaefli,2,0.00060,324192,97.88228,331206
5690,Cscotttaakan,2,0.00060,324194,97.88289,331206
5691,CT-noise,2,0.00060,324196,97.88349,331206
5692,cube-builder,2,0.00060,324198,97.88410,331206
5693,cumminsd,2,0.00060,324200,97.88470,331206
5694,curieos,2,0.00060,324202,97.88530,331206
5695,CurlyBraceTT,2,0.00060,324204,97.88591,331206
5696,cwbooth5,2,0.00060,324206,97.88651,331206
5697,cweagans,2,0.00060,324208,97.88712,331206
5698,CyanCoding,2,0.00060,324210,97.88772,331206
5699,czarnota,2,0.00060,324212,97.88832,331206
5700,CZHeron,2,0.00060,324214,97.88893,331206
5701,D1AS,2,0.00060,324216,97.88953,331206
5702,daboz5,2,0.00060,324218,97.89013,331206
5703,dabrain34,2,0.00060,324220,97.89074,331206
5704,DadangoGodotNoob,2,0.00060,324222,97.89134,331206
5705,DaddySmash,2,0.00060,324224,97.89195,331206
5706,daerogami,2,0.00060,324226,97.89255,331206
5707,dagit,2,0.00060,324228,97.89315,331206
5708,Dakkers,2,0.00060,324230,97.89376,331206
5709,dan-bolsun,2,0.00060,324232,97.89436,331206
5710,dancullen,2,0.00060,324234,97.89497,331206
5711,DangerChaser,2,0.00060,324236,97.89557,331206
5712,dangermousenz,2,0.00060,324238,97.89617,331206
5713,danicrem,2,0.00060,324240,97.89678,331206
5714,DanielDo98,2,0.00060,324242,97.89738,331206
5715,daniel-e-houghton,2,0.00060,324244,97.89798,331206
5716,DanielFlaum,2,0.00060,324246,97.89859,331206
5717,DanielLausch,2,0.00060,324248,97.89919,331206
5718,danielwray,2,0.00060,324250,97.89980,331206
5719,dantaylor,2,0.00060,324252,97.90040,331206
5720,dardanbujupaj,2,0.00060,324254,97.90100,331206
5721,DarkChowder,2,0.00060,324256,97.90161,331206
5722,darkf,2,0.00060,324258,97.90221,331206
5723,darkoff9,2,0.00060,324260,97.90282,331206
5724,darksylinc,2,0.00060,324262,97.90342,331206
5725,darrinm,2,0.00060,324264,97.90402,331206
5726,daskrs,2,0.00060,324266,97.90463,331206
5727,datatoolbox,2,0.00060,324268,97.90523,331206
5728,Dathide,2,0.00060,324270,97.90584,331206
5729,Datoh,2,0.00060,324272,97.90644,331206
5730,davi2205,2,0.00060,324274,97.90704,331206
5731,davidanes,2,0.00060,324276,97.90765,331206
5732,david-aranda,2,0.00060,324278,97.90825,331206
5733,DaviDevLop,2,0.00060,324280,97.90885,331206
5734,DavidjMarkham,2,0.00060,324282,97.90946,331206
5735,davidpol,2,0.00060,324284,97.91006,331206
5736,davidwesst,2,0.00060,324286,97.91067,331206
5737,Davoleo,2,0.00060,324288,97.91127,331206
5738,dawadam,2,0.00060,324290,97.91187,331206
5739,dawikur,2,0.00060,324292,97.91248,331206
5740,daxum,2,0.00060,324294,97.91308,331206
5741,Dbeckett23,2,0.00060,324296,97.91369,331206
5742,DDoop,2,0.00060,324298,97.91429,331206
5743,DDSuarez,2,0.00060,324300,97.91489,331206
5744,DeafMan1983,2,0.00060,324302,97.91550,331206
5745,deasek,2,0.00060,324304,97.91610,331206
5746,death180,2,0.00060,324306,97.91670,331206
5747,decepticlown,2,0.00060,324308,97.91731,331206
5748,deermen001,2,0.00060,324310,97.91791,331206
5749,Deftwun,2,0.00060,324312,97.91852,331206
5750,DeFYzz,2,0.00060,324314,97.91912,331206
5751,dejayc,2,0.00060,324316,97.91972,331206
5752,Dekker3D,2,0.00060,324318,97.92033,331206
5753,Deliner,2,0.00060,324320,97.92093,331206
5754,Dennis1000,2,0.00060,324322,97.92154,331206
5755,dennisseong,2,0.00060,324324,97.92214,331206
5756,dennmat,2,0.00060,324326,97.92274,331206
5757,Denza755,2,0.00060,324328,97.92335,331206
5758,derickvn,2,0.00060,324330,97.92395,331206
5759,derKosi,2,0.00060,324332,97.92455,331206
5760,dermoumi,2,0.00060,324334,97.92516,331206
5761,dethmuffin,2,0.00060,324336,97.92576,331206
5762,deusalgor,2,0.00060,324338,97.92637,331206
5763,devshgraphicsprogramming,2,0.00060,324340,97.92697,331206
5764,d-fect,2,0.00060,324342,97.92757,331206
5765,dfelinto,2,0.00060,324344,97.92818,331206
5766,diegodillenburg,2,0.00060,324346,97.92878,331206
5767,diegohiroshi,2,0.00060,324348,97.92939,331206
5768,DiegoRibeiro,2,0.00060,324350,97.92999,331206
5769,DigitalJokerMan,2,0.00060,324352,97.93059,331206
5770,DigNZ,2,0.00060,324354,97.93120,331206
5771,dijs,2,0.00060,324356,97.93180,331206
5772,dillikumar,2,0.00060,324358,97.93240,331206
5773,dimi3tron,2,0.00060,324360,97.93301,331206
5774,dino-,2,0.00060,324362,97.93361,331206
5775,diocore,2,0.00060,324364,97.93422,331206
5776,diogocarneiro,2,0.00060,324366,97.93482,331206
5777,distractedmosfet,2,0.00060,324368,97.93542,331206
5778,divyank0,2,0.00060,324370,97.93603,331206
5779,djiamnot,2,0.00060,324372,97.93663,331206
5780,dluke,2,0.00060,324374,97.93724,331206
5781,dneild,2,0.00060,324376,97.93784,331206
5782,dnleek,2,0.00060,324378,97.93844,331206
5783,doctorcrimson,2,0.00060,324380,97.93905,331206
5784,docyx,2,0.00060,324382,97.93965,331206
5785,Dodgetgo,2,0.00060,324384,97.94025,331206
5786,DOGEIGHT,2,0.00060,324386,97.94086,331206
5787,dognew,2,0.00060,324388,97.94146,331206
5788,do-kevin,2,0.00060,324390,97.94207,331206
5789,Dok-Sergey,2,0.00060,324392,97.94267,331206
5790,donohutcheon,2,0.00060,324394,97.94327,331206
5791,doquen,2,0.00060,324396,97.94388,331206
5792,dorgs,2,0.00060,324398,97.94448,331206
5793,Dorifor,2,0.00060,324400,97.94509,331206
5794,dosuserx,2,0.00060,324402,97.94569,331206
5795,douglasvini,2,0.00060,324404,97.94629,331206
5796,DoumanAsh,2,0.00060,324406,97.94690,331206
5797,dpalacio,2,0.00060,324408,97.94750,331206
5798,DragonDev1906,2,0.00060,324410,97.94810,331206
5799,dramdrum,2,0.00060,324412,97.94871,331206
5800,Drawsi,2,0.00060,324414,97.94931,331206
5801,dreamingWitch,2,0.00060,324416,97.94992,331206
5802,drewpotter,2,0.00060,324418,97.95052,331206
5803,drfloob,2,0.00060,324420,97.95112,331206
5804,Drkie,2,0.00060,324422,97.95173,331206
5805,DRKSLV,2,0.00060,324424,97.95233,331206
5806,DroidPlayer12,2,0.00060,324426,97.95294,331206
5807,DroppingBass3,2,0.00060,324428,97.95354,331206
5808,DropsOfSerenity,2,0.00060,324430,97.95414,331206
5809,drougge,2,0.00060,324432,97.95475,331206
5810,DrRevert,2,0.00060,324434,97.95535,331206
5811,dtori,2,0.00060,324436,97.95595,331206
5812,D-TurboKiller,2,0.00060,324438,97.95656,331206
5813,ductuan9603,2,0.00060,324440,97.95716,331206
5814,dudo-k,2,0.00060,324442,97.95777,331206
5815,dupuqub,2,0.00060,324444,97.95837,331206
5816,dusklight0,2,0.00060,324446,97.95897,331206
5817,DustinStuff,2,0.00060,324448,97.95958,331206
5818,dyzhu12,2,0.00060,324450,97.96018,331206
5819,dzil123,2,0.00060,324452,97.96079,331206
5820,e1e5en-gd,2,0.00060,324454,97.96139,331206
5821,earthcrafterman,2,0.00060,324456,97.96199,331206
5822,eastolfi,2,0.00060,324458,97.96260,331206
5823,eberan,2,0.00060,324460,97.96320,331206
5824,ebert83,2,0.00060,324462,97.96381,331206
5825,Echopraxium,2,0.00060,324464,97.96441,331206
5826,ecoludology,2,0.00060,324466,97.96501,331206
5827,edazpotato,2,0.00060,324468,97.96562,331206
5828,Ed-Lang,2,0.00060,324470,97.96622,331206
5829,edvwpo,2,0.00060,324472,97.96682,331206
5830,eggnot,2,0.00060,324474,97.96743,331206
5831,einnjo,2,0.00060,324476,97.96803,331206
5832,ekaris,2,0.00060,324478,97.96864,331206
5833,ekasit555,2,0.00060,324480,97.96924,331206
5834,eklmv,2,0.00060,324482,97.96984,331206
5835,eko234,2,0.00060,324484,97.97045,331206
5836,eldidou,2,0.00060,324486,97.97105,331206
5837,EliasWatson,2,0.00060,324488,97.97166,331206
5838,ellis-matthew4,2,0.00060,324490,97.97226,331206
5839,ElysRealm,2,0.00060,324492,97.97286,331206
5840,emalamela,2,0.00060,324494,97.97347,331206
5841,Emaleth-BSE,2,0.00060,324496,97.97407,331206
5842,EmAlexander,2,0.00060,324498,97.97467,331206
5843,embeddr,2,0.00060,324500,97.97528,331206
5844,emik,2,0.00060,324502,97.97588,331206
5845,emilhem,2,0.00060,324504,97.97649,331206
5846,emirhanaydin,2,0.00060,324506,97.97709,331206
5847,emmetoneillpdx,2,0.00060,324508,97.97769,331206
5848,EmptySet30,2,0.00060,324510,97.97830,331206
5849,enigma101,2,0.00060,324512,97.97890,331206
5850,Enverbalalic,2,0.00060,324514,97.97951,331206
5851,enxas,2,0.00060,324516,97.98011,331206
5852,erdavids,2,0.00060,324518,97.98071,331206
5853,ericholscher,2,0.00060,324520,97.98132,331206
5854,erikarn,2,0.00060,324522,97.98192,331206
5855,erri120,2,0.00060,324524,97.98252,331206
5856,Esikaho,2,0.00060,324526,97.98313,331206
5857,espofficial,2,0.00060,324528,97.98373,331206
5858,estellerostan,2,0.00060,324530,97.98434,331206
5859,EurekaAlgorithm,2,0.00060,324532,97.98494,331206
5860,ExDanmaku,2,0.00060,324534,97.98554,331206
5861,Exoow,2,0.00060,324536,97.98615,331206
5862,expat1999,2,0.00060,324538,97.98675,331206
5863,extrasyrup,2,0.00060,324540,97.98736,331206
5864,f8122dac,2,0.00060,324542,97.98796,331206
5865,fabemish,2,0.00060,324544,97.98856,331206
5866,FabienSailliet,2,0.00060,324546,97.98917,331206
5867,Fable-git,2,0.00060,324548,97.98977,331206
5868,fafner,2,0.00060,324550,97.99037,331206
5869,FailRapids,2,0.00060,324552,97.99098,331206
5870,fanus,2,0.00060,324554,97.99158,331206
5871,farisbdev,2,0.00060,324556,97.99219,331206
5872,Fasox,2,0.00060,324558,97.99279,331206
5873,fedeb95,2,0.00060,324560,97.99339,331206
5874,fede-Raider,2,0.00060,324562,97.99400,331206
5875,ferreiradaselva,2,0.00060,324564,97.99460,331206
5876,ffreling,2,0.00060,324566,97.99521,331206
5877,fibr0bl4st,2,0.00060,324568,97.99581,331206
5878,fightbear,2,0.00060,324570,97.99641,331206
5879,figloalds,2,0.00060,324572,97.99702,331206
5880,fikma,2,0.00060,324574,97.99762,331206
5881,Firepal,2,0.00060,324576,97.99822,331206
5882,fisbe,2,0.00060,324578,97.99883,331206
5883,Fishrock123,2,0.00060,324580,97.99943,331206
5884,FIXTHISPLEASE,2,0.00060,324582,98.00004,331206
5885,flashjaysan,2,0.00060,324584,98.00064,331206
5886,Flashnos,2,0.00060,324586,98.00124,331206
5887,FlatBartender,2,0.00060,324588,98.00185,331206
5888,flexflak,2,0.00060,324590,98.00245,331206
5889,fLUFFYbLUFF,2,0.00060,324592,98.00306,331206
5890,fluidvolt,2,0.00060,324594,98.00366,331206
5891,fluxrider,2,0.00060,324596,98.00426,331206
5892,fooff,2,0.00060,324598,98.00487,331206
5893,forgotten-king,2,0.00060,324600,98.00547,331206
5894,forsakenlight,2,0.00060,324602,98.00607,331206
5895,Fotheringay,2,0.00060,324604,98.00668,331206
5896,francisjsun,2,0.00060,324606,98.00728,331206
5897,Francois-Grassard,2,0.00060,324608,98.00789,331206
5898,FrancyP,2,0.00060,324610,98.00849,331206
5899,f-rank,2,0.00060,324612,98.00909,331206
5900,freerangerstudios,2,0.00060,324614,98.00970,331206
5901,FROSADO,2,0.00060,324616,98.01030,331206
5902,frsrz,2,0.00060,324618,98.01091,331206
5903,fugenkleber,2,0.00060,324620,98.01151,331206
5904,fumgames,2,0.00060,324622,98.01211,331206
5905,Furfoxsnakes,2,0.00060,324624,98.01272,331206
5906,furkanoeztuerk,2,0.00060,324626,98.01332,331206
5907,fzdravko,2,0.00060,324628,98.01392,331206
5908,gabriel-del-nardo,2,0.00060,324630,98.01453,331206
5909,Gaffen,2,0.00060,324632,98.01513,331206
5910,gaisama,2,0.00060,324634,98.01574,331206
5911,Gamegenorator,2,0.00060,324636,98.01634,331206
5912,gantsevdenis,2,0.00060,324638,98.01694,331206
5913,GaponkaGapon,2,0.00060,324640,98.01755,331206
5914,Garbaz,2,0.00060,324642,98.01815,331206
5915,Garimamudgal,2,0.00060,324644,98.01876,331206
5916,garrettmason,2,0.00060,324646,98.01936,331206
5917,gcsachin,2,0.00060,324648,98.01996,331206
5918,gdtbg,2,0.00060,324650,98.02057,331206
5919,gedw99,2,0.00060,324652,98.02117,331206
5920,geneishouko,2,0.00060,324654,98.02177,331206
5921,genesis-root,2,0.00060,324656,98.02238,331206
5922,geordieF,2,0.00060,324658,98.02298,331206
5923,George--K,2,0.00060,324660,98.02359,331206
5924,GeorgeNance,2,0.00060,324662,98.02419,331206
5925,georgewsinger,2,0.00060,324664,98.02479,331206
5926,germanalen,2,0.00060,324666,98.02540,331206
5927,GETASFAR,2,0.00060,324668,98.02600,331206
5928,GFX5000i,2,0.00060,324670,98.02661,331206
5929,gggiiia,2,0.00060,324672,98.02721,331206
5930,ghtalpo,2,0.00060,324674,98.02781,331206
5931,Ghuus,2,0.00060,324676,98.02842,331206
5932,gianmichelemariani,2,0.00060,324678,98.02902,331206
5933,giannis196,2,0.00060,324680,98.02963,331206
5934,Gigabitten,2,0.00060,324682,98.03023,331206
5935,giladbau,2,0.00060,324684,98.03083,331206
5936,giorgiga,2,0.00060,324686,98.03144,331206
5937,girng8rgtrhgtrh,2,0.00060,324688,98.03204,331206
5938,githubjsl118,2,0.00060,324690,98.03264,331206
5939,giyokun,2,0.00060,324692,98.03325,331206
5940,gjmcodes,2,0.00060,324694,98.03385,331206
5941,glek,2,0.00060,324696,98.03446,331206
5942,GlenIku,2,0.00060,324698,98.03506,331206
5943,glhrmfrts,2,0.00060,324700,98.03566,331206
5944,Glissando,2,0.00060,324702,98.03627,331206
5945,gnextia,2,0.00060,324704,98.03687,331206
5946,gnurn,2,0.00060,324706,98.03748,331206
5947,GoDotMad,2,0.00060,324708,98.03808,331206
5948,gogogry,2,0.00060,324710,98.03868,331206
5949,goldenratio,2,0.00060,324712,98.03929,331206
5950,GoOtterGo,2,0.00060,324714,98.03989,331206
5951,Goutye,2,0.00060,324716,98.04049,331206
5952,Grabli66,2,0.00060,324718,98.04110,331206
5953,GraffixGames,2,0.00060,324720,98.04170,331206
5954,GraigR,2,0.00060,324722,98.04231,331206
5955,gravitystorm,2,0.00060,324724,98.04291,331206
5956,greatoldoneHimself,2,0.00060,324726,98.04351,331206
5957,greenbas,2,0.00060,324728,98.04412,331206
5958,gregersn,2,0.00060,324730,98.04472,331206
5959,grigi,2,0.00060,324732,98.04533,331206
5960,grking,2,0.00060,324734,98.04593,331206
5961,gswashburn,2,0.00060,324736,98.04653,331206
5962,gtmacdonald,2,0.00060,324738,98.04714,331206
5963,guassmith,2,0.00060,324740,98.04774,331206
5964,gubblesdev,2,0.00060,324742,98.04834,331206
5965,Gustavo23,2,0.00060,324744,98.04895,331206
5966,Gutierrezjdr,2,0.00060,324746,98.04955,331206
5967,guycook,2,0.00060,324748,98.05016,331206
5968,gwilymk,2,0.00060,324750,98.05076,331206
5969,gyrcom,2,0.00060,324752,98.05136,331206
5970,H0010,2,0.00060,324754,98.05197,331206
5971,hal-314,2,0.00060,324756,98.05257,331206
5972,hamadmarri,2,0.00060,324758,98.05318,331206
5973,hanakou,2,0.00060,324760,98.05378,331206
5974,Handola,2,0.00060,324762,98.05438,331206
5975,hanoixan,2,0.00060,324764,98.05499,331206
5976,Hanprogramer,2,0.00060,324766,98.05559,331206
5977,Hapenia,2,0.00060,324768,98.05619,331206
5978,Hardm,2,0.00060,324770,98.05680,331206
5979,harraps,2,0.00060,324772,98.05740,331206
5980,Harvzor,2,0.00060,324774,98.05801,331206
5981,Hasnep,2,0.00060,324776,98.05861,331206
5982,haugenmitch,2,0.00060,324778,98.05921,331206
5983,Havok06,2,0.00060,324780,98.05982,331206
5984,hbgdo,2,0.00060,324782,98.06042,331206
5985,HeaTx,2,0.00060,324784,98.06103,331206
5986,hectordominguez,2,0.00060,324786,98.06163,331206
5987,heisty,2,0.00060,324788,98.06223,331206
5988,hellocld,2,0.00060,324790,98.06284,331206
5989,heniotierra,2,0.00060,324792,98.06344,331206
5990,heri333,2,0.00060,324794,98.06404,331206
5991,Herofied1180,2,0.00060,324796,98.06465,331206
5992,HeroicNate,2,0.00060,324798,98.06525,331206
5993,heroofhyla,2,0.00060,324800,98.06586,331206
5994,hestenfelder,2,0.00060,324802,98.06646,331206
5995,Heybye44,2,0.00060,324804,98.06706,331206
5996,Heyter,2,0.00060,324806,98.06767,331206
5997,HeyTheories,2,0.00060,324808,98.06827,331206
5998,hhirsch,2,0.00060,324810,98.06888,331206
5999,Hidden-Abstraction,2,0.00060,324812,98.06948,331206
6000,hirsimaki-markus,2,0.00060,324814,98.07008,331206
6001,hlb-schmidt,2,0.00060,324816,98.07069,331206
6002,hlship,2,0.00060,324818,98.07129,331206
6003,HoboGus,2,0.00060,324820,98.07189,331206
6004,hockdudu,2,0.00060,324822,98.07250,331206
6005,HolaCotoco,2,0.00060,324824,98.07310,331206
6006,Honkette,2,0.00060,324826,98.07371,331206
6007,HonorsoftEntertainment,2,0.00060,324828,98.07431,331206
6008,Hopefullyidontgetbanned,2,0.00060,324830,98.07491,331206
6009,HoratioZEDU,2,0.00060,324832,98.07552,331206
6010,houfaru,2,0.00060,324834,98.07612,331206
6011,howlingcatclops,2,0.00060,324836,98.07673,331206
6012,hporro,2,0.00060,324838,98.07733,331206
6013,HuangJunye,2,0.00060,324840,98.07793,331206
6014,huehue-tangerine,2,0.00060,324842,98.07854,331206
6015,Hugo0,2,0.00060,324844,98.07914,331206
6016,hugoel,2,0.00060,324846,98.07974,331206
6017,huttyblue,2,0.00060,324848,98.08035,331206
6018,hwangmaru,2,0.00060,324850,98.08095,331206
6019,HybridEidolon,2,0.00060,324852,98.08156,331206
6020,Hylek,2,0.00060,324854,98.08216,331206
6021,hyponymous,2,0.00060,324856,98.08276,331206
6022,Hzzkygcs,2,0.00060,324858,98.08337,331206
6023,i9i7,2,0.00060,324860,98.08397,331206
6024,iam13islucky,2,0.00060,324862,98.08458,331206
6025,IAmM1ne,2,0.00060,324864,98.08518,331206
6026,ianByrne,2,0.00060,324866,98.08578,331206
6027,idkaryan,2,0.00060,324868,98.08639,331206
6028,IINinja,2,0.00060,324870,98.08699,331206
6029,IllusionCatalyst,2,0.00060,324872,98.08760,331206
6030,ILope92,2,0.00060,324874,98.08820,331206
6031,IndieRonin,2,0.00060,324876,98.08880,331206
6032,Iniquitatis,2,0.00060,324878,98.08941,331206
6033,Inseighn,2,0.00060,324880,98.09001,331206
6034,insomnius,2,0.00060,324882,98.09061,331206
6035,interpol-kun,2,0.00060,324884,98.09122,331206
6036,ipavel83,2,0.00060,324886,98.09182,331206
6037,ironsoul,2,0.00060,324888,98.09243,331206
6038,Ironsx,2,0.00060,324890,98.09303,331206
6039,irresistiblejelly,2,0.00060,324892,98.09363,331206
6040,Irrgeist,2,0.00060,324894,98.09424,331206
6041,IsaacFehr,2,0.00060,324896,98.09484,331206
6042,isaacwhanson,2,0.00060,324898,98.09545,331206
6043,ishax-kos,2,0.00060,324900,98.09605,331206
6044,islemaster,2,0.00060,324902,98.09665,331206
6045,isral,2,0.00060,324904,98.09726,331206
6046,itnufc,2,0.00060,324906,98.09786,331206
6047,iusegodot,2,0.00060,324908,98.09846,331206
6048,iustin-nita,2,0.00060,324910,98.09907,331206
6049,IvanDem,2,0.00060,324912,98.09967,331206
6050,IvanSoldano,2,0.00060,324914,98.10028,331206
6051,ivanzamoraarias,2,0.00060,324916,98.10088,331206
6052,ivhilaire,2,0.00060,324918,98.10148,331206
6053,ivogrig,2,0.00060,324920,98.10209,331206
6054,izaleu,2,0.00060,324922,98.10269,331206
6055,JacobGood1,2,0.00060,324924,98.10330,331206
6056,jaibeer72,2,0.00060,324926,98.10390,331206
6057,JakeMcCann,2,0.00060,324928,98.10450,331206
6058,jambonsupreme,2,0.00060,324930,98.10511,331206
6059,jamesbunani,2,0.00060,324932,98.10571,331206
6060,JamesCraster,2,0.00060,324934,98.10631,331206
6061,JamesHinshelwood,2,0.00060,324936,98.10692,331206
6062,jameskirkwood,2,0.00060,324938,98.10752,331206
6063,jamesmintram,2,0.00060,324940,98.10813,331206
6064,jamestrotter,2,0.00060,324942,98.10873,331206
6065,jameszaghini,2,0.00060,324944,98.10933,331206
6066,Jamination,2,0.00060,324946,98.10994,331206
6067,Jamm6gamer,2,0.00060,324948,98.11054,331206
6068,janisozaur,2,0.00060,324950,98.11115,331206
6069,janmagtoast,2,0.00060,324952,98.11175,331206
6070,jansul,2,0.00060,324954,98.11235,331206
6071,japalekhin,2,0.00060,324956,98.11296,331206
6072,jasonpweber,2,0.00060,324958,98.11356,331206
6073,javiermtorres,2,0.00060,324960,98.11416,331206
6074,Jay2645,2,0.00060,324962,98.11477,331206
6075,jaynabonne,2,0.00060,324964,98.11537,331206
6076,JayPavlina,2,0.00060,324966,98.11598,331206
6077,jazn,2,0.00060,324968,98.11658,331206
6078,JBiche,2,0.00060,324970,98.11718,331206
6079,jbuschdev,2,0.00060,324972,98.11779,331206
6080,jbvovau,2,0.00060,324974,98.11839,331206
6081,jcostello,2,0.00060,324976,98.11900,331206
6082,jcranky,2,0.00060,324978,98.11960,331206
6083,JDoe543,2,0.00060,324980,98.12020,331206
6084,jean-dao,2,0.00060,324982,98.12081,331206
6085,jeanlucami,2,0.00060,324984,98.12141,331206
6086,jeff-s-zhou,2,0.00060,324986,98.12201,331206
6087,jejoivanic,2,0.00060,324988,98.12262,331206
6088,jellehermsen,2,0.00060,324990,98.12322,331206
6089,Jellycream,2,0.00060,324992,98.12383,331206
6090,Jendoliver,2,0.00060,324994,98.12443,331206
6091,jeremyherbert,2,0.00060,324996,98.12503,331206
6092,jezv,2,0.00060,324998,98.12564,331206
6093,jfrederickson,2,0.00060,325000,98.12624,331206
6094,jhagg85,2,0.00060,325002,98.12685,331206
6095,jihot2000,2,0.00060,325004,98.12745,331206
6096,jihuayu,2,0.00060,325006,98.12805,331206
6097,jjangga0214,2,0.00060,325008,98.12866,331206
6098,jjbandit,2,0.00060,325010,98.12926,331206
6099,JJChai01,2,0.00060,325012,98.12986,331206
6100,jjhaggar,2,0.00060,325014,98.13047,331206
6101,JJTriesHisBest,2,0.00060,325016,98.13107,331206
6102,J-Kat,2,0.00060,325018,98.13168,331206
6103,jkdean1,2,0.00060,325020,98.13228,331206
6104,JKiro93,2,0.00060,325022,98.13288,331206
6105,jlight0311,2,0.00060,325024,98.13349,331206
6106,jmarcher,2,0.00060,325026,98.13409,331206
6107,j-mckim,2,0.00060,325028,98.13470,331206
6108,jmdejong,2,0.00060,325030,98.13530,331206
6109,jminix,2,0.00060,325032,98.13590,331206
6110,jmoon1506,2,0.00060,325034,98.13651,331206
6111,jmvalin,2,0.00060,325036,98.13711,331206
6112,Joakker,2,0.00060,325038,98.13771,331206
6113,JoaoNSE,2,0.00060,325040,98.13832,331206
6114,jocamar,2,0.00060,325042,98.13892,331206
6115,joelmo,2,0.00060,325044,98.13953,331206
6116,JoeyCheung,2,0.00060,325046,98.14013,331206
6117,JohnCorby,2,0.00060,325048,98.14073,331206
6118,johnmick,2,0.00060,325050,98.14134,331206
6119,johnniehard,2,0.00060,325052,98.14194,331206
6120,johnnyjmcivorv,2,0.00060,325054,98.14255,331206
6121,JohnSmith25,2,0.00060,325056,98.14315,331206
6122,johnstt,2,0.00060,325058,98.14375,331206
6123,jonas-koeritz,2,0.00060,325060,98.14436,331206
6124,JonasMun,2,0.00060,325062,98.14496,331206
6125,JonasPf,2,0.00060,325064,98.14556,331206
6126,jonesmz,2,0.00060,325066,98.14617,331206
6127,Joseaay,2,0.00060,325068,98.14677,331206
6128,joseloc300,2,0.00060,325070,98.14738,331206
6129,josematiasrivero,2,0.00060,325072,98.14798,331206
6130,joshbenner,2,0.00060,325074,98.14858,331206
6131,JoshuaManuel,2,0.00060,325076,98.14919,331206
6132,joshwhitk,2,0.00060,325078,98.14979,331206
6133,joting,2,0.00060,325080,98.15040,331206
6134,jpernst,2,0.00060,325082,98.15100,331206
6135,jroy7110,2,0.00060,325084,98.15160,331206
6136,jsfdez,2,0.00060,325086,98.15221,331206
6137,jslater89,2,0.00060,325088,98.15281,331206
6138,jtank4,2,0.00060,325090,98.15342,331206
6139,juicetin,2,0.00060,325092,98.15402,331206
6140,JulGvoz,2,0.00060,325094,98.15462,331206
6141,juliopcrj,2,0.00060,325096,98.15523,331206
6142,juliotux,2,0.00060,325098,98.15583,331206
6143,junjaytan,2,0.00060,325100,98.15643,331206
6144,justinbot,2,0.00060,325102,98.15704,331206
6145,ka0s420,2,0.00060,325104,98.15764,331206
6146,Kadaka,2,0.00060,325106,98.15825,331206
6147,Kadoba,2,0.00060,325108,98.15885,331206
6148,kaiwlo,2,0.00060,325110,98.15945,331206
6149,kaliga,2,0.00060,325112,98.16006,331206
6150,Kaliham,2,0.00060,325114,98.16066,331206
6151,kartikey0303,2,0.00060,325116,98.16127,331206
6152,kattkieru,2,0.00060,325118,98.16187,331206
6153,KayacChang,2,0.00060,325120,98.16247,331206
6154,Kazetsukai,2,0.00060,325122,98.16308,331206
6155,kbad10,2,0.00060,325124,98.16368,331206
6156,kbhatia1996,2,0.00060,325126,98.16428,331206
6157,kbrizov,2,0.00060,325128,98.16489,331206
6158,kbs781025,2,0.00060,325130,98.16549,331206
6159,kCenk,2,0.00060,325132,98.16610,331206
6160,kcl101,2,0.00060,325134,98.16670,331206
6161,kedodrill,2,0.00060,325136,98.16730,331206
6162,Kejoko,2,0.00060,325138,98.16791,331206
6163,kekie1,2,0.00060,325140,98.16851,331206
6164,Kemeros,2,0.00060,325142,98.16912,331206
6165,KenderM,2,0.00060,325144,98.16972,331206
6166,keremcaliskan7,2,0.00060,325146,98.17032,331206
6167,ketan-m-patel,2,0.00060,325148,98.17093,331206
6168,kettle11,2,0.00060,325150,98.17153,331206
6169,kev93,2,0.00060,325152,98.17213,331206
6170,kewp,2,0.00060,325154,98.17274,331206
6171,keymastar,2,0.00060,325156,98.17334,331206
6172,kfpenguin,2,0.00060,325158,98.17395,331206
6173,KGI-John,2,0.00060,325160,98.17455,331206
6174,ki4jgt,2,0.00060,325162,98.17515,331206
6175,kienanstewart,2,0.00060,325164,98.17576,331206
6176,kikutaknight,2,0.00060,325166,98.17636,331206
6177,Kimapr,2,0.00060,325168,98.17697,331206
6178,kimkulling,2,0.00060,325170,98.17757,331206
6179,kimswe,2,0.00060,325172,98.17817,331206
6180,KingKone,2,0.00060,325174,98.17878,331206
6181,kisaragi-hiu,2,0.00060,325176,98.17938,331206
6182,Kitefr,2,0.00060,325178,98.17998,331206
6183,kjoshi,2,0.00060,325180,98.18059,331206
6184,kkeemmss,2,0.00060,325182,98.18119,331206
6185,klhrt,2,0.00060,325184,98.18180,331206
6186,KNejad,2,0.00060,325186,98.18240,331206
6187,komodor1,2,0.00060,325188,98.18300,331206
6188,konchunas,2,0.00060,325190,98.18361,331206
6189,konsvasi,2,0.00060,325192,98.18421,331206
6190,koopa,2,0.00060,325194,98.18482,331206
6191,kremetis,2,0.00060,325196,98.18542,331206
6192,Krummer,2,0.00060,325198,98.18602,331206
6193,krwolcott,2,0.00060,325200,98.18663,331206
6194,Krypton-Nova,2,0.00060,325202,98.18723,331206
6195,Kunall18,2,0.00060,325204,98.18783,331206
6196,KungTwo,2,0.00060,325206,98.18844,331206
6197,KuraiKokoro,2,0.00060,325208,98.18904,331206
6198,KursonSerg,2,0.00060,325210,98.18965,331206
6199,KyleFromOhio,2,0.00060,325212,98.19025,331206
6200,L4r0x,2,0.00060,325214,98.19085,331206
6201,labolado,2,0.00060,325216,98.19146,331206
6202,lacriment,2,0.00060,325218,98.19206,331206
6203,lagemanngui,2,0.00060,325220,98.19267,331206
6204,LainYC,2,0.00060,325222,98.19327,331206
6205,lajox666,2,0.00060,325224,98.19387,331206
6206,Lakorta,2,0.00060,325226,98.19448,331206
6207,lamsorsen,2,0.00060,325228,98.19508,331206
6208,lane-s,2,0.00060,325230,98.19568,331206
6209,Large-Lad,2,0.00060,325232,98.19629,331206
6210,laspencer91,2,0.00060,325234,98.19689,331206
6211,lasse8290,2,0.00060,325236,98.19750,331206
6212,leamendoza97,2,0.00060,325238,98.19810,331206
6213,Leandros,2,0.00060,325240,98.19870,331206
6214,LeD95,2,0.00060,325242,98.19931,331206
6215,ledocool,2,0.00060,325244,98.19991,331206
6216,leela52452,2,0.00060,325246,98.20052,331206
6217,lefavilla,2,0.00060,325248,98.20112,331206
6218,levifussell,2,0.00060,325250,98.20172,331206
6219,levilindsey,2,0.00060,325252,98.20233,331206
6220,LiChaozhong,2,0.00060,325254,98.20293,331206
6221,lichyard,2,0.00060,325256,98.20353,331206
6222,lijamez,2,0.00060,325258,98.20414,331206
6223,LimitlessChamp,2,0.00060,325260,98.20474,331206
6224,lincolnpepper,2,0.00060,325262,98.20535,331206
6225,linememory,2,0.00060,325264,98.20595,331206
6226,Ling2121,2,0.00060,325266,98.20655,331206
6227,LionH,2,0.00060,325268,98.20716,331206
6228,Liquidream,2,0.00060,325270,98.20776,331206
6229,LittleBigBug,2,0.00060,325272,98.20837,331206
6230,liuhantao9,2,0.00060,325274,98.20897,331206
6231,liuzhongshu,2,0.00060,325276,98.20957,331206
6232,Lknechtli,2,0.00060,325278,98.21018,331206
6233,lmcdd,2,0.00060,325280,98.21078,331206
6234,lnktree,2,0.00060,325282,98.21139,331206
6235,loadedsith,2,0.00060,325284,98.21199,331206
6236,loekni,2,0.00060,325286,98.21259,331206
6237,logo4poop,2,0.00060,325288,98.21320,331206
6238,lolbinarycat,2,0.00060,325290,98.21380,331206
6239,lolleko,2,0.00060,325292,98.21440,331206
6240,lonku,2,0.00060,325294,98.21501,331206
6241,LordEvilthe666,2,0.00060,325296,98.21561,331206
6242,lostdarkwolf,2,0.00060,325298,98.21622,331206
6243,LoubiTek,2,0.00060,325300,98.21682,331206
6244,LTheGreats,2,0.00060,325302,98.21742,331206
6245,LucasKA,2,0.00060,325304,98.21803,331206
6246,lucaspcamargo,2,0.00060,325306,98.21863,331206
6247,Lucas-Romao,2,0.00060,325308,98.21924,331206
6248,LuchitoDev,2,0.00060,325310,98.21984,331206
6249,LucidTaZ,2,0.00060,325312,98.22044,331206
6250,luffah,2,0.00060,325314,98.22105,331206
6251,luisboch,2,0.00060,325316,98.22165,331206
6252,lukas-durica,2,0.00060,325318,98.22225,331206
6253,lukasschmit,2,0.00060,325320,98.22286,331206
6254,lulersoft,2,0.00060,325322,98.22346,331206
6255,LuminousLizard,2,0.00060,325324,98.22407,331206
6256,LuminousNutria,2,0.00060,325326,98.22467,331206
6257,Luna-Rex,2,0.00060,325328,98.22527,331206
6258,lunarfyre7,2,0.00060,325330,98.22588,331206
6259,luokka,2,0.00060,325332,98.22648,331206
6260,lverona,2,0.00060,325334,98.22709,331206
6261,Lywx,2,0.00060,325336,98.22769,331206
6262,lzubiaur,2,0.00060,325338,98.22829,331206
6263,m23project,2,0.00060,325340,98.22890,331206
6264,m5tuff,2,0.00060,325342,98.22950,331206
6265,MacManny,2,0.00060,325344,98.23010,331206
6266,madeddy,2,0.00060,325346,98.23071,331206
6267,madjestic,2,0.00060,325348,98.23131,331206
6268,madprogramer,2,0.00060,325350,98.23192,331206
6269,mad-tzar,2,0.00060,325352,98.23252,331206
6270,maesi321,2,0.00060,325354,98.23312,331206
6271,MageJohn,2,0.00060,325356,98.23373,331206
6272,MagicIsArt,2,0.00060,325358,98.23433,331206
6273,mahersanalla,2,0.00060,325360,98.23494,331206
6274,makepanic,2,0.00060,325362,98.23554,331206
6275,MakovWait,2,0.00060,325364,98.23614,331206
6276,malk4444,2,0.00060,325366,98.23675,331206
6277,MallNinjaMax,2,0.00060,325368,98.23735,331206
6278,maluramichael,2,0.00060,325370,98.23795,331206
6279,mamadont,2,0.00060,325372,98.23856,331206
6280,manavspg2,2,0.00060,325374,98.23916,331206
6281,mandarinx,2,0.00060,325376,98.23977,331206
6282,manekinekodesu,2,0.00060,325378,98.24037,331206
6283,mannyobb,2,0.00060,325380,98.24097,331206
6284,manuieee,2,0.00060,325382,98.24158,331206
6285,Maratonec,2,0.00060,325384,98.24218,331206
6286,marchm3,2,0.00060,325386,98.24279,331206
6287,marco-vito,2,0.00060,325388,98.24339,331206
6288,markopolojorgensen,2,0.00060,325390,98.24399,331206
6289,mark-spiezio,2,0.00060,325392,98.24460,331206
6290,mart368b,2,0.00060,325394,98.24520,331206
6291,marzecdawid,2,0.00060,325396,98.24580,331206
6292,MasterSoft24,2,0.00060,325398,98.24641,331206
6293,mathias234,2,0.00060,325400,98.24701,331206
6294,MatiasFito,2,0.00060,325402,98.24762,331206
6295,matthew798,2,0.00060,325404,98.24822,331206
6296,mauricio-fidalgo,2,0.00060,325406,98.24882,331206
6297,mausedev,2,0.00060,325408,98.24943,331206
6298,MAX-71,2,0.00060,325410,98.25003,331206
6299,maxbarrett9,2,0.00060,325412,98.25064,331206
6300,maxdeviant,2,0.00060,325414,98.25124,331206
6301,Maxeonyx,2,0.00060,325416,98.25184,331206
6302,maxiestuinge,2,0.00060,325418,98.25245,331206
6303,MaxIsJoe,2,0.00060,325420,98.25305,331206
6304,maxxtepper,2,0.00060,325422,98.25365,331206
6305,McSora,2,0.00060,325424,98.25426,331206
6306,MeloJR,2,0.00060,325426,98.25486,331206
6307,meloonics,2,0.00060,325428,98.25547,331206
6308,melvin-ibuildings,2,0.00060,325430,98.25607,331206
6309,Meseira,2,0.00060,325432,98.25667,331206
6310,metablaster,2,0.00060,325434,98.25728,331206
6311,metalim,2,0.00060,325436,98.25788,331206
6312,Metalmastery,2,0.00060,325438,98.25849,331206
6313,metcalf-putnam,2,0.00060,325440,98.25909,331206
6314,metinc,2,0.00060,325442,98.25969,331206
6315,mfrancis107,2,0.00060,325444,98.26030,331206
6316,mgschwan,2,0.00060,325446,98.26090,331206
6317,mhamedoyt,2,0.00060,325448,98.26150,331206
6318,Michael-Kelley,2,0.00060,325450,98.26211,331206
6319,midopa,2,0.00060,325452,98.26271,331206
6320,Mielek,2,0.00060,325454,98.26332,331206
6321,mikehaney24,2,0.00060,325456,98.26392,331206
6322,mikethebuilder,2,0.00060,325458,98.26452,331206
6323,Mikeysax,2,0.00060,325460,98.26513,331206
6324,MiniDigger,2,0.00060,325462,98.26573,331206
6325,mirceaciu,2,0.00060,325464,98.26634,331206
6326,mirh,2,0.00060,325466,98.26694,331206
6327,miroro,2,0.00060,325468,98.26754,331206
6328,Mithil467,2,0.00060,325470,98.26815,331206
6329,Mithul,2,0.00060,325472,98.26875,331206
6330,mitsuha-miamizu,2,0.00060,325474,98.26936,331206
6331,mixedCase,2,0.00060,325476,98.26996,331206
6332,mjheikki,2,0.00060,325478,98.27056,331206
6333,mkhoi-r,2,0.00060,325480,98.27117,331206
6334,MmAaXx500,2,0.00060,325482,98.27177,331206
6335,MmTtDeveloper,2,0.00060,325484,98.27237,331206
6336,mncl,2,0.00060,325486,98.27298,331206
6337,mnemoli,2,0.00060,325488,98.27358,331206
6338,mobybrick,2,0.00060,325490,98.27419,331206
6339,moechofe,2,0.00060,325492,98.27479,331206
6340,Moguri,2,0.00060,325494,98.27539,331206
6341,mohr023,2,0.00060,325496,98.27600,331206
6342,moisesjpelaez,2,0.00060,325498,98.27660,331206
6343,moizez102,2,0.00060,325500,98.27721,331206
6344,MolbOrg,2,0.00060,325502,98.27781,331206
6345,monatsend,2,0.00060,325504,98.27841,331206
6346,monkeyhybrid,2,0.00060,325506,98.27902,331206
6347,Montecri,2,0.00060,325508,98.27962,331206
6348,morphiser,2,0.00060,325510,98.28022,331206
6349,MortimerMcMire,2,0.00060,325512,98.28083,331206
6350,moscoso,2,0.00060,325514,98.28143,331206
6351,mostlysoftware,2,0.00060,325516,98.28204,331206
6352,mount2010,2,0.00060,325518,98.28264,331206
6353,mprasil,2,0.00060,325520,98.28324,331206
6354,mralext20,2,0.00060,325522,98.28385,331206
6355,MrAnima,2,0.00060,325524,98.28445,331206
6356,mrbw85,2,0.00060,325526,98.28506,331206
6357,MrCelticFox,2,0.00060,325528,98.28566,331206
6358,mrcrb,2,0.00060,325530,98.28626,331206
6359,MRFaria,2,0.00060,325532,98.28687,331206
6360,MrGreenTea,2,0.00060,325534,98.28747,331206
6361,mrigangha,2,0.00060,325536,98.28807,331206
6362,MrKovar,2,0.00060,325538,98.28868,331206
6363,MrMorteZw,2,0.00060,325540,98.28928,331206
6364,mrshpot,2,0.00060,325542,98.28989,331206
6365,MrSuit,2,0.00060,325544,98.29049,331206
6366,MrTaron,2,0.00060,325546,98.29109,331206
6367,MrTeeXD,2,0.00060,325548,98.29170,331206
6368,MrVallentin,2,0.00060,325550,98.29230,331206
6369,Mrxx99,2,0.00060,325552,98.29291,331206
6370,MueVoid,2,0.00060,325554,98.29351,331206
6371,Mugiwara00,2,0.00060,325556,98.29411,331206
6372,mukul29,2,0.00060,325558,98.29472,331206
6373,Mustard867,2,0.00060,325560,98.29532,331206
6374,Mutim,2,0.00060,325562,98.29592,331206
6375,myfreeweb,2,0.00060,325564,98.29653,331206
6376,MysticalOS,2,0.00060,325566,98.29713,331206
6377,myuniquename,2,0.00060,325568,98.29774,331206
6378,n3xxt,2,0.00060,325570,98.29834,331206
6379,naive231,2,0.00060,325572,98.29894,331206
6380,nanoquack,2,0.00060,325574,98.29955,331206
6381,Nao-fox,2,0.00060,325576,98.30015,331206
6382,naolArega,2,0.00060,325578,98.30076,331206
6383,Nar568544,2,0.00060,325580,98.30136,331206
6384,NarayanaWalters,2,0.00060,325582,98.30196,331206
6385,naruto700,2,0.00060,325584,98.30257,331206
6386,nasdf,2,0.00060,325586,98.30317,331206
6387,NateRiz,2,0.00060,325588,98.30377,331206
6388,NateWardawg,2,0.00060,325590,98.30438,331206
6389,NathanielLLally,2,0.00060,325592,98.30498,331206
6390,naturbua,2,0.00060,325594,98.30559,331206
6391,nawillcodes,2,0.00060,325596,98.30619,331206
6392,necrosmash,2,0.00060,325598,98.30679,331206
6393,NedKJaims,2,0.00060,325600,98.30740,331206
6394,Neerti,2,0.00060,325602,98.30800,331206
6395,NekiCoule,2,0.00060,325604,98.30861,331206
6396,nekronk,2,0.00060,325606,98.30921,331206
6397,nelsondiaas,2,0.00060,325608,98.30981,331206
6398,NelsonSMG,2,0.00060,325610,98.31042,331206
6399,nem0,2,0.00060,325612,98.31102,331206
6400,nemesis567,2,0.00060,325614,98.31162,331206
6401,neogaston,2,0.00060,325616,98.31223,331206
6402,neomodern,2,0.00060,325618,98.31283,331206
6403,neosin,2,0.00060,325620,98.31344,331206
6404,neoxid501,2,0.00060,325622,98.31404,331206
6405,nerzhul,2,0.00060,325624,98.31464,331206
6406,Netforza,2,0.00060,325626,98.31525,331206
6407,NetonD,2,0.00060,325628,98.31585,331206
6408,newold3,2,0.00060,325630,98.31646,331206
6409,neynt,2,0.00060,325632,98.31706,331206
6410,Neyzenn,2,0.00060,325634,98.31766,331206
6411,ngmgit,2,0.00060,325636,98.31827,331206
6412,nguu,2,0.00060,325638,98.31887,331206
6413,nhartung,2,0.00060,325640,98.31947,331206
6414,niacat,2,0.00060,325642,98.32008,331206
6415,NickCaplinger,2,0.00060,325644,98.32068,331206
6416,nickrodgers42,2,0.00060,325646,98.32129,331206
6417,nicktheway,2,0.00060,325648,98.32189,331206
6418,NickToony,2,0.00060,325650,98.32249,331206
6419,nicoboss,2,0.00060,325652,98.32310,331206
6420,nicoechaniz,2,0.00060,325654,98.32370,331206
6421,NicoLira,2,0.00060,325656,98.32431,331206
6422,nielscool,2,0.00060,325658,98.32491,331206
6423,NigelTicknor,2,0.00060,325660,98.32551,331206
6424,NightIsland,2,0.00060,325662,98.32612,331206
6425,Nighttraveler,2,0.00060,325664,98.32672,331206
6426,nik0la-vr,2,0.00060,325666,98.32732,331206
6427,NikasAl,2,0.00060,325668,98.32793,331206
6428,nikhil232,2,0.00060,325670,98.32853,331206
6429,nitaku,2,0.00060,325672,98.32914,331206
6430,njean42,2,0.00060,325674,98.32974,331206
6431,NoahLavelle,2,0.00060,325676,98.33034,331206
6432,nobnob2015,2,0.00060,325678,98.33095,331206
6433,nobody5050,2,0.00060,325680,98.33155,331206
6434,Nohac,2,0.00060,325682,98.33216,331206
6435,NoIE,2,0.00060,325684,98.33276,331206
6436,nok-ko,2,0.00060,325686,98.33336,331206
6437,Nolic0321,2,0.00060,325688,98.33397,331206
6438,NomanGhiasy,2,0.00060,325690,98.33457,331206
6439,nonbeing,2,0.00060,325692,98.33518,331206
6440,nonfatmatt,2,0.00060,325694,98.33578,331206
6441,Nonnu42,2,0.00060,325696,98.33638,331206
6442,nonomiyo,2,0.00060,325698,98.33699,331206
6443,Nonoreve,2,0.00060,325700,98.33759,331206
6444,nooperation,2,0.00060,325702,98.33819,331206
6445,Nootria,2,0.00060,325704,98.33880,331206
6446,NosamMakesContent,2,0.00060,325706,98.33940,331206
6447,NoshyaarHasATinyPecker,2,0.00060,325708,98.34001,331206
6448,notamonopoly,2,0.00060,325710,98.34061,331206
6449,notklaatu,2,0.00060,325712,98.34121,331206
6450,notnsane,2,0.00060,325714,98.34182,331206
6451,novajimmy,2,0.00060,325716,98.34242,331206
6452,noxtrip,2,0.00060,325718,98.34303,331206
6453,NPohl,2,0.00060,325720,98.34363,331206
6454,NPScript,2,0.00060,325722,98.34423,331206
6455,n-smits,2,0.00060,325724,98.34484,331206
6456,nullterm,2,0.00060,325726,98.34544,331206
6457,numan98khan,2,0.00060,325728,98.34604,331206
6458,nuxlight,2,0.00060,325730,98.34665,331206
6459,Oberon-Tonya,2,0.00060,325732,98.34725,331206
6460,Obnivelint,2,0.00060,325734,98.34786,331206
6461,oceanpuzzle,2,0.00060,325736,98.34846,331206
6462,Ocete,2,0.00060,325738,98.34906,331206
6463,OgierM,2,0.00060,325740,98.34967,331206
6464,ohnoimdead,2,0.00060,325742,98.35027,331206
6465,Oklomsy,2,0.00060,325744,98.35088,331206
6466,okynos,2,0.00060,325746,98.35148,331206
6467,oleksandr-manakov,2,0.00060,325748,98.35208,331206
6468,oliverrausch,2,0.00060,325750,98.35269,331206
6469,omggomb,2,0.00060,325752,98.35329,331206
6470,omnizach,2,0.00060,325754,98.35389,331206
6471,omodamos,2,0.00060,325756,98.35450,331206
6472,omomthings,2,0.00060,325758,98.35510,331206
6473,Oneil974,2,0.00060,325760,98.35571,331206
6474,onelsonic,2,0.00060,325762,98.35631,331206
6475,oneoh,2,0.00060,325764,98.35691,331206
6476,OnomatoWombat,2,0.00060,325766,98.35752,331206
6477,opensw,2,0.00060,325768,98.35812,331206
6478,opleks,2,0.00060,325770,98.35873,331206
6479,opmana,2,0.00060,325772,98.35933,331206
6480,orangy,2,0.00060,325774,98.35993,331206
6481,orchym,2,0.00060,325776,98.36054,331206
6482,Orestisc,2,0.00060,325778,98.36114,331206
6483,oscarcp,2,0.00060,325780,98.36174,331206
6484,otanistudio,2,0.00060,325782,98.36235,331206
6485,Oussama-dev,2,0.00060,325784,98.36295,331206
6486,oxben,2,0.00060,325786,98.36356,331206
6487,Ozzadar,2,0.00060,325788,98.36416,331206
6488,p0wnz,2,0.00060,325790,98.36476,331206
6489,P1llus,2,0.00060,325792,98.36537,331206
6490,pablomz83,2,0.00060,325794,98.36597,331206
6491,Pandazuechter,2,0.00060,325796,98.36658,331206
6492,panicq,2,0.00060,325798,98.36718,331206
6493,paolobb4,2,0.00060,325800,98.36778,331206
6494,paper-vessel,2,0.00060,325802,98.36839,331206
6495,parishrutpandey,2,0.00060,325804,98.36899,331206
6496,partyvaper,2,0.00060,325806,98.36959,331206
6497,paryl,2,0.00060,325808,98.37020,331206
6498,pasimako,2,0.00060,325810,98.37080,331206
6499,pasquinelli,2,0.00060,325812,98.37141,331206
6500,pass0,2,0.00060,325814,98.37201,331206
6501,patchman,2,0.00060,325816,98.37261,331206
6502,PatrickKaster,2,0.00060,325818,98.37322,331206
6503,patrickWarvene,2,0.00060,325820,98.37382,331206
6504,paulenit,2,0.00060,325822,98.37443,331206
6505,Pawlost,2,0.00060,325824,98.37503,331206
6506,pbalter,2,0.00060,325826,98.37563,331206
6507,PBird,2,0.00060,325828,98.37624,331206
6508,PedroHugoNoevo,2,0.00060,325830,98.37684,331206
6509,pellea72,2,0.00060,325832,98.37744,331206
6510,pentazoe,2,0.00060,325834,98.37805,331206
6511,perbone,2,0.00060,325836,98.37865,331206
6512,pererikbergman,2,0.00060,325838,98.37926,331206
6513,personalizedrefrigerator,2,0.00060,325840,98.37986,331206
6514,peteroupc,2,0.00060,325842,98.38046,331206
6515,pfanne,2,0.00060,325844,98.38107,331206
6516,PhelixTaken,2,0.00060,325846,98.38167,331206
6517,phicore,2,0.00060,325848,98.38228,331206
6518,PhilipWee,2,0.00060,325850,98.38288,331206
6519,philj56,2,0.00060,325852,98.38348,331206
6520,PhilosopherTruelove,2,0.00060,325854,98.38409,331206
6521,pho,2,0.00060,325856,98.38469,331206
6522,phobos-tro,2,0.00060,325858,98.38529,331206
6523,phutflesz,2,0.00060,325860,98.38590,331206
6524,pichinep,2,0.00060,325862,98.38650,331206
6525,PierreNilsson,2,0.00060,325864,98.38711,331206
6526,PiezoMnemonic,2,0.00060,325866,98.38771,331206
6527,Pinchanzee,2,0.00060,325868,98.38831,331206
6528,pingul003,2,0.00060,325870,98.38892,331206
6529,piotrf230,2,0.00060,325872,98.38952,331206
6530,pipe01,2,0.00060,325874,98.39013,331206
6531,pipehat,2,0.00060,325876,98.39073,331206
6532,pipepkr,2,0.00060,325878,98.39133,331206
6533,Pixdigit,2,0.00060,325880,98.39194,331206
6534,pixelprogrammer,2,0.00060,325882,98.39254,331206
6535,PixelWizzard,2,0.00060,325884,98.39315,331206
6536,pizzapim,2,0.00060,325886,98.39375,331206
6537,pk-nb,2,0.00060,325888,98.39435,331206
6538,plabuda,2,0.00060,325890,98.39496,331206
6539,PlainCrown,2,0.00060,325892,98.39556,331206
6540,PlanetKiller,2,0.00060,325894,98.39616,331206
6541,PleaseBeGentle,2,0.00060,325896,98.39677,331206
6542,plokmijnuhby,2,0.00060,325898,98.39737,331206
6543,poberlohr,2,0.00060,325900,98.39798,331206
6544,PokemonAshLovesMyTurkeyAndILikeYouTwo,2,0.00060,325902,98.39858,331206
6545,PolarisJunior,2,0.00060,325904,98.39918,331206
6546,PonySchreck,2,0.00060,325906,98.39979,331206
6547,popoysan,2,0.00060,325908,98.40039,331206
6548,potato20,2,0.00060,325910,98.40100,331206
6549,PotatoNato,2,0.00060,325912,98.40160,331206
6550,ppfeiler,2,0.00060,325914,98.40220,331206
6551,pradyunsg,2,0.00060,325916,98.40281,331206
6552,Prinsn,2,0.00060,325918,98.40341,331206
6553,probedrone,2,0.00060,325920,98.40401,331206
6554,Probix,2,0.00060,325922,98.40462,331206
6555,profanicus,2,0.00060,325924,98.40522,331206
6556,proller,2,0.00060,325926,98.40583,331206
6557,protomouse,2,0.00060,325928,98.40643,331206
6558,Protosac,2,0.00060,325930,98.40703,331206
6559,proxemy,2,0.00060,325932,98.40764,331206
6560,Prunkles,2,0.00060,325934,98.40824,331206
6561,przemekd,2,0.00060,325936,98.40885,331206
6562,pschnorbus,2,0.00060,325938,98.40945,331206
6563,pshendry,2,0.00060,325940,98.41005,331206
6564,Puebeck,2,0.00060,325942,98.41066,331206
6565,pvmelnichuk,2,0.00060,325944,98.41126,331206
6566,q00u,2,0.00060,325946,98.41186,331206
6567,qez008,2,0.00060,325948,98.41247,331206
6568,qiqian,2,0.00060,325950,98.41307,331206
6569,qrilin,2,0.00060,325952,98.41368,331206
6570,Quakermann,2,0.00060,325954,98.41428,331206
6571,Quest79,2,0.00060,325956,98.41488,331206
6572,Quincy9000,2,0.00060,325958,98.41549,331206
6573,Qwertygiy,2,0.00060,325960,98.41609,331206
6574,R0adRunn3r,2,0.00060,325962,98.41670,331206
6575,R3ality,2,0.00060,325964,98.41730,331206
6576,raelik,2,0.00060,325966,98.41790,331206
6577,rafaela-ip,2,0.00060,325968,98.41851,331206
6578,rafalstapinski,2,0.00060,325970,98.41911,331206
6579,raformatico,2,0.00060,325972,98.41971,331206
6580,RagingFlames,2,0.00060,325974,98.42032,331206
6581,rainbyte,2,0.00060,325976,98.42092,331206
6582,rama0x9,2,0.00060,325978,98.42153,331206
6583,ramilefu,2,0.00060,325980,98.42213,331206
6584,randombenj,2,0.00060,325982,98.42273,331206
6585,RandomErivanHaub,2,0.00060,325984,98.42334,331206
6586,RandomNumber4,2,0.00060,325986,98.42394,331206
6587,Rannn1288210,2,0.00060,325988,98.42455,331206
6588,raphipod,2,0.00060,325990,98.42515,331206
6589,rapperdinesh,2,0.00060,325992,98.42575,331206
6590,raptdwar,2,0.00060,325994,98.42636,331206
6591,ratkingsminion,2,0.00060,325996,98.42696,331206
6592,raziel229,2,0.00060,325998,98.42756,331206
6593,rdckgames,2,0.00060,326000,98.42817,331206
6594,redmarbleroad,2,0.00060,326002,98.42877,331206
6595,RedstoneParadox,2,0.00060,326004,98.42938,331206
6596,Reinards,2,0.00060,326006,98.42998,331206
6597,Reisflocke,2,0.00060,326008,98.43058,331206
6598,Reituag,2,0.00060,326010,98.43119,331206
6599,remmah,2,0.00060,326012,98.43179,331206
6600,ReneHabermann,2,0.00060,326014,98.43240,331206
6601,rennurb3000,2,0.00060,326016,98.43300,331206
6602,repkino,2,0.00060,326018,98.43360,331206
6603,RetrocadeMedia,2,0.00060,326020,98.43421,331206
6604,RevampedSpider,2,0.00060,326022,98.43481,331206
6605,revanj,2,0.00060,326024,98.43541,331206
6606,revast,2,0.00060,326026,98.43602,331206
6607,rexfleischer,2,0.00060,326028,98.43662,331206
6608,rgson,2,0.00060,326030,98.43723,331206
6609,Richard74Huang,2,0.00060,326032,98.43783,331206
6610,RichardBetson,2,0.00060,326034,98.43843,331206
6611,riklauder,2,0.00060,326036,98.43904,331206
6612,rilifon,2,0.00060,326038,98.43964,331206
6613,rippledodger,2,0.00060,326040,98.44025,331206
6614,rixck,2,0.00060,326042,98.44085,331206
6615,rjdgheart,2,0.00060,326044,98.44145,331206
6616,rjkilpatrick,2,0.00060,326046,98.44206,331206
6617,rKinson,2,0.00060,326048,98.44266,331206
6618,rmlz,2,0.00060,326050,98.44326,331206
6619,rndevfx,2,0.00060,326052,98.44387,331206
6620,RobAley,2,0.00060,326054,98.44447,331206
6621,roberthofstra,2,0.00060,326056,98.44508,331206
6622,robert-wallis,2,0.00060,326058,98.44568,331206
6623,robinator8,2,0.00060,326060,98.44628,331206
6624,Robin-Wils,2,0.00060,326062,98.44689,331206
6625,RoboClonk,2,0.00060,326064,98.44749,331206
6626,RoboYorkie,2,0.00060,326066,98.44810,331206
6627,RodizzGamer,2,0.00060,326068,98.44870,331206
6628,rodly,2,0.00060,326070,98.44930,331206
6629,rodohanna,2,0.00060,326072,98.44991,331206
6630,rokyfox,2,0.00060,326074,98.45051,331206
6631,ronthomas345,2,0.00060,326076,98.45112,331206
6632,roscale,2,0.00060,326078,98.45172,331206
6633,rossimo,2,0.00060,326080,98.45232,331206
6634,rotonlin,2,0.00060,326082,98.45293,331206
6635,Roysten,2,0.00060,326084,98.45353,331206
6636,rpxomi,2,0.00060,326086,98.45413,331206
6637,rrei,2,0.00060,326088,98.45474,331206
6638,rseonp,2,0.00060,326090,98.45534,331206
6639,rsiadmin2015,2,0.00060,326092,98.45595,331206
6640,rtsketo,2,0.00060,326094,98.45655,331206
6641,rulz-coder,2,0.00060,326096,98.45715,331206
6642,rustybox,2,0.00060,326098,98.45776,331206
6643,rwaguy,2,0.00060,326100,98.45836,331206
6644,RXuq,2,0.00060,326102,98.45897,331206
6645,RyanGPalmer,2,0.00060,326104,98.45957,331206
6646,ryanhuellen,2,0.00060,326106,98.46017,331206
6647,ryaninlife,2,0.00060,326108,98.46078,331206
6648,ryanrowse,2,0.00060,326110,98.46138,331206
6649,Rylius,2,0.00060,326112,98.46198,331206
6650,Ryozuki,2,0.00060,326114,98.46259,331206
6651,s22h,2,0.00060,326116,98.46319,331206
6652,Saaamoth,2,0.00060,326118,98.46380,331206
6653,sabudum,2,0.00060,326120,98.46440,331206
6654,sadovsf,2,0.00060,326122,98.46500,331206
6655,safield,2,0.00060,326124,98.46561,331206
6656,SailorOnDaTea,2,0.00060,326126,98.46621,331206
6657,salomander86,2,0.00060,326128,98.46682,331206
6658,saltpowered,2,0.00060,326130,98.46742,331206
6659,SamMacedo,2,0.00060,326132,98.46802,331206
6660,samw3,2,0.00060,326134,98.46863,331206
6661,SandbergSan,2,0.00060,326136,98.46923,331206
6662,sangress,2,0.00060,326138,98.46983,331206
6663,sanki83,2,0.00060,326140,98.47044,331206
6664,sanslash332,2,0.00060,326142,98.47104,331206
6665,sapporovhs,2,0.00060,326144,98.47165,331206
6666,SAqsin,2,0.00060,326146,98.47225,331206
6667,sarahspock,2,0.00060,326148,98.47285,331206
6668,saschell,2,0.00060,326150,98.47346,331206
6669,SavageMcCabbage,2,0.00060,326152,98.47406,331206
6670,SbNanduri,2,0.00060,326154,98.47467,331206
6671,sburris0,2,0.00060,326156,98.47527,331206
6672,sc312,2,0.00060,326158,98.47587,331206
6673,Scarjit,2,0.00060,326160,98.47648,331206
6674,schwitin,2,0.00060,326162,98.47708,331206
6675,scionicspectre,2,0.00060,326164,98.47768,331206
6676,scottpetrovic,2,0.00060,326166,98.47829,331206
6677,Scozor,2,0.00060,326168,98.47889,331206
6678,scrappedgear,2,0.00060,326170,98.47950,331206
6679,Scubadoo2,2,0.00060,326172,98.48010,331206
6680,scurest,2,0.00060,326174,98.48070,331206
6681,Seabass247,2,0.00060,326176,98.48131,331206
6682,SebieF,2,0.00060,326178,98.48191,331206
6683,secondwind21,2,0.00060,326180,98.48252,331206
6684,segamanov,2,0.00060,326182,98.48312,331206
6685,Selene29,2,0.00060,326184,98.48372,331206
6686,selfsame,2,0.00060,326186,98.48433,331206
6687,selvabharathis,2,0.00060,326188,98.48493,331206
6688,semickolon,2,0.00060,326190,98.48553,331206
6689,Sephtenen,2,0.00060,326192,98.48614,331206
6690,serapth,2,0.00060,326194,98.48674,331206
6691,SergioJimenezM,2,0.00060,326196,98.48735,331206
6692,Serkan-devel,2,0.00060,326198,98.48795,331206
6693,seronis,2,0.00060,326200,98.48855,331206
6694,sgarcia22,2,0.00060,326202,98.48916,331206
6695,SGMcejo,2,0.00060,326204,98.48976,331206
6696,ShadowBelmolve,2,0.00060,326206,98.49037,331206
6697,shakenov-chinga,2,0.00060,326208,98.49097,331206
6698,sh-al,2,0.00060,326210,98.49157,331206
6699,shankuo,2,0.00060,326212,98.49218,331206
6700,shar0,2,0.00060,326214,98.49278,331206
6701,SHARKvince,2,0.00060,326216,98.49338,331206
6702,sharplet,2,0.00060,326218,98.49399,331206
6703,ShieldHero,2,0.00060,326220,98.49459,331206
6704,shimpe,2,0.00060,326222,98.49520,331206
6705,shivmsit,2,0.00060,326224,98.49580,331206
6706,shoaib-xo,2,0.00060,326226,98.49640,331206
6707,shonlove,2,0.00060,326228,98.49701,331206
6708,Shultc,2,0.00060,326230,98.49761,331206
6709,SiberianCatz,2,0.00060,326232,98.49822,331206
6710,sigmasoldi3r,2,0.00060,326234,98.49882,331206
6711,SimonCadge,2,0.00060,326236,98.49942,331206
6712,SimplySpike,2,0.00060,326238,98.50003,331206
6713,Sindern,2,0.00060,326240,98.50063,331206
6714,singalen,2,0.00060,326242,98.50123,331206
6715,singam96,2,0.00060,326244,98.50184,331206
6716,sirAlexDev,2,0.00060,326246,98.50244,331206
6717,SirNarpa,2,0.00060,326248,98.50305,331206
6718,sithumyo1998,2,0.00060,326250,98.50365,331206
6719,sjb8100,2,0.00060,326252,98.50425,331206
6720,sjbaines,2,0.00060,326254,98.50486,331206
6721,skar,2,0.00060,326256,98.50546,331206
6722,skarnl,2,0.00060,326258,98.50607,331206
6723,Skipperro,2,0.00060,326260,98.50667,331206
6724,skiz,2,0.00060,326262,98.50727,331206
6725,sksdutra,2,0.00060,326264,98.50788,331206
6726,skullleeep,2,0.00060,326266,98.50848,331206
6727,skynet1,2,0.00060,326268,98.50908,331206
6728,slango0513,2,0.00060,326270,98.50969,331206
6729,slavfox,2,0.00060,326272,98.51029,331206
6730,slevy85,2,0.00060,326274,98.51090,331206
6731,SL-RU,2,0.00060,326276,98.51150,331206
6732,sman026,2,0.00060,326278,98.51210,331206
6733,Smiley32,2,0.00060,326280,98.51271,331206
6734,smks,2,0.00060,326282,98.51331,331206
6735,sntdevco,2,0.00060,326284,98.51392,331206
6736,Soarex16,2,0.00060,326286,98.51452,331206
6737,soccerob,2,0.00060,326288,98.51512,331206
6738,soekmego,2,0.00060,326290,98.51573,331206
6739,SolarPolarMan,2,0.00060,326292,98.51633,331206
6740,Sonoracpp,2,0.00060,326294,98.51694,331206
6741,so-rose,2,0.00060,326296,98.51754,331206
6742,Soul3S8,2,0.00060,326298,98.51814,331206
6743,soumyalahiri,2,0.00060,326300,98.51875,331206
6744,SoWhich,2,0.00060,326302,98.51935,331206
6745,soyrandom1,2,0.00060,326304,98.51995,331206
6746,sp82,2,0.00060,326306,98.52056,331206
6747,spacemonaut,2,0.00060,326308,98.52116,331206
6748,spec-chum,2,0.00060,326310,98.52177,331206
6749,speckledsea,2,0.00060,326312,98.52237,331206
6750,spencewenski,2,0.00060,326314,98.52297,331206
6751,speratus,2,0.00060,326316,98.52358,331206
6752,SpiceyWolf,2,0.00060,326318,98.52418,331206
6753,SpoopyUI69,2,0.00060,326320,98.52479,331206
6754,sporeball,2,0.00060,326322,98.52539,331206
6755,Squatnet,2,0.00060,326324,98.52599,331206
6756,SradnickDev,2,0.00060,326326,98.52660,331206
6757,srcnalt,2,0.00060,326328,98.52720,331206
6758,sriramsk1999,2,0.00060,326330,98.52780,331206
6759,srodrigo,2,0.00060,326332,98.52841,331206
6760,SRugina,2,0.00060,326334,98.52901,331206
6761,SrZorro,2,0.00060,326336,98.52962,331206
6762,ssatguru,2,0.00060,326338,98.53022,331206
6763,ssavalot,2,0.00060,326340,98.53082,331206
6764,ssemakin,2,0.00060,326342,98.53143,331206
6765,starrydigits,2,0.00060,326344,98.53203,331206
6766,STcraft,2,0.00060,326346,98.53264,331206
6767,SteelyGlint,2,0.00060,326348,98.53324,331206
6768,steevm,2,0.00060,326350,98.53384,331206
6769,Stefan-GameDev,2,0.00060,326352,98.53445,331206
6770,steffenkre,2,0.00060,326354,98.53505,331206
6771,stengun,2,0.00060,326356,98.53565,331206
6772,stevearc,2,0.00060,326358,98.53626,331206
6773,Steve-Dusty,2,0.00060,326360,98.53686,331206
6774,stmckeni,2,0.00060,326362,98.53747,331206
6775,stolencatkarma,2,0.00060,326364,98.53807,331206
6776,Stovehead,2,0.00060,326366,98.53867,331206
6777,StripedMonkey,2,0.00060,326368,98.53928,331206
6778,stsewd,2,0.00060,326370,98.53988,331206
6779,Stumblinbear,2,0.00060,326372,98.54049,331206
6780,StyrmirNathrakh,2,0.00060,326374,98.54109,331206
6781,sukhchainn,2,0.00060,326376,98.54169,331206
6782,Sulkway,2,0.00060,326378,98.54230,331206
6783,summerblind,2,0.00060,326380,98.54290,331206
6784,suoicodilaipxecitsiligarfilacrepus,2,0.00060,326382,98.54350,331206
6785,SuperiorHobo,2,0.00060,326384,98.54411,331206
6786,SuperMeip,2,0.00060,326386,98.54471,331206
6787,supermoaaa,2,0.00060,326388,98.54532,331206
6788,supersmo,2,0.00060,326390,98.54592,331206
6789,supragya,2,0.00060,326392,98.54652,331206
6790,SureDroid,2,0.00060,326394,98.54713,331206
6791,suzumiyasmith,2,0.00060,326396,98.54773,331206
6792,Sveniff,2,0.00060,326398,98.54834,331206
6793,svntax,2,0.00060,326400,98.54894,331206
6794,swarminglogic,2,0.00060,326402,98.54954,331206
6795,swedneck,2,0.00060,326404,98.55015,331206
6796,sweetcode,2,0.00060,326406,98.55075,331206
6797,Swoboderz,2,0.00060,326408,98.55135,331206
6798,Swoppit,2,0.00060,326410,98.55196,331206
6799,Syntaxxor,2,0.00060,326412,98.55256,331206
6800,syoyo,2,0.00060,326414,98.55317,331206
6801,syrusakbary,2,0.00060,326416,98.55377,331206
6802,systemsoverload,2,0.00060,326418,98.55437,331206
6803,T1mL3arn,2,0.00060,326420,98.55498,331206
6804,TaberIV,2,0.00060,326422,98.55558,331206
6805,tabletopcrow,2,0.00060,326424,98.55619,331206
6806,Tachekentya,2,0.00060,326426,98.55679,331206
6807,TackerTacker,2,0.00060,326428,98.55739,331206
6808,talapbekov,2,0.00060,326430,98.55800,331206
6809,TaleTN,2,0.00060,326432,98.55860,331206
6810,TaofeekS,2,0.00060,326434,98.55920,331206
6811,Tarik02,2,0.00060,326436,98.55981,331206
6812,Tarudahat,2,0.00060,326438,98.56041,331206
6813,tavotell,2,0.00060,326440,98.56102,331206
6814,t-boom,2,0.00060,326442,98.56162,331206
6815,TD25,2,0.00060,326444,98.56222,331206
6816,tdnzr,2,0.00060,326446,98.56283,331206
6817,tebz,2,0.00060,326448,98.56343,331206
6818,techworm21,2,0.00060,326450,98.56404,331206
6819,teihoo,2,0.00060,326452,98.56464,331206
6820,teki,2,0.00060,326454,98.56524,331206
6821,Teknologicus,2,0.00060,326456,98.56585,331206
6822,TenDrunkMonks,2,0.00060,326458,98.56645,331206
6823,TensorTom,2,0.00060,326460,98.56705,331206
6824,terepaii,2,0.00060,326462,98.56766,331206
6825,thagberg,2,0.00060,326464,98.56826,331206
6826,thaSeNNiN,2,0.00060,326466,98.56887,331206
6827,TheArthurius,2,0.00060,326468,98.56947,331206
6828,Thebas,2,0.00060,326470,98.57007,331206
6829,TheBricktop,2,0.00060,326472,98.57068,331206
6830,TheBritain,2,0.00060,326474,98.57128,331206
6831,TheBrunoMiguel,2,0.00060,326476,98.57189,331206
6832,TheCodeNinja,2,0.00060,326478,98.57249,331206
6833,thecodethinker,2,0.00060,326480,98.57309,331206
6834,The-EDev,2,0.00060,326482,98.57370,331206
6835,TheFacto,2,0.00060,326484,98.57430,331206
6836,TheFamousRat,2,0.00060,326486,98.57491,331206
6837,thefryscorer,2,0.00060,326488,98.57551,331206
6838,TheHumanMachine,2,0.00060,326490,98.57611,331206
6839,TheHypeTrain,2,0.00060,326492,98.57672,331206
6840,theketchupdude,2,0.00060,326494,98.57732,331206
6841,Theliamx,2,0.00060,326496,98.57792,331206
6842,TheMagnat,2,0.00060,326498,98.57853,331206
6843,TheNamesGregoryAndounuts,2,0.00060,326500,98.57913,331206
6844,The-O-King,2,0.00060,326502,98.57974,331206
6845,ThePhisch,2,0.00060,326504,98.58034,331206
6846,ThePixelGuy,2,0.00060,326506,98.58094,331206
6847,therahedwig,2,0.00060,326508,98.58155,331206
6848,TheRealGammer,2,0.00060,326510,98.58215,331206
6849,TheSink,2,0.00060,326512,98.58276,331206
6850,TheSpydog,2,0.00060,326514,98.58336,331206
6851,theZadek,2,0.00060,326516,98.58396,331206
6852,thinkier-tim,2,0.00060,326518,98.58457,331206
6853,ThitTheThit,2,0.00060,326520,98.58517,331206
6854,thomak-dev,2,0.00060,326522,98.58577,331206
6855,ThomasMorley-T3D,2,0.00060,326524,98.58638,331206
6856,thomasRandall-git,2,0.00060,326526,98.58698,331206
6857,thorthur,2,0.00060,326528,98.58759,331206
6858,ThreeMileJump,2,0.00060,326530,98.58819,331206
6859,thunderk,2,0.00060,326532,98.58879,331206
6860,tiagomsa,2,0.00060,326534,98.58940,331206
6861,Tiberion000,2,0.00060,326536,98.59000,331206
6862,TintaKnight,2,0.00060,326538,98.59061,331206
6863,tinyBigGAMES,2,0.00060,326540,98.59121,331206
6864,TisFoolish,2,0.00060,326542,98.59181,331206
6865,tj4752,2,0.00060,326544,98.59242,331206
6866,Tkaewkunha,2,0.00060,326546,98.59302,331206
6867,tle-stratus,2,0.00060,326548,98.59362,331206
6868,tlitookilakin,2,0.00060,326550,98.59423,331206
6869,toddhd,2,0.00060,326552,98.59483,331206
6870,token-cjg,2,0.00060,326554,98.59544,331206
6871,tolga9009,2,0.00060,326556,98.59604,331206
6872,tolgakaranlik,2,0.00060,326558,98.59664,331206
6873,Tomisin127,2,0.00060,326560,98.59725,331206
6874,tomwassing,2,0.00060,326562,98.59785,331206
6875,tonyrh,2,0.00060,326564,98.59846,331206
6876,torresguilherme,2,0.00060,326566,98.59906,331206
6877,TotallyGatsby,2,0.00060,326568,98.59966,331206
6878,Trafel,2,0.00060,326570,98.60027,331206
6879,Tralexium,2,0.00060,326572,98.60087,331206
6880,TrevSaysHi,2,0.00060,326574,98.60147,331206
6881,TrickyFatCat,2,0.00060,326576,98.60208,331206
6882,triko88,2,0.00060,326578,98.60268,331206
6883,Trois-as,2,0.00060,326580,98.60329,331206
6884,trollodel,2,0.00060,326582,98.60389,331206
6885,trooper,2,0.00060,326584,98.60449,331206
6886,trsBasicLine10,2,0.00060,326586,98.60510,331206
6887,Tsar333,2,0.00060,326588,98.60570,331206
6888,tulsidaskhatri,2,0.00060,326590,98.60631,331206
6889,tungkradle,2,0.00060,326592,98.60691,331206
6890,tuxalin,2,0.00060,326594,98.60751,331206
6891,Tvs-Frank,2,0.00060,326596,98.60812,331206
6892,ulissescad,2,0.00060,326598,98.60872,331206
6893,Underwaterbob,2,0.00060,326600,98.60932,331206
6894,unelsson,2,0.00060,326602,98.60993,331206
6895,UnknownSkyrimPasserby,2,0.00060,326604,98.61053,331206
6896,uoji,2,0.00060,326606,98.61114,331206
6897,UPetit,2,0.00060,326608,98.61174,331206
6898,UpwindSpring01,2,0.00060,326610,98.61234,331206
6899,UsmaanSahak,2,0.00060,326612,98.61295,331206
6900,Vaasref,2,0.00060,326614,98.61355,331206
6901,va-de,2,0.00060,326616,98.61416,331206
6902,Vadkline,2,0.00060,326618,98.61476,331206
6903,valfus,2,0.00060,326620,98.61536,331206
6904,Valkia-INNOS,2,0.00060,326622,98.61597,331206
6905,Vallentin,2,0.00060,326624,98.61657,331206
6906,ValooFX,2,0.00060,326626,98.61717,331206
6907,Valtrouble44,2,0.00060,326628,98.61778,331206
6908,vayan,2,0.00060,326630,98.61838,331206
6909,vbousquet,2,0.00060,326632,98.61899,331206
6910,vekkna,2,0.00060,326634,98.61959,331206
6911,vektrix1,2,0.00060,326636,98.62019,331206
6912,velenux,2,0.00060,326638,98.62080,331206
6913,venomdev,2,0.00060,326640,98.62140,331206
6914,vesan66,2,0.00060,326642,98.62201,331206
6915,vgmoose,2,0.00060,326644,98.62261,331206
6916,VictorGonzalezFernandez,2,0.00060,326646,98.62321,331206
6917,VictorHASilva,2,0.00060,326648,98.62382,331206
6918,Vignesh1-art,2,0.00060,326650,98.62442,331206
6919,Vikingjonsson,2,0.00060,326652,98.62502,331206
6920,vince94,2,0.00060,326654,98.62563,331206
6921,VincentSinel,2,0.00060,326656,98.62623,331206
6922,Vine2D,2,0.00060,326658,98.62684,331206
6923,vinurd,2,0.00060,326660,98.62744,331206
6924,VioletasTheThird,2,0.00060,326662,98.62804,331206
6925,Viridflow,2,0.00060,326664,98.62865,331206
6926,viroidgames,2,0.00060,326666,98.62925,331206
6927,viteo,2,0.00060,326668,98.62986,331206
6928,VlachJosef,2,0.00060,326670,98.63046,331206
6929,vmpajares,2,0.00060,326672,98.63106,331206
6930,volffili,2,0.00060,326674,98.63167,331206
6931,vopi181,2,0.00060,326676,98.63227,331206
6932,vtepe,2,0.00060,326678,98.63288,331206
6933,Vulganot,2,0.00060,326680,98.63348,331206
6934,vvinhas,2,0.00060,326682,98.63408,331206
6935,vzaramel,2,0.00060,326684,98.63469,331206
6936,wacyym,2,0.00060,326686,98.63529,331206
6937,wahur666,2,0.00060,326688,98.63589,331206
6938,WarpspeedSCP,2,0.00060,326690,98.63650,331206
6939,wf192,2,0.00060,326692,98.63710,331206
6940,whendricso,2,0.00060,326694,98.63771,331206
6941,whilke,2,0.00060,326696,98.63831,331206
6942,wihrl,2,0.00060,326698,98.63891,331206
6943,wildwinni,2,0.00060,326700,98.63952,331206
6944,williamclarkmcbride,2,0.00060,326702,98.64012,331206
6945,windsurfer,2,0.00060,326704,98.64073,331206
6946,WinnerEX,2,0.00060,326706,98.64133,331206
6947,WinterVein,2,0.00060,326708,98.64193,331206
6948,wirwoluf,2,0.00060,326710,98.64254,331206
6949,wlsnxx,2,0.00060,326712,98.64314,331206
6950,wluckin,2,0.00060,326714,98.64374,331206
6951,Wolf17777,2,0.00060,326716,98.64435,331206
6952,WolfAtNight,2,0.00060,326718,98.64495,331206
6953,Wolfcrux,2,0.00060,326720,98.64556,331206
6954,wrbeck,2,0.00060,326722,98.64616,331206
6955,wrrwrr111,2,0.00060,326724,98.64676,331206
6956,WuBuzi,2,0.00060,326726,98.64737,331206
6957,wyattjsmith1,2,0.00060,326728,98.64797,331206
6958,Wykleph,2,0.00060,326730,98.64858,331206
6959,Xascoria,2,0.00060,326732,98.64918,331206
6960,XBigTK13X,2,0.00060,326734,98.64978,331206
6961,XenonCoder,2,0.00060,326736,98.65039,331206
6962,xiaozhuai,2,0.00060,326738,98.65099,331206
6963,XNargaHuntress,2,0.00060,326740,98.65159,331206
6964,xndcn,2,0.00060,326742,98.65220,331206
6965,xoSauce,2,0.00060,326744,98.65280,331206
6966,xPaw,2,0.00060,326746,98.65341,331206
6967,xpvpc,2,0.00060,326748,98.65401,331206
6968,xyzzy45,2,0.00060,326750,98.65461,331206
6969,yafacex,2,0.00060,326752,98.65522,331206
6970,Ybalrid,2,0.00060,326754,98.65582,331206
6971,Yeryomin1,2,0.00060,326756,98.65643,331206
6972,yigitgursoy,2,0.00060,326758,98.65703,331206
6973,yixiaoqingyuz,2,0.00060,326760,98.65763,331206
6974,YodamanJer,2,0.00060,326762,98.65824,331206
6975,yonni12,2,0.00060,326764,98.65884,331206
6976,ysharlaimov,2,0.00060,326766,98.65944,331206
6977,YuChaoGithub,2,0.00060,326768,98.66005,331206
6978,Yuki001,2,0.00060,326770,98.66065,331206
6979,yuvallanger,2,0.00060,326772,98.66126,331206
6980,z547743799,2,0.00060,326774,98.66186,331206
6981,Zababon,2,0.00060,326776,98.66246,331206
6982,Zacxalot,2,0.00060,326778,98.66307,331206
6983,Zaerei,2,0.00060,326780,98.66367,331206
6984,zakkor,2,0.00060,326782,98.66428,331206
6985,zanew,2,0.00060,326784,98.66488,331206
6986,Zaraka,2,0.00060,326786,98.66548,331206
6987,ZeBirosca,2,0.00060,326788,98.66609,331206
6988,zgub4,2,0.00060,326790,98.66669,331206
6989,zhengying,2,0.00060,326792,98.66729,331206
6990,ZhiTravelsNorth,2,0.00060,326794,98.66790,331206
6991,zigaosolin,2,0.00060,326796,98.66850,331206
6992,Zincr0,2,0.00060,326798,98.66911,331206
6993,zochris,2,0.00060,326800,98.66971,331206
6994,zoford,2,0.00060,326802,98.67031,331206
6995,zontreck,2,0.00060,326804,98.67092,331206
6996,zzz6519003,2,0.00060,326806,98.67152,331206
6997,0Shie0,1,0.00030,326807,98.67182,331206
6998,0shine0,1,0.00030,326808,98.67213,331206
6999,0x0177b11f,1,0.00030,326809,98.67243,331206
7000,0xafbf,1,0.00030,326810,98.67273,331206
7001,10c8,1,0.00030,326811,98.67303,331206
7002,123epsilon,1,0.00030,326812,98.67333,331206
7003,123idiot185,1,0.00030,326813,98.67364,331206
7004,123maxmix123,1,0.00030,326814,98.67394,331206
7005,1F1R5T,1,0.00030,326815,98.67424,331206
7006,1j01,1,0.00030,326816,98.67454,331206
7007,1l0,1,0.00030,326817,98.67484,331206
7008,1vanK,1,0.00030,326818,98.67514,331206
7009,20PercentRendered,1,0.00030,326819,98.67545,331206
7010,27163,1,0.00030,326820,98.67575,331206
7011,2blackbar,1,0.00030,326821,98.67605,331206
7012,2GoodPhoU,1,0.00030,326822,98.67635,331206
7013,2rsvold,1,0.00030,326823,98.67665,331206
7014,2tefan,1,0.00030,326824,98.67696,331206
7015,306760,1,0.00030,326825,98.67726,331206
7016,3demax,1,0.00030,326826,98.67756,331206
7017,4ctarus,1,0.00030,326827,98.67786,331206
7018,4lph4-Ph4un,1,0.00030,326828,98.67816,331206
7019,66945,1,0.00030,326829,98.67847,331206
7020,7-Core,1,0.00030,326830,98.67877,331206
7021,7sDream,1,0.00030,326831,98.67907,331206
7022,aaaaaaandreas,1,0.00030,326832,98.67937,331206
7023,aalhitennf,1,0.00030,326833,98.67967,331206
7024,aamir-abbas,1,0.00030,326834,98.67998,331206
7025,AandersonL,1,0.00030,326835,98.68028,331206
7026,aarongerber,1,0.00030,326836,98.68058,331206
7027,aaronmondal,1,0.00030,326837,98.68088,331206
7028,aaronsnoswell,1,0.00030,326838,98.68118,331206
7029,AaronSpeedy,1,0.00030,326839,98.68149,331206
7030,Aarstad,1,0.00030,326840,98.68179,331206
7031,Aasdyfi,1,0.00030,326841,98.68209,331206
7032,abaha2207,1,0.00030,326842,98.68239,331206
7033,abayerle1,1,0.00030,326843,98.68269,331206
7034,abdalrahmanhamami,1,0.00030,326844,98.68299,331206
7035,abecus,1,0.00030,326845,98.68330,331206
7036,abehaskins,1,0.00030,326846,98.68360,331206
7037,abelard-l,1,0.00030,326847,98.68390,331206
7038,abhilash1910,1,0.00030,326848,98.68420,331206
7039,AbnerSantos,1,0.00030,326849,98.68450,331206
7040,abrajam92,1,0.00030,326850,98.68481,331206
7041,abrenneke,1,0.00030,326851,98.68511,331206
7042,abreulima,1,0.00030,326852,98.68541,331206
7043,Abstract-Everything,1,0.00030,326853,98.68571,331206
7044,Abystus,1,0.00030,326854,98.68601,331206
7045,ACatThatPrograms,1,0.00030,326855,98.68632,331206
7046,Aceba1,1,0.00030,326856,98.68662,331206
7047,AceyT,1,0.00030,326857,98.68692,331206
7048,Achi92,1,0.00030,326858,98.68722,331206
7049,ackens,1,0.00030,326859,98.68752,331206
7050,Aculeo,1,0.00030,326860,98.68783,331206
7051,adalinesimonian,1,0.00030,326861,98.68813,331206
7052,Adam13531,1,0.00030,326862,98.68843,331206
7053,adampeled,1,0.00030,326863,98.68873,331206
7054,adamrej,1,0.00030,326864,98.68903,331206
7055,adamryczkowski,1,0.00030,326865,98.68934,331206
7056,AdamSGit,1,0.00030,326866,98.68964,331206
7057,adamspruijt,1,0.00030,326867,98.68994,331206
7058,adderly,1,0.00030,326868,98.69024,331206
7059,adimasduvitra,1,0.00030,326869,98.69054,331206
7060,AdityaCheruvu,1,0.00030,326870,98.69084,331206
7061,adrinux,1,0.00030,326871,98.69115,331206
7062,Ads20000,1,0.00030,326872,98.69145,331206
7063,adsmalley,1,0.00030,326873,98.69175,331206
7064,AdventurousDrake,1,0.00030,326874,98.69205,331206
7065,adxsoft,1,0.00030,326875,98.69235,331206
7066,aedart,1,0.00030,326876,98.69266,331206
7067,aegent,1,0.00030,326877,98.69296,331206
7068,aelspire,1,0.00030,326878,98.69326,331206
7069,aerger,1,0.00030,326879,98.69356,331206
7070,Aeropulu,1,0.00030,326880,98.69386,331206
7071,afeather123,1,0.00030,326881,98.69417,331206
7072,Aff8,1,0.00030,326882,98.69447,331206
7073,AFWSI,1,0.00030,326883,98.69477,331206
7074,AgentAvis,1,0.00030,326884,98.69507,331206
7075,agentzz9,1,0.00030,326885,98.69537,331206
7076,aggsol,1,0.00030,326886,98.69568,331206
7077,aghull,1,0.00030,326887,98.69598,331206
7078,AHAHACKA,1,0.00030,326888,98.69628,331206
7079,ahayzen,1,0.00030,326889,98.69658,331206
7080,ahibal,1,0.00030,326890,98.69688,331206
7081,ahmedminhaj,1,0.00030,326891,98.69719,331206
7082,Aidan-85,1,0.00030,326892,98.69749,331206
7083,aidanoflann,1,0.00030,326893,98.69779,331206
7084,aidenpain,1,0.00030,326894,98.69809,331206
7085,Aimarekin,1,0.00030,326895,98.69839,331206
7086,ajboni,1,0.00030,326896,98.69870,331206
7087,ajferrario,1,0.00030,326897,98.69900,331206
7088,akibabu,1,0.00030,326898,98.69930,331206
7089,aki-cat,1,0.00030,326899,98.69960,331206
7090,aKidCalledAris,1,0.00030,326900,98.69990,331206
7091,AkimboEG,1,0.00030,326901,98.70020,331206
7092,AkiraKeals1992,1,0.00030,326902,98.70051,331206
7093,akovaski,1,0.00030,326903,98.70081,331206
7094,alandao,1,0.00030,326904,98.70111,331206
7095,alandoni,1,0.00030,326905,98.70141,331206
7096,alan-j-hu,1,0.00030,326906,98.70171,331206
7097,alankemp,1,0.00030,326907,98.70202,331206
7098,alastair-JL,1,0.00030,326908,98.70232,331206
7099,al-barwani,1,0.00030,326909,98.70262,331206
7100,AlbertMontagutCasero,1,0.00030,326910,98.70292,331206
7101,Albertolopezs,1,0.00030,326911,98.70322,331206
7102,Alcamez,1,0.00030,326912,98.70353,331206
7103,aldebaran798,1,0.00030,326913,98.70383,331206
7104,alecsantos96,1,0.00030,326914,98.70413,331206
7105,alemansec,1,0.00030,326915,98.70443,331206
7106,AlessioCorridori,1,0.00030,326916,98.70473,331206
7107,alex8141,1,0.00030,326917,98.70504,331206
7108,alexfacciorusso,1,0.00030,326918,98.70534,331206
7109,alexforbes,1,0.00030,326919,98.70564,331206
7110,alexfriesen,1,0.00030,326920,98.70594,331206
7111,AlexHCC,1,0.00030,326921,98.70624,331206
7112,alexm622,1,0.00030,326922,98.70655,331206
7113,alexpana,1,0.00030,326923,98.70685,331206
7114,Alexsis987,1,0.00030,326924,98.70715,331206
7115,alfansuffa05,1,0.00030,326925,98.70745,331206
7116,algor512,1,0.00030,326926,98.70775,331206
7117,aliasbody,1,0.00030,326927,98.70805,331206
7118,alibix,1,0.00030,326928,98.70836,331206
7119,ALipAkrohk,1,0.00030,326929,98.70866,331206
7120,alishir,1,0.00030,326930,98.70896,331206
7121,all-iver,1,0.00030,326931,98.70926,331206
7122,allphfa,1,0.00030,326932,98.70956,331206
7123,almacero,1,0.00030,326933,98.70987,331206
7124,almighty-atlas,1,0.00030,326934,98.71017,331206
7125,AlmirNeeto99,1,0.00030,326935,98.71047,331206
7126,aloisdeniel,1,0.00030,326936,98.71077,331206
7127,alokranjan1234,1,0.00030,326937,98.71107,331206
7128,Alphasoup,1,0.00030,326938,98.71138,331206
7129,Alriightyman,1,0.00030,326939,98.71168,331206
7130,alroyo,1,0.00030,326940,98.71198,331206
7131,AlseinX,1,0.00030,326941,98.71228,331206
7132,alukreis,1,0.00030,326942,98.71258,331206
7133,AlvarBer,1,0.00030,326943,98.71289,331206
7134,AlvarezAriel,1,0.00030,326944,98.71319,331206
7135,AlwaysHungrie,1,0.00030,326945,98.71349,331206
7136,alwex,1,0.00030,326946,98.71379,331206
7137,AmagicalFishy,1,0.00030,326947,98.71409,331206
7138,amarsahinovic,1,0.00030,326948,98.71440,331206
7139,amcolash,1,0.00030,326949,98.71470,331206
7140,amhndu,1,0.00030,326950,98.71500,331206
7141,Amil-francescolima74,1,0.00030,326951,98.71530,331206
7142,amireldor,1,0.00030,326952,98.71560,331206
7143,amit6663,1,0.00030,326953,98.71590,331206
7144,AnarcoCapitalCapo,1,0.00030,326954,98.71621,331206
7145,anatagawa,1,0.00030,326955,98.71651,331206
7146,AnchoDotto,1,0.00030,326956,98.71681,331206
7147,andersmkruke,1,0.00030,326957,98.71711,331206
7148,andersoncsmat,1,0.00030,326958,98.71741,331206
7149,AndersonVale,1,0.00030,326959,98.71772,331206
7150,anders-s,1,0.00030,326960,98.71802,331206
7151,andfaxle,1,0.00030,326961,98.71832,331206
7152,Ando,1,0.00030,326962,98.71862,331206
7153,and-rad,1,0.00030,326963,98.71892,331206
7154,Andre12Lazaro,1,0.00030,326964,98.71923,331206
7155,AndreiBochar,1,0.00030,326965,98.71953,331206
7156,andreScutieri,1,0.00030,326966,98.71983,331206
7157,andresfelipemendez,1,0.00030,326967,98.72013,331206
7158,andrew121410,1,0.00030,326968,98.72043,331206
7159,andrewebdev,1,0.00030,326969,98.72074,331206
7160,andrewmwalker98,1,0.00030,326970,98.72104,331206
7161,andrewtu0182,1,0.00030,326971,98.72134,331206
7162,andrewvaughan,1,0.00030,326972,98.72164,331206
7163,andycodesstuff,1,0.00030,326973,98.72194,331206
7164,AnEnigmaticBug,1,0.00030,326974,98.72225,331206
7165,angadmishra,1,0.00030,326975,98.72255,331206
7166,AngeDemo599,1,0.00030,326976,98.72285,331206
7167,angelmixu,1,0.00030,326977,98.72315,331206
7168,Anheurystics,1,0.00030,326978,98.72345,331206
7169,animusblue,1,0.00030,326979,98.72376,331206
7170,Aninuscsalas,1,0.00030,326980,98.72406,331206
7171,anirudh24seven,1,0.00030,326981,98.72436,331206
7172,Ankk98,1,0.00030,326982,98.72466,331206
7173,anogro,1,0.00030,326983,98.72496,331206
7174,AnomalRoil,1,0.00030,326984,98.72526,331206
7175,ans3pl,1,0.00030,326985,98.72557,331206
7176,antonb-perfecto,1,0.00030,326986,98.72587,331206
7177,antoniocarreiro,1,0.00030,326987,98.72617,331206
7178,Antonz0,1,0.00030,326988,98.72647,331206
7179,antopilo,1,0.00030,326989,98.72677,331206
7180,antv199,1,0.00030,326990,98.72708,331206
7181,anula,1,0.00030,326991,98.72738,331206
7182,anunknowperson,1,0.00030,326992,98.72768,331206
7183,apaza610,1,0.00030,326993,98.72798,331206
7184,aplut,1,0.00030,326994,98.72828,331206
7185,apodtele,1,0.00030,326995,98.72859,331206
7186,Appeltabak,1,0.00030,326996,98.72889,331206
7187,approxdec,1,0.00030,326997,98.72919,331206
7188,Appsmofera,1,0.00030,326998,98.72949,331206
7189,Appw0905,1,0.00030,326999,98.72979,331206
7190,ar1a,1,0.00030,327000,98.73010,331206
7191,aragalie,1,0.00030,327001,98.73040,331206
7192,aranha92,1,0.00030,327002,98.73070,331206
7193,arawkins,1,0.00030,327003,98.73100,331206
7194,Arax89,1,0.00030,327004,98.73130,331206
7195,Arbint,1,0.00030,327005,98.73161,331206
7196,Archina,1,0.00030,327006,98.73191,331206
7197,archmage,1,0.00030,327007,98.73221,331206
7198,Archoney,1,0.00030,327008,98.73251,331206
7199,ardawan,1,0.00030,327009,98.73281,331206
7200,arguiot,1,0.00030,327010,98.73311,331206
7201,arigbs,1,0.00030,327011,98.73342,331206
7202,Arijit265,1,0.00030,327012,98.73372,331206
7203,arijoon,1,0.00030,327013,98.73402,331206
7204,ARJayDEV,1,0.00030,327014,98.73432,331206
7205,arjemour,1,0.00030,327015,98.73462,331206
7206,Ark2000,1,0.00030,327016,98.73493,331206
7207,arkinsamedi,1,0.00030,327017,98.73523,331206
7208,Arkinum,1,0.00030,327018,98.73553,331206
7209,Armanlex,1,0.00030,327019,98.73583,331206
7210,arnedirlelwy,1,0.00030,327020,98.73613,331206
7211,arostom,1,0.00030,327021,98.73644,331206
7212,ArsCreativa,1,0.00030,327022,98.73674,331206
7213,arsen-ch,1,0.00030,327023,98.73704,331206
7214,artdeell,1,0.00030,327024,98.73734,331206
7215,artems37rus,1,0.00030,327025,98.73764,331206
7216,arthurkehrwald,1,0.00030,327026,98.73795,331206
7217,artiescie,1,0.00030,327027,98.73825,331206
7218,arturertel,1,0.00030,327028,98.73855,331206
7219,arusenpai,1,0.00030,327029,98.73885,331206
7220,arvejeitor,1,0.00030,327030,98.73915,331206
7221,AscendeSuperius,1,0.00030,327031,98.73946,331206
7222,ash1247,1,0.00030,327032,98.73976,331206
7223,ashak,1,0.00030,327033,98.74006,331206
7224,ashandme,1,0.00030,327034,98.74036,331206
7225,asheratnoveltyfactor,1,0.00030,327035,98.74066,331206
7226,ashfidable,1,0.00030,327036,98.74096,331206
7227,ashishpatelcs,1,0.00030,327037,98.74127,331206
7228,AsixJin,1,0.00030,327038,98.74157,331206
7229,astalarico,1,0.00030,327039,98.74187,331206
7230,Astavie,1,0.00030,327040,98.74217,331206
7231,astearon,1,0.00030,327041,98.74247,331206
7232,AstemirK,1,0.00030,327042,98.74278,331206
7233,Astr01d,1,0.00030,327043,98.74308,331206
7234,AstroBoogie,1,0.00030,327044,98.74338,331206
7235,astroneer,1,0.00030,327045,98.74368,331206
7236,AstroStucky,1,0.00030,327046,98.74398,331206
7237,asusralis,1,0.00030,327047,98.74429,331206
7238,ASxa86,1,0.00030,327048,98.74459,331206
7239,atari-8bit,1,0.00030,327049,98.74489,331206
7240,Athsmar,1,0.00030,327050,98.74519,331206
7241,atom-fr,1,0.00030,327051,98.74549,331206
7242,AtomicFirefox,1,0.00030,327052,98.74580,331206
7243,aurorum999,1,0.00030,327053,98.74610,331206
7244,austinclem1,1,0.00030,327054,98.74640,331206
7245,AustinMackGameDev,1,0.00030,327055,98.74670,331206
7246,AutoMania,1,0.00030,327056,98.74700,331206
7247,auzden,1,0.00030,327057,98.74731,331206
7248,auztec,1,0.00030,327058,98.74761,331206
7249,avedar,1,0.00030,327059,98.74791,331206
7250,AVenzor,1,0.00030,327060,98.74821,331206
7251,avinashbn2,1,0.00030,327061,98.74851,331206
7252,Avindr,1,0.00030,327062,98.74881,331206
7253,avmrarmstrong,1,0.00030,327063,98.74912,331206
7254,avrame,1,0.00030,327064,98.74942,331206
7255,Awalvie,1,0.00030,327065,98.74972,331206
7256,axe-box,1,0.00030,327066,98.75002,331206
7257,Axelaredz,1,0.00030,327067,98.75032,331206
7258,Axol3,1,0.00030,327068,98.75063,331206
7259,aydjay,1,0.00030,327069,98.75093,331206
7260,ayndqy,1,0.00030,327070,98.75123,331206
7261,ayrat555,1,0.00030,327071,98.75153,331206
7262,aytekk,1,0.00030,327072,98.75183,331206
7263,azmrv,1,0.00030,327073,98.75214,331206
7264,Azumgi,1,0.00030,327074,98.75244,331206
7265,b2800,1,0.00030,327075,98.75274,331206
7266,B4DNetwork,1,0.00030,327076,98.75304,331206
7267,bahelit,1,0.00030,327077,98.75334,331206
7268,Bakainkorp,1,0.00030,327078,98.75365,331206
7269,bakenshake,1,0.00030,327079,98.75395,331206
7270,BalaDeSilver,1,0.00030,327080,98.75425,331206
7271,BalamChaac,1,0.00030,327081,98.75455,331206
7272,Banbury,1,0.00030,327082,98.75485,331206
7273,BanjoCollie,1,0.00030,327083,98.75516,331206
7274,Banjomike97,1,0.00030,327084,98.75546,331206
7275,banti101,1,0.00030,327085,98.75576,331206
7276,baptistepouget,1,0.00030,327086,98.75606,331206
7277,barefists,1,0.00030,327087,98.75636,331206
7278,BarelyAliveMau5,1,0.00030,327088,98.75667,331206
7279,BaronGames,1,0.00030,327089,98.75697,331206
7280,baseballpunt,1,0.00030,327090,98.75727,331206
7281,basiszwo,1,0.00030,327091,98.75757,331206
7282,BasitCode,1,0.00030,327092,98.75787,331206
7283,BastionInCzech,1,0.00030,327093,98.75817,331206
7284,baumschubser,1,0.00030,327094,98.75848,331206
7285,bazoka33,1,0.00030,327095,98.75878,331206
7286,bbooth87,1,0.00030,327096,98.75908,331206
7287,Bcheow,1,0.00030,327097,98.75938,331206
7288,BCleveland,1,0.00030,327098,98.75968,331206
7289,bcsmith2846,1,0.00030,327099,98.75999,331206
7290,Beafantles,1,0.00030,327100,98.76029,331206
7291,bearman92,1,0.00030,327101,98.76059,331206
7292,BeatriceFendt,1,0.00030,327102,98.76089,331206
7293,beegor,1,0.00030,327103,98.76119,331206
7294,beeryt,1,0.00030,327104,98.76150,331206
7295,behdad,1,0.00030,327105,98.76180,331206
7296,Beider,1,0.00030,327106,98.76210,331206
7297,benbotwin,1,0.00030,327107,98.76240,331206
7298,BenedictAllen,1,0.00030,327108,98.76270,331206
7299,bengtsts,1,0.00030,327109,98.76301,331206
7300,benitogf,1,0.00030,327110,98.76331,331206
7301,BenjaminSauder,1,0.00030,327111,98.76361,331206
7302,benjaminsuhr,1,0.00030,327112,98.76391,331206
7303,benji011,1,0.00030,327113,98.76421,331206
7304,benkaranja,1,0.00030,327114,98.76452,331206
7305,benmoran56,1,0.00030,327115,98.76482,331206
7306,benrstraw,1,0.00030,327116,98.76512,331206
7307,benstopics,1,0.00030,327117,98.76542,331206
7308,BenVercammen,1,0.00030,327118,98.76572,331206
7309,benwolf,1,0.00030,327119,98.76602,331206
7310,beregolas,1,0.00030,327120,98.76633,331206
7311,BernhardWerner,1,0.00030,327121,98.76663,331206
7312,betalars,1,0.00030,327122,98.76693,331206
7313,Betogcc,1,0.00030,327123,98.76723,331206
7314,beudbeud,1,0.00030,327124,98.76753,331206
7315,bfhobbes,1,0.00030,327125,98.76784,331206
7316,bflanagin,1,0.00030,327126,98.76814,331206
7317,bfoo75,1,0.00030,327127,98.76844,331206
7318,Bibekz-dev,1,0.00030,327128,98.76874,331206
7319,bigwebsite,1,0.00030,327129,98.76904,331206
7320,billy1380,1,0.00030,327130,98.76935,331206
7321,bimblewizard,1,0.00030,327131,98.76965,331206
7322,binaryorange,1,0.00030,327132,98.76995,331206
7323,bionick7,1,0.00030,327133,98.77025,331206
7324,Birdwards,1,0.00030,327134,98.77055,331206
7325,bisbas,1,0.00030,327135,98.77086,331206
7326,bitbrain,1,0.00030,327136,98.77116,331206
7327,BitTim,1,0.00030,327137,98.77146,331206
7328,bkanber,1,0.00030,327138,98.77176,331206
7329,bkapukaranov,1,0.00030,327139,98.77206,331206
7330,bkhl,1,0.00030,327140,98.77237,331206
7331,bkoklu001,1,0.00030,327141,98.77267,331206
7332,Blackhornet2134,1,0.00030,327142,98.77297,331206
7333,Blackiris,1,0.00030,327143,98.77327,331206
7334,BlackJitsu,1,0.00030,327144,98.77357,331206
7335,BlackScorp,1,0.00030,327145,98.77387,331206
7336,blackwire,1,0.00030,327146,98.77418,331206
7337,blake59,1,0.00030,327147,98.77448,331206
7338,blam9,1,0.00030,327148,98.77478,331206
7339,blazelink3,1,0.00030,327149,98.77508,331206
7340,bleknoir,1,0.00030,327150,98.77538,331206
7341,blendermed,1,0.00030,327151,98.77569,331206
7342,BlenderSleuth,1,0.00030,327152,98.77599,331206
7343,Blendify,1,0.00030,327153,98.77629,331206
7344,bleuthoot-sven,1,0.00030,327154,98.77659,331206
7345,bliksemman,1,0.00030,327155,98.77689,331206
7346,blinry,1,0.00030,327156,98.77720,331206
7347,Blizbor,1,0.00030,327157,98.77750,331206
7348,BliznyukNM,1,0.00030,327158,98.77780,331206
7349,bluebarnacles,1,0.00030,327159,98.77810,331206
7350,BlueG,1,0.00030,327160,98.77840,331206
7351,blueice08,1,0.00030,327161,98.77871,331206
7352,blumomatic,1,0.00030,327162,98.77901,331206
7353,bmillare,1,0.00030,327163,98.77931,331206
7354,bmollot,1,0.00030,327164,98.77961,331206
7355,bmwalters,1,0.00030,327165,98.77991,331206
7356,bnicholl,1,0.00030,327166,98.78022,331206
7357,bobbles911,1,0.00030,327167,98.78052,331206
7358,BodeDias,1,0.00030,327168,98.78082,331206
7359,BodeSpezial,1,0.00030,327169,98.78112,331206
7360,BoLindJensen,1,0.00030,327170,98.78142,331206
7361,BonarBeavis,1,0.00030,327171,98.78172,331206
7362,bonzio,1,0.00030,327172,98.78203,331206
7363,boquetipo,1,0.00030,327173,98.78233,331206
7364,borgdylan,1,0.00030,327174,98.78263,331206
7365,bostich83,1,0.00030,327175,98.78293,331206
7366,bottitytto,1,0.00030,327176,98.78323,331206
7367,Boulougou,1,0.00030,327177,98.78354,331206
7368,bozydar,1,0.00030,327178,98.78384,331206
7369,braceforimpact,1,0.00030,327179,98.78414,331206
7370,braedenf,1,0.00030,327180,98.78444,331206
7371,brainDOA,1,0.00030,327181,98.78474,331206
7372,Bramdalf,1,0.00030,327182,98.78505,331206
7373,branc116,1,0.00030,327183,98.78535,331206
7374,BrandonMakin,1,0.00030,327184,98.78565,331206
7375,branegames,1,0.00030,327185,98.78595,331206
7376,Brankec,1,0.00030,327186,98.78625,331206
7377,breezystatic77,1,0.00030,327187,98.78656,331206
7378,brempusz,1,0.00030,327188,98.78686,331206
7379,brendanmoyer,1,0.00030,327189,98.78716,331206
7380,BrianCook,1,0.00030,327190,98.78746,331206
7381,BrIt-neY,1,0.00030,327191,98.78776,331206
7382,broccoligamedev,1,0.00030,327192,98.78807,331206
7383,Broedy-BRX,1,0.00030,327193,98.78837,331206
7384,brokeyourbike,1,0.00030,327194,98.78867,331206
7385,bruh0,1,0.00030,327195,98.78897,331206
7386,brunoferreira94,1,0.00030,327196,98.78927,331206
7387,bruno-ortizgb,1,0.00030,327197,98.78958,331206
7388,brunurd,1,0.00030,327198,98.78988,331206
7389,bryan2207,1,0.00030,327199,98.79018,331206
7390,BryanEnid,1,0.00030,327200,98.79048,331206
7391,bspear8,1,0.00030,327201,98.79078,331206
7392,btk2392,1,0.00030,327202,98.79108,331206
7393,BTK-InterBlock,1,0.00030,327203,98.79139,331206
7394,Bubbad,1,0.00030,327204,98.79169,331206
7395,buefox,1,0.00030,327205,98.79199,331206
7396,BugBiteSquared,1,0.00030,327206,98.79229,331206
7397,buildersteven4,1,0.00030,327207,98.79259,331206
7398,Bumerang47,1,0.00030,327208,98.79290,331206
7399,Busata,1,0.00030,327209,98.79320,331206
7400,buscon,1,0.00030,327210,98.79350,331206
7401,butkeim,1,0.00030,327211,98.79380,331206
7402,bvdelft,1,0.00030,327212,98.79410,331206
7403,bwDialogs,1,0.00030,327213,98.79441,331206
7404,byDave251,1,0.00030,327214,98.79471,331206
7405,C0MPAQ,1,0.00030,327215,98.79501,331206
7406,c0ppo,1,0.00030,327216,98.79531,331206
7407,caburet,1,0.00030,327217,98.79561,331206
7408,Cadmik,1,0.00030,327218,98.79592,331206
7409,caiocutrim,1,0.00030,327219,98.79622,331206
7410,CalebJohn,1,0.00030,327220,98.79652,331206
7411,calegxm999,1,0.00030,327221,98.79682,331206
7412,CallumDev,1,0.00030,327222,98.79712,331206
7413,calumk,1,0.00030,327223,98.79743,331206
7414,Cambysses,1,0.00030,327224,98.79773,331206
7415,cameron7b,1,0.00030,327225,98.79803,331206
7416,camrodgers,1,0.00030,327226,98.79833,331206
7417,camsjams,1,0.00030,327227,98.79863,331206
7418,CannonContraption,1,0.00030,327228,98.79893,331206
7419,capnlove,1,0.00030,327229,98.79924,331206
7420,captaincrunch21,1,0.00030,327230,98.79954,331206
7421,Careknight,1,0.00030,327231,98.79984,331206
7422,Cariaga,1,0.00030,327232,98.80014,331206
7423,carlholmes,1,0.00030,327233,98.80044,331206
7424,carlmartus,1,0.00030,327234,98.80075,331206
7425,carlosbispo,1,0.00030,327235,98.80105,331206
7426,carlosribeiro1987,1,0.00030,327236,98.80135,331206
7427,carlosuh91,1,0.00030,327237,98.80165,331206
7428,carlsmith,1,0.00030,327238,98.80195,331206
7429,carmel4a,1,0.00030,327239,98.80226,331206
7430,Carmot,1,0.00030,327240,98.80256,331206
7431,Carpynch0,1,0.00030,327241,98.80286,331206
7432,carrascomj,1,0.00030,327242,98.80316,331206
7433,CarysT,1,0.00030,327243,98.80346,331206
7434,cassidyjames,1,0.00030,327244,98.80377,331206
7435,castled,1,0.00030,327245,98.80407,331206
7436,CatFlickerRis,1,0.00030,327246,98.80437,331206
7437,caylorme,1,0.00030,327247,98.80467,331206
7438,cb130felix,1,0.00030,327248,98.80497,331206
7439,cbird,1,0.00030,327249,98.80528,331206
7440,cbrooks41647,1,0.00030,327250,98.80558,331206
7441,cbrwn,1,0.00030,327251,98.80588,331206
7442,CBWeekijP,1,0.00030,327252,98.80618,331206
7443,cc861010,1,0.00030,327253,98.80648,331206
7444,ccLouis,1,0.00030,327254,98.80678,331206
7445,CDGames1,1,0.00030,327255,98.80709,331206
7446,cdreier,1,0.00030,327256,98.80739,331206
7447,Cediddi,1,0.00030,327257,98.80769,331206
7448,ceilingdoor,1,0.00030,327258,98.80799,331206
7449,cephalopodluke,1,0.00030,327259,98.80829,331206
7450,cerk,1,0.00030,327260,98.80860,331206
7451,CesarNoll,1,0.00030,327261,98.80890,331206
7452,Ch3sta23,1,0.00030,327262,98.80920,331206
7453,chadams,1,0.00030,327263,98.80950,331206
7454,ChainedLupine,1,0.00030,327264,98.80980,331206
7455,ChakradharGanta,1,0.00030,327265,98.81011,331206
7456,Chaosinism,1,0.00030,327266,98.81041,331206
7457,ChaqSilent,1,0.00030,327267,98.81071,331206
7458,CharlesJenkins,1,0.00030,327268,98.81101,331206
7459,Charlignon,1,0.00030,327269,98.81131,331206
7460,charlydelta,1,0.00030,327270,98.81162,331206
7461,CharlyHardcode,1,0.00030,327271,98.81192,331206
7462,Chedski,1,0.00030,327272,98.81222,331206
7463,Chepee73,1,0.00030,327273,98.81252,331206
7464,cherrydev,1,0.00030,327274,98.81282,331206
7465,cheukyin699,1,0.00030,327275,98.81313,331206
7466,CheZze,1,0.00030,327276,98.81343,331206
7467,chhjel,1,0.00030,327277,98.81373,331206
7468,chiara-jm,1,0.00030,327278,98.81403,331206
7469,ChickenStorm,1,0.00030,327279,98.81433,331206
7470,ChildishGiant,1,0.00030,327280,98.81464,331206
7471,chillen,1,0.00030,327281,98.81494,331206
7472,chiya-chan,1,0.00030,327282,98.81524,331206
7473,chocolatesquiddle,1,0.00030,327283,98.81554,331206
7474,choneface,1,0.00030,327284,98.81584,331206
7475,chris13524,1,0.00030,327285,98.81614,331206
7476,Chris3606,1,0.00030,327286,98.81645,331206
7477,chris-aguilar,1,0.00030,327287,98.81675,331206
7478,ChrisDill,1,0.00030,327288,98.81705,331206
7479,chrisgraf,1,0.00030,327289,98.81735,331206
7480,Chris-Is-Awesome,1,0.00030,327290,98.81765,331206
7481,chrismdp,1,0.00030,327291,98.81796,331206
7482,chris-me,1,0.00030,327292,98.81826,331206
7483,christh,1,0.00030,327293,98.81856,331206
7484,christiaan-janssen,1,0.00030,327294,98.81886,331206
7485,christinoleo,1,0.00030,327295,98.81916,331206
7486,christopherjsmith,1,0.00030,327296,98.81947,331206
7487,ChristopherMJohnson,1,0.00030,327297,98.81977,331206
7488,ChristophHaag,1,0.00030,327298,98.82007,331206
7489,ChronocideGames,1,0.00030,327299,98.82037,331206
7490,Ciastex,1,0.00030,327300,98.82067,331206
7491,CicholGricenchos,1,0.00030,327301,98.82098,331206
7492,cjhorton,1,0.00030,327302,98.82128,331206
7493,CKJBlueStar,1,0.00030,327303,98.82158,331206
7494,clanehin,1,0.00030,327304,98.82188,331206
7495,clarkkierstead,1,0.00030,327305,98.82218,331206
7496,claychinasky,1,0.00030,327306,98.82249,331206
7497,claydegruchy,1,0.00030,327307,98.82279,331206
7498,clayrone,1,0.00030,327308,98.82309,331206
7499,ClicksEnStock,1,0.00030,327309,98.82339,331206
7500,cliffrowley,1,0.00030,327310,98.82369,331206
7501,ClinToch,1,0.00030,327311,98.82399,331206
7502,CloneDeath,1,0.00030,327312,98.82430,331206
7503,Clonewayx,1,0.00030,327313,98.82460,331206
7504,clouds56,1,0.00030,327314,98.82490,331206
7505,cmcaine,1,0.00030,327315,98.82520,331206
7506,cmcarey,1,0.00030,327316,98.82550,331206
7507,cmourglia,1,0.00030,327317,98.82581,331206
7508,Cnidarias,1,0.00030,327318,98.82611,331206
7509,cnk16,1,0.00030,327319,98.82641,331206
7510,co42,1,0.00030,327320,98.82671,331206
7511,cobrapitz,1,0.00030,327321,98.82701,331206
7512,cochise,1,0.00030,327322,98.82732,331206
7513,CocoPommel,1,0.00030,327323,98.82762,331206
7514,code0wl,1,0.00030,327324,98.82792,331206
7515,code32,1,0.00030,327325,98.82822,331206
7516,CodeChomper,1,0.00030,327326,98.82852,331206
7517,codedevmdu,1,0.00030,327327,98.82883,331206
7518,CodeDoes,1,0.00030,327328,98.82913,331206
7519,codeeg,1,0.00030,327329,98.82943,331206
7520,CodeFreezr,1,0.00030,327330,98.82973,331206
7521,codeinclined,1,0.00030,327331,98.83003,331206
7522,codem4ster,1,0.00030,327332,98.83034,331206
7523,codeoftherings,1,0.00030,327333,98.83064,331206
7524,codeonion,1,0.00030,327334,98.83094,331206
7525,Coder6969696,1,0.00030,327335,98.83124,331206
7526,codercommand,1,0.00030,327336,98.83154,331206
7527,CoderEx24,1,0.00030,327337,98.83184,331206
7528,coderofsalvation,1,0.00030,327338,98.83215,331206
7529,CODeRUS,1,0.00030,327339,98.83245,331206
7530,codestick,1,0.00030,327340,98.83275,331206
7531,CodeZombie,1,0.00030,327341,98.83305,331206
7532,Codified-Vexing,1,0.00030,327342,98.83335,331206
7533,CodingWithMenno,1,0.00030,327343,98.83366,331206
7534,codyreign,1,0.00030,327344,98.83396,331206
7535,coffeeDrake,1,0.00030,327345,98.83426,331206
7536,CollinOmmen,1,0.00030,327346,98.83456,331206
7537,ColonelThirtyTwo,1,0.00030,327347,98.83486,331206
7538,Colorfingers,1,0.00030,327348,98.83517,331206
7539,colossalgnome,1,0.00030,327349,98.83547,331206
7540,combsbt,1,0.00030,327350,98.83577,331206
7541,CompeteMe,1,0.00030,327351,98.83607,331206
7542,Conferencier,1,0.00030,327352,98.83637,331206
7543,conrev,1,0.00030,327353,98.83668,331206
7544,contribute-or-stfu,1,0.00030,327354,98.83698,331206
7545,Coolcreeper27,1,0.00030,327355,98.83728,331206
7546,CoreBeacon,1,0.00030,327356,98.83758,331206
7547,cornytrace,1,0.00030,327357,98.83788,331206
7548,Costieman,1,0.00030,327358,98.83819,331206
7549,Courouxer,1,0.00030,327359,98.83849,331206
7550,couturierb,1,0.00030,327360,98.83879,331206
7551,cowhand214,1,0.00030,327361,98.83909,331206
7552,cpritchard,1,0.00030,327362,98.83939,331206
7553,cprn,1,0.00030,327363,98.83969,331206
7554,cptSwing,1,0.00030,327364,98.84000,331206
7555,crab69,1,0.00030,327365,98.84030,331206
7556,crantisz,1,0.00030,327366,98.84060,331206
7557,Crax97,1,0.00030,327367,98.84090,331206
7558,creole,1,0.00030,327368,98.84120,331206
7559,crimsonalucard,1,0.00030,327369,98.84151,331206
7560,CristianNieto,1,0.00030,327370,98.84181,331206
7561,cristoferfb,1,0.00030,327371,98.84211,331206
7562,criticc,1,0.00030,327372,98.84241,331206
7563,croconut,1,0.00030,327373,98.84271,331206
7564,crodnu,1,0.00030,327374,98.84302,331206
7565,cromorg,1,0.00030,327375,98.84332,331206
7566,cronayu,1,0.00030,327376,98.84362,331206
7567,crookedbard,1,0.00030,327377,98.84392,331206
7568,cross034,1,0.00030,327378,98.84422,331206
7569,CrowbarKZ,1,0.00030,327379,98.84453,331206
7570,CruelThorn,1,0.00030,327380,98.84483,331206
7571,CrustyRob,1,0.00030,327381,98.84513,331206
7572,CSaratakij,1,0.00030,327382,98.84543,331206
7573,cschar,1,0.00030,327383,98.84573,331206
7574,csm-yujinkim,1,0.00030,327384,98.84604,331206
7575,csteiiin,1,0.00030,327385,98.84634,331206
7576,ctemplin,1,0.00030,327386,98.84664,331206
7577,cuchalin,1,0.00030,327387,98.84694,331206
7578,CultOfApe,1,0.00030,327388,98.84724,331206
7579,cuntripper,1,0.00030,327389,98.84755,331206
7580,cunyx,1,0.00030,327390,98.84785,331206
7581,cupiniki,1,0.00030,327391,98.84815,331206
7582,curioussavage,1,0.00030,327392,98.84845,331206
7583,CuteGam3rGirl,1,0.00030,327393,98.84875,331206
7584,CyangYu,1,0.00030,327394,98.84905,331206
7585,CyanideGourmet,1,0.00030,327395,98.84936,331206
7586,Cyber4,1,0.00030,327396,98.84966,331206
7587,CyrusTheVirusG,1,0.00030,327397,98.84996,331206
7588,d347hkn16h7,1,0.00030,327398,98.85026,331206
7589,d3dc,1,0.00030,327399,98.85056,331206
7590,D3m0n92,1,0.00030,327400,98.85087,331206
7591,d3vplpl,1,0.00030,327401,98.85117,331206
7592,d871,1,0.00030,327402,98.85147,331206
7593,dacioromero,1,0.00030,327403,98.85177,331206
7594,DafabHoid,1,0.00030,327404,98.85207,331206
7595,daggad95,1,0.00030,327405,98.85238,331206
7596,Daisdarg,1,0.00030,327406,98.85268,331206
7597,damccull,1,0.00030,327407,98.85298,331206
7598,DAMO238,1,0.00030,327408,98.85328,331206
7599,DancingOx,1,0.00030,327409,98.85358,331206
7600,dandevs,1,0.00030,327410,98.85389,331206
7601,dane-johnson,1,0.00030,327411,98.85419,331206
7602,Daniel-del-Castillo,1,0.00030,327412,98.85449,331206
7603,danielkariv,1,0.00030,327413,98.85479,331206
7604,daniell1988,1,0.00030,327414,98.85509,331206
7605,danielsjf,1,0.00030,327415,98.85540,331206
7606,DanielTorreMiguel,1,0.00030,327416,98.85570,331206
7607,danielvmacedo,1,0.00030,327417,98.85600,331206
7608,daniloprogramador1991,1,0.00030,327418,98.85630,331206
7609,Danny3107,1,0.00030,327419,98.85660,331206
7610,dannytatom,1,0.00030,327420,98.85690,331206
7611,dantofei,1,0.00030,327421,98.85721,331206
7612,DanWilkerson,1,0.00030,327422,98.85751,331206
7613,DanX3,1,0.00030,327423,98.85781,331206
7614,darkcoderrises,1,0.00030,327424,98.85811,331206
7615,DarkDimius,1,0.00030,327425,98.85841,331206
7616,darkhero336,1,0.00030,327426,98.85872,331206
7617,DarkRoastStudio,1,0.00030,327427,98.85902,331206
7618,DarthSett,1,0.00030,327428,98.85932,331206
7619,DarylGraves,1,0.00030,327429,98.85962,331206
7620,dashorty,1,0.00030,327430,98.85992,331206
7621,DaSlang,1,0.00030,327431,98.86023,331206
7622,DataPlusProgram,1,0.00030,327432,98.86053,331206
7623,DATiiNG,1,0.00030,327433,98.86083,331206
7624,Dav1dde,1,0.00030,327434,98.86113,331206
7625,davesavage,1,0.00030,327435,98.86143,331206
7626,DaveThornton,1,0.00030,327436,98.86174,331206
7627,davey362,1,0.00030,327437,98.86204,331206
7628,daveyman123,1,0.00030,327438,98.86234,331206
7629,davibail,1,0.00030,327439,98.86264,331206
7630,david690,1,0.00030,327440,98.86294,331206
7631,Davi-Danger,1,0.00030,327441,98.86325,331206
7632,davidawad,1,0.00030,327442,98.86355,331206
7633,DavidKarlas,1,0.00030,327443,98.86385,331206
7634,davidlamhauge,1,0.00030,327444,98.86415,331206
7635,DavidMeagher1,1,0.00030,327445,98.86445,331206
7636,DavidNexuss,1,0.00030,327446,98.86475,331206
7637,davidwparker,1,0.00030,327447,98.86506,331206
7638,Davijonatas1998,1,0.00030,327448,98.86536,331206
7639,DaX0-ex,1,0.00030,327449,98.86566,331206
7640,dberickson,1,0.00030,327450,98.86596,331206
7641,dbiton,1,0.00030,327451,98.86626,331206
7642,ddelapaz,1,0.00030,327452,98.86657,331206
7643,ddiakopoulos,1,0.00030,327453,98.86687,331206
7644,ddrrr,1,0.00030,327454,98.86717,331206
7645,Deancsurya,1,0.00030,327455,98.86747,331206
7646,deanvaessen,1,0.00030,327456,98.86777,331206
7647,deberle,1,0.00030,327457,98.86808,331206
7648,decaf-doctor,1,0.00030,327458,98.86838,331206
7649,dedraks,1,0.00030,327459,98.86868,331206
7650,deep-gaurav,1,0.00030,327460,98.86898,331206
7651,Deere,1,0.00030,327461,98.86928,331206
7652,DeexCoding,1,0.00030,327462,98.86959,331206
7653,d-eisenga,1,0.00030,327463,98.86989,331206
7654,DeJake,1,0.00030,327464,98.87019,331206
7655,Delfrank94,1,0.00030,327465,98.87049,331206
7656,DellingF,1,0.00030,327466,98.87079,331206
7657,demacedius,1,0.00030,327467,98.87110,331206
7658,Demindiro,1,0.00030,327468,98.87140,331206
7659,Demolishun,1,0.00030,327469,98.87170,331206
7660,denisjecar1,1,0.00030,327470,98.87200,331206
7661,dennis-meagher,1,0.00030,327471,98.87230,331206
7662,DennisWG,1,0.00030,327472,98.87260,331206
7663,Deosperada,1,0.00030,327473,98.87291,331206
7664,Deph0,1,0.00030,327474,98.87321,331206
7665,depperm,1,0.00030,327475,98.87351,331206
7666,derac,1,0.00030,327476,98.87381,331206
7667,DerKorb,1,0.00030,327477,98.87411,331206
7668,derrideanauthor,1,0.00030,327478,98.87442,331206
7669,desk467,1,0.00030,327479,98.87472,331206
7670,desttinghim,1,0.00030,327480,98.87502,331206
7671,Deus0,1,0.00030,327481,98.87532,331206
7672,Devastus,1,0.00030,327482,98.87562,331206
7673,dev-cyprium,1,0.00030,327483,98.87593,331206
7674,developedby,1,0.00030,327484,98.87623,331206
7675,developer49,1,0.00030,327485,98.87653,331206
7676,Developpix,1,0.00030,327486,98.87683,331206
7677,Devination,1,0.00030,327487,98.87713,331206
7678,deviousdaemon,1,0.00030,327488,98.87744,331206
7679,DevmanAuthor,1,0.00030,327489,98.87774,331206
7680,dev-sr0,1,0.00030,327490,98.87804,331206
7681,dev-wq,1,0.00030,327491,98.87834,331206
7682,D-first,1,0.00030,327492,98.87864,331206
7683,dfuller,1,0.00030,327493,98.87895,331206
7684,dgoemans,1,0.00030,327494,98.87925,331206
7685,Dharengo,1,0.00030,327495,98.87955,331206
7686,Didifred,1,0.00030,327496,98.87985,331206
7687,DiegoBM,1,0.00030,327497,98.88015,331206
7688,DietrichDaniel,1,0.00030,327498,98.88046,331206
7689,DigiDigi,1,0.00030,327499,98.88076,331206
7690,DillonHemphill,1,0.00030,327500,98.88106,331206
7691,Dimonade,1,0.00030,327501,98.88136,331206
7692,dingdalong,1,0.00030,327502,98.88166,331206
7693,Diogoamorim27,1,0.00030,327503,98.88196,331206
7694,dirkbaechle,1,0.00030,327504,98.88227,331206
7695,DisasterMaster19,1,0.00030,327505,98.88257,331206
7696,Distace84,1,0.00030,327506,98.88287,331206
7697,ditikos,1,0.00030,327507,98.88317,331206
7698,divineforge,1,0.00030,327508,98.88347,331206
7699,dixiony,1,0.00030,327509,98.88378,331206
7700,djgaven588,1,0.00030,327510,98.88408,331206
7701,dkuku,1,0.00030,327511,98.88438,331206
7702,dmentation,1,0.00030,327512,98.88468,331206
7703,dmitrymatveev,1,0.00030,327513,98.88498,331206
7704,DNKpp,1,0.00030,327514,98.88529,331206
7705,dodisefti23,1,0.00030,327515,98.88559,331206
7706,dogatekin,1,0.00030,327516,98.88589,331206
7707,DogDod,1,0.00030,327517,98.88619,331206
7708,DoHe,1,0.00030,327518,98.88649,331206
7709,Dolichomps,1,0.00030,327519,98.88680,331206
7710,do-m-en,1,0.00030,327520,98.88710,331206
7711,dominicfreeston,1,0.00030,327521,98.88740,331206
7712,DonniYH,1,0.00030,327522,98.88770,331206
7713,DoodlesEpic,1,0.00030,327523,98.88800,331206
7714,DotChris,1,0.00030,327524,98.88831,331206
7715,dotwiz,1,0.00030,327525,98.88861,331206
7716,DoubleCakes,1,0.00030,327526,98.88891,331206
7717,dougneves,1,0.00030,327527,98.88921,331206
7718,doug-orchard,1,0.00030,327528,98.88951,331206
7719,dpensky,1,0.00030,327529,98.88981,331206
7720,dpiquet,1,0.00030,327530,98.89012,331206
7721,dplaton,1,0.00030,327531,98.89042,331206
7722,Drachenfrucht1,1,0.00030,327532,98.89072,331206
7723,draconequis,1,0.00030,327533,98.89102,331206
7724,dragongling,1,0.00030,327534,98.89132,331206
7725,DragonStorm97,1,0.00030,327535,98.89163,331206
7726,Drakenroft,1,0.00030,327536,98.89193,331206
7727,drakenshot23,1,0.00030,327537,98.89223,331206
7728,Drauthius,1,0.00030,327538,98.89253,331206
7729,Dreomite,1,0.00030,327539,98.89283,331206
7730,drewrotunno,1,0.00030,327540,98.89314,331206
7731,drezgames,1,0.00030,327541,98.89344,331206
7732,Drillur,1,0.00030,327542,98.89374,331206
7733,drjm,1,0.00030,327543,98.89404,331206
7734,DroppingBass11,1,0.00030,327544,98.89434,331206
7735,DroppingBass12,1,0.00030,327545,98.89465,331206
7736,DroppingBass2,1,0.00030,327546,98.89495,331206
7737,DroppingBass5,1,0.00030,327547,98.89525,331206
7738,DroppingBass6,1,0.00030,327548,98.89555,331206
7739,DroppingBass7,1,0.00030,327549,98.89585,331206
7740,droxmusic,1,0.00030,327550,98.89616,331206
7741,DrPandemic,1,0.00030,327551,98.89646,331206
7742,drproteus,1,0.00030,327552,98.89676,331206
7743,DrRayThe2nd,1,0.00030,327553,98.89706,331206
7744,dschoemehl,1,0.00030,327554,98.89736,331206
7745,duchowneyg,1,0.00030,327555,98.89766,331206
7746,Duobix,1,0.00030,327556,98.89797,331206
7747,durson,1,0.00030,327557,98.89827,331206
7748,dutchmo,1,0.00030,327558,98.89857,331206
7749,duurkak,1,0.00030,327559,98.89887,331206
7750,duwaar,1,0.00030,327560,98.89917,331206
7751,dvdbrink,1,0.00030,327561,98.89948,331206
7752,Dvdhyh,1,0.00030,327562,98.89978,331206
7753,DVLP,1,0.00030,327563,98.90008,331206
7754,dvorontsov,1,0.00030,327564,98.90038,331206
7755,dwlsalmeida,1,0.00030,327565,98.90068,331206
7756,DylanCulfogienis,1,0.00030,327566,98.90099,331206
7757,DylanSale,1,0.00030,327567,98.90129,331206
7758,E8AkoyqmTxWenGVG,1,0.00030,327568,98.90159,331206
7759,eadmaster,1,0.00030,327569,98.90189,331206
7760,EadraxOffice,1,0.00030,327570,98.90219,331206
7761,EamonnMR,1,0.00030,327571,98.90250,331206
7762,easy82,1,0.00030,327572,98.90280,331206
7763,EAzari,1,0.00030,327573,98.90310,331206
7764,ebbsenghargor,1,0.00030,327574,98.90340,331206
7765,ebeem,1,0.00030,327575,98.90370,331206
7766,ebuchmann,1,0.00030,327576,98.90401,331206
7767,ecdavis,1,0.00030,327577,98.90431,331206
7768,echorebel,1,0.00030,327578,98.90461,331206
7769,edg-l,1,0.00030,327579,98.90491,331206
7770,EdikTV,1,0.00030,327580,98.90521,331206
7771,EdmarDev,1,0.00030,327581,98.90551,331206
7772,edmarfjr,1,0.00030,327582,98.90582,331206
7773,edoblette,1,0.00030,327583,98.90612,331206
7774,EdsonMSouza,1,0.00030,327584,98.90642,331206
7775,Edwin-Pratt,1,0.00030,327585,98.90672,331206
7776,eespie,1,0.00030,327586,98.90702,331206
7777,efarms,1,0.00030,327587,98.90733,331206
7778,eff96,1,0.00030,327588,98.90763,331206
7779,efhilton,1,0.00030,327589,98.90793,331206
7780,efwff,1,0.00030,327590,98.90823,331206
7781,egalipchak,1,0.00030,327591,98.90853,331206
7782,egel-lang,1,0.00030,327592,98.90884,331206
7783,egtann,1,0.00030,327593,98.90914,331206
7784,eilamg,1,0.00030,327594,98.90944,331206
7785,ekliot,1,0.00030,327595,98.90974,331206
7786,elderlydoofus,1,0.00030,327596,98.91004,331206
7787,ElectricPlanet,1,0.00030,327597,98.91035,331206
7788,elisamuelps,1,0.00030,327598,98.91065,331206
7789,elisha464,1,0.00030,327599,98.91095,331206
7790,Elisto,1,0.00030,327600,98.91125,331206
7791,elixs,1,0.00030,327601,98.91155,331206
7792,ElliotBak3r,1,0.00030,327602,98.91186,331206
7793,elliotd123,1,0.00030,327603,98.91216,331206
7794,ellogwen,1,0.00030,327604,98.91246,331206
7795,ElMarck,1,0.00030,327605,98.91276,331206
7796,elmartirta,1,0.00030,327606,98.91306,331206
7797,elopezga,1,0.00030,327607,98.91337,331206
7798,EL-SHREIF,1,0.00030,327608,98.91367,331206
7799,elvencode,1,0.00030,327609,98.91397,331206
7800,elvircrn,1,0.00030,327610,98.91427,331206
7801,elvisish,1,0.00030,327611,98.91457,331206
7802,Elyntic,1,0.00030,327612,98.91487,331206
7803,Elyukeyey,1,0.00030,327613,98.91518,331206
7804,emackey,1,0.00030,327614,98.91548,331206
7805,emarod,1,0.00030,327615,98.91578,331206
7806,emeyex,1,0.00030,327616,98.91608,331206
7807,emilevdb,1,0.00030,327617,98.91638,331206
7808,emilnymann,1,0.00030,327618,98.91669,331206
7809,Emin981,1,0.00030,327619,98.91699,331206
7810,EmKeyy,1,0.00030,327620,98.91729,331206
7811,emma-fm,1,0.00030,327621,98.91759,331206
7812,emo10001,1,0.00030,327622,98.91789,331206
7813,emo44,1,0.00030,327623,98.91820,331206
7814,emocanmimocan,1,0.00030,327624,98.91850,331206
7815,emoulsdale,1,0.00030,327625,98.91880,331206
7816,emptyhead,1,0.00030,327626,98.91910,331206
7817,EnderNator10,1,0.00030,327627,98.91940,331206
7818,enesygt,1,0.00030,327628,98.91971,331206
7819,enricotj,1,0.00030,327629,98.92001,331206
7820,enrics,1,0.00030,327630,98.92031,331206
7821,Envalee,1,0.00030,327631,98.92061,331206
7822,envyniv,1,0.00030,327632,98.92091,331206
7823,eNzr,1,0.00030,327633,98.92122,331206
7824,epark009,1,0.00030,327634,98.92152,331206
7825,ephread,1,0.00030,327635,98.92182,331206
7826,epoblaguev,1,0.00030,327636,98.92212,331206
7827,EpproxZimlon,1,0.00030,327637,98.92242,331206
7828,eran95,1,0.00030,327638,98.92272,331206
7829,erayerdin,1,0.00030,327639,98.92303,331206
7830,ergo,1,0.00030,327640,98.92333,331206
7831,Eric-Arz,1,0.00030,327641,98.92363,331206
7832,erickgtorelli,1,0.00030,327642,98.92393,331206
7833,ericmeng,1,0.00030,327643,98.92423,331206
7834,ericssonpaul,1,0.00030,327644,98.92454,331206
7835,ErikChevalier,1,0.00030,327645,98.92484,331206
7836,erikp121,1,0.00030,327646,98.92514,331206
7837,erikreedstrom,1,0.00030,327647,98.92544,331206
7838,erjseals,1,0.00030,327648,98.92574,331206
7839,Errvald,1,0.00030,327649,98.92605,331206
7840,ertancanatik,1,0.00030,327650,98.92635,331206
7841,esdinev,1,0.00030,327651,98.92665,331206
7842,esper369,1,0.00030,327652,98.92695,331206
7843,essial,1,0.00030,327653,98.92725,331206
7844,estevancarlos,1,0.00030,327654,98.92756,331206
7845,Estianne,1,0.00030,327655,98.92786,331206
7846,ethanketell,1,0.00030,327656,98.92816,331206
7847,etse,1,0.00030,327657,98.92846,331206
7848,evah5,1,0.00030,327658,98.92876,331206
7849,evan13579b,1,0.00030,327659,98.92907,331206
7850,evgn,1,0.00030,327660,98.92937,331206
7851,evilmu,1,0.00030,327661,98.92967,331206
7852,EvilPyro,1,0.00030,327662,98.92997,331206
7853,ewewukek,1,0.00030,327663,98.93027,331206
7854,exe2k,1,0.00030,327664,98.93057,331206
7855,exe4que,1,0.00030,327665,98.93088,331206
7856,Exmajir2018,1,0.00030,327666,98.93118,331206
7857,exploids,1,0.00030,327667,98.93148,331206
7858,Extarys,1,0.00030,327668,98.93178,331206
7859,extrowerk,1,0.00030,327669,98.93208,331206
7860,ezdiy,1,0.00030,327670,98.93239,331206
7861,Ezyreme,1,0.00030,327671,98.93269,331206
7862,F-3r,1,0.00030,327672,98.93299,331206
7863,fabiomodesto,1,0.00030,327673,98.93329,331206
7864,fabricadegame,1,0.00030,327674,98.93359,331206
7865,Fafred,1,0.00030,327675,98.93390,331206
7866,fahim44,1,0.00030,327676,98.93420,331206
7867,fairhat,1,0.00030,327677,98.93450,331206
7868,famarques-site,1,0.00030,327678,98.93480,331206
7869,Famiu,1,0.00030,327679,98.93510,331206
7870,fancyn3rd,1,0.00030,327680,98.93541,331206
7871,Far117,1,0.00030,327681,98.93571,331206
7872,faraazahmad,1,0.00030,327682,98.93601,331206
7873,farhanmannan,1,0.00030,327683,98.93631,331206
7874,farism,1,0.00030,327684,98.93661,331206
7875,FartFish,1,0.00030,327685,98.93692,331206
7876,fasihrana,1,0.00030,327686,98.93722,331206
7877,fastfading,1,0.00030,327687,98.93752,331206
7878,faxfrag,1,0.00030,327688,98.93782,331206
7879,fbsr,1,0.00030,327689,98.93812,331206
7880,fedor-elizarov,1,0.00030,327690,98.93843,331206
7881,Feellikeabee,1,0.00030,327691,98.93873,331206
7882,Fefe-Hern,1,0.00030,327692,98.93903,331206
7883,Fekinox,1,0.00030,327693,98.93933,331206
7884,FeldrinH,1,0.00030,327694,98.93963,331206
7885,felipefcm,1,0.00030,327695,98.93993,331206
7886,felipetavares,1,0.00030,327696,98.94024,331206
7887,FelixMaxwell,1,0.00030,327697,98.94054,331206
7888,felixwcf,1,0.00030,327698,98.94084,331206
7889,feRpicoral,1,0.00030,327699,98.94114,331206
7890,ff7rule,1,0.00030,327700,98.94144,331206
7891,ffMathy,1,0.00030,327701,98.94175,331206
7892,FilippoBovo,1,0.00030,327702,98.94205,331206
7893,fillibuster77,1,0.00030,327703,98.94235,331206
7894,finalwarp,1,0.00030,327704,98.94265,331206
7895,firegate666,1,0.00030,327705,98.94295,331206
7896,fisheye36,1,0.00030,327706,98.94326,331206
7897,FlamyYT,1,0.00030,327707,98.94356,331206
7898,Flascher,1,0.00030,327708,98.94386,331206
7899,Flash1232,1,0.00030,327709,98.94416,331206
7900,Flavien,1,0.00030,327710,98.94446,331206
7901,fleyhe,1,0.00030,327711,98.94477,331206
7902,FlowOverFail,1,0.00030,327712,98.94507,331206
7903,Flyboy1010,1,0.00030,327713,98.94537,331206
7904,flydyman,1,0.00030,327714,98.94567,331206
7905,Fonden14,1,0.00030,327715,98.94597,331206
7906,fopeczek,1,0.00030,327716,98.94628,331206
7907,foreveryennefer,1,0.00030,327717,98.94658,331206
7908,form-follows-function,1,0.00030,327718,98.94688,331206
7909,Francochicano,1,0.00030,327719,98.94718,331206
7910,FrancoisSchnell,1,0.00030,327720,98.94748,331206
7911,FrandSX,1,0.00030,327721,98.94778,331206
7912,Freakmiko,1,0.00030,327722,98.94809,331206
7913,Frechylo,1,0.00030,327723,98.94839,331206
7914,frederico4d,1,0.00030,327724,98.94869,331206
7915,fredlim,1,0.00030,327725,98.94899,331206
7916,Frescote,1,0.00030,327726,98.94929,331206
7917,FringeSci-com,1,0.00030,327727,98.94960,331206
7918,frob,1,0.00030,327728,98.94990,331206
7919,FrostByteGER,1,0.00030,327729,98.95020,331206
7920,Frostings,1,0.00030,327730,98.95050,331206
7921,Fruitdude,1,0.00030,327731,98.95080,331206
7922,fuego0607,1,0.00030,327732,98.95111,331206
7923,funkbro,1,0.00030,327733,98.95141,331206
7924,funkeh,1,0.00030,327734,98.95171,331206
7925,funkystu,1,0.00030,327735,98.95201,331206
7926,Fupicat,1,0.00030,327736,98.95231,331206
7927,fusillator,1,0.00030,327737,98.95262,331206
7928,fvsch,1,0.00030,327738,98.95292,331206
7929,fx46,1,0.00030,327739,98.95322,331206
7930,fxcalibur,1,0.00030,327740,98.95352,331206
7931,G3bE,1,0.00030,327741,98.95382,331206
7932,gabe00122,1,0.00030,327742,98.95413,331206
7933,GabiLarbi,1,0.00030,327743,98.95443,331206
7934,gabrielf82,1,0.00030,327744,98.95473,331206
7935,GabrielPaes,1,0.00030,327745,98.95503,331206
7936,gabrielpreviato,1,0.00030,327746,98.95533,331206
7937,gabrjt,1,0.00030,327747,98.95563,331206
7938,gaconkzk,1,0.00030,327748,98.95594,331206
7939,gaetgu,1,0.00030,327749,98.95624,331206
7940,Gallaecio,1,0.00030,327750,98.95654,331206
7941,gamaralf,1,0.00030,327751,98.95684,331206
7942,gamecoder-nz,1,0.00030,327752,98.95714,331206
7943,Gamecrazy,1,0.00030,327753,98.95745,331206
7944,GameEndeavor,1,0.00030,327754,98.95775,331206
7945,GameingTwist,1,0.00030,327755,98.95805,331206
7946,gamepad-coder,1,0.00030,327756,98.95835,331206
7947,gamer-11,1,0.00030,327757,98.95865,331206
7948,gamerminstrel,1,0.00030,327758,98.95896,331206
7949,GameScripting,1,0.00030,327759,98.95926,331206
7950,GamesOpenSource,1,0.00030,327760,98.95956,331206
7951,gandalf3,1,0.00030,327761,98.95986,331206
7952,Gapster12,1,0.00030,327762,98.96016,331206
7953,GarmOfGnipahellir,1,0.00030,327763,98.96047,331206
7954,garred,1,0.00030,327764,98.96077,331206
7955,garuna-m6,1,0.00030,327765,98.96107,331206
7956,garyday2001,1,0.00030,327766,98.96137,331206
7957,GaryShem,1,0.00030,327767,98.96167,331206
7958,gaushikmr,1,0.00030,327768,98.96198,331206
7959,gavinws,1,0.00030,327769,98.96228,331206
7960,Gaweringo,1,0.00030,327770,98.96258,331206
7961,GbaCretin,1,0.00030,327771,98.96288,331206
7962,gblues,1,0.00030,327772,98.96318,331206
7963,gcivicodev,1,0.00030,327773,98.96348,331206
7964,gcomi1977,1,0.00030,327774,98.96379,331206
7965,gdeer81,1,0.00030,327775,98.96409,331206
7966,gdelazzari,1,0.00030,327776,98.96439,331206
7967,gdomaradzki,1,0.00030,327777,98.96469,331206
7968,gdtdftdqtd,1,0.00030,327778,98.96499,331206
7969,Gear-Code,1,0.00030,327779,98.96530,331206
7970,geckolocation,1,0.00030,327780,98.96560,331206
7971,gedaerm,1,0.00030,327781,98.96590,331206
7972,gejza74,1,0.00030,327782,98.96620,331206
7973,gelvinp,1,0.00030,327783,98.96650,331206
7974,genericFJS,1,0.00030,327784,98.96681,331206
7975,Gentle22,1,0.00030,327785,98.96711,331206
7976,geoduderino,1,0.00030,327786,98.96741,331206
7977,Geometror,1,0.00030,327787,98.96771,331206
7978,GerboPawa,1,0.00030,327788,98.96801,331206
7979,germandiago,1,0.00030,327789,98.96832,331206
7980,germinolegrand,1,0.00030,327790,98.96862,331206
7981,gerome323,1,0.00030,327791,98.96892,331206
7982,get-it-here,1,0.00030,327792,98.96922,331206
7983,getmorepc,1,0.00030,327793,98.96952,331206
7984,gff1979,1,0.00030,327794,98.96983,331206
7985,GGalizzi,1,0.00030,327795,98.97013,331206
7986,ghost,1,0.00030,327796,98.97043,331206
7987,ghtyrant,1,0.00030,327797,98.97073,331206
7988,giabeni,1,0.00030,327798,98.97103,331206
7989,giacomocaironi,1,0.00030,327799,98.97134,331206
7990,gigabison,1,0.00030,327800,98.97164,331206
7991,gilch,1,0.00030,327801,98.97194,331206
7992,gindar,1,0.00030,327802,98.97224,331206
7993,gingerageous,1,0.00030,327803,98.97254,331206
7994,gioele-santi,1,0.00030,327804,98.97284,331206
7995,giovanitrentin,1,0.00030,327805,98.97315,331206
7996,Giresharu,1,0.00030,327806,98.97345,331206
7997,gitajerb,1,0.00030,327807,98.97375,331206
7998,git-brandon,1,0.00030,327808,98.97405,331206
7999,gitnix,1,0.00030,327809,98.97435,331206
8000,giuliano-barberi-tf,1,0.00030,327810,98.97466,331206
8001,giuliosoro,1,0.00030,327811,98.97496,331206
8002,GiveMeAnthony,1,0.00030,327812,98.97526,331206
8003,gizaha,1,0.00030,327813,98.97556,331206
8004,Gliderz,1,0.00030,327814,98.97586,331206
8005,GlitchedCode,1,0.00030,327815,98.97617,331206
8006,GlOwl,1,0.00030,327816,98.97647,331206
8007,gnat,1,0.00030,327817,98.97677,331206
8008,Gnomeknows,1,0.00030,327818,98.97707,331206
8009,g--o,1,0.00030,327819,98.97737,331206
8010,gocs,1,0.00030,327820,98.97768,331206
8011,godotmj,1,0.00030,327821,98.97798,331206
8012,gokhansolak,1,0.00030,327822,98.97828,331206
8013,GoldenQubicle,1,0.00030,327823,98.97858,331206
8014,GolfinhoDoAlaska,1,0.00030,327824,98.97888,331206
8015,Goncharo,1,0.00030,327825,98.97919,331206
8016,Gonkee,1,0.00030,327826,98.97949,331206
8017,gonsor,1,0.00030,327827,98.97979,331206
8018,gonzapapa,1,0.00030,327828,98.98009,331206
8019,GonziHere,1,0.00030,327829,98.98039,331206
8020,Gooberpatrol66,1,0.00030,327830,98.98069,331206
8021,goooosick,1,0.00030,327831,98.98100,331206
8022,GoxelBug,1,0.00030,327832,98.98130,331206
8023,gozmoth,1,0.00030,327833,98.98160,331206
8024,Gpas,1,0.00030,327834,98.98190,331206
8025,gpp-games,1,0.00030,327835,98.98220,331206
8026,Gr0minet,1,0.00030,327836,98.98251,331206
8027,gra-frogger,1,0.00030,327837,98.98281,331206
8028,grantclarke-abertay,1,0.00030,327838,98.98311,331206
8029,gravymond,1,0.00030,327839,98.98341,331206
8030,graylikeme,1,0.00030,327840,98.98371,331206
8031,GreatRash,1,0.00030,327841,98.98402,331206
8032,greencloversguy,1,0.00030,327842,98.98432,331206
8033,GreenMan36,1,0.00030,327843,98.98462,331206
8034,greensand3,1,0.00030,327844,98.98492,331206
8035,gregdebonis,1,0.00030,327845,98.98522,331206
8036,GregTheMadMonk,1,0.00030,327846,98.98553,331206
8037,grejppi,1,0.00030,327847,98.98583,331206
8038,Greymanz,1,0.00030,327848,98.98613,331206
8039,greyspot,1,0.00030,327849,98.98643,331206
8040,grogcon,1,0.00030,327850,98.98673,331206
8041,groscalin,1,0.00030,327851,98.98704,331206
8042,GroundJet,1,0.00030,327852,98.98734,331206
8043,grubmunch,1,0.00030,327853,98.98764,331206
8044,gsss124,1,0.00030,327854,98.98794,331206
8045,gtd138,1,0.00030,327855,98.98824,331206
8046,gtkampos,1,0.00030,327856,98.98854,331206
8047,guiguismall,1,0.00030,327857,98.98885,331206
8048,guilhermehto,1,0.00030,327858,98.98915,331206
8049,Guillaume201,1,0.00030,327859,98.98945,331206
8050,gunrugger,1,0.00030,327860,98.98975,331206
8051,gurgu99,1,0.00030,327861,98.99005,331206
8052,Gustavolucas864,1,0.00030,327862,98.99036,331206
8053,Gustavomic13,1,0.00030,327863,98.99066,331206
8054,GustavoMuller2019,1,0.00030,327864,98.99096,331206
8055,Gutmaster,1,0.00030,327865,98.99126,331206
8056,GuyHanan,1,0.00030,327866,98.99156,331206
8057,GuyUnger,1,0.00030,327867,98.99187,331206
8058,Gwaehrynthe,1,0.00030,327868,98.99217,331206
8059,Gybes,1,0.00030,327869,98.99247,331206
8060,haaldor,1,0.00030,327870,98.99277,331206
8061,haasanen,1,0.00030,327871,98.99307,331206
8062,haasosaurus,1,0.00030,327872,98.99338,331206
8063,Hackmet,1,0.00030,327873,98.99368,331206
8064,hadbabits,1,0.00030,327874,98.99398,331206
8065,haekb,1,0.00030,327875,98.99428,331206
8066,hagabooga,1,0.00030,327876,98.99458,331206
8067,haikarainen,1,0.00030,327877,98.99489,331206
8068,Hamcha,1,0.00030,327878,98.99519,331206
8069,Hamezii,1,0.00030,327879,98.99549,331206
8070,HamfistMcMutton,1,0.00030,327880,98.99579,331206
8071,Hammster,1,0.00030,327881,98.99609,331206
8072,Hamzailer,1,0.00030,327882,98.99639,331206
8073,hana-lys,1,0.00030,327883,98.99670,331206
8074,Hansel-Dsilva,1,0.00030,327884,98.99700,331206
8075,Hanul,1,0.00030,327885,98.99730,331206
8076,hanzhihua1,1,0.00030,327886,98.99760,331206
8077,HarDevSan,1,0.00030,327887,98.99790,331206
8078,Hargbratch,1,0.00030,327888,98.99821,331206
8079,HaroldReyiz,1,0.00030,327889,98.99851,331206
8080,HarryVolek,1,0.00030,327890,98.99881,331206
8081,harshbawari,1,0.00030,327891,98.99911,331206
8082,hatemsh,1,0.00030,327892,98.99941,331206
8083,hatkyinc2,1,0.00030,327893,98.99972,331206
8084,haunterpokem,1,0.00030,327894,99.00002,331206
8085,havidarou,1,0.00030,327895,99.00032,331206
8086,Heathal,1,0.00030,327896,99.00062,331206
8087,hebedombiu,1,0.00030,327897,99.00092,331206
8088,Hector-GameBeast,1,0.00030,327898,99.00123,331206
8089,Hedre,1,0.00030,327899,99.00153,331206
8090,he-eh,1,0.00030,327900,99.00183,331206
8091,heibor,1,0.00030,327901,99.00213,331206
8092,helle253,1,0.00030,327902,99.00243,331206
8093,HelloCotoco4,1,0.00030,327903,99.00274,331206
8094,helpingDevs,1,0.00030,327904,99.00304,331206
8095,Hendrix63,1,0.00030,327905,99.00334,331206
8096,HenrySipp,1,0.00030,327906,99.00364,331206
8097,hero2bash,1,0.00030,327907,99.00394,331206
8098,herooyyy,1,0.00030,327908,99.00425,331206
8099,herrybiscuit,1,0.00030,327909,99.00455,331206
8100,HexKnight,1,0.00030,327910,99.00485,331206
8101,Hey44566,1,0.00030,327911,99.00515,331206
8102,hhedin,1,0.00030,327912,99.00545,331206
8103,hhuseyincihangir,1,0.00030,327913,99.00575,331206
8104,HiddenGoblin,1,0.00030,327914,99.00606,331206
8105,HiddenSide,1,0.00030,327915,99.00636,331206
8106,hieunc278,1,0.00030,327916,99.00666,331206
8107,HighCWu,1,0.00030,327917,99.00696,331206
8108,hignatious,1,0.00030,327918,99.00726,331206
8109,hi-p,1,0.00030,327919,99.00757,331206
8110,HisDivineShadow,1,0.00030,327920,99.00787,331206
8111,hjozwiak,1,0.00030,327921,99.00817,331206
8112,hjsrabi,1,0.00030,327922,99.00847,331206
8113,hjung4,1,0.00030,327923,99.00877,331206
8114,hman278,1,0.00030,327924,99.00908,331206
8115,hmech,1,0.00030,327925,99.00938,331206
8116,hogart,1,0.00030,327926,99.00968,331206
8117,hohfchns,1,0.00030,327927,99.00998,331206
8118,HolaCotoco2,1,0.00030,327928,99.01028,331206
8119,HolaCotoco3,1,0.00030,327929,99.01059,331206
8120,Hondres,1,0.00030,327930,99.01089,331206
8121,HooniusDev,1,0.00030,327931,99.01119,331206
8122,Hopetech,1,0.00030,327932,99.01149,331206
8123,hordric,1,0.00030,327933,99.01179,331206
8124,horneac,1,0.00030,327934,99.01210,331206
8125,hoskope,1,0.00030,327935,99.01240,331206
8126,HoutarouOreki,1,0.00030,327936,99.01270,331206
8127,howaajin,1,0.00030,327937,99.01300,331206
8128,howdoicomputer,1,0.00030,327938,99.01330,331206
8129,Howld,1,0.00030,327939,99.01360,331206
8130,hpnightowl,1,0.00030,327940,99.01391,331206
8131,hsdxpro,1,0.00030,327941,99.01421,331206
8132,htangidnerd,1,0.00030,327942,99.01451,331206
8133,HumayunE,1,0.00030,327943,99.01481,331206
8134,hutty,1,0.00030,327944,99.01511,331206
8135,HuvaaKoodia,1,0.00030,327945,99.01542,331206
8136,hydescarf,1,0.00030,327946,99.01572,331206
8137,hydrocat,1,0.00030,327947,99.01602,331206
8138,HysanDev,1,0.00030,327948,99.01632,331206
8139,iactix,1,0.00030,327949,99.01662,331206
8140,IAmBot102102,1,0.00030,327950,99.01693,331206
8141,iamiota,1,0.00030,327951,99.01723,331206
8142,IamRyusei,1,0.00030,327952,99.01753,331206
8143,iamthegithubghost,1,0.00030,327953,99.01783,331206
8144,IanGClifton,1,0.00030,327954,99.01813,331206
8145,ianhattendorf,1,0.00030,327955,99.01844,331206
8146,IanKovich,1,0.00030,327956,99.01874,331206
8147,ian-p-cooke,1,0.00030,327957,99.01904,331206
8148,IanWark,1,0.00030,327958,99.01934,331206
8149,Icaro-Lima,1,0.00030,327959,99.01964,331206
8150,icefalcn,1,0.00030,327960,99.01995,331206
8151,Icekey,1,0.00030,327961,99.02025,331206
8152,Icelimo,1,0.00030,327962,99.02055,331206
8153,Icemole,1,0.00030,327963,99.02085,331206
8154,IchiroKeisuke,1,0.00030,327964,99.02115,331206
8155,ico43,1,0.00030,327965,99.02145,331206
8156,IcyCoder368,1,0.00030,327966,99.02176,331206
8157,id01,1,0.00030,327967,99.02206,331206
8158,idi0tf0wl,1,0.00030,327968,99.02236,331206
8159,idrohr,1,0.00030,327969,99.02266,331206
8160,ifig4fireghost,1,0.00030,327970,99.02296,331206
8161,ignasKavaliauskas,1,0.00030,327971,99.02327,331206
8162,IgnasKavaliauskas,1,0.00030,327972,99.02357,331206
8163,Ikamyshev,1,0.00030,327973,99.02387,331206
8164,ikeofkc,1,0.00030,327974,99.02417,331206
8165,iKlsR,1,0.00030,327975,99.02447,331206
8166,ilmoeuro,1,0.00030,327976,99.02478,331206
8167,imbapunch,1,0.00030,327977,99.02508,331206
8168,inawayyoullneverknow,1,0.00030,327978,99.02538,331206
8169,includeLuka,1,0.00030,327979,99.02568,331206
8170,indexart,1,0.00030,327980,99.02598,331206
8171,infamousflame,1,0.00030,327981,99.02629,331206
8172,inferno986return,1,0.00030,327982,99.02659,331206
8173,infosisio,1,0.00030,327983,99.02689,331206
8174,ingiman1,1,0.00030,327984,99.02719,331206
8175,iniyanijoseph,1,0.00030,327985,99.02749,331206
8176,inkcomic,1,0.00030,327986,99.02780,331206
8177,Inreal,1,0.00030,327987,99.02810,331206
8178,Insiyaa,1,0.00030,327988,99.02840,331206
8179,Instaloid,1,0.00030,327989,99.02870,331206
8180,int010h,1,0.00030,327990,99.02900,331206
8181,intothi,1,0.00030,327991,99.02931,331206
8182,ipeerbhai,1,0.00030,327992,99.02961,331206
8183,iqualfragile,1,0.00030,327993,99.02991,331206
8184,irestone,1,0.00030,327994,99.03021,331206
8185,isaacbunsen,1,0.00030,327995,99.03051,331206
8186,Isfaaq,1,0.00030,327996,99.03081,331206
8187,isibley765,1,0.00030,327997,99.03112,331206
8188,isidentical,1,0.00030,327998,99.03142,331206
8189,Ismel94,1,0.00030,327999,99.03172,331206
8190,issacasimov,1,0.00030,328000,99.03202,331206
8191,Italo-Vieira,1,0.00030,328001,99.03232,331206
8192,itbrandonsilva,1,0.00030,328002,99.03263,331206
8193,IvanF,1,0.00030,328003,99.03293,331206
8194,ivansla,1,0.00030,328004,99.03323,331206
8195,Ivan-Veselov,1,0.00030,328005,99.03353,331206
8196,IVHM,1,0.00030,328006,99.03383,331206
8197,Ivoch,1,0.00030,328007,99.03414,331206
8198,j3d42,1,0.00030,328008,99.03444,331206
8199,jabarrera,1,0.00030,328009,99.03474,331206
8200,ja-brouil,1,0.00030,328010,99.03504,331206
8201,jacereda,1,0.00030,328011,99.03534,331206
8202,JackAidley,1,0.00030,328012,99.03565,331206
8203,jackbondpreston,1,0.00030,328013,99.03595,331206
8204,jackhumbert,1,0.00030,328014,99.03625,331206
8205,jackkinsey,1,0.00030,328015,99.03655,331206
8206,JackLenz92,1,0.00030,328016,99.03685,331206
8207,Jackn1fe,1,0.00030,328017,99.03716,331206
8208,JackToaster,1,0.00030,328018,99.03746,331206
8209,jack-vo,1,0.00030,328019,99.03776,331206
8210,JacobMillward,1,0.00030,328020,99.03806,331206
8211,Jaden-Giordano,1,0.00030,328021,99.03836,331206
8212,jaehallen,1,0.00030,328022,99.03866,331206
8213,jagannath-rath,1,0.00030,328023,99.03897,331206
8214,jahndis,1,0.00030,328024,99.03927,331206
8215,jahu00,1,0.00030,328025,99.03957,331206
8216,JakeBaumbaugh,1,0.00030,328026,99.03987,331206
8217,jakefriend-dev,1,0.00030,328027,99.04017,331206
8218,jakeonaut,1,0.00030,328028,99.04048,331206
8219,jakimfett,1,0.00030,328029,99.04078,331206
8220,JakubDemocko,1,0.00030,328030,99.04108,331206
8221,jalex7,1,0.00030,328031,99.04138,331206
8222,jamad,1,0.00030,328032,99.04168,331206
8223,jamesdolan,1,0.00030,328033,99.04199,331206
8224,JamesK89,1,0.00030,328034,99.04229,331206
8225,jamesmcm,1,0.00030,328035,99.04259,331206
8226,James-San,1,0.00030,328036,99.04289,331206
8227,jamis-leblanc,1,0.00030,328037,99.04319,331206
8228,jancnahn,1,0.00030,328038,99.04350,331206
8229,JanDeMann,1,0.00030,328039,99.04380,331206
8230,janetromero,1,0.00030,328040,99.04410,331206
8231,Jantho1990,1,0.00030,328041,99.04440,331206
8232,jaredtjenkins,1,0.00030,328042,99.04470,331206
8233,JarnoVgr,1,0.00030,328043,99.04501,331206
8234,Jarodwr,1,0.00030,328044,99.04531,331206
8235,JarredAllen,1,0.00030,328045,99.04561,331206
8236,jarrellmark,1,0.00030,328046,99.04591,331206
8237,jarroddavis6889,1,0.00030,328047,99.04621,331206
8238,JaseyMitch,1,0.00030,328048,99.04651,331206
8239,JASGames,1,0.00030,328049,99.04682,331206
8240,jason-luxsonic,1,0.00030,328050,99.04712,331206
8241,jasonwolf493,1,0.00030,328051,99.04742,331206
8242,jasperdunn,1,0.00030,328052,99.04772,331206
8243,jaswanth05rongali,1,0.00030,328053,99.04802,331206
8244,JavierJF,1,0.00030,328054,99.04833,331206
8245,jayaarrgh,1,0.00030,328055,99.04863,331206
8246,JayBlueManchu,1,0.00030,328056,99.04893,331206
8247,jayCgee,1,0.00030,328057,99.04923,331206
8248,Jay-deFox,1,0.00030,328058,99.04953,331206
8249,JayHiserote,1,0.00030,328059,99.04984,331206
8250,Jayhost,1,0.00030,328060,99.05014,331206
8251,jay-jlm,1,0.00030,328061,99.05044,331206
8252,jay-tux,1,0.00030,328062,99.05074,331206
8253,jbenman,1,0.00030,328063,99.05104,331206
8254,jbibbo,1,0.00030,328064,99.05135,331206
8255,jcampbellcodes,1,0.00030,328065,99.05165,331206
8256,JCAPER,1,0.00030,328066,99.05195,331206
8257,jclc,1,0.00030,328067,99.05225,331206
8258,jcmonkey,1,0.00030,328068,99.05255,331206
8259,jcnauta,1,0.00030,328069,99.05286,331206
8260,jcrapsey,1,0.00030,328070,99.05316,331206
8261,JCruzMi,1,0.00030,328071,99.05346,331206
8262,jdboris,1,0.00030,328072,99.05376,331206
8263,jduhls,1,0.00030,328073,99.05406,331206
8264,Jean28518,1,0.00030,328074,99.05436,331206
8265,JeanKouss,1,0.00030,328075,99.05467,331206
8266,Jean-Low,1,0.00030,328076,99.05497,331206
8267,Jeb187,1,0.00030,328077,99.05527,331206
8268,Jedi18,1,0.00030,328078,99.05557,331206
8269,jedobson,1,0.00030,328079,99.05587,331206
8270,jeduden,1,0.00030,328080,99.05618,331206
8271,jeffkdev,1,0.00030,328081,99.05648,331206
8272,JeffPack,1,0.00030,328082,99.05678,331206
8273,jeffrimko,1,0.00030,328083,99.05708,331206
8274,jeffs,1,0.00030,328084,99.05738,331206
8275,J-E-Mc,1,0.00030,328085,99.05769,331206
8276,Jengamon,1,0.00030,328086,99.05799,331206
8277,JenniBee,1,0.00030,328087,99.05829,331206
8278,Jeremiah86,1,0.00030,328088,99.05859,331206
8279,jeremybullock,1,0.00030,328089,99.05889,331206
8280,Jerferson4,1,0.00030,328090,99.05920,331206
8281,jeroengerits,1,0.00030,328091,99.05950,331206
8282,jes,1,0.00030,328092,99.05980,331206
8283,Jess3Jane,1,0.00030,328093,99.06010,331206
8284,jesselawson,1,0.00030,328094,99.06040,331206
8285,jeudy-ua,1,0.00030,328095,99.06071,331206
8286,jfps7777,1,0.00030,328096,99.06101,331206
8287,jfreedman0212,1,0.00030,328097,99.06131,331206
8288,J-Guenther,1,0.00030,328098,99.06161,331206
8289,jh62,1,0.00030,328099,99.06191,331206
8290,jhud,1,0.00030,328100,99.06222,331206
8291,J-Ibarra,1,0.00030,328101,99.06252,331206
8292,jimbeauphloyd,1,0.00030,328102,99.06282,331206
8293,Jimbobbedyjobob,1,0.00030,328103,99.06312,331206
8294,jimon,1,0.00030,328104,99.06342,331206
8295,jimsrobot,1,0.00030,328105,99.06372,331206
8296,jitheeshsk,1,0.00030,328106,99.06403,331206
8297,Jjony-dev,1,0.00030,328107,99.06433,331206
8298,jjphung,1,0.00030,328108,99.06463,331206
8299,jjsonick,1,0.00030,328109,99.06493,331206
8300,jkunable,1,0.00030,328110,99.06523,331206
8301,JL2210,1,0.00030,328111,99.06554,331206
8302,jlabrecque44,1,0.00030,328112,99.06584,331206
8303,jldinh,1,0.00030,328113,99.06614,331206
8304,jmbjr,1,0.00030,328114,99.06644,331206
8305,jmo7,1,0.00030,328115,99.06674,331206
8306,jmruzik87,1,0.00030,328116,99.06705,331206
8307,jnune09,1,0.00030,328117,99.06735,331206
8308,joakin,1,0.00030,328118,99.06765,331206
8309,joanroig,1,0.00030,328119,99.06795,331206
8310,J-Ocelotl,1,0.00030,328120,99.06825,331206
8311,joebentley,1,0.00030,328121,99.06856,331206
8312,joenorton,1,0.00030,328122,99.06886,331206
8313,JoeshuaBaker,1,0.00030,328123,99.06916,331206
8314,j-oh,1,0.00030,328124,99.06946,331206
8315,johannmeyer,1,0.00030,328125,99.06976,331206
8316,John42506176Linux,1,0.00030,328126,99.07007,331206
8317,johnb-odplot,1,0.00030,328127,99.07037,331206
8318,Johnbpo,1,0.00030,328128,99.07067,331206
8319,johnkappa221,1,0.00030,328129,99.07097,331206
8320,JohnMeireles,1,0.00030,328130,99.07127,331206
8321,johnorchard,1,0.00030,328131,99.07157,331206
8322,JohnPablok,1,0.00030,328132,99.07188,331206
8323,johnzantey,1,0.00030,328133,99.07218,331206
8324,Jollyblu,1,0.00030,328134,99.07248,331206
8325,jomoho,1,0.00030,328135,99.07278,331206
8326,jonathancm,1,0.00030,328136,99.07308,331206
8327,JonathanTron,1,0.00030,328137,99.07339,331206
8328,JonathonReinhart,1,0.00030,328138,99.07369,331206
8329,JonBoyleCoding,1,0.00030,328139,99.07399,331206
8330,jonchoo,1,0.00030,328140,99.07429,331206
8331,Jonchun,1,0.00030,328141,99.07459,331206
8332,jonorozcoc,1,0.00030,328142,99.07490,331206
8333,jontopielski,1,0.00030,328143,99.07520,331206
8334,jo-onis,1,0.00030,328144,99.07550,331206
8335,jordanlis,1,0.00030,328145,99.07580,331206
8336,jordydickinson,1,0.00030,328146,99.07610,331206
8337,Jorhlok,1,0.00030,328147,99.07641,331206
8338,JorySchossau,1,0.00030,328148,99.07671,331206
8339,josedgm,1,0.00030,328149,99.07701,331206
8340,JosefKuchar,1,0.00030,328150,99.07731,331206
8341,JosephVoid,1,0.00030,328151,99.07761,331206
8342,josesoplar,1,0.00030,328152,99.07792,331206
8343,JoshMooney,1,0.00030,328153,99.07822,331206
8344,joshuaagega,1,0.00030,328154,99.07852,331206
8345,joshuadavidthomas,1,0.00030,328155,99.07882,331206
8346,joshuatam,1,0.00030,328156,99.07912,331206
8347,Josmark,1,0.00030,328157,99.07942,331206
8348,JosueReis,1,0.00030,328158,99.07973,331206
8349,josx,1,0.00030,328159,99.08003,331206
8350,Josy123,1,0.00030,328160,99.08033,331206
8351,jotakob,1,0.00030,328161,99.08063,331206
8352,Jotonan,1,0.00030,328162,99.08093,331206
8353,joyskmathew,1,0.00030,328163,99.08124,331206
8354,jpate-fortinet,1,0.00030,328164,99.08154,331206
8355,jprob,1,0.00030,328165,99.08184,331206
8356,jrc03c,1,0.00030,328166,99.08214,331206
8357,JrDanny,1,0.00030,328167,99.08244,331206
8358,jrkd,1,0.00030,328168,99.08275,331206
8359,jrosberg,1,0.00030,328169,99.08305,331206
8360,jrowny,1,0.00030,328170,99.08335,331206
8361,jruizluque,1,0.00030,328171,99.08365,331206
8362,jsamar1,1,0.00030,328172,99.08395,331206
8363,jsgrant,1,0.00030,328173,99.08426,331206
8364,JstCruzn86,1,0.00030,328174,99.08456,331206
8365,jtiai,1,0.00030,328175,99.08486,331206
8366,JTippetts,1,0.00030,328176,99.08516,331206
8367,jtrlombard,1,0.00030,328177,99.08546,331206
8368,jtuttle,1,0.00030,328178,99.08577,331206
8369,JU-2094,1,0.00030,328179,99.08607,331206
8370,juampapo546,1,0.00030,328180,99.08637,331206
8371,juanbrena,1,0.00030,328181,99.08667,331206
8372,JuanIsAFuckingAlpaca,1,0.00030,328182,99.08697,331206
8373,jugrigori,1,0.00030,328183,99.08727,331206
8374,JuKilg,1,0.00030,328184,99.08758,331206
8375,Julianobsg,1,0.00030,328185,99.08788,331206
8376,JulienDuranleau,1,0.00030,328186,99.08818,331206
8377,julroy67,1,0.00030,328187,99.08848,331206
8378,Jumblemuddle,1,0.00030,328188,99.08878,331206
8379,junpeikun,1,0.00030,328189,99.08909,331206
8380,jupiterjosh,1,0.00030,328190,99.08939,331206
8381,justcosmic,1,0.00030,328191,99.08969,331206
8382,JustElectron,1,0.00030,328192,99.08999,331206
8383,justgage,1,0.00030,328193,99.09029,331206
8384,Justin25,1,0.00030,328194,99.09060,331206
8385,justinlok,1,0.00030,328195,99.09090,331206
8386,JustKato,1,0.00030,328196,99.09120,331206
8387,justStand,1,0.00030,328197,99.09150,331206
8388,jvallejodagua,1,0.00030,328198,99.09180,331206
8389,jvcoutinho,1,0.00030,328199,99.09211,331206
8390,jw-0,1,0.00030,328200,99.09241,331206
8391,jwpirvi,1,0.00030,328201,99.09271,331206
8392,jzgenius,1,0.00030,328202,99.09301,331206
8393,k0105,1,0.00030,328203,99.09331,331206
8394,K0bin,1,0.00030,328204,99.09362,331206
8395,k0nfus1us,1,0.00030,328205,99.09392,331206
8396,K1ll3rM,1,0.00030,328206,99.09422,331206
8397,K3nIchi,1,0.00030,328207,99.09452,331206
8398,k4sma,1,0.00030,328208,99.09482,331206
8399,K9Crunch,1,0.00030,328209,99.09513,331206
8400,KableChannel,1,0.00030,328210,99.09543,331206
8401,kaespr,1,0.00030,328211,99.09573,331206
8402,KafeleW,1,0.00030,328212,99.09603,331206
8403,kaincenteno,1,0.00030,328213,99.09633,331206
8404,KaizNike,1,0.00030,328214,99.09663,331206
8405,kamchailo,1,0.00030,328215,99.09694,331206
8406,kameloov,1,0.00030,328216,99.09724,331206
8407,kamranrad1993,1,0.00030,328217,99.09754,331206
8408,kant1989,1,0.00030,328218,99.09784,331206
8409,kaozdl,1,0.00030,328219,99.09814,331206
8410,KappyMan,1,0.00030,328220,99.09845,331206
8411,karaketir16,1,0.00030,328221,99.09875,331206
8412,karismatic-megafauna,1,0.00030,328222,99.09905,331206
8413,karlpeter35,1,0.00030,328223,99.09935,331206
8414,KarlWerf,1,0.00030,328224,99.09965,331206
8415,karotofel,1,0.00030,328225,99.09996,331206
8416,KarstenHoehne,1,0.00030,328226,99.10026,331206
8417,karthikthanikai,1,0.00030,328227,99.10056,331206
8418,katp32,1,0.00030,328228,99.10086,331206
8419,kattiapina,1,0.00030,328229,99.10116,331206
8420,kazi7,1,0.00030,328230,99.10147,331206
8421,kazman1,1,0.00030,328231,99.10177,331206
8422,kdotca,1,0.00030,328232,99.10207,331206
8423,keeblebrox,1,0.00030,328233,99.10237,331206
8424,Keerpich,1,0.00030,328234,99.10267,331206
8425,kefik,1,0.00030,328235,99.10298,331206
8426,keipaglows,1,0.00030,328236,99.10328,331206
8427,keletsorabalao,1,0.00030,328237,99.10358,331206
8428,kelteseth,1,0.00030,328238,99.10388,331206
8429,keltwookie,1,0.00030,328239,99.10418,331206
8430,Kelzorz,1,0.00030,328240,99.10448,331206
8431,kennethmundt,1,0.00030,328241,99.10479,331206
8432,kenoph,1,0.00030,328242,99.10509,331206
8433,Kentarosan,1,0.00030,328243,99.10539,331206
8434,kesinger,1,0.00030,328244,99.10569,331206
8435,Kesnek,1,0.00030,328245,99.10599,331206
8436,kev9318,1,0.00030,328246,99.10630,331206
8437,KevinStephens,1,0.00030,328247,99.10660,331206
8438,KevMorelli,1,0.00030,328248,99.10690,331206
8439,keyle,1,0.00030,328249,99.10720,331206
8440,kezkabarra,1,0.00030,328250,99.10750,331206
8441,KezzB,1,0.00030,328251,99.10781,331206
8442,kforney,1,0.00030,328252,99.10811,331206
8443,kgene1,1,0.00030,328253,99.10841,331206
8444,khalid151,1,0.00030,328254,99.10871,331206
8445,KhegayIV,1,0.00030,328255,99.10901,331206
8446,Khrolon,1,0.00030,328256,99.10932,331206
8447,kia4king,1,0.00030,328257,99.10962,331206
8448,kickmaniac,1,0.00030,328258,99.10992,331206
8449,kidando,1,0.00030,328259,99.11022,331206
8450,kielse,1,0.00030,328260,99.11052,331206
8451,KierBear11,1,0.00030,328261,99.11083,331206
8452,kiesenverseist,1,0.00030,328262,99.11113,331206
8453,KillerJaguar,1,0.00030,328263,99.11143,331206
8454,killerkpoke,1,0.00030,328264,99.11173,331206
8455,Kiloku,1,0.00030,328265,99.11203,331206
8456,kimokee,1,0.00030,328266,99.11233,331206
8457,Kimuth,1,0.00030,328267,99.11264,331206
8458,kingarthurpt,1,0.00030,328268,99.11294,331206
8459,KingDuckZ,1,0.00030,328269,99.11324,331206
8460,kingmateos,1,0.00030,328270,99.11354,331206
8461,KINGUMS,1,0.00030,328271,99.11384,331206
8462,kinqsley,1,0.00030,328272,99.11415,331206
8463,kintrix007,1,0.00030,328273,99.11445,331206
8464,KiransHub,1,0.00030,328274,99.11475,331206
8465,kirawi,1,0.00030,328275,99.11505,331206
8466,kirgene,1,0.00030,328276,99.11535,331206
8467,kiriri,1,0.00030,328277,99.11566,331206
8468,kirkfriend,1,0.00030,328278,99.11596,331206
8469,kitaguchi0189,1,0.00030,328279,99.11626,331206
8470,KitleOyun,1,0.00030,328280,99.11656,331206
8471,kittenseater,1,0.00030,328281,99.11686,331206
8472,kivabolt,1,0.00030,328282,99.11717,331206
8473,KiwoTez,1,0.00030,328283,99.11747,331206
8474,kjcasey,1,0.00030,328284,99.11777,331206
8475,Klassix,1,0.00030,328285,99.11807,331206
8476,KlemensStrasser,1,0.00030,328286,99.11837,331206
8477,klerpi,1,0.00030,328287,99.11868,331206
8478,kmanpro,1,0.00030,328288,99.11898,331206
8479,kmare,1,0.00030,328289,99.11928,331206
8480,KMDES,1,0.00030,328290,99.11958,331206
8481,kmorales13,1,0.00030,328291,99.11988,331206
8482,kmphua,1,0.00030,328292,99.12019,331206
8483,Knalco,1,0.00030,328293,99.12049,331206
8484,Knochi,1,0.00030,328294,99.12079,331206
8485,knrewp,1,0.00030,328295,99.12109,331206
8486,knut-soltvedt,1,0.00030,328296,99.12139,331206
8487,knuxbbs,1,0.00030,328297,99.12169,331206
8488,Koblenix,1,0.00030,328298,99.12200,331206
8489,Kocannn,1,0.00030,328299,99.12230,331206
8490,kochol,1,0.00030,328300,99.12260,331206
8491,kode54,1,0.00030,328301,99.12290,331206
8492,Kolefn,1,0.00030,328302,99.12320,331206
8493,komputerboy,1,0.00030,328303,99.12351,331206
8494,Kornelijus,1,0.00030,328304,99.12381,331206
8495,Kotlet,1,0.00030,328305,99.12411,331206
8496,Kotzuo,1,0.00030,328306,99.12441,331206
8497,Kotzwinkle,1,0.00030,328307,99.12471,331206
8498,kpiorno,1,0.00030,328308,99.12502,331206
8499,kr0n4ik,1,0.00030,328309,99.12532,331206
8500,KrakenBlack,1,0.00030,328310,99.12562,331206
8501,Kramchay-Dig,1,0.00030,328311,99.12592,331206
8502,Kranioceros,1,0.00030,328312,99.12622,331206
8503,kristinalustig,1,0.00030,328313,99.12653,331206
8504,kristjanvalur,1,0.00030,328314,99.12683,331206
8505,Kritjan,1,0.00030,328315,99.12713,331206
8506,kriw,1,0.00030,328316,99.12743,331206
8507,KroanNL,1,0.00030,328317,99.12773,331206
8508,Kromonaut,1,0.00030,328318,99.12804,331206
8509,kronok,1,0.00030,328319,99.12834,331206
8510,krzysztof-dluzniewski,1,0.00030,328320,99.12864,331206
8511,KScorp,1,0.00030,328321,99.12894,331206
8512,ksdhans,1,0.00030,328322,99.12924,331206
8513,KSean222,1,0.00030,328323,99.12954,331206
8514,ksjogo,1,0.00030,328324,99.12985,331206
8515,ksthiele,1,0.00030,328325,99.13015,331206
8516,kthornsbury,1,0.00030,328326,99.13045,331206
8517,kujiu,1,0.00030,328327,99.13075,331206
8518,kulumani,1,0.00030,328328,99.13105,331206
8519,KurtBliss,1,0.00030,328329,99.13136,331206
8520,KurtYilmaz,1,0.00030,328330,99.13166,331206
8521,kushagra-shukla,1,0.00030,328331,99.13196,331206
8522,kusnadiliem,1,0.00030,328332,99.13226,331206
8523,kutetapolu,1,0.00030,328333,99.13256,331206
8524,Kwarf,1,0.00030,328334,99.13287,331206
8525,Kyle873,1,0.00030,328335,99.13317,331206
8526,Kyle-Truebird,1,0.00030,328336,99.13347,331206
8527,Laaas,1,0.00030,328337,99.13377,331206
8528,Lachlainn,1,0.00030,328338,99.13407,331206
8529,Ladvace,1,0.00030,328339,99.13438,331206
8530,laerus,1,0.00030,328340,99.13468,331206
8531,Lafender,1,0.00030,328341,99.13498,331206
8532,Laihela,1,0.00030,328342,99.13528,331206
8533,lakpo,1,0.00030,328343,99.13558,331206
8534,Lambdanaut,1,0.00030,328344,99.13589,331206
8535,LameGod,1,0.00030,328345,99.13619,331206
8536,LamLamLLC,1,0.00030,328346,99.13649,331206
8537,landgrafa,1,0.00030,328347,99.13679,331206
8538,lanskey,1,0.00030,328348,99.13709,331206
8539,LaPieza,1,0.00030,328349,99.13739,331206
8540,LapizGaming7751,1,0.00030,328350,99.13770,331206
8541,larryc5,1,0.00030,328351,99.13800,331206
8542,Larzans,1,0.00030,328352,99.13830,331206
8543,Laseph,1,0.00030,328353,99.13860,331206
8544,lassade,1,0.00030,328354,99.13890,331206
8545,Lattay,1,0.00030,328355,99.13921,331206
8546,laubblaeser,1,0.00030,328356,99.13951,331206
8547,LaureeGrd,1,0.00030,328357,99.13981,331206
8548,laurentva,1,0.00030,328358,99.14011,331206
8549,lavrod,1,0.00030,328359,99.14041,331206
8550,lazalong,1,0.00030,328360,99.14072,331206
8551,lben,1,0.00030,328361,99.14102,331206
8552,lchew,1,0.00030,328362,99.14132,331206
8553,ldmfield,1,0.00030,328363,99.14162,331206
8554,Lebowski1234,1,0.00030,328364,99.14192,331206
8555,LeCodeurDuDimanche,1,0.00030,328365,99.14223,331206
8556,LeekinGTA,1,0.00030,328366,99.14253,331206
8557,leesang0612,1,0.00030,328367,99.14283,331206
8558,leewonghao,1,0.00030,328368,99.14313,331206
8559,lekxandy,1,0.00030,328369,99.14343,331206
8560,lemilonkh,1,0.00030,328370,99.14374,331206
8561,Lemony-Andrew,1,0.00030,328371,99.14404,331206
8562,Lendemor,1,0.00030,328372,99.14434,331206
8563,lennyco,1,0.00030,328373,99.14464,331206
8564,leo1mml,1,0.00030,328374,99.14494,331206
8565,Leocesar3D,1,0.00030,328375,99.14524,331206
8566,leogout,1,0.00030,328376,99.14555,331206
8567,leoxs22,1,0.00030,328377,99.14585,331206
8568,Lerke,1,0.00030,328378,99.14615,331206
8569,let4be,1,0.00030,328379,99.14645,331206
8570,Lev227,1,0.00030,328380,99.14675,331206
8571,levifox54,1,0.00030,328381,99.14706,331206
8572,levis501,1,0.00030,328382,99.14736,331206
8573,levonravel,1,0.00030,328383,99.14766,331206
8574,Lexas,1,0.00030,328384,99.14796,331206
8575,lexwhitfield,1,0.00030,328385,99.14826,331206
8576,LGLTeam,1,0.00030,328386,99.14857,331206
8577,lhinuz,1,0.00030,328387,99.14887,331206
8578,LHolten,1,0.00030,328388,99.14917,331206
8579,libaniol,1,0.00030,328389,99.14947,331206
8580,Libbae,1,0.00030,328390,99.14977,331206
8581,lihop,1,0.00030,328391,99.15008,331206
8582,LiJinZhong,1,0.00030,328392,99.15038,331206
8583,Lindenk,1,0.00030,328393,99.15068,331206
8584,linuxfree2016,1,0.00030,328394,99.15098,331206
8585,linuxsocke,1,0.00030,328395,99.15128,331206
8586,linuxtopia,1,0.00030,328396,99.15159,331206
8587,linyngfly,1,0.00030,328397,99.15189,331206
8588,liQuydform,1,0.00030,328398,99.15219,331206
8589,litdeviant,1,0.00030,328399,99.15249,331206
8590,LL3006,1,0.00030,328400,99.15279,331206
8591,LLBlumire,1,0.00030,328401,99.15310,331206
8592,LloydAlmeida,1,0.00030,328402,99.15340,331206
8593,lmomimi,1,0.00030,328403,99.15370,331206
8594,load1n9,1,0.00030,328404,99.15400,331206
8595,lohmaster,1,0.00030,328405,99.15430,331206
8596,lokesh-sharma,1,0.00030,328406,99.15460,331206
8597,loksonarius,1,0.00030,328407,99.15491,331206
8598,LordBozo,1,0.00030,328408,99.15521,331206
8599,lorderb,1,0.00030,328409,99.15551,331206
8600,LordHexahedron,1,0.00030,328410,99.15581,331206
8601,LordOdin,1,0.00030,328411,99.15611,331206
8602,lordoverflowgit,1,0.00030,328412,99.15642,331206
8603,LordSyd,1,0.00030,328413,99.15672,331206
8604,lord-tomorrow,1,0.00030,328414,99.15702,331206
8605,LorenzoDeMarco,1,0.00030,328415,99.15732,331206
8606,Lorespo,1,0.00030,328416,99.15762,331206
8607,LothairKizardjian,1,0.00030,328417,99.15793,331206
8608,LouisCyfer,1,0.00030,328418,99.15823,331206
8609,Louis-Simon22,1,0.00030,328419,99.15853,331206
8610,Lozamded,1,0.00030,328420,99.15883,331206
8611,LRFLEW,1,0.00030,328421,99.15913,331206
8612,lucabelluccini,1,0.00030,328422,99.15944,331206
8613,lucasabrigido,1,0.00030,328423,99.15974,331206
8614,lucasmazzetto,1,0.00030,328424,99.16004,331206
8615,Lucaspec72,1,0.00030,328425,99.16034,331206
8616,lucianohd,1,0.00030,328426,99.16064,331206
8617,lucicam,1,0.00030,328427,99.16095,331206
8618,luckyuk,1,0.00030,328428,99.16125,331206
8619,lucmichalski,1,0.00030,328429,99.16155,331206
8620,ludamad,1,0.00030,328430,99.16185,331206
8621,luisfmnunes,1,0.00030,328431,99.16215,331206
8622,luizgcorreia,1,0.00030,328432,99.16245,331206
8623,luizpvas,1,0.00030,328433,99.16276,331206
8624,lukacat10,1,0.00030,328434,99.16306,331206
8625,lukapascuttini,1,0.00030,328435,99.16336,331206
8626,lukaskj,1,0.00030,328436,99.16366,331206
8627,LukasOfLockless,1,0.00030,328437,99.16396,331206
8628,LukeDeighton,1,0.00030,328438,99.16427,331206
8629,LukeJordanRogers,1,0.00030,328439,99.16457,331206
8630,lukeoftheaura,1,0.00030,328440,99.16487,331206
8631,lulucart,1,0.00030,328441,99.16517,331206
8632,luluco250,1,0.00030,328442,99.16547,331206
8633,Lunadin,1,0.00030,328443,99.16578,331206
8634,Lunadyn,1,0.00030,328444,99.16608,331206
8635,LunaticExperimentalist,1,0.00030,328445,99.16638,331206
8636,lurppa,1,0.00030,328446,99.16668,331206
8637,Luzkan,1,0.00030,328447,99.16698,331206
8638,Luzzotica,1,0.00030,328448,99.16729,331206
8639,Lwiredthefirst,1,0.00030,328449,99.16759,331206
8640,m133solomon,1,0.00030,328450,99.16789,331206
8641,m1ga,1,0.00030,328451,99.16819,331206
8642,m312z,1,0.00030,328452,99.16849,331206
8643,maackey,1,0.00030,328453,99.16880,331206
8644,MacAddict81,1,0.00030,328454,99.16910,331206
8645,MacgyverMartins,1,0.00030,328455,99.16940,331206
8646,machineman357,1,0.00030,328456,99.16970,331206
8647,macktns,1,0.00030,328457,99.17000,331206
8648,madamc,1,0.00030,328458,99.17030,331206
8649,MadamLaunch,1,0.00030,328459,99.17061,331206
8650,madelfagam,1,0.00030,328460,99.17091,331206
8651,madig,1,0.00030,328461,99.17121,331206
8652,MADJIHADx,1,0.00030,328462,99.17151,331206
8653,MadOgre,1,0.00030,328463,99.17181,331206
8654,Maenny,1,0.00030,328464,99.17212,331206
8655,maexono,1,0.00030,328465,99.17242,331206
8656,maghor3356,1,0.00030,328466,99.17272,331206
8657,magikmw,1,0.00030,328467,99.17302,331206
8658,MagischeMango,1,0.00030,328468,99.17332,331206
8659,mahfuz10,1,0.00030,328469,99.17363,331206
8660,maho,1,0.00030,328470,99.17393,331206
8661,maidnaut,1,0.00030,328471,99.17423,331206
8662,MajesticGames,1,0.00030,328472,99.17453,331206
8663,MajorBarnulf,1,0.00030,328473,99.17483,331206
8664,makuto,1,0.00030,328474,99.17514,331206
8665,Malinduums,1,0.00030,328475,99.17544,331206
8666,malkav182,1,0.00030,328476,99.17574,331206
8667,Maluco22,1,0.00030,328477,99.17604,331206
8668,Mandriausias,1,0.00030,328478,99.17634,331206
8669,MangelMaxime,1,0.00030,328479,99.17665,331206
8670,Manuel-Koenig,1,0.00030,328480,99.17695,331206
8671,Mapachana,1,0.00030,328481,99.17725,331206
8672,marcelocg,1,0.00030,328482,99.17755,331206
8673,marcosoldati,1,0.00030,328483,99.17785,331206
8674,MarcusJBell,1,0.00030,328484,99.17815,331206
8675,MarcusSvensson81,1,0.00030,328485,99.17846,331206
8676,marineorganism,1,0.00030,328486,99.17876,331206
8677,mariothedog,1,0.00030,328487,99.17906,331206
8678,MarkAlicz,1,0.00030,328488,99.17936,331206
8679,Markaroninoranor,1,0.00030,328489,99.17966,331206
8680,Markmsq,1,0.00030,328490,99.17997,331206
8681,marko995,1,0.00030,328491,99.18027,331206
8682,MarkoB-hub,1,0.00030,328492,99.18057,331206
8683,markoi,1,0.00030,328493,99.18087,331206
8684,marlboro,1,0.00030,328494,99.18117,331206
8685,MarmotLord,1,0.00030,328495,99.18148,331206
8686,marningmol,1,0.00030,328496,99.18178,331206
8687,marooncarl,1,0.00030,328497,99.18208,331206
8688,martfors,1,0.00030,328498,99.18238,331206
8689,martincohen,1,0.00030,328499,99.18268,331206
8690,martin-damien,1,0.00030,328500,99.18299,331206
8691,MartinGrignard,1,0.00030,328501,99.18329,331206
8692,MartiniMoe,1,0.00030,328502,99.18359,331206
8693,martin-jw,1,0.00030,328503,99.18389,331206
8694,Martin-Ziegler,1,0.00030,328504,99.18419,331206
8695,MartyLake,1,0.00030,328505,99.18450,331206
8696,marxama,1,0.00030,328506,99.18480,331206
8697,marynate,1,0.00030,328507,99.18510,331206
8698,mashmawsh,1,0.00030,328508,99.18540,331206
8699,masiafrest,1,0.00030,328509,99.18570,331206
8700,MasihAkbari,1,0.00030,328510,99.18601,331206
8701,masphel,1,0.00030,328511,99.18631,331206
8702,MassiminoilTrace,1,0.00030,328512,99.18661,331206
8703,Masterblop,1,0.00030,328513,99.18691,331206
8704,MasterGordon,1,0.00030,328514,99.18721,331206
8705,mastern2k3,1,0.00030,328515,99.18751,331206
8706,MasterrenderStudio,1,0.00030,328516,99.18782,331206
8707,Matceporial,1,0.00030,328517,99.18812,331206
8708,mateusbds,1,0.00030,328518,99.18842,331206
8709,MatheusPese,1,0.00030,328519,99.18872,331206
8710,Matheusrma,1,0.00030,328520,99.18902,331206
8711,matlawsky,1,0.00030,328521,99.18933,331206
8712,Matshiro,1,0.00030,328522,99.18963,331206
8713,MattAnderson1,1,0.00030,328523,99.18993,331206
8714,mattiaswerner,1,0.00030,328524,99.19023,331206
8715,mattmarch,1,0.00030,328525,99.19053,331206
8716,MattRCole,1,0.00030,328526,99.19084,331206
8717,mattstone22133,1,0.00030,328527,99.19114,331206
8718,mauriciomarinho2,1,0.00030,328528,99.19144,331206
8719,maxim27,1,0.00030,328529,99.19174,331206
8720,maximinus,1,0.00030,328530,99.19204,331206
8721,MaxMarauder,1,0.00030,328531,99.19235,331206
8722,maxqsoftware,1,0.00030,328532,99.19265,331206
8723,maxwellc055,1,0.00030,328533,99.19295,331206
8724,maxwellnewage,1,0.00030,328534,99.19325,331206
8725,maybe-dragon,1,0.00030,328535,99.19355,331206
8726,maykillmore,1,0.00030,328536,99.19386,331206
8727,maystey,1,0.00030,328537,99.19416,331206
8728,mbarbre1,1,0.00030,328538,99.19446,331206
8729,mbnoimi,1,0.00030,328539,99.19476,331206
8730,mc4man,1,0.00030,328540,99.19506,331206
8731,mcannamela,1,0.00030,328541,99.19536,331206
8732,mcbits,1,0.00030,328542,99.19567,331206
8733,mcbloch,1,0.00030,328543,99.19597,331206
8734,Mccloudo,1,0.00030,328544,99.19627,331206
8735,mckeengreg,1,0.00030,328545,99.19657,331206
8736,mcKrawll,1,0.00030,328546,99.19687,331206
8737,mcladyz,1,0.00030,328547,99.19718,331206
8738,MCoyne1234,1,0.00030,328548,99.19748,331206
8739,mcradcliffe2490,1,0.00030,328549,99.19778,331206
8740,mdamien,1,0.00030,328550,99.19808,331206
8741,mdante97,1,0.00030,328551,99.19838,331206
8742,mdelz,1,0.00030,328552,99.19869,331206
8743,MEBonham,1,0.00030,328553,99.19899,331206
8744,Mec-iS,1,0.00030,328554,99.19929,331206
8745,Meenit,1,0.00030,328555,99.19959,331206
8746,megavenik,1,0.00030,328556,99.19989,331206
8747,mehrdadSun,1,0.00030,328557,99.20020,331206
8748,Melech,1,0.00030,328558,99.20050,331206
8749,mellogrand,1,0.00030,328559,99.20080,331206
8750,meng2468,1,0.00030,328560,99.20110,331206
8751,Mercerenies,1,0.00030,328561,99.20140,331206
8752,mercurysama,1,0.00030,328562,99.20171,331206
8753,merriam,1,0.00030,328563,99.20201,331206
8754,Metalraptor,1,0.00030,328564,99.20231,331206
8755,metsawyr,1,0.00030,328565,99.20261,331206
8756,MeTuS12,1,0.00030,328566,99.20291,331206
8757,mfindlater,1,0.00030,328567,99.20321,331206
8758,MGageMorgan,1,0.00030,328568,99.20352,331206
8759,mgd,1,0.00030,328569,99.20382,331206
8760,MHarm,1,0.00030,328570,99.20412,331206
8761,mhd1msyb,1,0.00030,328571,99.20442,331206
8762,michaeltintiuc,1,0.00030,328572,99.20472,331206
8763,MicheleLambertucci,1,0.00030,328573,99.20503,331206
8764,michelveloso,1,0.00030,328574,99.20533,331206
8765,michhhh,1,0.00030,328575,99.20563,331206
8766,mick-p1982,1,0.00030,328576,99.20593,331206
8767,microcontroller,1,0.00030,328577,99.20623,331206
8768,micwu562,1,0.00030,328578,99.20654,331206
8769,MIfeanyi,1,0.00030,328579,99.20684,331206
8770,migliaccio,1,0.00030,328580,99.20714,331206
8771,MiguelAtTweddle,1,0.00030,328581,99.20744,331206
8772,Migzus,1,0.00030,328582,99.20774,331206
8773,Mika571,1,0.00030,328583,99.20805,331206
8774,mikatuo,1,0.00030,328584,99.20835,331206
8775,mikebow,1,0.00030,328585,99.20865,331206
8776,MikeFP,1,0.00030,328586,99.20895,331206
8777,MikeLorenz,1,0.00030,328587,99.20925,331206
8778,mikeweilgart,1,0.00030,328588,99.20956,331206
8779,mikke89,1,0.00030,328589,99.20986,331206
8780,mikrokode,1,0.00030,328590,99.21016,331206
8781,MilanVasko,1,0.00030,328591,99.21046,331206
8782,milesturin,1,0.00030,328592,99.21076,331206
8783,milkvolleyball,1,0.00030,328593,99.21107,331206
8784,mindspyke,1,0.00030,328594,99.21137,331206
8785,Minecraft-Beast101,1,0.00030,328595,99.21167,331206
8786,MinestarsTV,1,0.00030,328596,99.21197,331206
8787,minexew,1,0.00030,328597,99.21227,331206
8788,minilene,1,0.00030,328598,99.21257,331206
8789,MinimumEntropy,1,0.00030,328599,99.21288,331206
8790,MintArcade,1,0.00030,328600,99.21318,331206
8791,mipesom,1,0.00030,328601,99.21348,331206
8792,mironb2,1,0.00030,328602,99.21378,331206
8793,mishkarch,1,0.00030,328603,99.21408,331206
8794,Misignu,1,0.00030,328604,99.21439,331206
8795,MisterDave,1,0.00030,328605,99.21469,331206
8796,MisterMashu,1,0.00030,328606,99.21499,331206
8797,MitchReidNZ,1,0.00030,328607,99.21529,331206
8798,mitchwagner,1,0.00030,328608,99.21559,331206
8799,mitsuan,1,0.00030,328609,99.21590,331206
8800,miwgmail,1,0.00030,328610,99.21620,331206
8801,mjf-89,1,0.00030,328611,99.21650,331206
8802,mkadirtan,1,0.00030,328612,99.21680,331206
8803,MKosonen,1,0.00030,328613,99.21710,331206
8804,mlabbe,1,0.00030,328614,99.21741,331206
8805,mllev,1,0.00030,328615,99.21771,331206
8806,mlpfanboi,1,0.00030,328616,99.21801,331206
8807,mm-2018,1,0.00030,328617,99.21831,331206
8808,mmatyas,1,0.00030,328618,99.21861,331206
8809,MMMaellon,1,0.00030,328619,99.21892,331206
8810,m-morin,1,0.00030,328620,99.21922,331206
8811,mmxcrono,1,0.00030,328621,99.21952,331206
8812,mn113,1,0.00030,328622,99.21982,331206
8813,MNchino,1,0.00030,328623,99.22012,331206
8814,modernretrocoder,1,0.00030,328624,99.22042,331206
8815,MohabMohamed,1,0.00030,328625,99.22073,331206
8816,mohd874,1,0.00030,328626,99.22103,331206
8817,Mohini-byte,1,0.00030,328627,99.22133,331206
8818,Momfus,1,0.00030,328628,99.22163,331206
8819,Monajunjamma,1,0.00030,328629,99.22193,331206
8820,monotonehell,1,0.00030,328630,99.22224,331206
8821,monrekai,1,0.00030,328631,99.22254,331206
8822,monsieurpigeon,1,0.00030,328632,99.22284,331206
8823,mooglegiant,1,0.00030,328633,99.22314,331206
8824,MoonKnight0,1,0.00030,328634,99.22344,331206
8825,moonpixelgames,1,0.00030,328635,99.22375,331206
8826,MordragT,1,0.00030,328636,99.22405,331206
8827,morgash1989,1,0.00030,328637,99.22435,331206
8828,Morgul,1,0.00030,328638,99.22465,331206
8829,MorphlingZhou,1,0.00030,328639,99.22495,331206
8830,mosmetro,1,0.00030,328640,99.22526,331206
8831,Motherships,1,0.00030,328641,99.22556,331206
8832,mpicard,1,0.00030,328642,99.22586,331206
8833,MrBlackswordsman,1,0.00030,328643,99.22616,331206
8834,MrBlockers,1,0.00030,328644,99.22646,331206
8835,MrBSmith,1,0.00030,328645,99.22677,331206
8836,MrDiamondGold,1,0.00030,328646,99.22707,331206
8837,MrDingbat,1,0.00030,328647,99.22737,331206
8838,mrgreywater,1,0.00030,328648,99.22767,331206
8839,MrHoothoot,1,0.00030,328649,99.22797,331206
8840,mrkidc2,1,0.00030,328650,99.22827,331206
8841,MrMoon666,1,0.00030,328651,99.22858,331206
8842,MrNoobGuy,1,0.00030,328652,99.22888,331206
8843,MrPeace03,1,0.00030,328653,99.22918,331206
8844,MrSaberhagen,1,0.00030,328654,99.22948,331206
8845,MrSkee,1,0.00030,328655,99.22978,331206
8846,MrSlimeOfSlime,1,0.00030,328656,99.23009,331206
8847,MrWormHole,1,0.00030,328657,99.23039,331206
8848,MRxRadex,1,0.00030,328658,99.23069,331206
8849,mslsr,1,0.00030,328659,99.23099,331206
8850,mstave,1,0.00030,328660,99.23129,331206
8851,mstfacmly,1,0.00030,328661,99.23160,331206
8852,mswf,1,0.00030,328662,99.23190,331206
8853,MSylvia,1,0.00030,328663,99.23220,331206
8854,mszynawa,1,0.00030,328664,99.23250,331206
8855,Mtaethefarmer,1,0.00030,328665,99.23280,331206
8856,m-trigo,1,0.00030,328666,99.23311,331206
8857,mudbug-z,1,0.00030,328667,99.23341,331206
8858,muditsharma12111174,1,0.00030,328668,99.23371,331206
8859,MuffinLover42,1,0.00030,328669,99.23401,331206
8860,MugenHachi,1,0.00030,328670,99.23431,331206
8861,muhammadzein0321,1,0.00030,328671,99.23462,331206
8862,muiz6,1,0.00030,328672,99.23492,331206
8863,MumChamber,1,0.00030,328673,99.23522,331206
8864,MunsterPlop,1,0.00030,328674,99.23552,331206
8865,murt,1,0.00030,328675,99.23582,331206
8866,Murtagy,1,0.00030,328676,99.23612,331206
8867,mustii82,1,0.00030,328677,99.23643,331206
8868,muthu0914,1,0.00030,328678,99.23673,331206
8869,muzir,1,0.00030,328679,99.23703,331206
8870,mwarchulinski,1,0.00030,328680,99.23733,331206
8871,mwkroening,1,0.00030,328681,99.23763,331206
8872,myDisconnect,1,0.00030,328682,99.23794,331206
8873,myin142,1,0.00030,328683,99.23824,331206
8874,myood,1,0.00030,328684,99.23854,331206
8875,Myriachan,1,0.00030,328685,99.23884,331206
8876,MysticShadow117,1,0.00030,328686,99.23914,331206
8877,Mythos-Games,1,0.00030,328687,99.23945,331206
8878,Nachasic,1,0.00030,328688,99.23975,331206
8879,nachitoes,1,0.00030,328689,99.24005,331206
8880,Nachocss,1,0.00030,328690,99.24035,331206
8881,nadershamma,1,0.00030,328691,99.24065,331206
8882,NadimD,1,0.00030,328692,99.24096,331206
8883,nadorkb,1,0.00030,328693,99.24126,331206
8884,NaejDoree,1,0.00030,328694,99.24156,331206
8885,nafysbrhm,1,0.00030,328695,99.24186,331206
8886,nairdaen,1,0.00030,328696,99.24216,331206
8887,name111,1,0.00030,328697,99.24247,331206
8888,Narice,1,0.00030,328698,99.24277,331206
8889,Narven,1,0.00030,328699,99.24307,331206
8890,nasser,1,0.00030,328700,99.24337,331206
8891,NatanielBR,1,0.00030,328701,99.24367,331206
8892,nate-trojian,1,0.00030,328702,99.24398,331206
8893,Nate-Wilkins,1,0.00030,328703,99.24428,331206
8894,nathaniellam,1,0.00030,328704,99.24458,331206
8895,nathansmith339,1,0.00030,328705,99.24488,331206
8896,Nattie-G,1,0.00030,328706,99.24518,331206
8897,nausika,1,0.00030,328707,99.24548,331206
8898,nbourre,1,0.00030,328708,99.24579,331206
8899,nchiring,1,0.00030,328709,99.24609,331206
8900,nclbgsz,1,0.00030,328710,99.24639,331206
8901,ncthbrt,1,0.00030,328711,99.24669,331206
8902,necrose99,1,0.00030,328712,99.24699,331206
8903,Neo6666666,1,0.00030,328713,99.24730,331206
8904,neogn95,1,0.00030,328714,99.24760,331206
8905,NeoTheThird,1,0.00030,328715,99.24790,331206
8906,neowoods,1,0.00030,328716,99.24820,331206
8907,nerdblaze,1,0.00030,328717,99.24850,331206
8908,nervecenter,1,0.00030,328718,99.24881,331206
8909,NesterGlover,1,0.00030,328719,99.24911,331206
8910,nestor-2099,1,0.00030,328720,99.24941,331206
8911,net8floz,1,0.00030,328721,99.24971,331206
8912,Neur0s1s,1,0.00030,328722,99.25001,331206
8913,neuromnem,1,0.00030,328723,99.25032,331206
8914,nevreth,1,0.00030,328724,99.25062,331206
8915,newbie125,1,0.00030,328725,99.25092,331206
8916,Newbytee,1,0.00030,328726,99.25122,331206
8917,NewSpark311,1,0.00030,328727,99.25152,331206
8918,nghtstr,1,0.00030,328728,99.25183,331206
8919,nguillot,1,0.00030,328729,99.25213,331206
8920,nialna,1,0.00030,328730,99.25243,331206
8921,nicholasrobertm,1,0.00030,328731,99.25273,331206
8922,NicholasShatokhin,1,0.00030,328732,99.25303,331206
8923,nickcernis,1,0.00030,328733,99.25333,331206
8924,nickelghost,1,0.00030,328734,99.25364,331206
8925,NickelGhost,1,0.00030,328735,99.25394,331206
8926,Nickerchen,1,0.00030,328736,99.25424,331206
8927,nickkoro02,1,0.00030,328737,99.25454,331206
8928,Nickneim,1,0.00030,328738,99.25484,331206
8929,nickritter,1,0.00030,328739,99.25515,331206
8930,NickSacoman,1,0.00030,328740,99.25545,331206
8931,NickvdMeij,1,0.00030,328741,99.25575,331206
8932,NicolasBischof,1,0.00030,328742,99.25605,331206
8933,nicola-zen,1,0.00030,328743,99.25635,331206
8934,nicoraf,1,0.00030,328744,99.25666,331206
8935,NightGriffin,1,0.00030,328745,99.25696,331206
8936,NihilAleph,1,0.00030,328746,99.25726,331206
8937,nihiluis,1,0.00030,328747,99.25756,331206
8938,nikvaessen,1,0.00030,328748,99.25786,331206
8939,NinkuX,1,0.00030,328749,99.25817,331206
8940,NiQuan,1,0.00030,328750,99.25847,331206
8941,nitant96,1,0.00030,328751,99.25877,331206
8942,nitodico,1,0.00030,328752,99.25907,331206
8943,nixpc,1,0.00030,328753,99.25937,331206
8944,nj-designs,1,0.00030,328754,99.25968,331206
8945,njlr,1,0.00030,328755,99.25998,331206
8946,nklbdev,1,0.00030,328756,99.26028,331206
8947,Nnarol,1,0.00030,328757,99.26058,331206
8948,nobody0,1,0.00030,328758,99.26088,331206
8949,nobreconfrade,1,0.00030,328759,99.26118,331206
8950,nocivus,1,0.00030,328760,99.26149,331206
8951,Noemata,1,0.00030,328761,99.26179,331206
8952,Nomys,1,0.00030,328762,99.26209,331206
8953,NonADev,1,0.00030,328763,99.26239,331206
8954,nonoesimposible,1,0.00030,328764,99.26269,331206
8955,Noobie2014,1,0.00030,328765,99.26300,331206
8956,norda97,1,0.00030,328766,99.26330,331206
8957,nosklo,1,0.00030,328767,99.26360,331206
8958,Nosliwnayr,1,0.00030,328768,99.26390,331206
8959,NotHacker101,1,0.00030,328769,99.26420,331206
8960,NotHawthorne,1,0.00030,328770,99.26451,331206
8961,notme1560,1,0.00030,328771,99.26481,331206
8962,notzoom,1,0.00030,328772,99.26511,331206
8963,novovnz,1,0.00030,328773,99.26541,331206
8964,noxarivis,1,0.00030,328774,99.26571,331206
8965,npit,1,0.00030,328775,99.26602,331206
8966,npretto,1,0.00030,328776,99.26632,331206
8967,ntovas,1,0.00030,328777,99.26662,331206
8968,nucky9,1,0.00030,328778,99.26692,331206
8969,NuclearCookie,1,0.00030,328779,99.26722,331206
8970,Null-7,1,0.00030,328780,99.26753,331206
8971,null-digital,1,0.00030,328781,99.26783,331206
8972,nulledcc,1,0.00030,328782,99.26813,331206
8973,nullinsight,1,0.00030,328783,99.26843,331206
8974,NumberSixOx,1,0.00030,328784,99.26873,331206
8975,numerical25,1,0.00030,328785,99.26903,331206
8976,Nurot,1,0.00030,328786,99.26934,331206
8977,Nutcake,1,0.00030,328787,99.26964,331206
8978,NuxaHD,1,0.00030,328788,99.26994,331206
8979,nvianney,1,0.00030,328789,99.27024,331206
8980,Nwott,1,0.00030,328790,99.27054,331206
8981,NYPDK,1,0.00030,328791,99.27085,331206
8982,NyxCode,1,0.00030,328792,99.27115,331206
8983,OakenBow,1,0.00030,328793,99.27145,331206
8984,obedabit,1,0.00030,328794,99.27175,331206
8985,Oblugi,1,0.00030,328795,99.27205,331206
8986,ochesto,1,0.00030,328796,99.27236,331206
8987,octavz,1,0.00030,328797,99.27266,331206
8988,octimuz,1,0.00030,328798,99.27296,331206
8989,OdellDotson,1,0.00030,328799,99.27326,331206
8990,odynm,1,0.00030,328800,99.27356,331206
8991,odyzzey,1,0.00030,328801,99.27387,331206
8992,OFGONEN,1,0.00030,328802,99.27417,331206
8993,OgierDev,1,0.00030,328803,99.27447,331206
8994,OGPEEWEE59,1,0.00030,328804,99.27477,331206
8995,ogrotten,1,0.00030,328805,99.27507,331206
8996,ohsayan,1,0.00030,328806,99.27538,331206
8997,OIronPigO,1,0.00030,328807,99.27568,331206
8998,okardec,1,0.00030,328808,99.27598,331206
8999,olafvisker,1,0.00030,328809,99.27628,331206
9000,olav89,1,0.00030,328810,99.27658,331206
9001,olesya-wo,1,0.00030,328811,99.27689,331206
9002,oliverKuha,1,0.00030,328812,99.27719,331206
9003,oliverw,1,0.00030,328813,99.27749,331206
9004,olivierdalang,1,0.00030,328814,99.27779,331206
9005,olivierLefebvre96,1,0.00030,328815,99.27809,331206
9006,OlleSettergren,1,0.00030,328816,99.27839,331206
9007,Olteon,1,0.00030,328817,99.27870,331206
9008,OmnipotentPotato,1,0.00030,328818,99.27900,331206
9009,OneginIII,1,0.00030,328819,99.27930,331206
9010,oneseedfruit,1,0.00030,328820,99.27960,331206
9011,onionpsy,1,0.00030,328821,99.27990,331206
9012,Onirik79,1,0.00030,328822,99.28021,331206
9013,oprypin,1,0.00030,328823,99.28051,331206
9014,optlink,1,0.00030,328824,99.28081,331206
9015,Oracuda,1,0.00030,328825,99.28111,331206
9016,Orange-Bitflip,1,0.00030,328826,99.28141,331206
9017,orausch,1,0.00030,328827,99.28172,331206
9018,orbatos,1,0.00030,328828,99.28202,331206
9019,orestiskon,1,0.00030,328829,99.28232,331206
9020,OrigamiDev-Pete,1,0.00030,328830,99.28262,331206
9021,orion78fr,1,0.00030,328831,99.28292,331206
9022,oritZeFitret,1,0.00030,328832,99.28323,331206
9023,oscar4aar,1,0.00030,328833,99.28353,331206
9024,oscarduretto,1,0.00030,328834,99.28383,331206
9025,osmiumforge,1,0.00030,328835,99.28413,331206
9026,otakuf,1,0.00030,328836,99.28443,331206
9027,otoomet,1,0.00030,328837,99.28474,331206
9028,owengalenjones,1,0.00030,328838,99.28504,331206
9029,Oxel40,1,0.00030,328839,99.28534,331206
9030,ozebe,1,0.00030,328840,99.28564,331206
9031,paacardoso,1,0.00030,328841,99.28594,331206
9032,PablitotilbaP,1,0.00030,328842,99.28624,331206
9033,PabloMonfort,1,0.00030,328843,99.28655,331206
9034,packedstack,1,0.00030,328844,99.28685,331206
9035,Paha-Zul,1,0.00030,328845,99.28715,331206
9036,pakky94,1,0.00030,328846,99.28745,331206
9037,palrogg,1,0.00030,328847,99.28775,331206
9038,Pandaqi,1,0.00030,328848,99.28806,331206
9039,panesofglass,1,0.00030,328849,99.28836,331206
9040,panorb,1,0.00030,328850,99.28866,331206
9041,panshouren,1,0.00030,328851,99.28896,331206
9042,pantomimepony,1,0.00030,328852,99.28926,331206
9043,PanzerRavana,1,0.00030,328853,99.28957,331206
9044,papush,1,0.00030,328854,99.28987,331206
9045,Paquebot,1,0.00030,328855,99.29017,331206
9046,Paspartout,1,0.00030,328856,99.29047,331206
9047,patcorwin,1,0.00030,328857,99.29077,331206
9048,Patlol,1,0.00030,328858,99.29108,331206
9049,Pato-desu,1,0.00030,328859,99.29138,331206
9050,patriceperez,1,0.00030,328860,99.29168,331206
9051,patrick-motard,1,0.00030,328861,99.29198,331206
9052,Patrycja20000,1,0.00030,328862,99.29228,331206
9053,paulicka,1,0.00030,328863,99.29259,331206
9054,PaulsonH,1,0.00030,328864,99.29289,331206
9055,PaulZibert,1,0.00030,328865,99.29319,331206
9056,pbgamestudio,1,0.00030,328866,99.29349,331206
9057,pbzweihander,1,0.00030,328867,99.29379,331206
9058,pcoyoTheDayDreamer,1,0.00030,328868,99.29409,331206
9059,pcting,1,0.00030,328869,99.29440,331206
9060,pdfrod,1,0.00030,328870,99.29470,331206
9061,pduzinki,1,0.00030,328871,99.29500,331206
9062,Peatral,1,0.00030,328872,99.29530,331206
9063,pederbacher,1,0.00030,328873,99.29560,331206
9064,PedroMAdorno4,1,0.00030,328874,99.29591,331206
9065,peeet95,1,0.00030,328875,99.29621,331206
9066,peeterdog,1,0.00030,328876,99.29651,331206
9067,PepticPaladin,1,0.00030,328877,99.29681,331206
9068,Perfluoroalkyl,1,0.00030,328878,99.29711,331206
9069,peroman86,1,0.00030,328879,99.29742,331206
9070,pesto12,1,0.00030,328880,99.29772,331206
9071,pete3000a,1,0.00030,328881,99.29802,331206
9072,Petelavi,1,0.00030,328882,99.29832,331206
9073,petergloor,1,0.00030,328883,99.29862,331206
9074,peterjcarroll,1,0.00030,328884,99.29893,331206
9075,peterkingsbury,1,0.00030,328885,99.29923,331206
9076,PeterPansen,1,0.00030,328886,99.29953,331206
9077,PeterSeresAvy,1,0.00030,328887,99.29983,331206
9078,peter-todorov,1,0.00030,328888,99.30013,331206
9079,PeteX,1,0.00030,328889,99.30044,331206
9080,peteyycz,1,0.00030,328890,99.30074,331206
9081,petia-davidova,1,0.00030,328891,99.30104,331206
9082,PGrad,1,0.00030,328892,99.30134,331206
9083,pgyage3263,1,0.00030,328893,99.30164,331206
9084,phelipefox,1,0.00030,328894,99.30195,331206
9085,Phenomen,1,0.00030,328895,99.30225,331206
9086,phil-blain,1,0.00030,328896,99.30255,331206
9087,philipov,1,0.00030,328897,99.30285,331206
9088,Philip-Scott,1,0.00030,328898,99.30315,331206
9089,Philius342,1,0.00030,328899,99.30345,331206
9090,PhilWun,1,0.00030,328900,99.30376,331206
9091,Phobos1337,1,0.00030,328901,99.30406,331206
9092,phoe-krk,1,0.00030,328902,99.30436,331206
9093,PhoenixAran,1,0.00030,328903,99.30466,331206
9094,phoenixweiss,1,0.00030,328904,99.30496,331206
9095,PhoneixS,1,0.00030,328905,99.30527,331206
9096,Pierre-Narcisi,1,0.00030,328906,99.30557,331206
9097,PiGuyTheCoolGuy,1,0.00030,328907,99.30587,331206
9098,pikadon92,1,0.00030,328908,99.30617,331206
9099,pikol93,1,0.00030,328909,99.30647,331206
9100,pinellos,1,0.00030,328910,99.30678,331206
9101,PiOverFour,1,0.00030,328911,99.30708,331206
9102,piratechipgames,1,0.00030,328912,99.30738,331206
9103,Piripant,1,0.00030,328913,99.30768,331206
9104,pistea,1,0.00030,328914,99.30798,331206
9105,pitfritsch,1,0.00030,328915,99.30829,331206
9106,pivot5,1,0.00030,328916,99.30859,331206
9107,piXelicidio,1,0.00030,328917,99.30889,331206
9108,PixelNectar,1,0.00030,328918,99.30919,331206
9109,pixelr0,1,0.00030,328919,99.30949,331206
9110,piyush1104,1,0.00030,328920,99.30980,331206
9111,Pizzaernam,1,0.00030,328921,99.31010,331206
9112,Pkshields,1,0.00030,328922,99.31040,331206
9113,pkubaj,1,0.00030,328923,99.31070,331206
9114,PL3B3,1,0.00030,328924,99.31100,331206
9115,placasse,1,0.00030,328925,99.31130,331206
9116,planetxpress,1,0.00030,328926,99.31161,331206
9117,plangworthy,1,0.00030,328927,99.31191,331206
9118,PlasmaScreamTV,1,0.00030,328928,99.31221,331206
9119,plasticbomb1986,1,0.00030,328929,99.31251,331206
9120,PlatonCodes,1,0.00030,328930,99.31281,331206
9121,pmarcelll,1,0.00030,328931,99.31312,331206
9122,PMGRNTS,1,0.00030,328932,99.31342,331206
9123,PockelHockel,1,0.00030,328933,99.31372,331206
9124,podmentor,1,0.00030,328934,99.31402,331206
9125,Pofriel,1,0.00030,328935,99.31432,331206
9126,pohy,1,0.00030,328936,99.31463,331206
9127,pokemonchw,1,0.00030,328937,99.31493,331206
9128,pokon548,1,0.00030,328938,99.31523,331206
9129,polpoy,1,0.00030,328939,99.31553,331206
9130,polychromia,1,0.00030,328940,99.31583,331206
9131,PolyVector,1,0.00030,328941,99.31614,331206
9132,popcade,1,0.00030,328942,99.31644,331206
9133,PorkyFan,1,0.00030,328943,99.31674,331206
9134,possatti,1,0.00030,328944,99.31704,331206
9135,Poyo64,1,0.00030,328945,99.31734,331206
9136,pphysch,1,0.00030,328946,99.31765,331206
9137,pracedru,1,0.00030,328947,99.31795,331206
9138,pradeepbyju5,1,0.00030,328948,99.31825,331206
9139,PragmaticBeaver,1,0.00030,328949,99.31855,331206
9140,pratikprajapati30,1,0.00030,328950,99.31885,331206
9141,Prifurin,1,0.00030,328951,99.31915,331206
9142,PritAnmol,1,0.00030,328952,99.31946,331206
9143,pro100taA,1,0.00030,328953,99.31976,331206
9144,prock-fife,1,0.00030,328954,99.32006,331206
9145,produno,1,0.00030,328955,99.32036,331206
9146,PROGRAM-IX,1,0.00030,328956,99.32066,331206
9147,PROgramJEDI,1,0.00030,328957,99.32097,331206
9148,Programmer213,1,0.00030,328958,99.32127,331206
9149,ProgrammingLife,1,0.00030,328959,99.32157,331206
9150,ProHiScore,1,0.00030,328960,99.32187,331206
9151,prokopst,1,0.00030,328961,99.32217,331206
9152,pro-mole,1,0.00030,328962,99.32248,331206
9153,PrototypeNM1,1,0.00030,328963,99.32278,331206
9154,PROuserR,1,0.00030,328964,99.32308,331206
9155,Pseudopode,1,0.00030,328965,99.32338,331206
9156,psionic12,1,0.00030,328966,99.32368,331206
9157,pst123,1,0.00030,328967,99.32399,331206
9158,psychobeans,1,0.00030,328968,99.32429,331206
9159,Psykopear,1,0.00030,328969,99.32459,331206
9160,ptlthg,1,0.00030,328970,99.32489,331206
9161,ptrnycz,1,0.00030,328971,99.32519,331206
9162,Puthranps,1,0.00030,328972,99.32550,331206
9163,pwilkins,1,0.00030,328973,99.32580,331206
9164,pyloor,1,0.00030,328974,99.32610,331206
9165,pyroxar,1,0.00030,328975,99.32640,331206
9166,q2dg,1,0.00030,328976,99.32670,331206
9167,QatariGameDev,1,0.00030,328977,99.32700,331206
9168,qiulang,1,0.00030,328978,99.32731,331206
9169,qq624509330,1,0.00030,328979,99.32761,331206
9170,qtip,1,0.00030,328980,99.32791,331206
9171,Qu4k,1,0.00030,328981,99.32821,331206
9172,QuackDuckStudios,1,0.00030,328982,99.32851,331206
9173,quadraxas,1,0.00030,328983,99.32882,331206
9174,QuartzKnight,1,0.00030,328984,99.32912,331206
9175,qudware,1,0.00030,328985,99.32942,331206
9176,queer,1,0.00030,328986,99.32972,331206
9177,QuestofIranon,1,0.00030,328987,99.33002,331206
9178,r0l3k,1,0.00030,328988,99.33033,331206
9179,r3fio,1,0.00030,328989,99.33063,331206
9180,r6turboextreme,1,0.00030,328990,99.33093,331206
9181,raavan199,1,0.00030,328991,99.33123,331206
9182,Rabadonnn,1,0.00030,328992,99.33153,331206
9183,RabdPnguin,1,0.00030,328993,99.33184,331206
9184,rabensm,1,0.00030,328994,99.33214,331206
9185,radzo73,1,0.00030,328995,99.33244,331206
9186,rafael-abuawad,1,0.00030,328996,99.33274,331206
9187,RafaelHiguera,1,0.00030,328997,99.33304,331206
9188,rafaelpontes,1,0.00030,328998,99.33335,331206
9189,RafaRossi,1,0.00030,328999,99.33365,331206
9190,rafeu,1,0.00030,329000,99.33395,331206
9191,raffael0,1,0.00030,329001,99.33425,331206
9192,rafgp,1,0.00030,329002,99.33455,331206
9193,rafik-z,1,0.00030,329003,99.33486,331206
9194,rafoufoun,1,0.00030,329004,99.33516,331206
9195,RagingRoosevelt,1,0.00030,329005,99.33546,331206
9196,Ragnar293,1,0.00030,329006,99.33576,331206
9197,raincomplex,1,0.00030,329007,99.33606,331206
9198,rajasimon,1,0.00030,329008,99.33636,331206
9199,rajin-s,1,0.00030,329009,99.33667,331206
9200,Rallec,1,0.00030,329010,99.33697,331206
9201,Ralsei19,1,0.00030,329011,99.33727,331206
9202,rambda,1,0.00030,329012,99.33757,331206
9203,RamblerBot,1,0.00030,329013,99.33787,331206
9204,RamiAwar,1,0.00030,329014,99.33818,331206
9205,Rami-Slicer,1,0.00030,329015,99.33848,331206
9206,RamseyD,1,0.00030,329016,99.33878,331206
9207,RanaIsHere,1,0.00030,329017,99.33908,331206
9208,ranalytica,1,0.00030,329018,99.33938,331206
9209,randoum,1,0.00030,329019,99.33969,331206
9210,randyemens,1,0.00030,329020,99.33999,331206
9211,ranjian0,1,0.00030,329021,99.34029,331206
9212,ranmrdrakono,1,0.00030,329022,99.34059,331206
9213,RaoulMarz,1,0.00030,329023,99.34089,331206
9214,rasonage,1,0.00030,329024,99.34120,331206
9215,rattasak,1,0.00030,329025,99.34150,331206
9216,raulboo,1,0.00030,329026,99.34180,331206
9217,Raulvgz,1,0.00030,329027,99.34210,331206
9218,raunovillberg,1,0.00030,329028,99.34240,331206
9219,rawbitt,1,0.00030,329029,99.34271,331206
9220,ray314,1,0.00030,329030,99.34301,331206
9221,Rayek,1,0.00030,329031,99.34331,331206
9222,RaySisyphus,1,0.00030,329032,99.34361,331206
9223,rayxuln,1,0.00030,329033,99.34391,331206
9224,Rayzorblade23,1,0.00030,329034,99.34421,331206
9225,Razorback1911,1,0.00030,329035,99.34452,331206
9226,rdominick,1,0.00030,329036,99.34482,331206
9227,ReadmeCritic,1,0.00030,329037,99.34512,331206
9228,realmaster42,1,0.00030,329038,99.34542,331206
9229,rebertmatheus,1,0.00030,329039,99.34572,331206
9230,rechutox,1,0.00030,329040,99.34603,331206
9231,recloser,1,0.00030,329041,99.34633,331206
9232,redapple91,1,0.00030,329042,99.34663,331206
9233,redhoot-dev,1,0.00030,329043,99.34693,331206
9234,redmoss,1,0.00030,329044,99.34723,331206
9235,ReDucTor,1,0.00030,329045,99.34754,331206
9236,RedwanFox,1,0.00030,329046,99.34784,331206
9237,regniraj,1,0.00030,329047,99.34814,331206
9238,reimgrab,1,0.00030,329048,99.34844,331206
9239,Reiqy,1,0.00030,329049,99.34874,331206
9240,rektuiemforameme,1,0.00030,329050,99.34905,331206
9241,Remxb4,1,0.00030,329051,99.34935,331206
9242,Reparadocs,1,0.00030,329052,99.34965,331206
9243,Resonious,1,0.00030,329053,99.34995,331206
9244,retendo,1,0.00030,329054,99.35025,331206
9245,retro65,1,0.00030,329055,99.35056,331206
9246,Revanic,1,0.00030,329056,99.35086,331206
9247,revsyy,1,0.00030,329057,99.35116,331206
9248,Reyitgex,1,0.00030,329058,99.35146,331206
9249,reza86,1,0.00030,329059,99.35176,331206
9250,RFDaemoniac,1,0.00030,329060,99.35206,331206
9251,rgrcnh,1,0.00030,329061,99.35237,331206
9252,rhberro,1,0.00030,329062,99.35267,331206
9253,rheemcode,1,0.00030,329063,99.35297,331206
9254,ribhav99,1,0.00030,329064,99.35327,331206
9255,ricargoes,1,0.00030,329065,99.35357,331206
9256,richardeigenmann,1,0.00030,329066,99.35388,331206
9257,RichardMcAdam,1,0.00030,329067,99.35418,331206
9258,richard-porteous,1,0.00030,329068,99.35448,331206
9259,RichmondGame,1,0.00030,329069,99.35478,331206
9260,RIKDXHQ11,1,0.00030,329070,99.35508,331206
9261,rikedyp,1,0.00030,329071,99.35539,331206
9262,RilicTheFox,1,0.00030,329072,99.35569,331206
9263,RisaI,1,0.00030,329073,99.35599,331206
9264,RishabhRawat,1,0.00030,329074,99.35629,331206
9265,RiverHeart,1,0.00030,329075,99.35659,331206
9266,rivten,1,0.00030,329076,99.35690,331206
9267,rjungemann,1,0.00030,329077,99.35720,331206
9268,RKiemGames,1,0.00030,329078,99.35750,331206
9269,rlewicki,1,0.00030,329079,99.35780,331206
9270,rluis,1,0.00030,329080,99.35810,331206
9271,rmichaluszek,1,0.00030,329081,99.35841,331206
9272,roa-nyx,1,0.00030,329082,99.35871,331206
9273,roastchicken,1,0.00030,329083,99.35901,331206
9274,robertiancu,1,0.00030,329084,99.35931,331206
9275,robertlugg,1,0.00030,329085,99.35961,331206
9276,roberto-proenca,1,0.00030,329086,99.35991,331206
9277,RoboCafaz,1,0.00030,329087,99.36022,331206
9278,robodraif,1,0.00030,329088,99.36052,331206
9279,Robyo12121,1,0.00030,329089,99.36082,331206
9280,RocketBlueAutomation,1,0.00030,329090,99.36112,331206
9281,rockingdice,1,0.00030,329091,99.36142,331206
9282,rockisch,1,0.00030,329092,99.36173,331206
9283,rodimusX,1,0.00030,329093,99.36203,331206
9284,rodri042,1,0.00030,329094,99.36233,331206
9285,RodrigoMedeirosrRS,1,0.00030,329095,99.36263,331206
9286,rogerdv,1,0.00030,329096,99.36293,331206
9287,rogersteve97,1,0.00030,329097,99.36324,331206
9288,roguh,1,0.00030,329098,99.36354,331206
9289,roipoussiere,1,0.00030,329099,99.36384,331206
9290,RokaRoka,1,0.00030,329100,99.36414,331206
9291,rokit,1,0.00030,329101,99.36444,331206
9292,RomanKoziolek,1,0.00030,329102,99.36475,331206
9293,Rombersoft,1,0.00030,329103,99.36505,331206
9294,romikusumabakti,1,0.00030,329104,99.36535,331206
9295,RomualdDub,1,0.00030,329105,99.36565,331206
9296,RoniPerson,1,0.00030,329106,99.36595,331206
9297,Ronnyator,1,0.00030,329107,99.36626,331206
9298,ronsoule,1,0.00030,329108,99.36656,331206
9299,rosancoderian,1,0.00030,329109,99.36686,331206
9300,Rossosaurus,1,0.00030,329110,99.36716,331206
9301,RotateMe,1,0.00030,329111,99.36746,331206
9302,rotoglup,1,0.00030,329112,99.36777,331206
9303,Rottenburger,1,0.00030,329113,99.36807,331206
9304,rpsrosario,1,0.00030,329114,99.36837,331206
9305,rsquires,1,0.00030,329115,99.36867,331206
9306,rtSketo,1,0.00030,329116,99.36897,331206
9307,Rubakai,1,0.00030,329117,99.36927,331206
9308,rubenwardy,1,0.00030,329118,99.36958,331206
9309,rubyFeedback,1,0.00030,329119,99.36988,331206
9310,ruddles,1,0.00030,329120,99.37018,331206
9311,Rudyon,1,0.00030,329121,99.37048,331206
9312,rui-curado,1,0.00030,329122,99.37078,331206
9313,ruipsrosario,1,0.00030,329123,99.37109,331206
9314,rulijoh,1,0.00030,329124,99.37139,331206
9315,rumpfc,1,0.00030,329125,99.37169,331206
9316,Rumpunzel,1,0.00030,329126,99.37199,331206
9317,ruperstinsky,1,0.00030,329127,99.37229,331206
9318,russellsch,1,0.00030,329128,99.37260,331206
9319,russianhun,1,0.00030,329129,99.37290,331206
9320,RustanHakansson,1,0.00030,329130,99.37320,331206
9321,RustyStriker,1,0.00030,329131,99.37350,331206
9322,rvinuela,1,0.00030,329132,99.37380,331206
9323,Ryan1729,1,0.00030,329133,99.37411,331206
9324,RyeNixie,1,0.00030,329134,99.37441,331206
9325,Ryhon0,1,0.00030,329135,99.37471,331206
9326,ryu1981,1,0.00030,329136,99.37501,331206
9327,RyuShai,1,0.00030,329137,99.37531,331206
9328,rzil,1,0.00030,329138,99.37562,331206
9329,s1-en,1,0.00030,329139,99.37592,331206
9330,sadat-s-ahmed,1,0.00030,329140,99.37622,331206
9331,SAFAD,1,0.00030,329141,99.37652,331206
9332,sagartewari01,1,0.00030,329142,99.37682,331206
9333,SajeOne,1,0.00030,329143,99.37712,331206
9334,Sakull284,1,0.00030,329144,99.37743,331206
9335,salido-m,1,0.00030,329145,99.37773,331206
9336,saljic,1,0.00030,329146,99.37803,331206
9337,SamiDidier,1,0.00030,329147,99.37833,331206
9338,samsface,1,0.00030,329148,99.37863,331206
9339,samsindt,1,0.00030,329149,99.37894,331206
9340,samthemagicman,1,0.00030,329150,99.37924,331206
9341,samuale,1,0.00030,329151,99.37954,331206
9342,Samuel-Clarke123,1,0.00030,329152,99.37984,331206
9343,samuelGrahame,1,0.00030,329153,99.38014,331206
9344,SamVishwakarma,1,0.00030,329154,99.38045,331206
9345,sanchopanca,1,0.00030,329155,99.38075,331206
9346,SanderForGodot,1,0.00030,329156,99.38105,331206
9347,sandorex,1,0.00030,329157,99.38135,331206
9348,sankarsh98,1,0.00030,329158,99.38165,331206
9349,sankumar-ari,1,0.00030,329159,99.38196,331206
9350,SantiagoMenelao,1,0.00030,329160,99.38226,331206
9351,santiagopf,1,0.00030,329161,99.38256,331206
9352,sarbot,1,0.00030,329162,99.38286,331206
9353,SarojKumar10,1,0.00030,329163,99.38316,331206
9354,Sarvar12,1,0.00030,329164,99.38347,331206
9355,sashton,1,0.00030,329165,99.38377,331206
9356,SasoriOlkof,1,0.00030,329166,99.38407,331206
9357,SatishGodaPearl,1,0.00030,329167,99.38437,331206
9358,satrus08,1,0.00030,329168,99.38467,331206
9359,saulpalv,1,0.00030,329169,99.38497,331206
9360,saur9323,1,0.00030,329170,99.38528,331206
9361,saurabhtembhurne,1,0.00030,329171,99.38558,331206
9362,savorywatt,1,0.00030,329172,99.38588,331206
9363,savuori,1,0.00030,329173,99.38618,331206
9364,sboukortt,1,0.00030,329174,99.38648,331206
9365,sbruce,1,0.00030,329175,99.38679,331206
9366,sbward,1,0.00030,329176,99.38709,331206
9367,SchismDev,1,0.00030,329177,99.38739,331206
9368,Schmetzler,1,0.00030,329178,99.38769,331206
9369,schmurfy,1,0.00030,329179,99.38799,331206
9370,schraf,1,0.00030,329180,99.38830,331206
9371,Schranz0r,1,0.00030,329181,99.38860,331206
9372,scorsi,1,0.00030,329182,99.38890,331206
9373,scottluker,1,0.00030,329183,99.38920,331206
9374,Scottz0r,1,0.00030,329184,99.38950,331206
9375,scyq,1,0.00030,329185,99.38981,331206
9376,sdwfrost,1,0.00030,329186,99.39011,331206
9377,sdzyba,1,0.00030,329187,99.39041,331206
9378,s-e,1,0.00030,329188,99.39071,331206
9379,Seanfy,1,0.00030,329189,99.39101,331206
9380,seanputera,1,0.00030,329190,99.39132,331206
9381,searetseltev,1,0.00030,329191,99.39162,331206
9382,seaskyways,1,0.00030,329192,99.39192,331206
9383,seattleowl,1,0.00030,329193,99.39222,331206
9384,sebastianfast,1,0.00030,329194,99.39252,331206
9385,sebbeutler,1,0.00030,329195,99.39283,331206
9386,Sebjugate,1,0.00030,329196,99.39313,331206
9387,seedback,1,0.00030,329197,99.39343,331206
9388,seijihariki,1,0.00030,329198,99.39373,331206
9389,sekhat,1,0.00030,329199,99.39403,331206
9390,selamba,1,0.00030,329200,99.39433,331206
9391,selfReferentialName,1,0.00030,329201,99.39464,331206
9392,Seliniakolukos,1,0.00030,329202,99.39494,331206
9393,Senre,1,0.00030,329203,99.39524,331206
9394,SensArice,1,0.00030,329204,99.39554,331206
9395,senteix2,1,0.00030,329205,99.39584,331206
9396,sergiocanram,1,0.00030,329206,99.39615,331206
9397,seriousCoolness,1,0.00030,329207,99.39645,331206
9398,Servail,1,0.00030,329208,99.39675,331206
9399,Sesian007,1,0.00030,329209,99.39705,331206
9400,Setherino,1,0.00030,329210,99.39735,331206
9401,seththefirst,1,0.00030,329211,99.39766,331206
9402,Sevensidedmarble,1,0.00030,329212,99.39796,331206
9403,seyhbold,1,0.00030,329213,99.39826,331206
9404,SFilinsky,1,0.00030,329214,99.39856,331206
9405,sftblw,1,0.00030,329215,99.39886,331206
9406,sgamerw,1,0.00030,329216,99.39917,331206
9407,sgleto,1,0.00030,329217,99.39947,331206
9408,Sgt-Miller,1,0.00030,329218,99.39977,331206
9409,ShadeVivid,1,0.00030,329219,99.40007,331206
9410,Shadow1Raven,1,0.00030,329220,99.40037,331206
9411,ShadowKyogre,1,0.00030,329221,99.40068,331206
9412,shadycake,1,0.00030,329222,99.40098,331206
9413,Shahsavarzade,1,0.00030,329223,99.40128,331206
9414,shajj1234,1,0.00030,329224,99.40158,331206
9415,shalinsirwani,1,0.00030,329225,99.40188,331206
9416,shannonrothe,1,0.00030,329226,99.40218,331206
9417,ShantanuBalse,1,0.00030,329227,99.40249,331206
9418,sharp-94,1,0.00030,329228,99.40279,331206
9419,ShashankaNataraj,1,0.00030,329229,99.40309,331206
9420,shash-nerurkar,1,0.00030,329230,99.40339,331206
9421,Shaterpox,1,0.00030,329231,99.40369,331206
9422,Shavais,1,0.00030,329232,99.40400,331206
9423,sherden,1,0.00030,329233,99.40430,331206
9424,Shewebi,1,0.00030,329234,99.40460,331206
9425,Shilo,1,0.00030,329235,99.40490,331206
9426,shintaronippon,1,0.00030,329236,99.40520,331206
9427,ShivanshAnand,1,0.00030,329237,99.40551,331206
9428,shmlalex,1,0.00030,329238,99.40581,331206
9429,ShooterMG,1,0.00030,329239,99.40611,331206
9430,shrewdlogarithm,1,0.00030,329240,99.40641,331206
9431,shrnjad,1,0.00030,329241,99.40671,331206
9432,shroudedcode,1,0.00030,329242,99.40702,331206
9433,ShRyDeR,1,0.00030,329243,99.40732,331206
9434,shudaxia,1,0.00030,329244,99.40762,331206
9435,shvelo,1,0.00030,329245,99.40792,331206
9436,shweshiki,1,0.00030,329246,99.40822,331206
9437,ShyAnimeGirl,1,0.00030,329247,99.40853,331206
9438,shylicks,1,0.00030,329248,99.40883,331206
9439,shyn01,1,0.00030,329249,99.40913,331206
9440,ShyPixie,1,0.00030,329250,99.40943,331206
9441,Siberian-Cat,1,0.00030,329251,99.40973,331206
9442,sicarul,1,0.00030,329252,99.41003,331206
9443,sidsahay,1,0.00030,329253,99.41034,331206
9444,sielver,1,0.00030,329254,99.41064,331206
9445,SiENcE,1,0.00030,329255,99.41094,331206
9446,SigmaOne,1,0.00030,329256,99.41124,331206
9447,sihela,1,0.00030,329257,99.41154,331206
9448,sikub,1,0.00030,329258,99.41185,331206
9449,Silendel,1,0.00030,329259,99.41215,331206
9450,s-ilent,1,0.00030,329260,99.41245,331206
9451,silentorb,1,0.00030,329261,99.41275,331206
9452,Siler88,1,0.00030,329262,99.41305,331206
9453,Silinsar,1,0.00030,329263,99.41336,331206
9454,Silver1063,1,0.00030,329264,99.41366,331206
9455,SilverFoxA,1,0.00030,329265,99.41396,331206
9456,SilverLuke,1,0.00030,329266,99.41426,331206
9457,simaimch,1,0.00030,329267,99.41456,331206
9458,SimoFoto,1,0.00030,329268,99.41487,331206
9459,Simonah88,1,0.00030,329269,99.41517,331206
9460,SimoneBruhn,1,0.00030,329270,99.41547,331206
9461,SimoneStorai,1,0.00030,329271,99.41577,331206
9462,simonhowey,1,0.00030,329272,99.41607,331206
9463,SimplyCmd,1,0.00030,329273,99.41638,331206
9464,sinaiyuc,1,0.00030,329274,99.41668,331206
9465,singh2646,1,0.00030,329275,99.41698,331206
9466,SinghRupesh,1,0.00030,329276,99.41728,331206
9467,SinhtUp,1,0.00030,329277,99.41758,331206
9468,sinistro25,1,0.00030,329278,99.41788,331206
9469,sinni800,1,0.00030,329279,99.41819,331206
9470,SirBrott,1,0.00030,329280,99.41849,331206
9471,siriamez,1,0.00030,329281,99.41879,331206
9472,SirMoM,1,0.00030,329282,99.41909,331206
9473,Sirosky,1,0.00030,329283,99.41939,331206
9474,sirrius-a-b,1,0.00030,329284,99.41970,331206
9475,SirTates,1,0.00030,329285,99.42000,331206
9476,sitiom,1,0.00030,329286,99.42030,331206
9477,six519,1,0.00030,329287,99.42060,331206
9478,SiyahaS,1,0.00030,329288,99.42090,331206
9479,siyal343,1,0.00030,329289,99.42121,331206
9480,skang1,1,0.00030,329290,99.42151,331206
9481,SkeeVitch,1,0.00030,329291,99.42181,331206
9482,skemps,1,0.00030,329292,99.42211,331206
9483,skiibot,1,0.00030,329293,99.42241,331206
9484,Skintillion,1,0.00030,329294,99.42272,331206
9485,Skorpio-X,1,0.00030,329295,99.42302,331206
9486,skurwielstein,1,0.00030,329296,99.42332,331206
9487,skycook,1,0.00030,329297,99.42362,331206
9488,Slainlight,1,0.00030,329298,99.42392,331206
9489,slapin-omp,1,0.00030,329299,99.42423,331206
9490,SlashScreen,1,0.00030,329300,99.42453,331206
9491,slawo1605,1,0.00030,329301,99.42483,331206
9492,Sleaker,1,0.00030,329302,99.42513,331206
9493,SleepE,1,0.00030,329303,99.42543,331206
9494,Sliii,1,0.00030,329304,99.42574,331206
9495,SliverLIVE,1,0.00030,329305,99.42604,331206
9496,Slluxx,1,0.00030,329306,99.42634,331206
9497,slmjkdbtl,1,0.00030,329307,99.42664,331206
9498,sloneczko,1,0.00030,329308,99.42694,331206
9499,sluedecke,1,0.00030,329309,99.42724,331206
9500,slyd4r,1,0.00030,329310,99.42755,331206
9501,SmacArt,1,0.00030,329311,99.42785,331206
9502,Small-Develop,1,0.00030,329312,99.42815,331206
9503,smallporgies,1,0.00030,329313,99.42845,331206
9504,smark91,1,0.00030,329314,99.42875,331206
9505,Smashalidis,1,0.00030,329315,99.42906,331206
9506,smellynoname,1,0.00030,329316,99.42936,331206
9507,SmirNick,1,0.00030,329317,99.42966,331206
9508,smkplus,1,0.00030,329318,99.42996,331206
9509,SMLVG,1,0.00030,329319,99.43026,331206
9510,smolkat,1,0.00030,329320,99.43057,331206
9511,snakeskinsalamander,1,0.00030,329321,99.43087,331206
9512,sneaker333,1,0.00030,329322,99.43117,331206
9513,Snimchenko,1,0.00030,329323,99.43147,331206
9514,snkkid99,1,0.00030,329324,99.43177,331206
9515,socket220,1,0.00030,329325,99.43208,331206
9516,sodium-chloride,1,0.00030,329326,99.43238,331206
9517,soham0243,1,0.00030,329327,99.43268,331206
9518,SojanJanso,1,0.00030,329328,99.43298,331206
9519,solidmoose,1,0.00030,329329,99.43328,331206
9520,SoloCarryGuy,1,0.00030,329330,99.43359,331206
9521,solorvox,1,0.00030,329331,99.43389,331206
9522,somefoo,1,0.00030,329332,99.43419,331206
9523,Son-Goku89,1,0.00030,329333,99.43449,331206
9524,SonicZentropy,1,0.00030,329334,99.43479,331206
9525,sophienarwhal666,1,0.00030,329335,99.43509,331206
9526,Sorae,1,0.00030,329336,99.43540,331206
9527,SoSubtle,1,0.00030,329337,99.43570,331206
9528,sothys,1,0.00030,329338,99.43600,331206
9529,SoulKa,1,0.00030,329339,99.43630,331206
9530,Sourgin,1,0.00030,329340,99.43660,331206
9531,southpaw-decoy,1,0.00030,329341,99.43691,331206
9532,soyyo5159,1,0.00030,329342,99.43721,331206
9533,sp00mm,1,0.00030,329343,99.43751,331206
9534,spacehuhn,1,0.00030,329344,99.43781,331206
9535,spada-hk,1,0.00030,329345,99.43811,331206
9536,sparkskapil,1,0.00030,329346,99.43842,331206
9537,spazmantiz,1,0.00030,329347,99.43872,331206
9538,speedAde,1,0.00030,329348,99.43902,331206
9539,Speterius,1,0.00030,329349,99.43932,331206
9540,speters,1,0.00030,329350,99.43962,331206
9541,spinda,1,0.00030,329351,99.43993,331206
9542,splash21,1,0.00030,329352,99.44023,331206
9543,splinefx,1,0.00030,329353,99.44053,331206
9544,spongebob,1,0.00030,329354,99.44083,331206
9545,spookyblackbox,1,0.00030,329355,99.44113,331206
9546,sportshead,1,0.00030,329356,99.44144,331206
9547,spoutnickgp,1,0.00030,329357,99.44174,331206
9548,SpyrexDE,1,0.00030,329358,99.44204,331206
9549,srejv,1,0.00030,329359,99.44234,331206
9550,sstelfox,1,0.00030,329360,99.44264,331206
9551,SSytheMedia,1,0.00030,329361,99.44294,331206
9552,Stabington,1,0.00030,329362,99.44325,331206
9553,StarlkYT,1,0.00030,329363,99.44355,331206
9554,starlord1311,1,0.00030,329364,99.44385,331206
9555,stdio2016,1,0.00030,329365,99.44415,331206
9556,steambap,1,0.00030,329366,99.44445,331206
9557,steb-vs,1,0.00030,329367,99.44476,331206
9558,stefanbaur-neugelb,1,0.00030,329368,99.44506,331206
9559,stefanobieler,1,0.00030,329369,99.44536,331206
9560,steinm6,1,0.00030,329370,99.44566,331206
9561,stereoa,1,0.00030,329371,99.44596,331206
9562,stevematdavies,1,0.00030,329372,99.44627,331206
9563,Steven89Liu,1,0.00030,329373,99.44657,331206
9564,Stevie-O,1,0.00030,329374,99.44687,331206
9565,stewbasic,1,0.00030,329375,99.44717,331206
9566,stfnk,1,0.00030,329376,99.44747,331206
9567,sthiago,1,0.00030,329377,99.44778,331206
9568,StiliyanKushev,1,0.00030,329378,99.44808,331206
9569,stoladev,1,0.00030,329379,99.44838,331206
9570,storm36969,1,0.00030,329380,99.44868,331206
9571,StormFalcon32,1,0.00030,329381,99.44898,331206
9572,StormtekGames,1,0.00030,329382,99.44929,331206
9573,storyfeet,1,0.00030,329383,99.44959,331206
9574,StoykoDimitrov,1,0.00030,329384,99.44989,331206
9575,StradivariT,1,0.00030,329385,99.45019,331206
9576,StragaSevera,1,0.00030,329386,99.45049,331206
9577,Stralle,1,0.00030,329387,99.45079,331206
9578,strangebroadcasts,1,0.00030,329388,99.45110,331206
9579,StratoSil,1,0.00030,329389,99.45140,331206
9580,stratts,1,0.00030,329390,99.45170,331206
9581,strikie,1,0.00030,329391,99.45200,331206
9582,strongmuffin,1,0.00030,329392,99.45230,331206
9583,strzelaminat,1,0.00030,329393,99.45261,331206
9584,stuatk,1,0.00030,329394,99.45291,331206
9585,stuckne1,1,0.00030,329395,99.45321,331206
9586,stuckthread,1,0.00030,329396,99.45351,331206
9587,StUNt71,1,0.00030,329397,99.45381,331206
9588,subjectdenied,1,0.00030,329398,99.45412,331206
9589,suchaaver-chahal,1,0.00030,329399,99.45442,331206
9590,sudoguy,1,0.00030,329400,99.45472,331206
9591,suiradproject,1,0.00030,329401,99.45502,331206
9592,sunjam,1,0.00030,329402,99.45532,331206
9593,Supaplex77,1,0.00030,329403,99.45563,331206
9594,Supergeek,1,0.00030,329404,99.45593,331206
9595,superoven,1,0.00030,329405,99.45623,331206
9596,SuperPrower,1,0.00030,329406,99.45653,331206
9597,SuperSamus,1,0.00030,329407,99.45683,331206
9598,Supersonic112,1,0.00030,329408,99.45714,331206
9599,supertin,1,0.00030,329409,99.45744,331206
9600,surfer776,1,0.00030,329410,99.45774,331206
9601,surrealistichamster,1,0.00030,329411,99.45804,331206
9602,svanderweele,1,0.00030,329412,99.45834,331206
9603,svenfinke,1,0.00030,329413,99.45865,331206
9604,Svetomechc,1,0.00030,329414,99.45895,331206
9605,SwapnillTek,1,0.00030,329415,99.45925,331206
9606,swedgwood,1,0.00030,329416,99.45955,331206
9607,Swivelgames,1,0.00030,329417,99.45985,331206
9608,swojas,1,0.00030,329418,99.46015,331206
9609,swordofbling,1,0.00030,329419,99.46046,331206
9610,Synar,1,0.00030,329420,99.46076,331206
9611,SystemLogoff,1,0.00030,329421,99.46106,331206
9612,szmyd,1,0.00030,329422,99.46136,331206
9613,sztomi,1,0.00030,329423,99.46166,331206
9614,T0BiD,1,0.00030,329424,99.46197,331206
9615,t17dr,1,0.00030,329425,99.46227,331206
9616,t2dk49580,1,0.00030,329426,99.46257,331206
9617,TacoShank,1,0.00030,329427,99.46287,331206
9618,tadzik,1,0.00030,329428,99.46317,331206
9619,Tajnymag,1,0.00030,329429,99.46348,331206
9620,takeontom,1,0.00030,329430,99.46378,331206
9621,talickca,1,0.00030,329431,99.46408,331206
9622,Talops,1,0.00030,329432,99.46438,331206
9623,Talunava,1,0.00030,329433,99.46468,331206
9624,tangmi,1,0.00030,329434,99.46499,331206
9625,Tanjoodo,1,0.00030,329435,99.46529,331206
9626,tankorsmash,1,0.00030,329436,99.46559,331206
9627,TanosOP,1,0.00030,329437,99.46589,331206
9628,Tarkenton,1,0.00030,329438,99.46619,331206
9629,Tas-Hur,1,0.00030,329439,99.46650,331206
9630,Tattomoosa,1,0.00030,329440,99.46680,331206
9631,tawandachiteshe,1,0.00030,329441,99.46710,331206
9632,taylerallen6,1,0.00030,329442,99.46740,331206
9633,taylorhansen,1,0.00030,329443,99.46770,331206
9634,tB0nE,1,0.00030,329444,99.46800,331206
9635,TC1061,1,0.00030,329445,99.46831,331206
9636,tdo1,1,0.00030,329446,99.46861,331206
9637,Technipion,1,0.00030,329447,99.46891,331206
9638,Technius,1,0.00030,329448,99.46921,331206
9639,technobroken,1,0.00030,329449,99.46951,331206
9640,techtide,1,0.00030,329450,99.46982,331206
9641,TecoSV,1,0.00030,329451,99.47012,331206
9642,tedbrandston,1,0.00030,329452,99.47042,331206
9643,teknobilly,1,0.00030,329453,99.47072,331206
9644,Tenes,1,0.00030,329454,99.47102,331206
9645,terahlunah,1,0.00030,329455,99.47133,331206
9646,terater,1,0.00030,329456,99.47163,331206
9647,terids,1,0.00030,329457,99.47193,331206
9648,Test4436,1,0.00030,329458,99.47223,331206
9649,tfcat,1,0.00030,329459,99.47253,331206
9650,tghgg,1,0.00030,329460,99.47284,331206
9651,tGuMedia,1,0.00030,329461,99.47314,331206
9652,ThaddeusWilliams,1,0.00030,329462,99.47344,331206
9653,than10AM,1,0.00030,329463,99.47374,331206
9654,ThanosOP,1,0.00030,329464,99.47404,331206
9655,thatcashcow,1,0.00030,329465,99.47435,331206
9656,thbell,1,0.00030,329466,99.47465,331206
9657,TheAkashicTraveller,1,0.00030,329467,99.47495,331206
9658,TheArchitect4855,1,0.00030,329468,99.47525,331206
9659,TheArturZh,1,0.00030,329469,99.47555,331206
9660,theblacktiger59,1,0.00030,329470,99.47585,331206
9661,TheBoJaN,1,0.00030,329471,99.47616,331206
9662,theCanabrava,1,0.00030,329472,99.47646,331206
9663,thechubbypanda,1,0.00030,329473,99.47676,331206
9664,TheCleric,1,0.00030,329474,99.47706,331206
9665,thecocce,1,0.00030,329475,99.47736,331206
9666,TheDeafCreeper,1,0.00030,329476,99.47767,331206
9667,TheDriller,1,0.00030,329477,99.47797,331206
9668,TheExtremeGamer,1,0.00030,329478,99.47827,331206
9669,The-Foilist,1,0.00030,329479,99.47857,331206
9670,TheFoppian,1,0.00030,329480,99.47887,331206
9671,TheGameMakersGuide,1,0.00030,329481,99.47918,331206
9672,thegrumpybuffalo,1,0.00030,329482,99.47948,331206
9673,TheInterDan,1,0.00030,329483,99.47978,331206
9674,theitsloth,1,0.00030,329484,99.48008,331206
9675,thejustinwalsh,1,0.00030,329485,99.48038,331206
9676,TheLastOperator,1,0.00030,329486,99.48069,331206
9677,TheLazyLemur,1,0.00030,329487,99.48099,331206
9678,Themaker482,1,0.00030,329488,99.48129,331206
9679,theMiggsBoson,1,0.00030,329489,99.48159,331206
9680,theMotionblur,1,0.00030,329490,99.48189,331206
9681,Thenend,1,0.00030,329491,99.48220,331206
9682,TheNeverK,1,0.00030,329492,99.48250,331206
9683,thePostFuturist,1,0.00030,329493,99.48280,331206
9684,theraot,1,0.00030,329494,99.48310,331206
9685,TheRawMeatball,1,0.00030,329495,99.48340,331206
9686,TheRealMisterFix,1,0.00030,329496,99.48371,331206
9687,TheRealPhotonic,1,0.00030,329497,99.48401,331206
9688,ThereIs0Spoon,1,0.00030,329498,99.48431,331206
9689,TheRookie2018,1,0.00030,329499,99.48461,331206
9690,TheRubeThing,1,0.00030,329500,99.48491,331206
9691,TheSuspiciousWombat,1,0.00030,329501,99.48521,331206
9692,thetoblin,1,0.00030,329502,99.48552,331206
9693,TheTokenMaster,1,0.00030,329503,99.48582,331206
9694,thewilfen,1,0.00030,329504,99.48612,331206
9695,TheWrightDev,1,0.00030,329505,99.48642,331206
9696,thiagobruno,1,0.00030,329506,99.48672,331206
9697,Thijs-Riezebeek,1,0.00030,329507,99.48703,331206
9698,Think-Jumper,1,0.00030,329508,99.48733,331206
9699,ThirtyTwo-32,1,0.00030,329509,99.48763,331206
9700,ThisIsNoZaku,1,0.00030,329510,99.48793,331206
9701,thojaw,1,0.00030,329511,99.48823,331206
9702,thomas-alrek,1,0.00030,329512,99.48854,331206
9703,ThomasEckburg,1,0.00030,329513,99.48884,331206
9704,thomasedwards,1,0.00030,329514,99.48914,331206
9705,thomashodgkinson1987,1,0.00030,329515,99.48944,331206
9706,thomaswormann,1,0.00030,329516,99.48974,331206
9707,thomcraver,1,0.00030,329517,99.49005,331206
9708,Thorhian,1,0.00030,329518,99.49035,331206
9709,thrashmodule,1,0.00030,329519,99.49065,331206
9710,threethan,1,0.00030,329520,99.49095,331206
9711,thsu93,1,0.00030,329521,99.49125,331206
9712,thunderrabbit,1,0.00030,329522,99.49156,331206
9713,thurines,1,0.00030,329523,99.49186,331206
9714,TiagoBarbosa98,1,0.00030,329524,99.49216,331206
9715,Tiagoesc,1,0.00030,329525,99.49246,331206
9716,Tianmaru,1,0.00030,329526,99.49276,331206
9717,tiax615,1,0.00030,329527,99.49306,331206
9718,TiberiumPY,1,0.00030,329528,99.49337,331206
9719,tijmenennik,1,0.00030,329529,99.49367,331206
9720,tillre,1,0.00030,329530,99.49397,331206
9721,Tilmn,1,0.00030,329531,99.49427,331206
9722,tiltfox,1,0.00030,329532,99.49457,331206
9723,TimCoraxAudio,1,0.00030,329533,99.49488,331206
9724,Tim-Do,1,0.00030,329534,99.49518,331206
9725,TimHu6001,1,0.00030,329535,99.49548,331206
9726,timjo6789,1,0.00030,329536,99.49578,331206
9727,timokoesters,1,0.00030,329537,99.49608,331206
9728,TimOleSanmann,1,0.00030,329538,99.49639,331206
9729,TimStokes47,1,0.00030,329539,99.49669,331206
9730,TimurBahadir,1,0.00030,329540,99.49699,331206
9731,timvheck,1,0.00030,329541,99.49729,331206
9732,tinyogre,1,0.00030,329542,99.49759,331206
9733,titangamingglt,1,0.00030,329543,99.49790,331206
9734,titonova,1,0.00030,329544,99.49820,331206
9735,Tkap1,1,0.00030,329545,99.49850,331206
9736,ToadsworthLP,1,0.00030,329546,99.49880,331206
9737,tobiasbu,1,0.00030,329547,99.49910,331206
9738,toboRlivE,1,0.00030,329548,99.49941,331206
9739,toddmedema,1,0.00030,329549,99.49971,331206
9740,Todilo,1,0.00030,329550,99.50001,331206
9741,Toemsel,1,0.00030,329551,99.50031,331206
9742,tofutim,1,0.00030,329552,99.50061,331206
9743,Toiya,1,0.00030,329553,99.50091,331206
9744,to-jajav33,1,0.00030,329554,99.50122,331206
9745,tomankirilov,1,0.00030,329555,99.50152,331206
9746,tomansill,1,0.00030,329556,99.50182,331206
9747,tomc1998,1,0.00030,329557,99.50212,331206
9748,tomkun,1,0.00030,329558,99.50242,331206
9749,tommitytom,1,0.00030,329559,99.50273,331206
9750,tommy3,1,0.00030,329560,99.50303,331206
9751,tomsiw,1,0.00030,329561,99.50333,331206
9752,TongTungGiang,1,0.00030,329562,99.50363,331206
9753,tonycowan,1,0.00030,329563,99.50393,331206
9754,tonypuglieso,1,0.00030,329564,99.50424,331206
9755,tooldoctor,1,0.00030,329565,99.50454,331206
9756,topevidence,1,0.00030,329566,99.50484,331206
9757,TopShimmer,1,0.00030,329567,99.50514,331206
9758,topy72,1,0.00030,329568,99.50544,331206
9759,torkleyy,1,0.00030,329569,99.50575,331206
9760,TormentorMaharaj,1,0.00030,329570,99.50605,331206
9761,tortino,1,0.00030,329571,99.50635,331206
9762,Tottel,1,0.00030,329572,99.50665,331206
9763,Touitoui,1,0.00030,329573,99.50695,331206
9764,Toxlc,1,0.00030,329574,99.50726,331206
9765,toxub23,1,0.00030,329575,99.50756,331206
9766,tpwrules,1,0.00030,329576,99.50786,331206
9767,tragiccommons,1,0.00030,329577,99.50816,331206
9768,tragicmanner,1,0.00030,329578,99.50846,331206
9769,trajano,1,0.00030,329579,99.50876,331206
9770,Travistyse,1,0.00030,329580,99.50907,331206
9771,tre4b,1,0.00030,329581,99.50937,331206
9772,Triavanicus,1,0.00030,329582,99.50967,331206
9773,Trigve,1,0.00030,329583,99.50997,331206
9774,triplefox,1,0.00030,329584,99.51027,331206
9775,tripodsan,1,0.00030,329585,99.51058,331206
9776,tristongilley,1,0.00030,329586,99.51088,331206
9777,trolog,1,0.00030,329587,99.51118,331206
9778,trondsg,1,0.00030,329588,99.51148,331206
9779,Troutpack,1,0.00030,329589,99.51178,331206
9780,TrueBlueX,1,0.00030,329590,99.51209,331206
9781,trumanellis,1,0.00030,329591,99.51239,331206
9782,Trystan-SA,1,0.00030,329592,99.51269,331206
9783,tsheilds7,1,0.00030,329593,99.51299,331206
9784,TSOT7,1,0.00030,329594,99.51329,331206
9785,tsrite88,1,0.00030,329595,99.51360,331206
9786,tsrnc2,1,0.00030,329596,99.51390,331206
9787,TTorai,1,0.00030,329597,99.51420,331206
9788,Tubeliar,1,0.00030,329598,99.51450,331206
9789,tuket,1,0.00030,329599,99.51480,331206
9790,tumGER,1,0.00030,329600,99.51511,331206
9791,turbohz,1,0.00030,329601,99.51541,331206
9792,tuto193,1,0.00030,329602,99.51571,331206
9793,Twey,1,0.00030,329603,99.51601,331206
9794,twheys,1,0.00030,329604,99.51631,331206
9795,twincannon,1,0.00030,329605,99.51662,331206
9796,twirlimp,1,0.00030,329606,99.51692,331206
9797,tximiss,1,0.00030,329607,99.51722,331206
9798,txjohnson,1,0.00030,329608,99.51752,331206
9799,Tymonrare,1,0.00030,329609,99.51782,331206
9800,TynanSylvester,1,0.00030,329610,99.51812,331206
9801,typewriter1,1,0.00030,329611,99.51843,331206
9802,tyradeveloper,1,0.00030,329612,99.51873,331206
9803,Ubiw,1,0.00030,329613,99.51903,331206
9804,UchihaRetr0,1,0.00030,329614,99.51933,331206
9805,ueshita,1,0.00030,329615,99.51963,331206
9806,UgisProductMadness,1,0.00030,329616,99.51994,331206
9807,uheartbeast,1,0.00030,329617,99.52024,331206
9808,UKNightWatch,1,0.00030,329618,99.52054,331206
9809,umbravi,1,0.00030,329619,99.52084,331206
9810,umfk,1,0.00030,329620,99.52114,331206
9811,UnderGamerJ,1,0.00030,329621,99.52145,331206
9812,UngratefulFool,1,0.00030,329622,99.52175,331206
9813,unichat,1,0.00030,329623,99.52205,331206
9814,unit73e,1,0.00030,329624,99.52235,331206
9815,Unlimiter,1,0.00030,329625,99.52265,331206
9816,UnnoTed,1,0.00030,329626,99.52296,331206
9817,unorderedpizza,1,0.00030,329627,99.52326,331206
9818,Unpotable,1,0.00030,329628,99.52356,331206
9819,unreadable,1,0.00030,329629,99.52386,331206
9820,unTanana,1,0.00030,329630,99.52416,331206
9821,UrakAttack,1,0.00030,329631,99.52447,331206
9822,urholaukkarinen,1,0.00030,329632,99.52477,331206
9823,urothis,1,0.00030,329633,99.52507,331206
9824,useada,1,0.00030,329634,99.52537,331206
9825,user865,1,0.00030,329635,99.52567,331206
9826,user9747,1,0.00030,329636,99.52597,331206
9827,UsernameSArEHardD,1,0.00030,329637,99.52628,331206
9828,usersaurus,1,0.00030,329638,99.52658,331206
9829,UTilitieeees,1,0.00030,329639,99.52688,331206
9830,Va11hal1a,1,0.00030,329640,99.52718,331206
9831,Vadyanga,1,0.00030,329641,99.52748,331206
9832,vaisakhchandran,1,0.00030,329642,99.52779,331206
9833,valeriehalla,1,0.00030,329643,99.52809,331206
9834,Validifyed,1,0.00030,329644,99.52839,331206
9835,Valkrysa,1,0.00030,329645,99.52869,331206
9836,vallentin,1,0.00030,329646,99.52899,331206
9837,vansoest,1,0.00030,329647,99.52930,331206
9838,vantrung1993,1,0.00030,329648,99.52960,331206
9839,vaporlain,1,0.00030,329649,99.52990,331206
9840,VarolOkan,1,0.00030,329650,99.53020,331206
9841,VaZark,1,0.00030,329651,99.53050,331206
9842,Vedurumudi-Priyanka,1,0.00030,329652,99.53081,331206
9843,veermetri05,1,0.00030,329653,99.53111,331206
9844,veikolippand,1,0.00030,329654,99.53141,331206
9845,Velro,1,0.00030,329655,99.53171,331206
9846,velteyn,1,0.00030,329656,99.53201,331206
9847,Veryvast,1,0.00030,329657,99.53232,331206
9848,vgabler,1,0.00030,329658,99.53262,331206
9849,Viacheslav-Romanov,1,0.00030,329659,99.53292,331206
9850,vickyorlo,1,0.00030,329660,99.53322,331206
9851,ViddMan,1,0.00030,329661,99.53352,331206
9852,vidjogamer,1,0.00030,329662,99.53382,331206
9853,viiragon,1,0.00030,329663,99.53413,331206
9854,Viish,1,0.00030,329664,99.53443,331206
9855,vikasTmz,1,0.00030,329665,99.53473,331206
9856,viksl,1,0.00030,329666,99.53503,331206
9857,v-i-m,1,0.00030,329667,99.53533,331206
9858,vinaypoddar1,1,0.00030,329668,99.53564,331206
9859,vinchi9,1,0.00030,329669,99.53594,331206
9860,ViniciosLugli,1,0.00030,329670,99.53624,331206
9861,viniciusaportela,1,0.00030,329671,99.53654,331206
9862,vinimtex,1,0.00030,329672,99.53684,331206
9863,vinzenz,1,0.00030,329673,99.53715,331206
9864,Violettica,1,0.00030,329674,99.53745,331206
9865,virtualfish,1,0.00030,329675,99.53775,331206
9866,VirtualMaestro,1,0.00030,329676,99.53805,331206
9867,virtualpain,1,0.00030,329677,99.53835,331206
9868,vishtheshnu,1,0.00030,329678,99.53866,331206
9869,ViteFalcon,1,0.00030,329679,99.53896,331206
9870,vitorfgd,1,0.00030,329680,99.53926,331206
9871,Vizalkar,1,0.00030,329681,99.53956,331206
9872,vkubre,1,0.00030,329682,99.53986,331206
9873,vlad94568,1,0.00030,329683,99.54017,331206
9874,vladpazych,1,0.00030,329684,99.54047,331206
9875,vmd90,1,0.00030,329685,99.54077,331206
9876,VoidMagick,1,0.00030,329686,99.54107,331206
9877,Voltini,1,0.00030,329687,99.54137,331206
9878,vonedo3011,1,0.00030,329688,99.54167,331206
9879,voymasa,1,0.00030,329689,99.54198,331206
9880,vt5491,1,0.00030,329690,99.54228,331206
9881,Vulcwen,1,0.00030,329691,99.54258,331206
9882,vwood,1,0.00030,329692,99.54288,331206
9883,vyhgatfq,1,0.00030,329693,99.54318,331206
9884,vysmund,1,0.00030,329694,99.54349,331206
9885,w2qiao,1,0.00030,329695,99.54379,331206
9886,wafflepan,1,0.00030,329696,99.54409,331206
9887,wahming,1,0.00030,329697,99.54439,331206
9888,wakadoodle,1,0.00030,329698,99.54469,331206
9889,WakaJoekoe,1,0.00030,329699,99.54500,331206
9890,walkibe2015,1,0.00030,329700,99.54530,331206
9891,WalkingPlaces,1,0.00030,329701,99.54560,331206
9892,wallyfoo,1,0.00030,329702,99.54590,331206
9893,walstap,1,0.00030,329703,99.54620,331206
9894,wangell,1,0.00030,329704,99.54651,331206
9895,wangjianpeng,1,0.00030,329705,99.54681,331206
9896,wannabewallaby,1,0.00030,329706,99.54711,331206
9897,warner-programming,1,0.00030,329707,99.54741,331206
9898,warwicky,1,0.00030,329708,99.54771,331206
9899,WaterPower,1,0.00030,329709,99.54802,331206
9900,WatIsDeze,1,0.00030,329710,99.54832,331206
9901,Wavertron,1,0.00030,329711,99.54862,331206
9902,wayjake,1,0.00030,329712,99.54892,331206
9903,Waynesaurus,1,0.00030,329713,99.54922,331206
9904,weblate,1,0.00030,329714,99.54953,331206
9905,WebNuary,1,0.00030,329715,99.54983,331206
9906,Webzen92,1,0.00030,329716,99.55013,331206
9907,weirdo23,1,0.00030,329717,99.55043,331206
9908,welldiniz,1,0.00030,329718,99.55073,331206
9909,werererer,1,0.00030,329719,99.55103,331206
9910,WeRideForCoffee,1,0.00030,329720,99.55134,331206
9911,WesCook,1,0.00030,329721,99.55164,331206
9912,Wesxdz,1,0.00030,329722,99.55194,331206
9913,whatsmynameagain,1,0.00030,329723,99.55224,331206
9914,WhiskeyLake,1,0.00030,329724,99.55254,331206
9915,whysguy52,1,0.00030,329725,99.55285,331206
9916,wiki333,1,0.00030,329726,99.55315,331206
9917,wilbefast,1,0.00030,329727,99.55345,331206
9918,Wildcarde,1,0.00030,329728,99.55375,331206
9919,Wildos,1,0.00030,329729,99.55405,331206
9920,williamdsw,1,0.00030,329730,99.55436,331206
9921,William-Owen,1,0.00030,329731,99.55466,331206
9922,willmccullough,1,0.00030,329732,99.55496,331206
9923,WindAndNothing,1,0.00030,329733,99.55526,331206
9924,Windigo,1,0.00030,329734,99.55556,331206
9925,Windsdon,1,0.00030,329735,99.55587,331206
9926,WindWallk,1,0.00030,329736,99.55617,331206
9927,Winsalot,1,0.00030,329737,99.55647,331206
9928,WinstonHartnett,1,0.00030,329738,99.55677,331206
9929,Wircoark,1,0.00030,329739,99.55707,331206
9930,wisewoman547,1,0.00030,329740,99.55738,331206
9931,wisprabbit,1,0.00030,329741,99.55768,331206
9932,wmiler,1,0.00030,329742,99.55798,331206
9933,wojtossfm,1,0.00030,329743,99.55828,331206
9934,Wolfe2x7,1,0.00030,329744,99.55858,331206
9935,Wontoon,1,0.00030,329745,99.55888,331206
9936,wookoouk,1,0.00030,329746,99.55919,331206
9937,WOOSEUNGHOON,1,0.00030,329747,99.55949,331206
9938,worldsayshi,1,0.00030,329748,99.55979,331206
9939,woshichuanqilz,1,0.00030,329749,99.56009,331206
9940,wozeparrot,1,0.00030,329750,99.56039,331206
9941,Wraith1978,1,0.00030,329751,99.56070,331206
9942,wraitii,1,0.00030,329752,99.56100,331206
9943,wriddz,1,0.00030,329753,99.56130,331206
9944,wseng,1,0.00030,329754,99.56160,331206
9945,wt,1,0.00030,329755,99.56190,331206
9946,wtksana,1,0.00030,329756,99.56221,331206
9947,wuramspaul,1,0.00030,329757,99.56251,331206
9948,ww2commander,1,0.00030,329758,99.56281,331206
9949,wwjjbb,1,0.00030,329759,99.56311,331206
9950,wyckster,1,0.00030,329760,99.56341,331206
9951,wydgit,1,0.00030,329761,99.56372,331206
9952,wyemun,1,0.00030,329762,99.56402,331206
9953,wynoo,1,0.00030,329763,99.56432,331206
9954,xaagaar,1,0.00030,329764,99.56462,331206
9955,xag67,1,0.00030,329765,99.56492,331206
9956,xaguzman,1,0.00030,329766,99.56523,331206
9957,xalyes,1,0.00030,329767,99.56553,331206
9958,Xartorx,1,0.00030,329768,99.56583,331206
9959,XavianOgletree,1,0.00030,329769,99.56613,331206
9960,xdefoy-idcc,1,0.00030,329770,99.56643,331206
9961,Xebeth,1,0.00030,329771,99.56673,331206
9962,Xeonbg2,1,0.00030,329772,99.56704,331206
9963,xeoplatinium,1,0.00030,329773,99.56734,331206
9964,xeranas,1,0.00030,329774,99.56764,331206
9965,xerosugar,1,0.00030,329775,99.56794,331206
9966,xevinbox,1,0.00030,329776,99.56824,331206
9967,XexisKhan,1,0.00030,329777,99.56855,331206
9968,xhokir,1,0.00030,329778,99.56885,331206
9969,xiay-lcw,1,0.00030,329779,99.56915,331206
9970,xiico,1,0.00030,329780,99.56945,331206
9971,xo6a,1,0.00030,329781,99.56975,331206
9972,XoToM,1,0.00030,329782,99.57006,331206
9973,xpapad,1,0.00030,329783,99.57036,331206
9974,xSeditx,1,0.00030,329784,99.57066,331206
9975,xtpor,1,0.00030,329785,99.57096,331206
9976,xudz,1,0.00030,329786,99.57126,331206
9977,xukongwen,1,0.00030,329787,99.57157,331206
9978,xuv,1,0.00030,329788,99.57187,331206
9979,xuvatilavv,1,0.00030,329789,99.57217,331206
9980,xxDeathskillxx,1,0.00030,329790,99.57247,331206
9981,xXGOTNOFANSXx,1,0.00030,329791,99.57277,331206
9982,xxmatxx,1,0.00030,329792,99.57308,331206
9983,XxStuxnetxX,1,0.00030,329793,99.57338,331206
9984,y2k4life,1,0.00030,329794,99.57368,331206
9985,YaharaOctanis,1,0.00030,329795,99.57398,331206
9986,yakrell,1,0.00030,329796,99.57428,331206
9987,Yakud,1,0.00030,329797,99.57459,331206
9988,yalmanmfp,1,0.00030,329798,99.57489,331206
9989,Yam76,1,0.00030,329799,99.57519,331206
9990,YannKervran,1,0.00030,329800,99.57549,331206
9991,YannKh,1,0.00030,329801,99.57579,331206
9992,yarwelp,1,0.00030,329802,99.57609,331206
9993,YasmineBOU,1,0.00030,329803,99.57640,331206
9994,Yavmarto,1,0.00030,329804,99.57670,331206
9995,YeeshuRastogi,1,0.00030,329805,99.57700,331206
9996,YeloGalaxy,1,0.00030,329806,99.57730,331206
9997,yerbestpal,1,0.00030,329807,99.57760,331206
9998,yhcharles,1,0.00030,329808,99.57791,331206
9999,yhydra,1,0.00030,329809,99.57821,331206
10000,yichee,1,0.00030,329810,99.57851,331206
10001,yigitozdemir,1,0.00030,329811,99.57881,331206
10002,yongminparks,1,0.00030,329812,99.57911,331206
10003,yoonjoonso,1,0.00030,329813,99.57942,331206
10004,yorgje,1,0.00030,329814,99.57972,331206
10005,Yoshiyuka,1,0.00030,329815,99.58002,331206
10006,yougotwill,1,0.00030,329816,99.58032,331206
10007,YounesThabet,1,0.00030,329817,99.58062,331206
10008,Youngey339,1,0.00030,329818,99.58093,331206
10009,yscik,1,0.00030,329819,99.58123,331206
10010,yslo,1,0.00030,329820,99.58153,331206
10011,Ythundyth,1,0.00030,329821,99.58183,331206
10012,YulinAle,1,0.00030,329822,99.58213,331206
10013,yupaul,1,0.00030,329823,99.58244,331206
10014,YuruNekoMiko,1,0.00030,329824,99.58274,331206
10015,yvesns,1,0.00030,329825,99.58304,331206
10016,yzt123,1,0.00030,329826,99.58334,331206
10017,z0mbie42,1,0.00030,329827,99.58364,331206
10018,z4rdoz,1,0.00030,329828,99.58394,331206
10019,Zach777,1,0.00030,329829,99.58425,331206
10020,zachThePerson,1,0.00030,329830,99.58455,331206
10021,ZackyGameDev,1,0.00030,329831,99.58485,331206
10022,zagortenej,1,0.00030,329832,99.58515,331206
10023,Zamundaaa,1,0.00030,329833,99.58545,331206
10024,Zarasan,1,0.00030,329834,99.58576,331206
10025,zargy,1,0.00030,329835,99.58606,331206
10026,Zarkaa,1,0.00030,329836,99.58636,331206
10027,zarmath,1,0.00030,329837,99.58666,331206
10028,zatsme,1,0.00030,329838,99.58696,331206
10029,Zatsuwar,1,0.00030,329839,99.58727,331206
10030,zavijavasoft,1,0.00030,329840,99.58757,331206
10031,zbh2047,1,0.00030,329841,99.58787,331206
10032,zedrian,1,0.00030,329842,99.58817,331206
10033,zedwick,1,0.00030,329843,99.58847,331206
10034,ZEkA10000,1,0.00030,329844,99.58878,331206
10035,Zekronz,1,0.00030,329845,99.58908,331206
10036,Zennoe,1,0.00030,329846,99.58938,331206
10037,zero334,1,0.00030,329847,99.58968,331206
10038,zerweck,1,0.00030,329848,99.58998,331206
10039,zerxoxo,1,0.00030,329849,99.59029,331206
10040,ZeXtrasJay,1,0.00030,329850,99.59059,331206
10041,zhaytee,1,0.00030,329851,99.59089,331206
10042,zhuofeijian,1,0.00030,329852,99.59119,331206
10043,Zig-03,1,0.00030,329853,99.59149,331206
10044,ZikaaZ,1,0.00030,329854,99.59179,331206
10045,Zlrxyy,1,0.00030,329855,99.59210,331206
10046,zolizolizoli,1,0.00030,329856,99.59240,331206
10047,Zolzak,1,0.00030,329857,99.59270,331206
10048,Zoodinger,1,0.00030,329858,99.59300,331206
10049,zoopp,1,0.00030,329859,99.59330,331206
10050,zorq2,1,0.00030,329860,99.59361,331206
10051,Zottelchen,1,0.00030,329861,99.59391,331206
10052,Zulban,1,0.00030,329862,99.59421,331206
10053,zvoislav,1,0.00030,329863,99.59451,331206
10054,zyq0825,1,0.00030,329864,99.59481,331206
10055,zzyyxxww,1,0.00030,329865,99.59512,331206
